REG,PROV,CODAT,DESC,CESSUFFSC,CESSUFFSP,CESSUFFDI,CESSUFFAF,CESSUFFTOT,Anno
PIE,  ,A   ,"Agricoltura, silvicoltura pesca                             ",1,5,78,43,127,2024
PIE,  ,A 01,"Coltivazioni agricole e produzione di prodotti animali, c...",1,5,75,41,122,2024
PIE,  ,A 02,Silvicoltura ed utilizzo di aree forestali                  ,0,0,3,2,5,2024
PIE,  ,A 03,Pesca e acquacoltura                                        ,0,0,0,0,0,2024
PIE,  ,B   ,Estrazione di minerali da cave e miniere                    ,0,0,0,0,0,2024
PIE,  ,B 05,Estrazione di carbone (esclusa torba)                       ,0,0,0,0,0,2024
PIE,  ,B 06,Estraz.di petrolio greggio e di gas naturale                ,0,0,0,0,0,2024
PIE,  ,B 07,Estrazione di minerali metalliferi                          ,0,0,0,0,0,2024
PIE,  ,B 08,Altre attività di estrazione di minerali da cave e miniere  ,0,0,0,0,0,2024
PIE,  ,B 09,Attività dei servizi di supporto all'estrazione             ,0,0,0,0,0,2024
PIE,  ,C   ,Attività manifatturiere                                     ,90,109,51,47,297,2024
PIE,  ,C 10,Industrie alimentari                                        ,1,16,4,2,23,2024
PIE,  ,C 11,Industria delle bevande                                     ,1,1,0,1,3,2024
PIE,  ,C 12,Industria del tabacco                                       ,0,0,0,0,0,2024
PIE,  ,C 13,Industrie tessili                                           ,24,5,1,0,30,2024
PIE,  ,C 14,Confezione di articoli di abbigliamento; confezione di ar...,8,7,2,3,20,2024
PIE,  ,C 15,Fabbricazione di articoli in pelle e simili                 ,0,7,0,1,8,2024
PIE,  ,C 16,Industria del legno e dei prodotti in legno e sughero (es...,2,10,2,1,15,2024
PIE,  ,C 17,Fabbricazione di carta e di prodotti di carta               ,1,1,0,0,2,2024
PIE,  ,C 18,Stampa e riproduzione di supporti registrati                ,1,5,2,4,12,2024
PIE,  ,C 19,Fabbricazione di coke e prodotti derivanti dalla raffinaz...,0,0,0,0,0,2024
PIE,  ,C 20,Fabbricazione di prodotti chimici                           ,3,2,0,0,5,2024
PIE,  ,C 21,Fabbricazione di prodotti farmaceutici di base e di prepa...,0,0,0,0,0,2024
PIE,  ,C 22,Fabbricazione di articoli in gomma e materie plastiche      ,5,9,1,4,19,2024
PIE,  ,C 23,Fabbricazione di altri prodotti della lavorazione di miner..,3,3,3,1,10,2024
PIE,  ,C 24,Metallurgia                                                 ,1,1,0,0,2,2024
PIE,  ,C 25,Fabbricazione di prodotti in metallo (esclusi macchinari ...,13,24,19,14,70,2024
PIE,  ,C 26,Fabbricazione di computer e prodotti di elettronica e ott...,3,3,0,2,8,2024
PIE,  ,C 27,Fabbricazione di apparecchiature elettriche ed apparecchi...,4,1,2,3,10,2024
PIE,  ,C 28,Fabbricazione di macchinari ed apparecchiature nca          ,9,5,5,2,21,2024
PIE,  ,C 29,"Fabbricazione di autoveicoli, rimorchi e semirimorchi       ",5,2,2,2,11,2024
PIE,  ,C 30,Fabbricazione di altri mezzi di trasporto                   ,2,0,0,0,2,2024
PIE,  ,C 31,Fabbricazione di mobili                                     ,3,2,0,1,6,2024
PIE,  ,C 32,Altre industrie manifatturiere                              ,1,4,6,5,16,2024
PIE,  ,C 33,"Riparazione, manutenzione ed installazione di macchine ed...",0,1,2,1,4,2024
PIE,  ,D   ,"Fornitura di energia elettrica, gas, vapore e aria condiz...",2,0,0,0,2,2024
PIE,  ,D 35,"Fornitura di energia elettrica, gas, vapore e aria condiz...",2,0,0,0,2,2024
PIE,  ,E   ,"Fornitura di acqua; reti fognarie, attività di gestione d...",1,0,0,2,3,2024
PIE,  ,E 36,"Raccolta, trattamento e fornitura di acqua                  ",0,0,0,0,0,2024
PIE,  ,E 37,Gestione delle reti fognarie                                ,0,0,0,0,0,2024
PIE,  ,E 38,"Attività di raccolta, trattamento e smaltimento dei rifiu...",1,0,0,2,3,2024
PIE,  ,E 39,Attività di risanamento e altri servizi di gestione dei r...,0,0,0,0,0,2024
PIE,  ,F   ,Costruzioni                                                 ,73,45,267,102,487,2024
PIE,  ,F 41,Costruzione di edifici                                      ,47,33,37,58,175,2024
PIE,  ,F 42,Ingegneria civile                                           ,1,0,0,5,6,2024
PIE,  ,F 43,Lavori di costruzione specializzati                         ,25,12,230,39,306,2024
PIE,  ,G   ,Commercio all'ingrosso e al dettaglio; riparazione di aut...,141,192,129,36,498,2024
PIE,  ,G 45,Commercio all'ingrosso e al dettaglio e riparazione di au...,18,11,18,3,50,2024
PIE,  ,G 46,Commercio all'ingrosso (escluso quello di autoveicoli e d...,68,69,44,22,203,2024
PIE,  ,G 47,Commercio al dettaglio (escluso quello di autoveicoli e d...,55,112,67,11,245,2024
PIE,  ,H   ,Trasporto e magazzinaggio                                   ,14,14,17,102,147,2024
PIE,  ,H 49,Trasporto terrestre e mediante condotte                     ,8,12,17,35,72,2024
PIE,  ,H 50,Trasporto marittimo e per vie d'acqua                       ,0,0,0,0,0,2024
PIE,  ,H 51,Trasporto aereo                                             ,1,0,0,0,1,2024
PIE,  ,H 52,Magazzinaggio e attività di supporto ai trasporti           ,4,2,0,64,70,2024
PIE,  ,H 53,Servizi postali e attività di corriere                      ,1,0,0,3,4,2024
PIE,  ,I   ,Attività dei servizi alloggio e ristorazione                ,49,184,20,24,277,2024
PIE,  ,I 55,Alloggio                                                    ,4,6,0,1,11,2024
PIE,  ,I 56,Attività dei servizi di ristorazione                        ,45,178,20,23,266,2024
PIE,  ,J   ,Servizi di informazione e comunicazione                     ,17,11,3,22,53,2024
PIE,  ,J 58,Attività editoriali                                         ,2,2,0,4,8,2024
PIE,  ,J 59,"Attività di produzione cinematografica, di video e di pro...",1,0,0,2,3,2024
PIE,  ,J 60,Attività di programmazione e trasmissione                   ,2,1,0,1,4,2024
PIE,  ,J 61,Telecomunicazioni                                           ,1,4,1,0,6,2024
PIE,  ,J 62,"Produzione di software, consulenza informatica e attività...",6,1,2,4,13,2024
PIE,  ,J 63,Attività dei servizi d'informazione e altri servizi infor...,5,3,0,11,19,2024
PIE,  ,K   ,Attività finanziarie e assicurative                         ,7,9,13,0,29,2024
PIE,  ,K 64,Attività di servizi finanziari (escluse le assicurazioni ...,6,5,0,0,11,2024
PIE,  ,K 65,"Assicurazioni, riassicurazioni e fondi pensione (escluse ...",0,0,0,0,0,2024
PIE,  ,K 66,Attività ausiliarie dei servizi finanziari e delle attivi...,1,4,13,0,18,2024
PIE,  ,L   ,Attivita' immobiliari                                       ,28,48,4,94,174,2024
PIE,  ,L 68,Attivita' immobiliari                                       ,28,48,4,94,174,2024
PIE,  ,M   ,"Attività professionali, scientifiche e tecniche             ",38,22,8,24,92,2024
PIE,  ,M 69,Attività legali e contabilità                               ,2,1,0,2,5,2024
PIE,  ,M 70,Attività di direzione aziendale e di consulenza gestional...,14,6,1,10,31,2024
PIE,  ,M 71,Attività degli studi di architettura e d'ingegneria; coll...,4,5,0,3,12,2024
PIE,  ,M 72,Ricerca scientifica e sviluppo                              ,1,0,0,0,1,2024
PIE,  ,M 73,Pubblicità e ricerche di mercato                            ,8,3,3,5,19,2024
PIE,  ,M 74,"Altre attività professionali, scientifiche e tecniche       ",9,7,4,4,24,2024
PIE,  ,M 75,Servizi veterinari                                          ,0,0,0,0,0,2024
PIE,  ,N   ,"Noleggio, agenzie di viaggio, servizi di supporto alle im...",19,16,16,110,161,2024
PIE,  ,N 77,Attività di noleggio e leasing operativo                    ,5,2,1,1,9,2024
PIE,  ,N 78,"Attività di ricerca, selezione, fornitura di personale      ",0,0,0,1,1,2024
PIE,  ,N 79,"Attività dei servizi delle agenzie di viaggio, dei tour o...",1,0,0,1,2,2024
PIE,  ,N 80,Servizi di vigilanza e investigazione                       ,1,2,1,1,5,2024
PIE,  ,N 81,Attività di servizi per edifici e paesaggio                 ,5,5,8,68,86,2024
PIE,  ,N 82,Attività di supporto per le funzioni d'ufficio e altri se...,7,7,6,38,58,2024
PIE,  ,O   ,Amministrazione pubblica e difesa; assicurazione sociale ...,0,0,0,0,0,2024
PIE,  ,O 84,Amministrazione pubblica e difesa; assicurazione sociale ...,0,0,0,0,0,2024
PIE,  ,P   ,Istruzione                                                  ,2,4,0,10,16,2024
PIE,  ,P 85,Istruzione                                                  ,2,4,0,10,16,2024
PIE,  ,Q   ,Sanita' e assistenza sociale                                ,3,4,0,35,42,2024
PIE,  ,Q 86,Assistenza sanitaria                                        ,1,2,0,4,7,2024
PIE,  ,Q 87,Servizi di assistenza sociale residenziale                  ,1,1,0,3,5,2024
PIE,  ,Q 88,Assistenza sociale non residenziale                         ,1,1,0,28,30,2024
PIE,  ,R   ,"Attività artistiche, sportive, di intrattenimento e diver...",8,6,1,10,25,2024
PIE,  ,R 90,"Attività creative, artistiche e di intrattenimento          ",2,2,1,3,8,2024
PIE,  ,R 91,"Attività di biblioteche, archivi, musei ed altre attività...",0,0,0,1,1,2024
PIE,  ,R 92,"Attività riguardanti le lotterie, le scommesse, le case d...",1,0,0,0,1,2024
PIE,  ,R 93,"Attività sportive, di intrattenimento e di divertimento     ",5,4,0,6,15,2024
PIE,  ,S   ,Altre attività di servizi                                   ,12,13,14,14,53,2024
PIE,  ,S 94,Attività di organizzazioni associative                      ,0,0,0,1,1,2024
PIE,  ,S 95,Riparazione di computer e di beni per uso personale e per...,2,0,5,1,8,2024
PIE,  ,S 96,Altre attività di servizi per la persona                    ,10,13,9,12,44,2024
PIE,  ,T   ,Attività di famiglie e convivenze come datori di lavoro p...,0,0,0,0,0,2024
PIE,  ,T 97,Attività di famiglie e convivenze come datori di lavoro p...,0,0,0,0,0,2024
PIE,  ,T 98,Produzione di beni e servizi indifferenziati per uso prop...,0,0,0,0,0,2024
PIE,  ,U   ,Organizzazioni ed organismi extraterritoriali               ,0,0,0,0,0,2024
PIE,  ,U 99,Organizzazioni ed organismi extraterritoriali               ,0,0,0,0,0,2024
PIE,  ,XX  ,Imprese non classificate                                    ,90,235,6,130,461,2024
PIE,  ,TOT ,TOTALE                                                      ,595,917,627,805,2944,2024
PIE,TO,A   ,"Agricoltura, silvicoltura pesca                             ",1,0,5,6,12,2024
PIE,TO,A 01,"Coltivazioni agricole e produzione di prodotti animali, c...",1,0,5,6,12,2024
PIE,TO,A 02,Silvicoltura ed utilizzo di aree forestali                  ,0,0,0,0,0,2024
PIE,TO,A 03,Pesca e acquacoltura                                        ,0,0,0,0,0,2024
PIE,TO,B   ,Estrazione di minerali da cave e miniere                    ,0,0,0,0,0,2024
PIE,TO,B 05,Estrazione di carbone (esclusa torba)                       ,0,0,0,0,0,2024
PIE,TO,B 06,Estraz.di petrolio greggio e di gas naturale                ,0,0,0,0,0,2024
PIE,TO,B 07,Estrazione di minerali metalliferi                          ,0,0,0,0,0,2024
PIE,TO,B 08,Altre attività di estrazione di minerali da cave e miniere  ,0,0,0,0,0,2024
PIE,TO,B 09,Attività dei servizi di supporto all'estrazione             ,0,0,0,0,0,2024
PIE,TO,C   ,Attività manifatturiere                                     ,37,69,14,23,143,2024
PIE,TO,C 10,Industrie alimentari                                        ,1,5,1,0,7,2024
PIE,TO,C 11,Industria delle bevande                                     ,0,0,0,1,1,2024
PIE,TO,C 12,Industria del tabacco                                       ,0,0,0,0,0,2024
PIE,TO,C 13,Industrie tessili                                           ,0,3,0,0,3,2024
PIE,TO,C 14,Confezione di articoli di abbigliamento; confezione di ar...,2,3,1,0,6,2024
PIE,TO,C 15,Fabbricazione di articoli in pelle e simili                 ,0,3,0,0,3,2024
PIE,TO,C 16,Industria del legno e dei prodotti in legno e sughero (es...,2,7,1,1,11,2024
PIE,TO,C 17,Fabbricazione di carta e di prodotti di carta               ,0,1,0,0,1,2024
PIE,TO,C 18,Stampa e riproduzione di supporti registrati                ,0,4,0,3,7,2024
PIE,TO,C 19,Fabbricazione di coke e prodotti derivanti dalla raffinaz...,0,0,0,0,0,2024
PIE,TO,C 20,Fabbricazione di prodotti chimici                           ,2,1,0,0,3,2024
PIE,TO,C 21,Fabbricazione di prodotti farmaceutici di base e di prepa...,0,0,0,0,0,2024
PIE,TO,C 22,Fabbricazione di articoli in gomma e materie plastiche      ,3,7,0,3,13,2024
PIE,TO,C 23,Fabbricazione di altri prodotti della lavorazione di miner..,2,3,1,0,6,2024
PIE,TO,C 24,Metallurgia                                                 ,1,0,0,0,1,2024
PIE,TO,C 25,Fabbricazione di prodotti in metallo (esclusi macchinari ...,12,18,9,8,47,2024
PIE,TO,C 26,Fabbricazione di computer e prodotti di elettronica e ott...,2,3,0,1,6,2024
PIE,TO,C 27,Fabbricazione di apparecchiature elettriche ed apparecchi...,0,1,0,2,3,2024
PIE,TO,C 28,Fabbricazione di macchinari ed apparecchiature nca          ,2,4,0,0,6,2024
PIE,TO,C 29,"Fabbricazione di autoveicoli, rimorchi e semirimorchi       ",4,2,1,1,8,2024
PIE,TO,C 30,Fabbricazione di altri mezzi di trasporto                   ,2,0,0,0,2,2024
PIE,TO,C 31,Fabbricazione di mobili                                     ,2,2,0,0,4,2024
PIE,TO,C 32,Altre industrie manifatturiere                              ,0,1,0,3,4,2024
PIE,TO,C 33,"Riparazione, manutenzione ed installazione di macchine ed...",0,1,0,0,1,2024
PIE,TO,D   ,"Fornitura di energia elettrica, gas, vapore e aria condiz...",2,0,0,0,2,2024
PIE,TO,D 35,"Fornitura di energia elettrica, gas, vapore e aria condiz...",2,0,0,0,2,2024
PIE,TO,E   ,"Fornitura di acqua; reti fognarie, attività di gestione d...",1,0,0,2,3,2024
PIE,TO,E 36,"Raccolta, trattamento e fornitura di acqua                  ",0,0,0,0,0,2024
PIE,TO,E 37,Gestione delle reti fognarie                                ,0,0,0,0,0,2024
PIE,TO,E 38,"Attività di raccolta, trattamento e smaltimento dei rifiu...",1,0,0,2,3,2024
PIE,TO,E 39,Attività di risanamento e altri servizi di gestione dei r...,0,0,0,0,0,2024
PIE,TO,F   ,Costruzioni                                                 ,61,21,104,47,233,2024
PIE,TO,F 41,Costruzione di edifici                                      ,38,18,12,24,92,2024
PIE,TO,F 42,Ingegneria civile                                           ,1,0,0,4,5,2024
PIE,TO,F 43,Lavori di costruzione specializzati                         ,22,3,92,19,136,2024
PIE,TO,G   ,Commercio all'ingrosso e al dettaglio; riparazione di aut...,113,140,5,22,280,2024
PIE,TO,G 45,Commercio all'ingrosso e al dettaglio e riparazione di au...,15,9,3,2,29,2024
PIE,TO,G 46,Commercio all'ingrosso (escluso quello di autoveicoli e d...,53,57,1,12,123,2024
PIE,TO,G 47,Commercio al dettaglio (escluso quello di autoveicoli e d...,45,74,1,8,128,2024
PIE,TO,H   ,Trasporto e magazzinaggio                                   ,13,8,3,66,90,2024
PIE,TO,H 49,Trasporto terrestre e mediante condotte                     ,7,7,3,25,42,2024
PIE,TO,H 50,Trasporto marittimo e per vie d'acqua                       ,0,0,0,0,0,2024
PIE,TO,H 51,Trasporto aereo                                             ,1,0,0,0,1,2024
PIE,TO,H 52,Magazzinaggio e attività di supporto ai trasporti           ,4,1,0,38,43,2024
PIE,TO,H 53,Servizi postali e attività di corriere                      ,1,0,0,3,4,2024
PIE,TO,I   ,Attività dei servizi alloggio e ristorazione                ,43,101,3,8,155,2024
PIE,TO,I 55,Alloggio                                                    ,2,1,0,0,3,2024
PIE,TO,I 56,Attività dei servizi di ristorazione                        ,41,100,3,8,152,2024
PIE,TO,J   ,Servizi di informazione e comunicazione                     ,13,4,0,15,32,2024
PIE,TO,J 58,Attività editoriali                                         ,1,1,0,3,5,2024
PIE,TO,J 59,"Attività di produzione cinematografica, di video e di pro...",1,0,0,1,2,2024
PIE,TO,J 60,Attività di programmazione e trasmissione                   ,1,1,0,0,2,2024
PIE,TO,J 61,Telecomunicazioni                                           ,1,1,0,0,2,2024
PIE,TO,J 62,"Produzione di software, consulenza informatica e attività...",5,1,0,3,9,2024
PIE,TO,J 63,Attività dei servizi d'informazione e altri servizi infor...,4,0,0,8,12,2024
PIE,TO,K   ,Attività finanziarie e assicurative                         ,4,4,0,0,8,2024
PIE,TO,K 64,Attività di servizi finanziari (escluse le assicurazioni ...,3,3,0,0,6,2024
PIE,TO,K 65,"Assicurazioni, riassicurazioni e fondi pensione (escluse ...",0,0,0,0,0,2024
PIE,TO,K 66,Attività ausiliarie dei servizi finanziari e delle attivi...,1,1,0,0,2,2024
PIE,TO,L   ,Attivita' immobiliari                                       ,25,20,0,84,129,2024
PIE,TO,L 68,Attivita' immobiliari                                       ,25,20,0,84,129,2024
PIE,TO,M   ,"Attività professionali, scientifiche e tecniche             ",36,15,2,14,67,2024
PIE,TO,M 69,Attività legali e contabilità                               ,2,1,0,1,4,2024
PIE,TO,M 70,Attività di direzione aziendale e di consulenza gestional...,13,2,0,5,20,2024
PIE,TO,M 71,Attività degli studi di architettura e d'ingegneria; coll...,4,4,0,3,11,2024
PIE,TO,M 72,Ricerca scientifica e sviluppo                              ,1,0,0,0,1,2024
PIE,TO,M 73,Pubblicità e ricerche di mercato                            ,8,3,2,4,17,2024
PIE,TO,M 74,"Altre attività professionali, scientifiche e tecniche       ",8,5,0,1,14,2024
PIE,TO,M 75,Servizi veterinari                                          ,0,0,0,0,0,2024
PIE,TO,N   ,"Noleggio, agenzie di viaggio, servizi di supporto alle im...",19,9,6,52,86,2024
PIE,TO,N 77,Attività di noleggio e leasing operativo                    ,5,1,0,0,6,2024
PIE,TO,N 78,"Attività di ricerca, selezione, fornitura di personale      ",0,0,0,1,1,2024
PIE,TO,N 79,"Attività dei servizi delle agenzie di viaggio, dei tour o...",1,0,0,1,2,2024
PIE,TO,N 80,Servizi di vigilanza e investigazione                       ,1,2,0,0,3,2024
PIE,TO,N 81,Attività di servizi per edifici e paesaggio                 ,5,1,5,33,44,2024
PIE,TO,N 82,Attività di supporto per le funzioni d'ufficio e altri se...,7,5,1,17,30,2024
PIE,TO,O   ,Amministrazione pubblica e difesa; assicurazione sociale ...,0,0,0,0,0,2024
PIE,TO,O 84,Amministrazione pubblica e difesa; assicurazione sociale ...,0,0,0,0,0,2024
PIE,TO,P   ,Istruzione                                                  ,1,3,0,4,8,2024
PIE,TO,P 85,Istruzione                                                  ,1,3,0,4,8,2024
PIE,TO,Q   ,Sanita' e assistenza sociale                                ,3,3,0,13,19,2024
PIE,TO,Q 86,Assistenza sanitaria                                        ,1,1,0,2,4,2024
PIE,TO,Q 87,Servizi di assistenza sociale residenziale                  ,1,1,0,2,4,2024
PIE,TO,Q 88,Assistenza sociale non residenziale                         ,1,1,0,9,11,2024
PIE,TO,R   ,"Attività artistiche, sportive, di intrattenimento e diver...",8,4,0,5,17,2024
PIE,TO,R 90,"Attività creative, artistiche e di intrattenimento          ",2,2,0,2,6,2024
PIE,TO,R 91,"Attività di biblioteche, archivi, musei ed altre attività...",0,0,0,0,0,2024
PIE,TO,R 92,"Attività riguardanti le lotterie, le scommesse, le case d...",1,0,0,0,1,2024
PIE,TO,R 93,"Attività sportive, di intrattenimento e di divertimento     ",5,2,0,3,10,2024
PIE,TO,S   ,Altre attività di servizi                                   ,11,7,3,7,28,2024
PIE,TO,S 94,Attività di organizzazioni associative                      ,0,0,0,0,0,2024
PIE,TO,S 95,Riparazione di computer e di beni per uso personale e per...,1,0,1,1,3,2024
PIE,TO,S 96,Altre attività di servizi per la persona                    ,10,7,2,6,25,2024
PIE,TO,T   ,Attività di famiglie e convivenze come datori di lavoro p...,0,0,0,0,0,2024
PIE,TO,T 97,Attività di famiglie e convivenze come datori di lavoro p...,0,0,0,0,0,2024
PIE,TO,T 98,Produzione di beni e servizi indifferenziati per uso prop...,0,0,0,0,0,2024
PIE,TO,U   ,Organizzazioni ed organismi extraterritoriali               ,0,0,0,0,0,2024
PIE,TO,U 99,Organizzazioni ed organismi extraterritoriali               ,0,0,0,0,0,2024
PIE,TO,XX  ,Imprese non classificate                                    ,84,209,1,62,356,2024
PIE,TO,TOT ,TOTALE                                                      ,475,617,146,430,1668,2024
PIE,VC,A   ,"Agricoltura, silvicoltura pesca                             ",0,0,0,2,2,2024
PIE,VC,A 01,"Coltivazioni agricole e produzione di prodotti animali, c...",0,0,0,2,2,2024
PIE,VC,A 02,Silvicoltura ed utilizzo di aree forestali                  ,0,0,0,0,0,2024
PIE,VC,A 03,Pesca e acquacoltura                                        ,0,0,0,0,0,2024
PIE,VC,B   ,Estrazione di minerali da cave e miniere                    ,0,0,0,0,0,2024
PIE,VC,B 05,Estrazione di carbone (esclusa torba)                       ,0,0,0,0,0,2024
PIE,VC,B 06,Estraz.di petrolio greggio e di gas naturale                ,0,0,0,0,0,2024
PIE,VC,B 07,Estrazione di minerali metalliferi                          ,0,0,0,0,0,2024
PIE,VC,B 08,Altre attività di estrazione di minerali da cave e miniere  ,0,0,0,0,0,2024
PIE,VC,B 09,Attività dei servizi di supporto all'estrazione             ,0,0,0,0,0,2024
PIE,VC,C   ,Attività manifatturiere                                     ,9,7,0,2,18,2024
PIE,VC,C 10,Industrie alimentari                                        ,0,3,0,1,4,2024
PIE,VC,C 11,Industria delle bevande                                     ,0,0,0,0,0,2024
PIE,VC,C 12,Industria del tabacco                                       ,0,0,0,0,0,2024
PIE,VC,C 13,Industrie tessili                                           ,0,0,0,0,0,2024
PIE,VC,C 14,Confezione di articoli di abbigliamento; confezione di ar...,3,1,0,0,4,2024
PIE,VC,C 15,Fabbricazione di articoli in pelle e simili                 ,0,0,0,0,0,2024
PIE,VC,C 16,Industria del legno e dei prodotti in legno e sughero (es...,0,2,0,0,2,2024
PIE,VC,C 17,Fabbricazione di carta e di prodotti di carta               ,0,0,0,0,0,2024
PIE,VC,C 18,Stampa e riproduzione di supporti registrati                ,1,0,0,0,1,2024
PIE,VC,C 19,Fabbricazione di coke e prodotti derivanti dalla raffinaz...,0,0,0,0,0,2024
PIE,VC,C 20,Fabbricazione di prodotti chimici                           ,0,0,0,0,0,2024
PIE,VC,C 21,Fabbricazione di prodotti farmaceutici di base e di prepa...,0,0,0,0,0,2024
PIE,VC,C 22,Fabbricazione di articoli in gomma e materie plastiche      ,1,0,0,0,1,2024
PIE,VC,C 23,Fabbricazione di altri prodotti della lavorazione di miner..,1,0,0,1,2,2024
PIE,VC,C 24,Metallurgia                                                 ,0,0,0,0,0,2024
PIE,VC,C 25,Fabbricazione di prodotti in metallo (esclusi macchinari ...,0,1,0,0,1,2024
PIE,VC,C 26,Fabbricazione di computer e prodotti di elettronica e ott...,1,0,0,0,1,2024
PIE,VC,C 27,Fabbricazione di apparecchiature elettriche ed apparecchi...,0,0,0,0,0,2024
PIE,VC,C 28,Fabbricazione di macchinari ed apparecchiature nca          ,2,0,0,0,2,2024
PIE,VC,C 29,"Fabbricazione di autoveicoli, rimorchi e semirimorchi       ",0,0,0,0,0,2024
PIE,VC,C 30,Fabbricazione di altri mezzi di trasporto                   ,0,0,0,0,0,2024
PIE,VC,C 31,Fabbricazione di mobili                                     ,0,0,0,0,0,2024
PIE,VC,C 32,Altre industrie manifatturiere                              ,0,0,0,0,0,2024
PIE,VC,C 33,"Riparazione, manutenzione ed installazione di macchine ed...",0,0,0,0,0,2024
PIE,VC,D   ,"Fornitura di energia elettrica, gas, vapore e aria condiz...",0,0,0,0,0,2024
PIE,VC,D 35,"Fornitura di energia elettrica, gas, vapore e aria condiz...",0,0,0,0,0,2024
PIE,VC,E   ,"Fornitura di acqua; reti fognarie, attività di gestione d...",0,0,0,0,0,2024
PIE,VC,E 36,"Raccolta, trattamento e fornitura di acqua                  ",0,0,0,0,0,2024
PIE,VC,E 37,Gestione delle reti fognarie                                ,0,0,0,0,0,2024
PIE,VC,E 38,"Attività di raccolta, trattamento e smaltimento dei rifiu...",0,0,0,0,0,2024
PIE,VC,E 39,Attività di risanamento e altri servizi di gestione dei r...,0,0,0,0,0,2024
PIE,VC,F   ,Costruzioni                                                 ,2,1,0,7,10,2024
PIE,VC,F 41,Costruzione di edifici                                      ,1,0,0,5,6,2024
PIE,VC,F 42,Ingegneria civile                                           ,0,0,0,0,0,2024
PIE,VC,F 43,Lavori di costruzione specializzati                         ,1,1,0,2,4,2024
PIE,VC,G   ,Commercio all'ingrosso e al dettaglio; riparazione di aut...,5,5,0,0,10,2024
PIE,VC,G 45,Commercio all'ingrosso e al dettaglio e riparazione di au...,0,0,0,0,0,2024
PIE,VC,G 46,Commercio all'ingrosso (escluso quello di autoveicoli e d...,4,1,0,0,5,2024
PIE,VC,G 47,Commercio al dettaglio (escluso quello di autoveicoli e d...,1,4,0,0,5,2024
PIE,VC,H   ,Trasporto e magazzinaggio                                   ,1,0,0,5,6,2024
PIE,VC,H 49,Trasporto terrestre e mediante condotte                     ,1,0,0,2,3,2024
PIE,VC,H 50,Trasporto marittimo e per vie d'acqua                       ,0,0,0,0,0,2024
PIE,VC,H 51,Trasporto aereo                                             ,0,0,0,0,0,2024
PIE,VC,H 52,Magazzinaggio e attività di supporto ai trasporti           ,0,0,0,3,3,2024
PIE,VC,H 53,Servizi postali e attività di corriere                      ,0,0,0,0,0,2024
PIE,VC,I   ,Attività dei servizi alloggio e ristorazione                ,0,5,0,0,5,2024
PIE,VC,I 55,Alloggio                                                    ,0,1,0,0,1,2024
PIE,VC,I 56,Attività dei servizi di ristorazione                        ,0,4,0,0,4,2024
PIE,VC,J   ,Servizi di informazione e comunicazione                     ,0,0,0,0,0,2024
PIE,VC,J 58,Attività editoriali                                         ,0,0,0,0,0,2024
PIE,VC,J 59,"Attività di produzione cinematografica, di video e di pro...",0,0,0,0,0,2024
PIE,VC,J 60,Attività di programmazione e trasmissione                   ,0,0,0,0,0,2024
PIE,VC,J 61,Telecomunicazioni                                           ,0,0,0,0,0,2024
PIE,VC,J 62,"Produzione di software, consulenza informatica e attività...",0,0,0,0,0,2024
PIE,VC,J 63,Attività dei servizi d'informazione e altri servizi infor...,0,0,0,0,0,2024
PIE,VC,K   ,Attività finanziarie e assicurative                         ,0,0,0,0,0,2024
PIE,VC,K 64,Attività di servizi finanziari (escluse le assicurazioni ...,0,0,0,0,0,2024
PIE,VC,K 65,"Assicurazioni, riassicurazioni e fondi pensione (escluse ...",0,0,0,0,0,2024
PIE,VC,K 66,Attività ausiliarie dei servizi finanziari e delle attivi...,0,0,0,0,0,2024
PIE,VC,L   ,Attivita' immobiliari                                       ,0,3,0,2,5,2024
PIE,VC,L 68,Attivita' immobiliari                                       ,0,3,0,2,5,2024
PIE,VC,M   ,"Attività professionali, scientifiche e tecniche             ",0,0,0,0,0,2024
PIE,VC,M 69,Attività legali e contabilità                               ,0,0,0,0,0,2024
PIE,VC,M 70,Attività di direzione aziendale e di consulenza gestional...,0,0,0,0,0,2024
PIE,VC,M 71,Attività degli studi di architettura e d'ingegneria; coll...,0,0,0,0,0,2024
PIE,VC,M 72,Ricerca scientifica e sviluppo                              ,0,0,0,0,0,2024
PIE,VC,M 73,Pubblicità e ricerche di mercato                            ,0,0,0,0,0,2024
PIE,VC,M 74,"Altre attività professionali, scientifiche e tecniche       ",0,0,0,0,0,2024
PIE,VC,M 75,Servizi veterinari                                          ,0,0,0,0,0,2024
PIE,VC,N   ,"Noleggio, agenzie di viaggio, servizi di supporto alle im...",0,0,0,6,6,2024
PIE,VC,N 77,Attività di noleggio e leasing operativo                    ,0,0,0,0,0,2024
PIE,VC,N 78,"Attività di ricerca, selezione, fornitura di personale      ",0,0,0,0,0,2024
PIE,VC,N 79,"Attività dei servizi delle agenzie di viaggio, dei tour o...",0,0,0,0,0,2024
PIE,VC,N 80,Servizi di vigilanza e investigazione                       ,0,0,0,0,0,2024
PIE,VC,N 81,Attività di servizi per edifici e paesaggio                 ,0,0,0,5,5,2024
PIE,VC,N 82,Attività di supporto per le funzioni d'ufficio e altri se...,0,0,0,1,1,2024
PIE,VC,O   ,Amministrazione pubblica e difesa; assicurazione sociale ...,0,0,0,0,0,2024
PIE,VC,O 84,Amministrazione pubblica e difesa; assicurazione sociale ...,0,0,0,0,0,2024
PIE,VC,P   ,Istruzione                                                  ,0,0,0,0,0,2024
PIE,VC,P 85,Istruzione                                                  ,0,0,0,0,0,2024
PIE,VC,Q   ,Sanita' e assistenza sociale                                ,0,1,0,2,3,2024
PIE,VC,Q 86,Assistenza sanitaria                                        ,0,1,0,0,1,2024
PIE,VC,Q 87,Servizi di assistenza sociale residenziale                  ,0,0,0,1,1,2024
PIE,VC,Q 88,Assistenza sociale non residenziale                         ,0,0,0,1,1,2024
PIE,VC,R   ,"Attività artistiche, sportive, di intrattenimento e diver...",0,0,0,2,2,2024
PIE,VC,R 90,"Attività creative, artistiche e di intrattenimento          ",0,0,0,1,1,2024
PIE,VC,R 91,"Attività di biblioteche, archivi, musei ed altre attività...",0,0,0,0,0,2024
PIE,VC,R 92,"Attività riguardanti le lotterie, le scommesse, le case d...",0,0,0,0,0,2024
PIE,VC,R 93,"Attività sportive, di intrattenimento e di divertimento     ",0,0,0,1,1,2024
PIE,VC,S   ,Altre attività di servizi                                   ,1,0,0,0,1,2024
PIE,VC,S 94,Attività di organizzazioni associative                      ,0,0,0,0,0,2024
PIE,VC,S 95,Riparazione di computer e di beni per uso personale e per...,1,0,0,0,1,2024
PIE,VC,S 96,Altre attività di servizi per la persona                    ,0,0,0,0,0,2024
PIE,VC,T   ,Attività di famiglie e convivenze come datori di lavoro p...,0,0,0,0,0,2024
PIE,VC,T 97,Attività di famiglie e convivenze come datori di lavoro p...,0,0,0,0,0,2024
PIE,VC,T 98,Produzione di beni e servizi indifferenziati per uso prop...,0,0,0,0,0,2024
PIE,VC,U   ,Organizzazioni ed organismi extraterritoriali               ,0,0,0,0,0,2024
PIE,VC,U 99,Organizzazioni ed organismi extraterritoriali               ,0,0,0,0,0,2024
PIE,VC,XX  ,Imprese non classificate                                    ,4,3,0,5,12,2024
PIE,VC,TOT ,TOTALE                                                      ,22,25,0,33,80,2024
PIE,NO,A   ,"Agricoltura, silvicoltura pesca                             ",0,0,0,2,2,2024
PIE,NO,A 01,"Coltivazioni agricole e produzione di prodotti animali, c...",0,0,0,2,2,2024
PIE,NO,A 02,Silvicoltura ed utilizzo di aree forestali                  ,0,0,0,0,0,2024
PIE,NO,A 03,Pesca e acquacoltura                                        ,0,0,0,0,0,2024
PIE,NO,B   ,Estrazione di minerali da cave e miniere                    ,0,0,0,0,0,2024
PIE,NO,B 05,Estrazione di carbone (esclusa torba)                       ,0,0,0,0,0,2024
PIE,NO,B 06,Estraz.di petrolio greggio e di gas naturale                ,0,0,0,0,0,2024
PIE,NO,B 07,Estrazione di minerali metalliferi                          ,0,0,0,0,0,2024
PIE,NO,B 08,Altre attività di estrazione di minerali da cave e miniere  ,0,0,0,0,0,2024
PIE,NO,B 09,Attività dei servizi di supporto all'estrazione             ,0,0,0,0,0,2024
PIE,NO,C   ,Attività manifatturiere                                     ,3,5,0,7,15,2024
PIE,NO,C 10,Industrie alimentari                                        ,0,0,0,1,1,2024
PIE,NO,C 11,Industria delle bevande                                     ,0,0,0,0,0,2024
PIE,NO,C 12,Industria del tabacco                                       ,0,0,0,0,0,2024
PIE,NO,C 13,Industrie tessili                                           ,0,0,0,0,0,2024
PIE,NO,C 14,Confezione di articoli di abbigliamento; confezione di ar...,0,2,0,1,3,2024
PIE,NO,C 15,Fabbricazione di articoli in pelle e simili                 ,0,2,0,0,2,2024
PIE,NO,C 16,Industria del legno e dei prodotti in legno e sughero (es...,0,0,0,0,0,2024
PIE,NO,C 17,Fabbricazione di carta e di prodotti di carta               ,0,0,0,0,0,2024
PIE,NO,C 18,Stampa e riproduzione di supporti registrati                ,0,1,0,0,1,2024
PIE,NO,C 19,Fabbricazione di coke e prodotti derivanti dalla raffinaz...,0,0,0,0,0,2024
PIE,NO,C 20,Fabbricazione di prodotti chimici                           ,0,0,0,0,0,2024
PIE,NO,C 21,Fabbricazione di prodotti farmaceutici di base e di prepa...,0,0,0,0,0,2024
PIE,NO,C 22,Fabbricazione di articoli in gomma e materie plastiche      ,0,0,0,0,0,2024
PIE,NO,C 23,Fabbricazione di altri prodotti della lavorazione di miner..,0,0,0,0,0,2024
PIE,NO,C 24,Metallurgia                                                 ,0,0,0,0,0,2024
PIE,NO,C 25,Fabbricazione di prodotti in metallo (esclusi macchinari ...,0,0,0,1,1,2024
PIE,NO,C 26,Fabbricazione di computer e prodotti di elettronica e ott...,0,0,0,0,0,2024
PIE,NO,C 27,Fabbricazione di apparecchiature elettriche ed apparecchi...,0,0,0,0,0,2024
PIE,NO,C 28,Fabbricazione di macchinari ed apparecchiature nca          ,3,0,0,2,5,2024
PIE,NO,C 29,"Fabbricazione di autoveicoli, rimorchi e semirimorchi       ",0,0,0,0,0,2024
PIE,NO,C 30,Fabbricazione di altri mezzi di trasporto                   ,0,0,0,0,0,2024
PIE,NO,C 31,Fabbricazione di mobili                                     ,0,0,0,0,0,2024
PIE,NO,C 32,Altre industrie manifatturiere                              ,0,0,0,1,1,2024
PIE,NO,C 33,"Riparazione, manutenzione ed installazione di macchine ed...",0,0,0,1,1,2024
PIE,NO,D   ,"Fornitura di energia elettrica, gas, vapore e aria condiz...",0,0,0,0,0,2024
PIE,NO,D 35,"Fornitura di energia elettrica, gas, vapore e aria condiz...",0,0,0,0,0,2024
PIE,NO,E   ,"Fornitura di acqua; reti fognarie, attività di gestione d...",0,0,0,0,0,2024
PIE,NO,E 36,"Raccolta, trattamento e fornitura di acqua                  ",0,0,0,0,0,2024
PIE,NO,E 37,Gestione delle reti fognarie                                ,0,0,0,0,0,2024
PIE,NO,E 38,"Attività di raccolta, trattamento e smaltimento dei rifiu...",0,0,0,0,0,2024
PIE,NO,E 39,Attività di risanamento e altri servizi di gestione dei r...,0,0,0,0,0,2024
PIE,NO,F   ,Costruzioni                                                 ,0,0,0,12,12,2024
PIE,NO,F 41,Costruzione di edifici                                      ,0,0,0,8,8,2024
PIE,NO,F 42,Ingegneria civile                                           ,0,0,0,0,0,2024
PIE,NO,F 43,Lavori di costruzione specializzati                         ,0,0,0,4,4,2024
PIE,NO,G   ,Commercio all'ingrosso e al dettaglio; riparazione di aut...,0,4,0,2,6,2024
PIE,NO,G 45,Commercio all'ingrosso e al dettaglio e riparazione di au...,0,0,0,0,0,2024
PIE,NO,G 46,Commercio all'ingrosso (escluso quello di autoveicoli e d...,0,0,0,2,2,2024
PIE,NO,G 47,Commercio al dettaglio (escluso quello di autoveicoli e d...,0,4,0,0,4,2024
PIE,NO,H   ,Trasporto e magazzinaggio                                   ,0,0,0,12,12,2024
PIE,NO,H 49,Trasporto terrestre e mediante condotte                     ,0,0,0,3,3,2024
PIE,NO,H 50,Trasporto marittimo e per vie d'acqua                       ,0,0,0,0,0,2024
PIE,NO,H 51,Trasporto aereo                                             ,0,0,0,0,0,2024
PIE,NO,H 52,Magazzinaggio e attività di supporto ai trasporti           ,0,0,0,9,9,2024
PIE,NO,H 53,Servizi postali e attività di corriere                      ,0,0,0,0,0,2024
PIE,NO,I   ,Attività dei servizi alloggio e ristorazione                ,0,1,0,1,2,2024
PIE,NO,I 55,Alloggio                                                    ,0,0,0,0,0,2024
PIE,NO,I 56,Attività dei servizi di ristorazione                        ,0,1,0,1,2,2024
PIE,NO,J   ,Servizi di informazione e comunicazione                     ,0,1,0,3,4,2024
PIE,NO,J 58,Attività editoriali                                         ,0,0,0,0,0,2024
PIE,NO,J 59,"Attività di produzione cinematografica, di video e di pro...",0,0,0,1,1,2024
PIE,NO,J 60,Attività di programmazione e trasmissione                   ,0,0,0,1,1,2024
PIE,NO,J 61,Telecomunicazioni                                           ,0,0,0,0,0,2024
PIE,NO,J 62,"Produzione di software, consulenza informatica e attività...",0,0,0,0,0,2024
PIE,NO,J 63,Attività dei servizi d'informazione e altri servizi infor...,0,1,0,1,2,2024
PIE,NO,K   ,Attività finanziarie e assicurative                         ,0,0,0,0,0,2024
PIE,NO,K 64,Attività di servizi finanziari (escluse le assicurazioni ...,0,0,0,0,0,2024
PIE,NO,K 65,"Assicurazioni, riassicurazioni e fondi pensione (escluse ...",0,0,0,0,0,2024
PIE,NO,K 66,Attività ausiliarie dei servizi finanziari e delle attivi...,0,0,0,0,0,2024
PIE,NO,L   ,Attivita' immobiliari                                       ,0,0,0,2,2,2024
PIE,NO,L 68,Attivita' immobiliari                                       ,0,0,0,2,2,2024
PIE,NO,M   ,"Attività professionali, scientifiche e tecniche             ",0,0,0,0,0,2024
PIE,NO,M 69,Attività legali e contabilità                               ,0,0,0,0,0,2024
PIE,NO,M 70,Attività di direzione aziendale e di consulenza gestional...,0,0,0,0,0,2024
PIE,NO,M 71,Attività degli studi di architettura e d'ingegneria; coll...,0,0,0,0,0,2024
PIE,NO,M 72,Ricerca scientifica e sviluppo                              ,0,0,0,0,0,2024
PIE,NO,M 73,Pubblicità e ricerche di mercato                            ,0,0,0,0,0,2024
PIE,NO,M 74,"Altre attività professionali, scientifiche e tecniche       ",0,0,0,0,0,2024
PIE,NO,M 75,Servizi veterinari                                          ,0,0,0,0,0,2024
PIE,NO,N   ,"Noleggio, agenzie di viaggio, servizi di supporto alle im...",0,0,0,14,14,2024
PIE,NO,N 77,Attività di noleggio e leasing operativo                    ,0,0,0,1,1,2024
PIE,NO,N 78,"Attività di ricerca, selezione, fornitura di personale      ",0,0,0,0,0,2024
PIE,NO,N 79,"Attività dei servizi delle agenzie di viaggio, dei tour o...",0,0,0,0,0,2024
PIE,NO,N 80,Servizi di vigilanza e investigazione                       ,0,0,0,0,0,2024
PIE,NO,N 81,Attività di servizi per edifici e paesaggio                 ,0,0,0,6,6,2024
PIE,NO,N 82,Attività di supporto per le funzioni d'ufficio e altri se...,0,0,0,7,7,2024
PIE,NO,O   ,Amministrazione pubblica e difesa; assicurazione sociale ...,0,0,0,0,0,2024
PIE,NO,O 84,Amministrazione pubblica e difesa; assicurazione sociale ...,0,0,0,0,0,2024
PIE,NO,P   ,Istruzione                                                  ,0,0,0,2,2,2024
PIE,NO,P 85,Istruzione                                                  ,0,0,0,2,2,2024
PIE,NO,Q   ,Sanita' e assistenza sociale                                ,0,0,0,4,4,2024
PIE,NO,Q 86,Assistenza sanitaria                                        ,0,0,0,1,1,2024
PIE,NO,Q 87,Servizi di assistenza sociale residenziale                  ,0,0,0,0,0,2024
PIE,NO,Q 88,Assistenza sociale non residenziale                         ,0,0,0,3,3,2024
PIE,NO,R   ,"Attività artistiche, sportive, di intrattenimento e diver...",0,0,0,1,1,2024
PIE,NO,R 90,"Attività creative, artistiche e di intrattenimento          ",0,0,0,0,0,2024
PIE,NO,R 91,"Attività di biblioteche, archivi, musei ed altre attività...",0,0,0,0,0,2024
PIE,NO,R 92,"Attività riguardanti le lotterie, le scommesse, le case d...",0,0,0,0,0,2024
PIE,NO,R 93,"Attività sportive, di intrattenimento e di divertimento     ",0,0,0,1,1,2024
PIE,NO,S   ,Altre attività di servizi                                   ,0,0,0,2,2,2024
PIE,NO,S 94,Attività di organizzazioni associative                      ,0,0,0,0,0,2024
PIE,NO,S 95,Riparazione di computer e di beni per uso personale e per...,0,0,0,0,0,2024
PIE,NO,S 96,Altre attività di servizi per la persona                    ,0,0,0,2,2,2024
PIE,NO,T   ,Attività di famiglie e convivenze come datori di lavoro p...,0,0,0,0,0,2024
PIE,NO,T 97,Attività di famiglie e convivenze come datori di lavoro p...,0,0,0,0,0,2024
PIE,NO,T 98,Produzione di beni e servizi indifferenziati per uso prop...,0,0,0,0,0,2024
PIE,NO,U   ,Organizzazioni ed organismi extraterritoriali               ,0,0,0,0,0,2024
PIE,NO,U 99,Organizzazioni ed organismi extraterritoriali               ,0,0,0,0,0,2024
PIE,NO,XX  ,Imprese non classificate                                    ,0,2,0,12,14,2024
PIE,NO,TOT ,TOTALE                                                      ,3,13,0,76,92,2024
PIE,CN,A   ,"Agricoltura, silvicoltura pesca                             ",0,1,1,13,15,2024
PIE,CN,A 01,"Coltivazioni agricole e produzione di prodotti animali, c...",0,1,1,12,14,2024
PIE,CN,A 02,Silvicoltura ed utilizzo di aree forestali                  ,0,0,0,1,1,2024
PIE,CN,A 03,Pesca e acquacoltura                                        ,0,0,0,0,0,2024
PIE,CN,B   ,Estrazione di minerali da cave e miniere                    ,0,0,0,0,0,2024
PIE,CN,B 05,Estrazione di carbone (esclusa torba)                       ,0,0,0,0,0,2024
PIE,CN,B 06,Estraz.di petrolio greggio e di gas naturale                ,0,0,0,0,0,2024
PIE,CN,B 07,Estrazione di minerali metalliferi                          ,0,0,0,0,0,2024
PIE,CN,B 08,Altre attività di estrazione di minerali da cave e miniere  ,0,0,0,0,0,2024
PIE,CN,B 09,Attività dei servizi di supporto all'estrazione             ,0,0,0,0,0,2024
PIE,CN,C   ,Attività manifatturiere                                     ,0,2,0,3,5,2024
PIE,CN,C 10,Industrie alimentari                                        ,0,1,0,0,1,2024
PIE,CN,C 11,Industria delle bevande                                     ,0,0,0,0,0,2024
PIE,CN,C 12,Industria del tabacco                                       ,0,0,0,0,0,2024
PIE,CN,C 13,Industrie tessili                                           ,0,0,0,0,0,2024
PIE,CN,C 14,Confezione di articoli di abbigliamento; confezione di ar...,0,0,0,0,0,2024
PIE,CN,C 15,Fabbricazione di articoli in pelle e simili                 ,0,0,0,0,0,2024
PIE,CN,C 16,Industria del legno e dei prodotti in legno e sughero (es...,0,0,0,0,0,2024
PIE,CN,C 17,Fabbricazione di carta e di prodotti di carta               ,0,0,0,0,0,2024
PIE,CN,C 18,Stampa e riproduzione di supporti registrati                ,0,0,0,0,0,2024
PIE,CN,C 19,Fabbricazione di coke e prodotti derivanti dalla raffinaz...,0,0,0,0,0,2024
PIE,CN,C 20,Fabbricazione di prodotti chimici                           ,0,1,0,0,1,2024
PIE,CN,C 21,Fabbricazione di prodotti farmaceutici di base e di prepa...,0,0,0,0,0,2024
PIE,CN,C 22,Fabbricazione di articoli in gomma e materie plastiche      ,0,0,0,0,0,2024
PIE,CN,C 23,Fabbricazione di altri prodotti della lavorazione di miner..,0,0,0,0,0,2024
PIE,CN,C 24,Metallurgia                                                 ,0,0,0,0,0,2024
PIE,CN,C 25,Fabbricazione di prodotti in metallo (esclusi macchinari ...,0,0,0,3,3,2024
PIE,CN,C 26,Fabbricazione di computer e prodotti di elettronica e ott...,0,0,0,0,0,2024
PIE,CN,C 27,Fabbricazione di apparecchiature elettriche ed apparecchi...,0,0,0,0,0,2024
PIE,CN,C 28,Fabbricazione di macchinari ed apparecchiature nca          ,0,0,0,0,0,2024
PIE,CN,C 29,"Fabbricazione di autoveicoli, rimorchi e semirimorchi       ",0,0,0,0,0,2024
PIE,CN,C 30,Fabbricazione di altri mezzi di trasporto                   ,0,0,0,0,0,2024
PIE,CN,C 31,Fabbricazione di mobili                                     ,0,0,0,0,0,2024
PIE,CN,C 32,Altre industrie manifatturiere                              ,0,0,0,0,0,2024
PIE,CN,C 33,"Riparazione, manutenzione ed installazione di macchine ed...",0,0,0,0,0,2024
PIE,CN,D   ,"Fornitura di energia elettrica, gas, vapore e aria condiz...",0,0,0,0,0,2024
PIE,CN,D 35,"Fornitura di energia elettrica, gas, vapore e aria condiz...",0,0,0,0,0,2024
PIE,CN,E   ,"Fornitura di acqua; reti fognarie, attività di gestione d...",0,0,0,0,0,2024
PIE,CN,E 36,"Raccolta, trattamento e fornitura di acqua                  ",0,0,0,0,0,2024
PIE,CN,E 37,Gestione delle reti fognarie                                ,0,0,0,0,0,2024
PIE,CN,E 38,"Attività di raccolta, trattamento e smaltimento dei rifiu...",0,0,0,0,0,2024
PIE,CN,E 39,Attività di risanamento e altri servizi di gestione dei r...,0,0,0,0,0,2024
PIE,CN,F   ,Costruzioni                                                 ,0,3,0,7,10,2024
PIE,CN,F 41,Costruzione di edifici                                      ,0,2,0,3,5,2024
PIE,CN,F 42,Ingegneria civile                                           ,0,0,0,0,0,2024
PIE,CN,F 43,Lavori di costruzione specializzati                         ,0,1,0,4,5,2024
PIE,CN,G   ,Commercio all'ingrosso e al dettaglio; riparazione di aut...,1,8,0,5,14,2024
PIE,CN,G 45,Commercio all'ingrosso e al dettaglio e riparazione di au...,0,1,0,0,1,2024
PIE,CN,G 46,Commercio all'ingrosso (escluso quello di autoveicoli e d...,1,3,0,4,8,2024
PIE,CN,G 47,Commercio al dettaglio (escluso quello di autoveicoli e d...,0,4,0,1,5,2024
PIE,CN,H   ,Trasporto e magazzinaggio                                   ,0,1,0,6,7,2024
PIE,CN,H 49,Trasporto terrestre e mediante condotte                     ,0,1,0,0,1,2024
PIE,CN,H 50,Trasporto marittimo e per vie d'acqua                       ,0,0,0,0,0,2024
PIE,CN,H 51,Trasporto aereo                                             ,0,0,0,0,0,2024
PIE,CN,H 52,Magazzinaggio e attività di supporto ai trasporti           ,0,0,0,6,6,2024
PIE,CN,H 53,Servizi postali e attività di corriere                      ,0,0,0,0,0,2024
PIE,CN,I   ,Attività dei servizi alloggio e ristorazione                ,0,2,1,5,8,2024
PIE,CN,I 55,Alloggio                                                    ,0,0,0,0,0,2024
PIE,CN,I 56,Attività dei servizi di ristorazione                        ,0,2,1,5,8,2024
PIE,CN,J   ,Servizi di informazione e comunicazione                     ,0,1,0,0,1,2024
PIE,CN,J 58,Attività editoriali                                         ,0,0,0,0,0,2024
PIE,CN,J 59,"Attività di produzione cinematografica, di video e di pro...",0,0,0,0,0,2024
PIE,CN,J 60,Attività di programmazione e trasmissione                   ,0,0,0,0,0,2024
PIE,CN,J 61,Telecomunicazioni                                           ,0,0,0,0,0,2024
PIE,CN,J 62,"Produzione di software, consulenza informatica e attività...",0,0,0,0,0,2024
PIE,CN,J 63,Attività dei servizi d'informazione e altri servizi infor...,0,1,0,0,1,2024
PIE,CN,K   ,Attività finanziarie e assicurative                         ,0,0,0,0,0,2024
PIE,CN,K 64,Attività di servizi finanziari (escluse le assicurazioni ...,0,0,0,0,0,2024
PIE,CN,K 65,"Assicurazioni, riassicurazioni e fondi pensione (escluse ...",0,0,0,0,0,2024
PIE,CN,K 66,Attività ausiliarie dei servizi finanziari e delle attivi...,0,0,0,0,0,2024
PIE,CN,L   ,Attivita' immobiliari                                       ,0,12,0,0,12,2024
PIE,CN,L 68,Attivita' immobiliari                                       ,0,12,0,0,12,2024
PIE,CN,M   ,"Attività professionali, scientifiche e tecniche             ",0,0,1,2,3,2024
PIE,CN,M 69,Attività legali e contabilità                               ,0,0,0,0,0,2024
PIE,CN,M 70,Attività di direzione aziendale e di consulenza gestional...,0,0,0,1,1,2024
PIE,CN,M 71,Attività degli studi di architettura e d'ingegneria; coll...,0,0,0,0,0,2024
PIE,CN,M 72,Ricerca scientifica e sviluppo                              ,0,0,0,0,0,2024
PIE,CN,M 73,Pubblicità e ricerche di mercato                            ,0,0,0,0,0,2024
PIE,CN,M 74,"Altre attività professionali, scientifiche e tecniche       ",0,0,1,1,2,2024
PIE,CN,M 75,Servizi veterinari                                          ,0,0,0,0,0,2024
PIE,CN,N   ,"Noleggio, agenzie di viaggio, servizi di supporto alle im...",0,1,0,12,13,2024
PIE,CN,N 77,Attività di noleggio e leasing operativo                    ,0,0,0,0,0,2024
PIE,CN,N 78,"Attività di ricerca, selezione, fornitura di personale      ",0,0,0,0,0,2024
PIE,CN,N 79,"Attività dei servizi delle agenzie di viaggio, dei tour o...",0,0,0,0,0,2024
PIE,CN,N 80,Servizi di vigilanza e investigazione                       ,0,0,0,0,0,2024
PIE,CN,N 81,Attività di servizi per edifici e paesaggio                 ,0,0,0,5,5,2024
PIE,CN,N 82,Attività di supporto per le funzioni d'ufficio e altri se...,0,1,0,7,8,2024
PIE,CN,O   ,Amministrazione pubblica e difesa; assicurazione sociale ...,0,0,0,0,0,2024
PIE,CN,O 84,Amministrazione pubblica e difesa; assicurazione sociale ...,0,0,0,0,0,2024
PIE,CN,P   ,Istruzione                                                  ,0,0,0,1,1,2024
PIE,CN,P 85,Istruzione                                                  ,0,0,0,1,1,2024
PIE,CN,Q   ,Sanita' e assistenza sociale                                ,0,0,0,4,4,2024
PIE,CN,Q 86,Assistenza sanitaria                                        ,0,0,0,0,0,2024
PIE,CN,Q 87,Servizi di assistenza sociale residenziale                  ,0,0,0,0,0,2024
PIE,CN,Q 88,Assistenza sociale non residenziale                         ,0,0,0,4,4,2024
PIE,CN,R   ,"Attività artistiche, sportive, di intrattenimento e diver...",0,0,0,0,0,2024
PIE,CN,R 90,"Attività creative, artistiche e di intrattenimento          ",0,0,0,0,0,2024
PIE,CN,R 91,"Attività di biblioteche, archivi, musei ed altre attività...",0,0,0,0,0,2024
PIE,CN,R 92,"Attività riguardanti le lotterie, le scommesse, le case d...",0,0,0,0,0,2024
PIE,CN,R 93,"Attività sportive, di intrattenimento e di divertimento     ",0,0,0,0,0,2024
PIE,CN,S   ,Altre attività di servizi                                   ,0,1,0,3,4,2024
PIE,CN,S 94,Attività di organizzazioni associative                      ,0,0,0,0,0,2024
PIE,CN,S 95,Riparazione di computer e di beni per uso personale e per...,0,0,0,0,0,2024
PIE,CN,S 96,Altre attività di servizi per la persona                    ,0,1,0,3,4,2024
PIE,CN,T   ,Attività di famiglie e convivenze come datori di lavoro p...,0,0,0,0,0,2024
PIE,CN,T 97,Attività di famiglie e convivenze come datori di lavoro p...,0,0,0,0,0,2024
PIE,CN,T 98,Produzione di beni e servizi indifferenziati per uso prop...,0,0,0,0,0,2024
PIE,CN,U   ,Organizzazioni ed organismi extraterritoriali               ,0,0,0,0,0,2024
PIE,CN,U 99,Organizzazioni ed organismi extraterritoriali               ,0,0,0,0,0,2024
PIE,CN,XX  ,Imprese non classificate                                    ,0,0,0,17,17,2024
PIE,CN,TOT ,TOTALE                                                      ,1,32,3,78,114,2024
PIE,AT,A   ,"Agricoltura, silvicoltura pesca                             ",0,1,23,12,36,2024
PIE,AT,A 01,"Coltivazioni agricole e produzione di prodotti animali, c...",0,1,23,12,36,2024
PIE,AT,A 02,Silvicoltura ed utilizzo di aree forestali                  ,0,0,0,0,0,2024
PIE,AT,A 03,Pesca e acquacoltura                                        ,0,0,0,0,0,2024
PIE,AT,B   ,Estrazione di minerali da cave e miniere                    ,0,0,0,0,0,2024
PIE,AT,B 05,Estrazione di carbone (esclusa torba)                       ,0,0,0,0,0,2024
PIE,AT,B 06,Estraz.di petrolio greggio e di gas naturale                ,0,0,0,0,0,2024
PIE,AT,B 07,Estrazione di minerali metalliferi                          ,0,0,0,0,0,2024
PIE,AT,B 08,Altre attività di estrazione di minerali da cave e miniere  ,0,0,0,0,0,2024
PIE,AT,B 09,Attività dei servizi di supporto all'estrazione             ,0,0,0,0,0,2024
PIE,AT,C   ,Attività manifatturiere                                     ,0,6,16,5,27,2024
PIE,AT,C 10,Industrie alimentari                                        ,0,1,1,0,2,2024
PIE,AT,C 11,Industria delle bevande                                     ,0,1,0,0,1,2024
PIE,AT,C 12,Industria del tabacco                                       ,0,0,0,0,0,2024
PIE,AT,C 13,Industrie tessili                                           ,0,0,1,0,1,2024
PIE,AT,C 14,Confezione di articoli di abbigliamento; confezione di ar...,0,1,1,1,3,2024
PIE,AT,C 15,Fabbricazione di articoli in pelle e simili                 ,0,0,0,0,0,2024
PIE,AT,C 16,Industria del legno e dei prodotti in legno e sughero (es...,0,0,1,0,1,2024
PIE,AT,C 17,Fabbricazione di carta e di prodotti di carta               ,0,0,0,0,0,2024
PIE,AT,C 18,Stampa e riproduzione di supporti registrati                ,0,0,1,0,1,2024
PIE,AT,C 19,Fabbricazione di coke e prodotti derivanti dalla raffinaz...,0,0,0,0,0,2024
PIE,AT,C 20,Fabbricazione di prodotti chimici                           ,0,0,0,0,0,2024
PIE,AT,C 21,Fabbricazione di prodotti farmaceutici di base e di prepa...,0,0,0,0,0,2024
PIE,AT,C 22,Fabbricazione di articoli in gomma e materie plastiche      ,0,1,1,0,2,2024
PIE,AT,C 23,Fabbricazione di altri prodotti della lavorazione di miner..,0,0,2,0,2,2024
PIE,AT,C 24,Metallurgia                                                 ,0,0,0,0,0,2024
PIE,AT,C 25,Fabbricazione di prodotti in metallo (esclusi macchinari ...,0,2,4,2,8,2024
PIE,AT,C 26,Fabbricazione di computer e prodotti di elettronica e ott...,0,0,0,0,0,2024
PIE,AT,C 27,Fabbricazione di apparecchiature elettriche ed apparecchi...,0,0,1,0,1,2024
PIE,AT,C 28,Fabbricazione di macchinari ed apparecchiature nca          ,0,0,2,0,2,2024
PIE,AT,C 29,"Fabbricazione di autoveicoli, rimorchi e semirimorchi       ",0,0,1,1,2,2024
PIE,AT,C 30,Fabbricazione di altri mezzi di trasporto                   ,0,0,0,0,0,2024
PIE,AT,C 31,Fabbricazione di mobili                                     ,0,0,0,1,1,2024
PIE,AT,C 32,Altre industrie manifatturiere                              ,0,0,0,0,0,2024
PIE,AT,C 33,"Riparazione, manutenzione ed installazione di macchine ed...",0,0,0,0,0,2024
PIE,AT,D   ,"Fornitura di energia elettrica, gas, vapore e aria condiz...",0,0,0,0,0,2024
PIE,AT,D 35,"Fornitura di energia elettrica, gas, vapore e aria condiz...",0,0,0,0,0,2024
PIE,AT,E   ,"Fornitura di acqua; reti fognarie, attività di gestione d...",0,0,0,0,0,2024
PIE,AT,E 36,"Raccolta, trattamento e fornitura di acqua                  ",0,0,0,0,0,2024
PIE,AT,E 37,Gestione delle reti fognarie                                ,0,0,0,0,0,2024
PIE,AT,E 38,"Attività di raccolta, trattamento e smaltimento dei rifiu...",0,0,0,0,0,2024
PIE,AT,E 39,Attività di risanamento e altri servizi di gestione dei r...,0,0,0,0,0,2024
PIE,AT,F   ,Costruzioni                                                 ,0,8,48,6,62,2024
PIE,AT,F 41,Costruzione di edifici                                      ,0,5,10,3,18,2024
PIE,AT,F 42,Ingegneria civile                                           ,0,0,0,0,0,2024
PIE,AT,F 43,Lavori di costruzione specializzati                         ,0,3,38,3,44,2024
PIE,AT,G   ,Commercio all'ingrosso e al dettaglio; riparazione di aut...,0,9,51,2,62,2024
PIE,AT,G 45,Commercio all'ingrosso e al dettaglio e riparazione di au...,0,1,4,0,5,2024
PIE,AT,G 46,Commercio all'ingrosso (escluso quello di autoveicoli e d...,0,1,18,1,20,2024
PIE,AT,G 47,Commercio al dettaglio (escluso quello di autoveicoli e d...,0,7,29,1,37,2024
PIE,AT,H   ,Trasporto e magazzinaggio                                   ,0,2,4,2,8,2024
PIE,AT,H 49,Trasporto terrestre e mediante condotte                     ,0,2,4,1,7,2024
PIE,AT,H 50,Trasporto marittimo e per vie d'acqua                       ,0,0,0,0,0,2024
PIE,AT,H 51,Trasporto aereo                                             ,0,0,0,0,0,2024
PIE,AT,H 52,Magazzinaggio e attività di supporto ai trasporti           ,0,0,0,1,1,2024
PIE,AT,H 53,Servizi postali e attività di corriere                      ,0,0,0,0,0,2024
PIE,AT,I   ,Attività dei servizi alloggio e ristorazione                ,0,18,8,2,28,2024
PIE,AT,I 55,Alloggio                                                    ,0,1,0,1,2,2024
PIE,AT,I 56,Attività dei servizi di ristorazione                        ,0,17,8,1,26,2024
PIE,AT,J   ,Servizi di informazione e comunicazione                     ,0,1,1,1,3,2024
PIE,AT,J 58,Attività editoriali                                         ,0,0,0,0,0,2024
PIE,AT,J 59,"Attività di produzione cinematografica, di video e di pro...",0,0,0,0,0,2024
PIE,AT,J 60,Attività di programmazione e trasmissione                   ,0,0,0,0,0,2024
PIE,AT,J 61,Telecomunicazioni                                           ,0,1,0,0,1,2024
PIE,AT,J 62,"Produzione di software, consulenza informatica e attività...",0,0,1,0,1,2024
PIE,AT,J 63,Attività dei servizi d'informazione e altri servizi infor...,0,0,0,1,1,2024
PIE,AT,K   ,Attività finanziarie e assicurative                         ,0,0,4,0,4,2024
PIE,AT,K 64,Attività di servizi finanziari (escluse le assicurazioni ...,0,0,0,0,0,2024
PIE,AT,K 65,"Assicurazioni, riassicurazioni e fondi pensione (escluse ...",0,0,0,0,0,2024
PIE,AT,K 66,Attività ausiliarie dei servizi finanziari e delle attivi...,0,0,4,0,4,2024
PIE,AT,L   ,Attivita' immobiliari                                       ,0,6,2,1,9,2024
PIE,AT,L 68,Attivita' immobiliari                                       ,0,6,2,1,9,2024
PIE,AT,M   ,"Attività professionali, scientifiche e tecniche             ",0,3,1,2,6,2024
PIE,AT,M 69,Attività legali e contabilità                               ,0,0,0,0,0,2024
PIE,AT,M 70,Attività di direzione aziendale e di consulenza gestional...,0,2,0,0,2,2024
PIE,AT,M 71,Attività degli studi di architettura e d'ingegneria; coll...,0,1,0,0,1,2024
PIE,AT,M 72,Ricerca scientifica e sviluppo                              ,0,0,0,0,0,2024
PIE,AT,M 73,Pubblicità e ricerche di mercato                            ,0,0,0,0,0,2024
PIE,AT,M 74,"Altre attività professionali, scientifiche e tecniche       ",0,0,1,2,3,2024
PIE,AT,M 75,Servizi veterinari                                          ,0,0,0,0,0,2024
PIE,AT,N   ,"Noleggio, agenzie di viaggio, servizi di supporto alle im...",0,1,1,2,4,2024
PIE,AT,N 77,Attività di noleggio e leasing operativo                    ,0,1,0,0,1,2024
PIE,AT,N 78,"Attività di ricerca, selezione, fornitura di personale      ",0,0,0,0,0,2024
PIE,AT,N 79,"Attività dei servizi delle agenzie di viaggio, dei tour o...",0,0,0,0,0,2024
PIE,AT,N 80,Servizi di vigilanza e investigazione                       ,0,0,0,0,0,2024
PIE,AT,N 81,Attività di servizi per edifici e paesaggio                 ,0,0,0,2,2,2024
PIE,AT,N 82,Attività di supporto per le funzioni d'ufficio e altri se...,0,0,1,0,1,2024
PIE,AT,O   ,Amministrazione pubblica e difesa; assicurazione sociale ...,0,0,0,0,0,2024
PIE,AT,O 84,Amministrazione pubblica e difesa; assicurazione sociale ...,0,0,0,0,0,2024
PIE,AT,P   ,Istruzione                                                  ,0,1,0,0,1,2024
PIE,AT,P 85,Istruzione                                                  ,0,1,0,0,1,2024
PIE,AT,Q   ,Sanita' e assistenza sociale                                ,0,0,0,1,1,2024
PIE,AT,Q 86,Assistenza sanitaria                                        ,0,0,0,1,1,2024
PIE,AT,Q 87,Servizi di assistenza sociale residenziale                  ,0,0,0,0,0,2024
PIE,AT,Q 88,Assistenza sociale non residenziale                         ,0,0,0,0,0,2024
PIE,AT,R   ,"Attività artistiche, sportive, di intrattenimento e diver...",0,1,0,1,2,2024
PIE,AT,R 90,"Attività creative, artistiche e di intrattenimento          ",0,0,0,0,0,2024
PIE,AT,R 91,"Attività di biblioteche, archivi, musei ed altre attività...",0,0,0,0,0,2024
PIE,AT,R 92,"Attività riguardanti le lotterie, le scommesse, le case d...",0,0,0,0,0,2024
PIE,AT,R 93,"Attività sportive, di intrattenimento e di divertimento     ",0,1,0,1,2,2024
PIE,AT,S   ,Altre attività di servizi                                   ,0,2,2,0,4,2024
PIE,AT,S 94,Attività di organizzazioni associative                      ,0,0,0,0,0,2024
PIE,AT,S 95,Riparazione di computer e di beni per uso personale e per...,0,0,0,0,0,2024
PIE,AT,S 96,Altre attività di servizi per la persona                    ,0,2,2,0,4,2024
PIE,AT,T   ,Attività di famiglie e convivenze come datori di lavoro p...,0,0,0,0,0,2024
PIE,AT,T 97,Attività di famiglie e convivenze come datori di lavoro p...,0,0,0,0,0,2024
PIE,AT,T 98,Produzione di beni e servizi indifferenziati per uso prop...,0,0,0,0,0,2024
PIE,AT,U   ,Organizzazioni ed organismi extraterritoriali               ,0,0,0,0,0,2024
PIE,AT,U 99,Organizzazioni ed organismi extraterritoriali               ,0,0,0,0,0,2024
PIE,AT,XX  ,Imprese non classificate                                    ,0,7,1,8,16,2024
PIE,AT,TOT ,TOTALE                                                      ,0,66,162,45,273,2024
PIE,AL,A   ,"Agricoltura, silvicoltura pesca                             ",0,3,49,7,59,2024
PIE,AL,A 01,"Coltivazioni agricole e produzione di prodotti animali, c...",0,3,46,6,55,2024
PIE,AL,A 02,Silvicoltura ed utilizzo di aree forestali                  ,0,0,3,1,4,2024
PIE,AL,A 03,Pesca e acquacoltura                                        ,0,0,0,0,0,2024
PIE,AL,B   ,Estrazione di minerali da cave e miniere                    ,0,0,0,0,0,2024
PIE,AL,B 05,Estrazione di carbone (esclusa torba)                       ,0,0,0,0,0,2024
PIE,AL,B 06,Estraz.di petrolio greggio e di gas naturale                ,0,0,0,0,0,2024
PIE,AL,B 07,Estrazione di minerali metalliferi                          ,0,0,0,0,0,2024
PIE,AL,B 08,Altre attività di estrazione di minerali da cave e miniere  ,0,0,0,0,0,2024
PIE,AL,B 09,Attività dei servizi di supporto all'estrazione             ,0,0,0,0,0,2024
PIE,AL,C   ,Attività manifatturiere                                     ,0,11,21,7,39,2024
PIE,AL,C 10,Industrie alimentari                                        ,0,5,2,0,7,2024
PIE,AL,C 11,Industria delle bevande                                     ,0,0,0,0,0,2024
PIE,AL,C 12,Industria del tabacco                                       ,0,0,0,0,0,2024
PIE,AL,C 13,Industrie tessili                                           ,0,0,0,0,0,2024
PIE,AL,C 14,Confezione di articoli di abbigliamento; confezione di ar...,0,0,0,1,1,2024
PIE,AL,C 15,Fabbricazione di articoli in pelle e simili                 ,0,0,0,1,1,2024
PIE,AL,C 16,Industria del legno e dei prodotti in legno e sughero (es...,0,1,0,0,1,2024
PIE,AL,C 17,Fabbricazione di carta e di prodotti di carta               ,0,0,0,0,0,2024
PIE,AL,C 18,Stampa e riproduzione di supporti registrati                ,0,0,1,1,2,2024
PIE,AL,C 19,Fabbricazione di coke e prodotti derivanti dalla raffinaz...,0,0,0,0,0,2024
PIE,AL,C 20,Fabbricazione di prodotti chimici                           ,0,0,0,0,0,2024
PIE,AL,C 21,Fabbricazione di prodotti farmaceutici di base e di prepa...,0,0,0,0,0,2024
PIE,AL,C 22,Fabbricazione di articoli in gomma e materie plastiche      ,0,1,0,1,2,2024
PIE,AL,C 23,Fabbricazione di altri prodotti della lavorazione di miner..,0,0,0,0,0,2024
PIE,AL,C 24,Metallurgia                                                 ,0,0,0,0,0,2024
PIE,AL,C 25,Fabbricazione di prodotti in metallo (esclusi macchinari ...,0,2,6,0,8,2024
PIE,AL,C 26,Fabbricazione di computer e prodotti di elettronica e ott...,0,0,0,1,1,2024
PIE,AL,C 27,Fabbricazione di apparecchiature elettriche ed apparecchi...,0,0,1,1,2,2024
PIE,AL,C 28,Fabbricazione di macchinari ed apparecchiature nca          ,0,0,3,0,3,2024
PIE,AL,C 29,"Fabbricazione di autoveicoli, rimorchi e semirimorchi       ",0,0,0,0,0,2024
PIE,AL,C 30,Fabbricazione di altri mezzi di trasporto                   ,0,0,0,0,0,2024
PIE,AL,C 31,Fabbricazione di mobili                                     ,0,0,0,0,0,2024
PIE,AL,C 32,Altre industrie manifatturiere                              ,0,2,6,1,9,2024
PIE,AL,C 33,"Riparazione, manutenzione ed installazione di macchine ed...",0,0,2,0,2,2024
PIE,AL,D   ,"Fornitura di energia elettrica, gas, vapore e aria condiz...",0,0,0,0,0,2024
PIE,AL,D 35,"Fornitura di energia elettrica, gas, vapore e aria condiz...",0,0,0,0,0,2024
PIE,AL,E   ,"Fornitura di acqua; reti fognarie, attività di gestione d...",0,0,0,0,0,2024
PIE,AL,E 36,"Raccolta, trattamento e fornitura di acqua                  ",0,0,0,0,0,2024
PIE,AL,E 37,Gestione delle reti fognarie                                ,0,0,0,0,0,2024
PIE,AL,E 38,"Attività di raccolta, trattamento e smaltimento dei rifiu...",0,0,0,0,0,2024
PIE,AL,E 39,Attività di risanamento e altri servizi di gestione dei r...,0,0,0,0,0,2024
PIE,AL,F   ,Costruzioni                                                 ,0,11,115,11,137,2024
PIE,AL,F 41,Costruzione di edifici                                      ,0,7,15,8,30,2024
PIE,AL,F 42,Ingegneria civile                                           ,0,0,0,0,0,2024
PIE,AL,F 43,Lavori di costruzione specializzati                         ,0,4,100,3,107,2024
PIE,AL,G   ,Commercio all'ingrosso e al dettaglio; riparazione di aut...,0,17,73,1,91,2024
PIE,AL,G 45,Commercio all'ingrosso e al dettaglio e riparazione di au...,0,0,11,1,12,2024
PIE,AL,G 46,Commercio all'ingrosso (escluso quello di autoveicoli e d...,0,3,25,0,28,2024
PIE,AL,G 47,Commercio al dettaglio (escluso quello di autoveicoli e d...,0,14,37,0,51,2024
PIE,AL,H   ,Trasporto e magazzinaggio                                   ,0,2,10,6,18,2024
PIE,AL,H 49,Trasporto terrestre e mediante condotte                     ,0,1,10,4,15,2024
PIE,AL,H 50,Trasporto marittimo e per vie d'acqua                       ,0,0,0,0,0,2024
PIE,AL,H 51,Trasporto aereo                                             ,0,0,0,0,0,2024
PIE,AL,H 52,Magazzinaggio e attività di supporto ai trasporti           ,0,1,0,2,3,2024
PIE,AL,H 53,Servizi postali e attività di corriere                      ,0,0,0,0,0,2024
PIE,AL,I   ,Attività dei servizi alloggio e ristorazione                ,0,54,8,3,65,2024
PIE,AL,I 55,Alloggio                                                    ,0,2,0,0,2,2024
PIE,AL,I 56,Attività dei servizi di ristorazione                        ,0,52,8,3,63,2024
PIE,AL,J   ,Servizi di informazione e comunicazione                     ,0,4,2,1,7,2024
PIE,AL,J 58,Attività editoriali                                         ,0,1,0,0,1,2024
PIE,AL,J 59,"Attività di produzione cinematografica, di video e di pro...",0,0,0,0,0,2024
PIE,AL,J 60,Attività di programmazione e trasmissione                   ,0,0,0,0,0,2024
PIE,AL,J 61,Telecomunicazioni                                           ,0,2,1,0,3,2024
PIE,AL,J 62,"Produzione di software, consulenza informatica e attività...",0,0,1,1,2,2024
PIE,AL,J 63,Attività dei servizi d'informazione e altri servizi infor...,0,1,0,0,1,2024
PIE,AL,K   ,Attività finanziarie e assicurative                         ,0,2,9,0,11,2024
PIE,AL,K 64,Attività di servizi finanziari (escluse le assicurazioni ...,0,0,0,0,0,2024
PIE,AL,K 65,"Assicurazioni, riassicurazioni e fondi pensione (escluse ...",0,0,0,0,0,2024
PIE,AL,K 66,Attività ausiliarie dei servizi finanziari e delle attivi...,0,2,9,0,11,2024
PIE,AL,L   ,Attivita' immobiliari                                       ,0,5,2,3,10,2024
PIE,AL,L 68,Attivita' immobiliari                                       ,0,5,2,3,10,2024
PIE,AL,M   ,"Attività professionali, scientifiche e tecniche             ",0,3,4,3,10,2024
PIE,AL,M 69,Attività legali e contabilità                               ,0,0,0,1,1,2024
PIE,AL,M 70,Attività di direzione aziendale e di consulenza gestional...,0,2,1,2,5,2024
PIE,AL,M 71,Attività degli studi di architettura e d'ingegneria; coll...,0,0,0,0,0,2024
PIE,AL,M 72,Ricerca scientifica e sviluppo                              ,0,0,0,0,0,2024
PIE,AL,M 73,Pubblicità e ricerche di mercato                            ,0,0,1,0,1,2024
PIE,AL,M 74,"Altre attività professionali, scientifiche e tecniche       ",0,1,2,0,3,2024
PIE,AL,M 75,Servizi veterinari                                          ,0,0,0,0,0,2024
PIE,AL,N   ,"Noleggio, agenzie di viaggio, servizi di supporto alle im...",0,4,9,10,23,2024
PIE,AL,N 77,Attività di noleggio e leasing operativo                    ,0,0,1,0,1,2024
PIE,AL,N 78,"Attività di ricerca, selezione, fornitura di personale      ",0,0,0,0,0,2024
PIE,AL,N 79,"Attività dei servizi delle agenzie di viaggio, dei tour o...",0,0,0,0,0,2024
PIE,AL,N 80,Servizi di vigilanza e investigazione                       ,0,0,1,1,2,2024
PIE,AL,N 81,Attività di servizi per edifici e paesaggio                 ,0,3,3,6,12,2024
PIE,AL,N 82,Attività di supporto per le funzioni d'ufficio e altri se...,0,1,4,3,8,2024
PIE,AL,O   ,Amministrazione pubblica e difesa; assicurazione sociale ...,0,0,0,0,0,2024
PIE,AL,O 84,Amministrazione pubblica e difesa; assicurazione sociale ...,0,0,0,0,0,2024
PIE,AL,P   ,Istruzione                                                  ,0,0,0,2,2,2024
PIE,AL,P 85,Istruzione                                                  ,0,0,0,2,2,2024
PIE,AL,Q   ,Sanita' e assistenza sociale                                ,0,0,0,4,4,2024
PIE,AL,Q 86,Assistenza sanitaria                                        ,0,0,0,0,0,2024
PIE,AL,Q 87,Servizi di assistenza sociale residenziale                  ,0,0,0,0,0,2024
PIE,AL,Q 88,Assistenza sociale non residenziale                         ,0,0,0,4,4,2024
PIE,AL,R   ,"Attività artistiche, sportive, di intrattenimento e diver...",0,0,1,1,2,2024
PIE,AL,R 90,"Attività creative, artistiche e di intrattenimento          ",0,0,1,0,1,2024
PIE,AL,R 91,"Attività di biblioteche, archivi, musei ed altre attività...",0,0,0,1,1,2024
PIE,AL,R 92,"Attività riguardanti le lotterie, le scommesse, le case d...",0,0,0,0,0,2024
PIE,AL,R 93,"Attività sportive, di intrattenimento e di divertimento     ",0,0,0,0,0,2024
PIE,AL,S   ,Altre attività di servizi                                   ,0,3,9,0,12,2024
PIE,AL,S 94,Attività di organizzazioni associative                      ,0,0,0,0,0,2024
PIE,AL,S 95,Riparazione di computer e di beni per uso personale e per...,0,0,4,0,4,2024
PIE,AL,S 96,Altre attività di servizi per la persona                    ,0,3,5,0,8,2024
PIE,AL,T   ,Attività di famiglie e convivenze come datori di lavoro p...,0,0,0,0,0,2024
PIE,AL,T 97,Attività di famiglie e convivenze come datori di lavoro p...,0,0,0,0,0,2024
PIE,AL,T 98,Produzione di beni e servizi indifferenziati per uso prop...,0,0,0,0,0,2024
PIE,AL,U   ,Organizzazioni ed organismi extraterritoriali               ,0,0,0,0,0,2024
PIE,AL,U 99,Organizzazioni ed organismi extraterritoriali               ,0,0,0,0,0,2024
PIE,AL,XX  ,Imprese non classificate                                    ,0,10,4,14,28,2024
PIE,AL,TOT ,TOTALE                                                      ,0,129,316,73,518,2024
PIE,BI,A   ,"Agricoltura, silvicoltura pesca                             ",0,0,0,1,1,2024
PIE,BI,A 01,"Coltivazioni agricole e produzione di prodotti animali, c...",0,0,0,1,1,2024
PIE,BI,A 02,Silvicoltura ed utilizzo di aree forestali                  ,0,0,0,0,0,2024
PIE,BI,A 03,Pesca e acquacoltura                                        ,0,0,0,0,0,2024
PIE,BI,B   ,Estrazione di minerali da cave e miniere                    ,0,0,0,0,0,2024
PIE,BI,B 05,Estrazione di carbone (esclusa torba)                       ,0,0,0,0,0,2024
PIE,BI,B 06,Estraz.di petrolio greggio e di gas naturale                ,0,0,0,0,0,2024
PIE,BI,B 07,Estrazione di minerali metalliferi                          ,0,0,0,0,0,2024
PIE,BI,B 08,Altre attività di estrazione di minerali da cave e miniere  ,0,0,0,0,0,2024
PIE,BI,B 09,Attività dei servizi di supporto all'estrazione             ,0,0,0,0,0,2024
PIE,BI,C   ,Attività manifatturiere                                     ,32,5,0,0,37,2024
PIE,BI,C 10,Industrie alimentari                                        ,0,0,0,0,0,2024
PIE,BI,C 11,Industria delle bevande                                     ,0,0,0,0,0,2024
PIE,BI,C 12,Industria del tabacco                                       ,0,0,0,0,0,2024
PIE,BI,C 13,Industrie tessili                                           ,24,2,0,0,26,2024
PIE,BI,C 14,Confezione di articoli di abbigliamento; confezione di ar...,3,0,0,0,3,2024
PIE,BI,C 15,Fabbricazione di articoli in pelle e simili                 ,0,1,0,0,1,2024
PIE,BI,C 16,Industria del legno e dei prodotti in legno e sughero (es...,0,0,0,0,0,2024
PIE,BI,C 17,Fabbricazione di carta e di prodotti di carta               ,1,0,0,0,1,2024
PIE,BI,C 18,Stampa e riproduzione di supporti registrati                ,0,0,0,0,0,2024
PIE,BI,C 19,Fabbricazione di coke e prodotti derivanti dalla raffinaz...,0,0,0,0,0,2024
PIE,BI,C 20,Fabbricazione di prodotti chimici                           ,1,0,0,0,1,2024
PIE,BI,C 21,Fabbricazione di prodotti farmaceutici di base e di prepa...,0,0,0,0,0,2024
PIE,BI,C 22,Fabbricazione di articoli in gomma e materie plastiche      ,1,0,0,0,1,2024
PIE,BI,C 23,Fabbricazione di altri prodotti della lavorazione di miner..,0,0,0,0,0,2024
PIE,BI,C 24,Metallurgia                                                 ,0,0,0,0,0,2024
PIE,BI,C 25,Fabbricazione di prodotti in metallo (esclusi macchinari ...,0,1,0,0,1,2024
PIE,BI,C 26,Fabbricazione di computer e prodotti di elettronica e ott...,0,0,0,0,0,2024
PIE,BI,C 27,Fabbricazione di apparecchiature elettriche ed apparecchi...,1,0,0,0,1,2024
PIE,BI,C 28,Fabbricazione di macchinari ed apparecchiature nca          ,1,0,0,0,1,2024
PIE,BI,C 29,"Fabbricazione di autoveicoli, rimorchi e semirimorchi       ",0,0,0,0,0,2024
PIE,BI,C 30,Fabbricazione di altri mezzi di trasporto                   ,0,0,0,0,0,2024
PIE,BI,C 31,Fabbricazione di mobili                                     ,0,0,0,0,0,2024
PIE,BI,C 32,Altre industrie manifatturiere                              ,0,1,0,0,1,2024
PIE,BI,C 33,"Riparazione, manutenzione ed installazione di macchine ed...",0,0,0,0,0,2024
PIE,BI,D   ,"Fornitura di energia elettrica, gas, vapore e aria condiz...",0,0,0,0,0,2024
PIE,BI,D 35,"Fornitura di energia elettrica, gas, vapore e aria condiz...",0,0,0,0,0,2024
PIE,BI,E   ,"Fornitura di acqua; reti fognarie, attività di gestione d...",0,0,0,0,0,2024
PIE,BI,E 36,"Raccolta, trattamento e fornitura di acqua                  ",0,0,0,0,0,2024
PIE,BI,E 37,Gestione delle reti fognarie                                ,0,0,0,0,0,2024
PIE,BI,E 38,"Attività di raccolta, trattamento e smaltimento dei rifiu...",0,0,0,0,0,2024
PIE,BI,E 39,Attività di risanamento e altri servizi di gestione dei r...,0,0,0,0,0,2024
PIE,BI,F   ,Costruzioni                                                 ,5,1,0,8,14,2024
PIE,BI,F 41,Costruzione di edifici                                      ,4,1,0,4,9,2024
PIE,BI,F 42,Ingegneria civile                                           ,0,0,0,1,1,2024
PIE,BI,F 43,Lavori di costruzione specializzati                         ,1,0,0,3,4,2024
PIE,BI,G   ,Commercio all'ingrosso e al dettaglio; riparazione di aut...,17,5,0,2,24,2024
PIE,BI,G 45,Commercio all'ingrosso e al dettaglio e riparazione di au...,2,0,0,0,2,2024
PIE,BI,G 46,Commercio all'ingrosso (escluso quello di autoveicoli e d...,7,3,0,1,11,2024
PIE,BI,G 47,Commercio al dettaglio (escluso quello di autoveicoli e d...,8,2,0,1,11,2024
PIE,BI,H   ,Trasporto e magazzinaggio                                   ,0,0,0,5,5,2024
PIE,BI,H 49,Trasporto terrestre e mediante condotte                     ,0,0,0,0,0,2024
PIE,BI,H 50,Trasporto marittimo e per vie d'acqua                       ,0,0,0,0,0,2024
PIE,BI,H 51,Trasporto aereo                                             ,0,0,0,0,0,2024
PIE,BI,H 52,Magazzinaggio e attività di supporto ai trasporti           ,0,0,0,5,5,2024
PIE,BI,H 53,Servizi postali e attività di corriere                      ,0,0,0,0,0,2024
PIE,BI,I   ,Attività dei servizi alloggio e ristorazione                ,2,1,0,0,3,2024
PIE,BI,I 55,Alloggio                                                    ,0,0,0,0,0,2024
PIE,BI,I 56,Attività dei servizi di ristorazione                        ,2,1,0,0,3,2024
PIE,BI,J   ,Servizi di informazione e comunicazione                     ,4,0,0,1,5,2024
PIE,BI,J 58,Attività editoriali                                         ,1,0,0,0,1,2024
PIE,BI,J 59,"Attività di produzione cinematografica, di video e di pro...",0,0,0,0,0,2024
PIE,BI,J 60,Attività di programmazione e trasmissione                   ,1,0,0,0,1,2024
PIE,BI,J 61,Telecomunicazioni                                           ,0,0,0,0,0,2024
PIE,BI,J 62,"Produzione di software, consulenza informatica e attività...",1,0,0,0,1,2024
PIE,BI,J 63,Attività dei servizi d'informazione e altri servizi infor...,1,0,0,1,2,2024
PIE,BI,K   ,Attività finanziarie e assicurative                         ,2,3,0,0,5,2024
PIE,BI,K 64,Attività di servizi finanziari (escluse le assicurazioni ...,2,2,0,0,4,2024
PIE,BI,K 65,"Assicurazioni, riassicurazioni e fondi pensione (escluse ...",0,0,0,0,0,2024
PIE,BI,K 66,Attività ausiliarie dei servizi finanziari e delle attivi...,0,1,0,0,1,2024
PIE,BI,L   ,Attivita' immobiliari                                       ,1,2,0,2,5,2024
PIE,BI,L 68,Attivita' immobiliari                                       ,1,2,0,2,5,2024
PIE,BI,M   ,"Attività professionali, scientifiche e tecniche             ",1,1,0,3,5,2024
PIE,BI,M 69,Attività legali e contabilità                               ,0,0,0,0,0,2024
PIE,BI,M 70,Attività di direzione aziendale e di consulenza gestional...,1,0,0,2,3,2024
PIE,BI,M 71,Attività degli studi di architettura e d'ingegneria; coll...,0,0,0,0,0,2024
PIE,BI,M 72,Ricerca scientifica e sviluppo                              ,0,0,0,0,0,2024
PIE,BI,M 73,Pubblicità e ricerche di mercato                            ,0,0,0,1,1,2024
PIE,BI,M 74,"Altre attività professionali, scientifiche e tecniche       ",0,1,0,0,1,2024
PIE,BI,M 75,Servizi veterinari                                          ,0,0,0,0,0,2024
PIE,BI,N   ,"Noleggio, agenzie di viaggio, servizi di supporto alle im...",0,0,0,14,14,2024
PIE,BI,N 77,Attività di noleggio e leasing operativo                    ,0,0,0,0,0,2024
PIE,BI,N 78,"Attività di ricerca, selezione, fornitura di personale      ",0,0,0,0,0,2024
PIE,BI,N 79,"Attività dei servizi delle agenzie di viaggio, dei tour o...",0,0,0,0,0,2024
PIE,BI,N 80,Servizi di vigilanza e investigazione                       ,0,0,0,0,0,2024
PIE,BI,N 81,Attività di servizi per edifici e paesaggio                 ,0,0,0,11,11,2024
PIE,BI,N 82,Attività di supporto per le funzioni d'ufficio e altri se...,0,0,0,3,3,2024
PIE,BI,O   ,Amministrazione pubblica e difesa; assicurazione sociale ...,0,0,0,0,0,2024
PIE,BI,O 84,Amministrazione pubblica e difesa; assicurazione sociale ...,0,0,0,0,0,2024
PIE,BI,P   ,Istruzione                                                  ,0,0,0,1,1,2024
PIE,BI,P 85,Istruzione                                                  ,0,0,0,1,1,2024
PIE,BI,Q   ,Sanita' e assistenza sociale                                ,0,0,0,7,7,2024
PIE,BI,Q 86,Assistenza sanitaria                                        ,0,0,0,0,0,2024
PIE,BI,Q 87,Servizi di assistenza sociale residenziale                  ,0,0,0,0,0,2024
PIE,BI,Q 88,Assistenza sociale non residenziale                         ,0,0,0,7,7,2024
PIE,BI,R   ,"Attività artistiche, sportive, di intrattenimento e diver...",0,1,0,0,1,2024
PIE,BI,R 90,"Attività creative, artistiche e di intrattenimento          ",0,0,0,0,0,2024
PIE,BI,R 91,"Attività di biblioteche, archivi, musei ed altre attività...",0,0,0,0,0,2024
PIE,BI,R 92,"Attività riguardanti le lotterie, le scommesse, le case d...",0,0,0,0,0,2024
PIE,BI,R 93,"Attività sportive, di intrattenimento e di divertimento     ",0,1,0,0,1,2024
PIE,BI,S   ,Altre attività di servizi                                   ,0,0,0,1,1,2024
PIE,BI,S 94,Attività di organizzazioni associative                      ,0,0,0,0,0,2024
PIE,BI,S 95,Riparazione di computer e di beni per uso personale e per...,0,0,0,0,0,2024
PIE,BI,S 96,Altre attività di servizi per la persona                    ,0,0,0,1,1,2024
PIE,BI,T   ,Attività di famiglie e convivenze come datori di lavoro p...,0,0,0,0,0,2024
PIE,BI,T 97,Attività di famiglie e convivenze come datori di lavoro p...,0,0,0,0,0,2024
PIE,BI,T 98,Produzione di beni e servizi indifferenziati per uso prop...,0,0,0,0,0,2024
PIE,BI,U   ,Organizzazioni ed organismi extraterritoriali               ,0,0,0,0,0,2024
PIE,BI,U 99,Organizzazioni ed organismi extraterritoriali               ,0,0,0,0,0,2024
PIE,BI,XX  ,Imprese non classificate                                    ,2,3,0,11,16,2024
PIE,BI,TOT ,TOTALE                                                      ,66,22,0,56,144,2024
PIE,VB,A   ,"Agricoltura, silvicoltura pesca                             ",0,0,0,0,0,2024
PIE,VB,A 01,"Coltivazioni agricole e produzione di prodotti animali, c...",0,0,0,0,0,2024
PIE,VB,A 02,Silvicoltura ed utilizzo di aree forestali                  ,0,0,0,0,0,2024
PIE,VB,A 03,Pesca e acquacoltura                                        ,0,0,0,0,0,2024
PIE,VB,B   ,Estrazione di minerali da cave e miniere                    ,0,0,0,0,0,2024
PIE,VB,B 05,Estrazione di carbone (esclusa torba)                       ,0,0,0,0,0,2024
PIE,VB,B 06,Estraz.di petrolio greggio e di gas naturale                ,0,0,0,0,0,2024
PIE,VB,B 07,Estrazione di minerali metalliferi                          ,0,0,0,0,0,2024
PIE,VB,B 08,Altre attività di estrazione di minerali da cave e miniere  ,0,0,0,0,0,2024
PIE,VB,B 09,Attività dei servizi di supporto all'estrazione             ,0,0,0,0,0,2024
PIE,VB,C   ,Attività manifatturiere                                     ,9,4,0,0,13,2024
PIE,VB,C 10,Industrie alimentari                                        ,0,1,0,0,1,2024
PIE,VB,C 11,Industria delle bevande                                     ,1,0,0,0,1,2024
PIE,VB,C 12,Industria del tabacco                                       ,0,0,0,0,0,2024
PIE,VB,C 13,Industrie tessili                                           ,0,0,0,0,0,2024
PIE,VB,C 14,Confezione di articoli di abbigliamento; confezione di ar...,0,0,0,0,0,2024
PIE,VB,C 15,Fabbricazione di articoli in pelle e simili                 ,0,1,0,0,1,2024
PIE,VB,C 16,Industria del legno e dei prodotti in legno e sughero (es...,0,0,0,0,0,2024
PIE,VB,C 17,Fabbricazione di carta e di prodotti di carta               ,0,0,0,0,0,2024
PIE,VB,C 18,Stampa e riproduzione di supporti registrati                ,0,0,0,0,0,2024
PIE,VB,C 19,Fabbricazione di coke e prodotti derivanti dalla raffinaz...,0,0,0,0,0,2024
PIE,VB,C 20,Fabbricazione di prodotti chimici                           ,0,0,0,0,0,2024
PIE,VB,C 21,Fabbricazione di prodotti farmaceutici di base e di prepa...,0,0,0,0,0,2024
PIE,VB,C 22,Fabbricazione di articoli in gomma e materie plastiche      ,0,0,0,0,0,2024
PIE,VB,C 23,Fabbricazione di altri prodotti della lavorazione di miner..,0,0,0,0,0,2024
PIE,VB,C 24,Metallurgia                                                 ,0,1,0,0,1,2024
PIE,VB,C 25,Fabbricazione di prodotti in metallo (esclusi macchinari ...,1,0,0,0,1,2024
PIE,VB,C 26,Fabbricazione di computer e prodotti di elettronica e ott...,0,0,0,0,0,2024
PIE,VB,C 27,Fabbricazione di apparecchiature elettriche ed apparecchi...,3,0,0,0,3,2024
PIE,VB,C 28,Fabbricazione di macchinari ed apparecchiature nca          ,1,1,0,0,2,2024
PIE,VB,C 29,"Fabbricazione di autoveicoli, rimorchi e semirimorchi       ",1,0,0,0,1,2024
PIE,VB,C 30,Fabbricazione di altri mezzi di trasporto                   ,0,0,0,0,0,2024
PIE,VB,C 31,Fabbricazione di mobili                                     ,1,0,0,0,1,2024
PIE,VB,C 32,Altre industrie manifatturiere                              ,1,0,0,0,1,2024
PIE,VB,C 33,"Riparazione, manutenzione ed installazione di macchine ed...",0,0,0,0,0,2024
PIE,VB,D   ,"Fornitura di energia elettrica, gas, vapore e aria condiz...",0,0,0,0,0,2024
PIE,VB,D 35,"Fornitura di energia elettrica, gas, vapore e aria condiz...",0,0,0,0,0,2024
PIE,VB,E   ,"Fornitura di acqua; reti fognarie, attività di gestione d...",0,0,0,0,0,2024
PIE,VB,E 36,"Raccolta, trattamento e fornitura di acqua                  ",0,0,0,0,0,2024
PIE,VB,E 37,Gestione delle reti fognarie                                ,0,0,0,0,0,2024
PIE,VB,E 38,"Attività di raccolta, trattamento e smaltimento dei rifiu...",0,0,0,0,0,2024
PIE,VB,E 39,Attività di risanamento e altri servizi di gestione dei r...,0,0,0,0,0,2024
PIE,VB,F   ,Costruzioni                                                 ,5,0,0,4,9,2024
PIE,VB,F 41,Costruzione di edifici                                      ,4,0,0,3,7,2024
PIE,VB,F 42,Ingegneria civile                                           ,0,0,0,0,0,2024
PIE,VB,F 43,Lavori di costruzione specializzati                         ,1,0,0,1,2,2024
PIE,VB,G   ,Commercio all'ingrosso e al dettaglio; riparazione di aut...,5,4,0,2,11,2024
PIE,VB,G 45,Commercio all'ingrosso e al dettaglio e riparazione di au...,1,0,0,0,1,2024
PIE,VB,G 46,Commercio all'ingrosso (escluso quello di autoveicoli e d...,3,1,0,2,6,2024
PIE,VB,G 47,Commercio al dettaglio (escluso quello di autoveicoli e d...,1,3,0,0,4,2024
PIE,VB,H   ,Trasporto e magazzinaggio                                   ,0,1,0,0,1,2024
PIE,VB,H 49,Trasporto terrestre e mediante condotte                     ,0,1,0,0,1,2024
PIE,VB,H 50,Trasporto marittimo e per vie d'acqua                       ,0,0,0,0,0,2024
PIE,VB,H 51,Trasporto aereo                                             ,0,0,0,0,0,2024
PIE,VB,H 52,Magazzinaggio e attività di supporto ai trasporti           ,0,0,0,0,0,2024
PIE,VB,H 53,Servizi postali e attività di corriere                      ,0,0,0,0,0,2024
PIE,VB,I   ,Attività dei servizi alloggio e ristorazione                ,4,2,0,5,11,2024
PIE,VB,I 55,Alloggio                                                    ,2,1,0,0,3,2024
PIE,VB,I 56,Attività dei servizi di ristorazione                        ,2,1,0,5,8,2024
PIE,VB,J   ,Servizi di informazione e comunicazione                     ,0,0,0,1,1,2024
PIE,VB,J 58,Attività editoriali                                         ,0,0,0,1,1,2024
PIE,VB,J 59,"Attività di produzione cinematografica, di video e di pro...",0,0,0,0,0,2024
PIE,VB,J 60,Attività di programmazione e trasmissione                   ,0,0,0,0,0,2024
PIE,VB,J 61,Telecomunicazioni                                           ,0,0,0,0,0,2024
PIE,VB,J 62,"Produzione di software, consulenza informatica e attività...",0,0,0,0,0,2024
PIE,VB,J 63,Attività dei servizi d'informazione e altri servizi infor...,0,0,0,0,0,2024
PIE,VB,K   ,Attività finanziarie e assicurative                         ,1,0,0,0,1,2024
PIE,VB,K 64,Attività di servizi finanziari (escluse le assicurazioni ...,1,0,0,0,1,2024
PIE,VB,K 65,"Assicurazioni, riassicurazioni e fondi pensione (escluse ...",0,0,0,0,0,2024
PIE,VB,K 66,Attività ausiliarie dei servizi finanziari e delle attivi...,0,0,0,0,0,2024
PIE,VB,L   ,Attivita' immobiliari                                       ,2,0,0,0,2,2024
PIE,VB,L 68,Attivita' immobiliari                                       ,2,0,0,0,2,2024
PIE,VB,M   ,"Attività professionali, scientifiche e tecniche             ",1,0,0,0,1,2024
PIE,VB,M 69,Attività legali e contabilità                               ,0,0,0,0,0,2024
PIE,VB,M 70,Attività di direzione aziendale e di consulenza gestional...,0,0,0,0,0,2024
PIE,VB,M 71,Attività degli studi di architettura e d'ingegneria; coll...,0,0,0,0,0,2024
PIE,VB,M 72,Ricerca scientifica e sviluppo                              ,0,0,0,0,0,2024
PIE,VB,M 73,Pubblicità e ricerche di mercato                            ,0,0,0,0,0,2024
PIE,VB,M 74,"Altre attività professionali, scientifiche e tecniche       ",1,0,0,0,1,2024
PIE,VB,M 75,Servizi veterinari                                          ,0,0,0,0,0,2024
PIE,VB,N   ,"Noleggio, agenzie di viaggio, servizi di supporto alle im...",0,1,0,0,1,2024
PIE,VB,N 77,Attività di noleggio e leasing operativo                    ,0,0,0,0,0,2024
PIE,VB,N 78,"Attività di ricerca, selezione, fornitura di personale      ",0,0,0,0,0,2024
PIE,VB,N 79,"Attività dei servizi delle agenzie di viaggio, dei tour o...",0,0,0,0,0,2024
PIE,VB,N 80,Servizi di vigilanza e investigazione                       ,0,0,0,0,0,2024
PIE,VB,N 81,Attività di servizi per edifici e paesaggio                 ,0,1,0,0,1,2024
PIE,VB,N 82,Attività di supporto per le funzioni d'ufficio e altri se...,0,0,0,0,0,2024
PIE,VB,O   ,Amministrazione pubblica e difesa; assicurazione sociale ...,0,0,0,0,0,2024
PIE,VB,O 84,Amministrazione pubblica e difesa; assicurazione sociale ...,0,0,0,0,0,2024
PIE,VB,P   ,Istruzione                                                  ,1,0,0,0,1,2024
PIE,VB,P 85,Istruzione                                                  ,1,0,0,0,1,2024
PIE,VB,Q   ,Sanita' e assistenza sociale                                ,0,0,0,0,0,2024
PIE,VB,Q 86,Assistenza sanitaria                                        ,0,0,0,0,0,2024
PIE,VB,Q 87,Servizi di assistenza sociale residenziale                  ,0,0,0,0,0,2024
PIE,VB,Q 88,Assistenza sociale non residenziale                         ,0,0,0,0,0,2024
PIE,VB,R   ,"Attività artistiche, sportive, di intrattenimento e diver...",0,0,0,0,0,2024
PIE,VB,R 90,"Attività creative, artistiche e di intrattenimento          ",0,0,0,0,0,2024
PIE,VB,R 91,"Attività di biblioteche, archivi, musei ed altre attività...",0,0,0,0,0,2024
PIE,VB,R 92,"Attività riguardanti le lotterie, le scommesse, le case d...",0,0,0,0,0,2024
PIE,VB,R 93,"Attività sportive, di intrattenimento e di divertimento     ",0,0,0,0,0,2024
PIE,VB,S   ,Altre attività di servizi                                   ,0,0,0,1,1,2024
PIE,VB,S 94,Attività di organizzazioni associative                      ,0,0,0,1,1,2024
PIE,VB,S 95,Riparazione di computer e di beni per uso personale e per...,0,0,0,0,0,2024
PIE,VB,S 96,Altre attività di servizi per la persona                    ,0,0,0,0,0,2024
PIE,VB,T   ,Attività di famiglie e convivenze come datori di lavoro p...,0,0,0,0,0,2024
PIE,VB,T 97,Attività di famiglie e convivenze come datori di lavoro p...,0,0,0,0,0,2024
PIE,VB,T 98,Produzione di beni e servizi indifferenziati per uso prop...,0,0,0,0,0,2024
PIE,VB,U   ,Organizzazioni ed organismi extraterritoriali               ,0,0,0,0,0,2024
PIE,VB,U 99,Organizzazioni ed organismi extraterritoriali               ,0,0,0,0,0,2024
PIE,VB,XX  ,Imprese non classificate                                    ,0,1,0,1,2,2024
PIE,VB,TOT ,TOTALE                                                      ,28,13,0,14,55,2024
VAO,  ,A   ,"Agricoltura, silvicoltura pesca                             ",0,0,0,0,0,2024
VAO,  ,A 01,"Coltivazioni agricole e produzione di prodotti animali, c...",0,0,0,0,0,2024
VAO,  ,A 02,Silvicoltura ed utilizzo di aree forestali                  ,0,0,0,0,0,2024
VAO,  ,A 03,Pesca e acquacoltura                                        ,0,0,0,0,0,2024
VAO,  ,B   ,Estrazione di minerali da cave e miniere                    ,0,0,0,0,0,2024
VAO,  ,B 05,Estrazione di carbone (esclusa torba)                       ,0,0,0,0,0,2024
VAO,  ,B 06,Estraz.di petrolio greggio e di gas naturale                ,0,0,0,0,0,2024
VAO,  ,B 07,Estrazione di minerali metalliferi                          ,0,0,0,0,0,2024
VAO,  ,B 08,Altre attività di estrazione di minerali da cave e miniere  ,0,0,0,0,0,2024
VAO,  ,B 09,Attività dei servizi di supporto all'estrazione             ,0,0,0,0,0,2024
VAO,  ,C   ,Attività manifatturiere                                     ,1,0,0,0,1,2024
VAO,  ,C 10,Industrie alimentari                                        ,0,0,0,0,0,2024
VAO,  ,C 11,Industria delle bevande                                     ,0,0,0,0,0,2024
VAO,  ,C 12,Industria del tabacco                                       ,0,0,0,0,0,2024
VAO,  ,C 13,Industrie tessili                                           ,0,0,0,0,0,2024
VAO,  ,C 14,Confezione di articoli di abbigliamento; confezione di ar...,0,0,0,0,0,2024
VAO,  ,C 15,Fabbricazione di articoli in pelle e simili                 ,0,0,0,0,0,2024
VAO,  ,C 16,Industria del legno e dei prodotti in legno e sughero (es...,0,0,0,0,0,2024
VAO,  ,C 17,Fabbricazione di carta e di prodotti di carta               ,0,0,0,0,0,2024
VAO,  ,C 18,Stampa e riproduzione di supporti registrati                ,0,0,0,0,0,2024
VAO,  ,C 19,Fabbricazione di coke e prodotti derivanti dalla raffinaz...,0,0,0,0,0,2024
VAO,  ,C 20,Fabbricazione di prodotti chimici                           ,0,0,0,0,0,2024
VAO,  ,C 21,Fabbricazione di prodotti farmaceutici di base e di prepa...,0,0,0,0,0,2024
VAO,  ,C 22,Fabbricazione di articoli in gomma e materie plastiche      ,0,0,0,0,0,2024
VAO,  ,C 23,Fabbricazione di altri prodotti della lavorazione di miner..,0,0,0,0,0,2024
VAO,  ,C 24,Metallurgia                                                 ,0,0,0,0,0,2024
VAO,  ,C 25,Fabbricazione di prodotti in metallo (esclusi macchinari ...,0,0,0,0,0,2024
VAO,  ,C 26,Fabbricazione di computer e prodotti di elettronica e ott...,0,0,0,0,0,2024
VAO,  ,C 27,Fabbricazione di apparecchiature elettriche ed apparecchi...,0,0,0,0,0,2024
VAO,  ,C 28,Fabbricazione di macchinari ed apparecchiature nca          ,0,0,0,0,0,2024
VAO,  ,C 29,"Fabbricazione di autoveicoli, rimorchi e semirimorchi       ",0,0,0,0,0,2024
VAO,  ,C 30,Fabbricazione di altri mezzi di trasporto                   ,0,0,0,0,0,2024
VAO,  ,C 31,Fabbricazione di mobili                                     ,0,0,0,0,0,2024
VAO,  ,C 32,Altre industrie manifatturiere                              ,0,0,0,0,0,2024
VAO,  ,C 33,"Riparazione, manutenzione ed installazione di macchine ed...",1,0,0,0,1,2024
VAO,  ,D   ,"Fornitura di energia elettrica, gas, vapore e aria condiz...",0,0,0,0,0,2024
VAO,  ,D 35,"Fornitura di energia elettrica, gas, vapore e aria condiz...",0,0,0,0,0,2024
VAO,  ,E   ,"Fornitura di acqua; reti fognarie, attività di gestione d...",0,0,0,0,0,2024
VAO,  ,E 36,"Raccolta, trattamento e fornitura di acqua                  ",0,0,0,0,0,2024
VAO,  ,E 37,Gestione delle reti fognarie                                ,0,0,0,0,0,2024
VAO,  ,E 38,"Attività di raccolta, trattamento e smaltimento dei rifiu...",0,0,0,0,0,2024
VAO,  ,E 39,Attività di risanamento e altri servizi di gestione dei r...,0,0,0,0,0,2024
VAO,  ,F   ,Costruzioni                                                 ,1,0,0,1,2,2024
VAO,  ,F 41,Costruzione di edifici                                      ,1,0,0,0,1,2024
VAO,  ,F 42,Ingegneria civile                                           ,0,0,0,0,0,2024
VAO,  ,F 43,Lavori di costruzione specializzati                         ,0,0,0,1,1,2024
VAO,  ,G   ,Commercio all'ingrosso e al dettaglio; riparazione di aut...,3,0,0,0,3,2024
VAO,  ,G 45,Commercio all'ingrosso e al dettaglio e riparazione di au...,0,0,0,0,0,2024
VAO,  ,G 46,Commercio all'ingrosso (escluso quello di autoveicoli e d...,2,0,0,0,2,2024
VAO,  ,G 47,Commercio al dettaglio (escluso quello di autoveicoli e d...,1,0,0,0,1,2024
VAO,  ,H   ,Trasporto e magazzinaggio                                   ,0,0,0,0,0,2024
VAO,  ,H 49,Trasporto terrestre e mediante condotte                     ,0,0,0,0,0,2024
VAO,  ,H 50,Trasporto marittimo e per vie d'acqua                       ,0,0,0,0,0,2024
VAO,  ,H 51,Trasporto aereo                                             ,0,0,0,0,0,2024
VAO,  ,H 52,Magazzinaggio e attività di supporto ai trasporti           ,0,0,0,0,0,2024
VAO,  ,H 53,Servizi postali e attività di corriere                      ,0,0,0,0,0,2024
VAO,  ,I   ,Attività dei servizi alloggio e ristorazione                ,1,0,0,0,1,2024
VAO,  ,I 55,Alloggio                                                    ,0,0,0,0,0,2024
VAO,  ,I 56,Attività dei servizi di ristorazione                        ,1,0,0,0,1,2024
VAO,  ,J   ,Servizi di informazione e comunicazione                     ,1,0,0,0,1,2024
VAO,  ,J 58,Attività editoriali                                         ,0,0,0,0,0,2024
VAO,  ,J 59,"Attività di produzione cinematografica, di video e di pro...",0,0,0,0,0,2024
VAO,  ,J 60,Attività di programmazione e trasmissione                   ,0,0,0,0,0,2024
VAO,  ,J 61,Telecomunicazioni                                           ,0,0,0,0,0,2024
VAO,  ,J 62,"Produzione di software, consulenza informatica e attività...",1,0,0,0,1,2024
VAO,  ,J 63,Attività dei servizi d'informazione e altri servizi infor...,0,0,0,0,0,2024
VAO,  ,K   ,Attività finanziarie e assicurative                         ,0,0,0,0,0,2024
VAO,  ,K 64,Attività di servizi finanziari (escluse le assicurazioni ...,0,0,0,0,0,2024
VAO,  ,K 65,"Assicurazioni, riassicurazioni e fondi pensione (escluse ...",0,0,0,0,0,2024
VAO,  ,K 66,Attività ausiliarie dei servizi finanziari e delle attivi...,0,0,0,0,0,2024
VAO,  ,L   ,Attivita' immobiliari                                       ,2,0,0,0,2,2024
VAO,  ,L 68,Attivita' immobiliari                                       ,2,0,0,0,2,2024
VAO,  ,M   ,"Attività professionali, scientifiche e tecniche             ",1,0,0,0,1,2024
VAO,  ,M 69,Attività legali e contabilità                               ,0,0,0,0,0,2024
VAO,  ,M 70,Attività di direzione aziendale e di consulenza gestional...,0,0,0,0,0,2024
VAO,  ,M 71,Attività degli studi di architettura e d'ingegneria; coll...,1,0,0,0,1,2024
VAO,  ,M 72,Ricerca scientifica e sviluppo                              ,0,0,0,0,0,2024
VAO,  ,M 73,Pubblicità e ricerche di mercato                            ,0,0,0,0,0,2024
VAO,  ,M 74,"Altre attività professionali, scientifiche e tecniche       ",0,0,0,0,0,2024
VAO,  ,M 75,Servizi veterinari                                          ,0,0,0,0,0,2024
VAO,  ,N   ,"Noleggio, agenzie di viaggio, servizi di supporto alle im...",1,0,0,0,1,2024
VAO,  ,N 77,Attività di noleggio e leasing operativo                    ,1,0,0,0,1,2024
VAO,  ,N 78,"Attività di ricerca, selezione, fornitura di personale      ",0,0,0,0,0,2024
VAO,  ,N 79,"Attività dei servizi delle agenzie di viaggio, dei tour o...",0,0,0,0,0,2024
VAO,  ,N 80,Servizi di vigilanza e investigazione                       ,0,0,0,0,0,2024
VAO,  ,N 81,Attività di servizi per edifici e paesaggio                 ,0,0,0,0,0,2024
VAO,  ,N 82,Attività di supporto per le funzioni d'ufficio e altri se...,0,0,0,0,0,2024
VAO,  ,O   ,Amministrazione pubblica e difesa; assicurazione sociale ...,0,0,0,0,0,2024
VAO,  ,O 84,Amministrazione pubblica e difesa; assicurazione sociale ...,0,0,0,0,0,2024
VAO,  ,P   ,Istruzione                                                  ,0,0,0,0,0,2024
VAO,  ,P 85,Istruzione                                                  ,0,0,0,0,0,2024
VAO,  ,Q   ,Sanita' e assistenza sociale                                ,0,0,0,0,0,2024
VAO,  ,Q 86,Assistenza sanitaria                                        ,0,0,0,0,0,2024
VAO,  ,Q 87,Servizi di assistenza sociale residenziale                  ,0,0,0,0,0,2024
VAO,  ,Q 88,Assistenza sociale non residenziale                         ,0,0,0,0,0,2024
VAO,  ,R   ,"Attività artistiche, sportive, di intrattenimento e diver...",0,0,0,0,0,2024
VAO,  ,R 90,"Attività creative, artistiche e di intrattenimento          ",0,0,0,0,0,2024
VAO,  ,R 91,"Attività di biblioteche, archivi, musei ed altre attività...",0,0,0,0,0,2024
VAO,  ,R 92,"Attività riguardanti le lotterie, le scommesse, le case d...",0,0,0,0,0,2024
VAO,  ,R 93,"Attività sportive, di intrattenimento e di divertimento     ",0,0,0,0,0,2024
VAO,  ,S   ,Altre attività di servizi                                   ,0,0,0,0,0,2024
VAO,  ,S 94,Attività di organizzazioni associative                      ,0,0,0,0,0,2024
VAO,  ,S 95,Riparazione di computer e di beni per uso personale e per...,0,0,0,0,0,2024
VAO,  ,S 96,Altre attività di servizi per la persona                    ,0,0,0,0,0,2024
VAO,  ,T   ,Attività di famiglie e convivenze come datori di lavoro p...,0,0,0,0,0,2024
VAO,  ,T 97,Attività di famiglie e convivenze come datori di lavoro p...,0,0,0,0,0,2024
VAO,  ,T 98,Produzione di beni e servizi indifferenziati per uso prop...,0,0,0,0,0,2024
VAO,  ,U   ,Organizzazioni ed organismi extraterritoriali               ,0,0,0,0,0,2024
VAO,  ,U 99,Organizzazioni ed organismi extraterritoriali               ,0,0,0,0,0,2024
VAO,  ,XX  ,Imprese non classificate                                    ,7,0,0,0,7,2024
VAO,  ,TOT ,TOTALE                                                      ,18,0,0,1,19,2024
VAO,AO,A   ,"Agricoltura, silvicoltura pesca                             ",0,0,0,0,0,2024
VAO,AO,A 01,"Coltivazioni agricole e produzione di prodotti animali, c...",0,0,0,0,0,2024
VAO,AO,A 02,Silvicoltura ed utilizzo di aree forestali                  ,0,0,0,0,0,2024
VAO,AO,A 03,Pesca e acquacoltura                                        ,0,0,0,0,0,2024
VAO,AO,B   ,Estrazione di minerali da cave e miniere                    ,0,0,0,0,0,2024
VAO,AO,B 05,Estrazione di carbone (esclusa torba)                       ,0,0,0,0,0,2024
VAO,AO,B 06,Estraz.di petrolio greggio e di gas naturale                ,0,0,0,0,0,2024
VAO,AO,B 07,Estrazione di minerali metalliferi                          ,0,0,0,0,0,2024
VAO,AO,B 08,Altre attività di estrazione di minerali da cave e miniere  ,0,0,0,0,0,2024
VAO,AO,B 09,Attività dei servizi di supporto all'estrazione             ,0,0,0,0,0,2024
VAO,AO,C   ,Attività manifatturiere                                     ,1,0,0,0,1,2024
VAO,AO,C 10,Industrie alimentari                                        ,0,0,0,0,0,2024
VAO,AO,C 11,Industria delle bevande                                     ,0,0,0,0,0,2024
VAO,AO,C 12,Industria del tabacco                                       ,0,0,0,0,0,2024
VAO,AO,C 13,Industrie tessili                                           ,0,0,0,0,0,2024
VAO,AO,C 14,Confezione di articoli di abbigliamento; confezione di ar...,0,0,0,0,0,2024
VAO,AO,C 15,Fabbricazione di articoli in pelle e simili                 ,0,0,0,0,0,2024
VAO,AO,C 16,Industria del legno e dei prodotti in legno e sughero (es...,0,0,0,0,0,2024
VAO,AO,C 17,Fabbricazione di carta e di prodotti di carta               ,0,0,0,0,0,2024
VAO,AO,C 18,Stampa e riproduzione di supporti registrati                ,0,0,0,0,0,2024
VAO,AO,C 19,Fabbricazione di coke e prodotti derivanti dalla raffinaz...,0,0,0,0,0,2024
VAO,AO,C 20,Fabbricazione di prodotti chimici                           ,0,0,0,0,0,2024
VAO,AO,C 21,Fabbricazione di prodotti farmaceutici di base e di prepa...,0,0,0,0,0,2024
VAO,AO,C 22,Fabbricazione di articoli in gomma e materie plastiche      ,0,0,0,0,0,2024
VAO,AO,C 23,Fabbricazione di altri prodotti della lavorazione di miner..,0,0,0,0,0,2024
VAO,AO,C 24,Metallurgia                                                 ,0,0,0,0,0,2024
VAO,AO,C 25,Fabbricazione di prodotti in metallo (esclusi macchinari ...,0,0,0,0,0,2024
VAO,AO,C 26,Fabbricazione di computer e prodotti di elettronica e ott...,0,0,0,0,0,2024
VAO,AO,C 27,Fabbricazione di apparecchiature elettriche ed apparecchi...,0,0,0,0,0,2024
VAO,AO,C 28,Fabbricazione di macchinari ed apparecchiature nca          ,0,0,0,0,0,2024
VAO,AO,C 29,"Fabbricazione di autoveicoli, rimorchi e semirimorchi       ",0,0,0,0,0,2024
VAO,AO,C 30,Fabbricazione di altri mezzi di trasporto                   ,0,0,0,0,0,2024
VAO,AO,C 31,Fabbricazione di mobili                                     ,0,0,0,0,0,2024
VAO,AO,C 32,Altre industrie manifatturiere                              ,0,0,0,0,0,2024
VAO,AO,C 33,"Riparazione, manutenzione ed installazione di macchine ed...",1,0,0,0,1,2024
VAO,AO,D   ,"Fornitura di energia elettrica, gas, vapore e aria condiz...",0,0,0,0,0,2024
VAO,AO,D 35,"Fornitura di energia elettrica, gas, vapore e aria condiz...",0,0,0,0,0,2024
VAO,AO,E   ,"Fornitura di acqua; reti fognarie, attività di gestione d...",0,0,0,0,0,2024
VAO,AO,E 36,"Raccolta, trattamento e fornitura di acqua                  ",0,0,0,0,0,2024
VAO,AO,E 37,Gestione delle reti fognarie                                ,0,0,0,0,0,2024
VAO,AO,E 38,"Attività di raccolta, trattamento e smaltimento dei rifiu...",0,0,0,0,0,2024
VAO,AO,E 39,Attività di risanamento e altri servizi di gestione dei r...,0,0,0,0,0,2024
VAO,AO,F   ,Costruzioni                                                 ,1,0,0,1,2,2024
VAO,AO,F 41,Costruzione di edifici                                      ,1,0,0,0,1,2024
VAO,AO,F 42,Ingegneria civile                                           ,0,0,0,0,0,2024
VAO,AO,F 43,Lavori di costruzione specializzati                         ,0,0,0,1,1,2024
VAO,AO,G   ,Commercio all'ingrosso e al dettaglio; riparazione di aut...,3,0,0,0,3,2024
VAO,AO,G 45,Commercio all'ingrosso e al dettaglio e riparazione di au...,0,0,0,0,0,2024
VAO,AO,G 46,Commercio all'ingrosso (escluso quello di autoveicoli e d...,2,0,0,0,2,2024
VAO,AO,G 47,Commercio al dettaglio (escluso quello di autoveicoli e d...,1,0,0,0,1,2024
VAO,AO,H   ,Trasporto e magazzinaggio                                   ,0,0,0,0,0,2024
VAO,AO,H 49,Trasporto terrestre e mediante condotte                     ,0,0,0,0,0,2024
VAO,AO,H 50,Trasporto marittimo e per vie d'acqua                       ,0,0,0,0,0,2024
VAO,AO,H 51,Trasporto aereo                                             ,0,0,0,0,0,2024
VAO,AO,H 52,Magazzinaggio e attività di supporto ai trasporti           ,0,0,0,0,0,2024
VAO,AO,H 53,Servizi postali e attività di corriere                      ,0,0,0,0,0,2024
VAO,AO,I   ,Attività dei servizi alloggio e ristorazione                ,1,0,0,0,1,2024
VAO,AO,I 55,Alloggio                                                    ,0,0,0,0,0,2024
VAO,AO,I 56,Attività dei servizi di ristorazione                        ,1,0,0,0,1,2024
VAO,AO,J   ,Servizi di informazione e comunicazione                     ,1,0,0,0,1,2024
VAO,AO,J 58,Attività editoriali                                         ,0,0,0,0,0,2024
VAO,AO,J 59,"Attività di produzione cinematografica, di video e di pro...",0,0,0,0,0,2024
VAO,AO,J 60,Attività di programmazione e trasmissione                   ,0,0,0,0,0,2024
VAO,AO,J 61,Telecomunicazioni                                           ,0,0,0,0,0,2024
VAO,AO,J 62,"Produzione di software, consulenza informatica e attività...",1,0,0,0,1,2024
VAO,AO,J 63,Attività dei servizi d'informazione e altri servizi infor...,0,0,0,0,0,2024
VAO,AO,K   ,Attività finanziarie e assicurative                         ,0,0,0,0,0,2024
VAO,AO,K 64,Attività di servizi finanziari (escluse le assicurazioni ...,0,0,0,0,0,2024
VAO,AO,K 65,"Assicurazioni, riassicurazioni e fondi pensione (escluse ...",0,0,0,0,0,2024
VAO,AO,K 66,Attività ausiliarie dei servizi finanziari e delle attivi...,0,0,0,0,0,2024
VAO,AO,L   ,Attivita' immobiliari                                       ,2,0,0,0,2,2024
VAO,AO,L 68,Attivita' immobiliari                                       ,2,0,0,0,2,2024
VAO,AO,M   ,"Attività professionali, scientifiche e tecniche             ",1,0,0,0,1,2024
VAO,AO,M 69,Attività legali e contabilità                               ,0,0,0,0,0,2024
VAO,AO,M 70,Attività di direzione aziendale e di consulenza gestional...,0,0,0,0,0,2024
VAO,AO,M 71,Attività degli studi di architettura e d'ingegneria; coll...,1,0,0,0,1,2024
VAO,AO,M 72,Ricerca scientifica e sviluppo                              ,0,0,0,0,0,2024
VAO,AO,M 73,Pubblicità e ricerche di mercato                            ,0,0,0,0,0,2024
VAO,AO,M 74,"Altre attività professionali, scientifiche e tecniche       ",0,0,0,0,0,2024
VAO,AO,M 75,Servizi veterinari                                          ,0,0,0,0,0,2024
VAO,AO,N   ,"Noleggio, agenzie di viaggio, servizi di supporto alle im...",1,0,0,0,1,2024
VAO,AO,N 77,Attività di noleggio e leasing operativo                    ,1,0,0,0,1,2024
VAO,AO,N 78,"Attività di ricerca, selezione, fornitura di personale      ",0,0,0,0,0,2024
VAO,AO,N 79,"Attività dei servizi delle agenzie di viaggio, dei tour o...",0,0,0,0,0,2024
VAO,AO,N 80,Servizi di vigilanza e investigazione                       ,0,0,0,0,0,2024
VAO,AO,N 81,Attività di servizi per edifici e paesaggio                 ,0,0,0,0,0,2024
VAO,AO,N 82,Attività di supporto per le funzioni d'ufficio e altri se...,0,0,0,0,0,2024
VAO,AO,O   ,Amministrazione pubblica e difesa; assicurazione sociale ...,0,0,0,0,0,2024
VAO,AO,O 84,Amministrazione pubblica e difesa; assicurazione sociale ...,0,0,0,0,0,2024
VAO,AO,P   ,Istruzione                                                  ,0,0,0,0,0,2024
VAO,AO,P 85,Istruzione                                                  ,0,0,0,0,0,2024
VAO,AO,Q   ,Sanita' e assistenza sociale                                ,0,0,0,0,0,2024
VAO,AO,Q 86,Assistenza sanitaria                                        ,0,0,0,0,0,2024
VAO,AO,Q 87,Servizi di assistenza sociale residenziale                  ,0,0,0,0,0,2024
VAO,AO,Q 88,Assistenza sociale non residenziale                         ,0,0,0,0,0,2024
VAO,AO,R   ,"Attività artistiche, sportive, di intrattenimento e diver...",0,0,0,0,0,2024
VAO,AO,R 90,"Attività creative, artistiche e di intrattenimento          ",0,0,0,0,0,2024
VAO,AO,R 91,"Attività di biblioteche, archivi, musei ed altre attività...",0,0,0,0,0,2024
VAO,AO,R 92,"Attività riguardanti le lotterie, le scommesse, le case d...",0,0,0,0,0,2024
VAO,AO,R 93,"Attività sportive, di intrattenimento e di divertimento     ",0,0,0,0,0,2024
VAO,AO,S   ,Altre attività di servizi                                   ,0,0,0,0,0,2024
VAO,AO,S 94,Attività di organizzazioni associative                      ,0,0,0,0,0,2024
VAO,AO,S 95,Riparazione di computer e di beni per uso personale e per...,0,0,0,0,0,2024
VAO,AO,S 96,Altre attività di servizi per la persona                    ,0,0,0,0,0,2024
VAO,AO,T   ,Attività di famiglie e convivenze come datori di lavoro p...,0,0,0,0,0,2024
VAO,AO,T 97,Attività di famiglie e convivenze come datori di lavoro p...,0,0,0,0,0,2024
VAO,AO,T 98,Produzione di beni e servizi indifferenziati per uso prop...,0,0,0,0,0,2024
VAO,AO,U   ,Organizzazioni ed organismi extraterritoriali               ,0,0,0,0,0,2024
VAO,AO,U 99,Organizzazioni ed organismi extraterritoriali               ,0,0,0,0,0,2024
VAO,AO,XX  ,Imprese non classificate                                    ,7,0,0,0,7,2024
VAO,AO,TOT ,TOTALE                                                      ,18,0,0,1,19,2024
LOM,  ,A   ,"Agricoltura, silvicoltura pesca                             ",11,7,150,55,223,2024
LOM,  ,A 01,"Coltivazioni agricole e produzione di prodotti animali, c...",11,7,141,54,213,2024
LOM,  ,A 02,Silvicoltura ed utilizzo di aree forestali                  ,0,0,8,1,9,2024
LOM,  ,A 03,Pesca e acquacoltura                                        ,0,0,1,0,1,2024
LOM,  ,B   ,Estrazione di minerali da cave e miniere                    ,2,1,1,2,6,2024
LOM,  ,B 05,Estrazione di carbone (esclusa torba)                       ,0,0,0,0,0,2024
LOM,  ,B 06,Estraz.di petrolio greggio e di gas naturale                ,0,1,0,0,1,2024
LOM,  ,B 07,Estrazione di minerali metalliferi                          ,0,0,0,0,0,2024
LOM,  ,B 08,Altre attività di estrazione di minerali da cave e miniere  ,2,0,0,1,3,2024
LOM,  ,B 09,Attività dei servizi di supporto all'estrazione             ,0,0,1,1,2,2024
LOM,  ,C   ,Attività manifatturiere                                     ,373,378,338,257,1346,2024
LOM,  ,C 10,Industrie alimentari                                        ,7,19,12,45,83,2024
LOM,  ,C 11,Industria delle bevande                                     ,0,1,0,0,1,2024
LOM,  ,C 12,Industria del tabacco                                       ,0,0,0,0,0,2024
LOM,  ,C 13,Industrie tessili                                           ,17,13,10,4,44,2024
LOM,  ,C 14,Confezione di articoli di abbigliamento; confezione di ar...,32,38,106,11,187,2024
LOM,  ,C 15,Fabbricazione di articoli in pelle e simili                 ,13,21,7,5,46,2024
LOM,  ,C 16,Industria del legno e dei prodotti in legno e sughero (es...,12,10,6,8,36,2024
LOM,  ,C 17,Fabbricazione di carta e di prodotti di carta               ,8,7,1,3,19,2024
LOM,  ,C 18,Stampa e riproduzione di supporti registrati                ,22,44,3,21,90,2024
LOM,  ,C 19,Fabbricazione di coke e prodotti derivanti dalla raffinaz...,0,0,0,0,0,2024
LOM,  ,C 20,Fabbricazione di prodotti chimici                           ,8,13,0,2,23,2024
LOM,  ,C 21,Fabbricazione di prodotti farmaceutici di base e di prepa...,1,1,0,1,3,2024
LOM,  ,C 22,Fabbricazione di articoli in gomma e materie plastiche      ,12,23,6,13,54,2024
LOM,  ,C 23,Fabbricazione di altri prodotti della lavorazione di miner..,14,10,4,6,34,2024
LOM,  ,C 24,Metallurgia                                                 ,5,9,1,0,15,2024
LOM,  ,C 25,Fabbricazione di prodotti in metallo (esclusi macchinari ...,70,68,93,82,313,2024
LOM,  ,C 26,Fabbricazione di computer e prodotti di elettronica e ott...,15,16,2,4,37,2024
LOM,  ,C 27,Fabbricazione di apparecchiature elettriche ed apparecchi...,29,14,4,10,57,2024
LOM,  ,C 28,Fabbricazione di macchinari ed apparecchiature nca          ,55,33,6,6,100,2024
LOM,  ,C 29,"Fabbricazione di autoveicoli, rimorchi e semirimorchi       ",1,3,3,1,8,2024
LOM,  ,C 30,Fabbricazione di altri mezzi di trasporto                   ,4,3,1,1,9,2024
LOM,  ,C 31,Fabbricazione di mobili                                     ,29,22,5,2,58,2024
LOM,  ,C 32,Altre industrie manifatturiere                              ,10,6,14,9,39,2024
LOM,  ,C 33,"Riparazione, manutenzione ed installazione di macchine ed...",9,4,54,23,90,2024
LOM,  ,D   ,"Fornitura di energia elettrica, gas, vapore e aria condiz...",7,0,2,2,11,2024
LOM,  ,D 35,"Fornitura di energia elettrica, gas, vapore e aria condiz...",7,0,2,2,11,2024
LOM,  ,E   ,"Fornitura di acqua; reti fognarie, attività di gestione d...",1,3,2,2,8,2024
LOM,  ,E 36,"Raccolta, trattamento e fornitura di acqua                  ",0,1,0,0,1,2024
LOM,  ,E 37,Gestione delle reti fognarie                                ,0,0,0,0,0,2024
LOM,  ,E 38,"Attività di raccolta, trattamento e smaltimento dei rifiu...",1,2,2,2,7,2024
LOM,  ,E 39,Attività di risanamento e altri servizi di gestione dei r...,0,0,0,0,0,2024
LOM,  ,F   ,Costruzioni                                                 ,352,167,1042,859,2420,2024
LOM,  ,F 41,Costruzione di edifici                                      ,231,72,188,565,1056,2024
LOM,  ,F 42,Ingegneria civile                                           ,3,2,3,5,13,2024
LOM,  ,F 43,Lavori di costruzione specializzati                         ,118,93,851,289,1351,2024
LOM,  ,G   ,Commercio all'ingrosso e al dettaglio; riparazione di aut...,508,551,1104,100,2263,2024
LOM,  ,G 45,Commercio all'ingrosso e al dettaglio e riparazione di au...,50,41,271,7,369,2024
LOM,  ,G 46,Commercio all'ingrosso (escluso quello di autoveicoli e d...,296,213,317,49,875,2024
LOM,  ,G 47,Commercio al dettaglio (escluso quello di autoveicoli e d...,162,297,516,44,1019,2024
LOM,  ,H   ,Trasporto e magazzinaggio                                   ,58,47,87,1206,1398,2024
LOM,  ,H 49,Trasporto terrestre e mediante condotte                     ,25,38,73,192,328,2024
LOM,  ,H 50,Trasporto marittimo e per vie d'acqua                       ,2,0,1,0,3,2024
LOM,  ,H 51,Trasporto aereo                                             ,1,0,0,0,1,2024
LOM,  ,H 52,Magazzinaggio e attività di supporto ai trasporti           ,26,7,10,1008,1051,2024
LOM,  ,H 53,Servizi postali e attività di corriere                      ,4,2,3,6,15,2024
LOM,  ,I   ,Attività dei servizi alloggio e ristorazione                ,131,286,273,52,742,2024
LOM,  ,I 55,Alloggio                                                    ,8,5,3,3,19,2024
LOM,  ,I 56,Attività dei servizi di ristorazione                        ,123,281,270,49,723,2024
LOM,  ,J   ,Servizi di informazione e comunicazione                     ,96,39,27,68,230,2024
LOM,  ,J 58,Attività editoriali                                         ,12,11,2,8,33,2024
LOM,  ,J 59,"Attività di produzione cinematografica, di video e di pro...",8,2,2,7,19,2024
LOM,  ,J 60,Attività di programmazione e trasmissione                   ,1,1,0,0,2,2024
LOM,  ,J 61,Telecomunicazioni                                           ,4,5,8,6,23,2024
LOM,  ,J 62,"Produzione di software, consulenza informatica e attività...",48,10,9,19,86,2024
LOM,  ,J 63,Attività dei servizi d'informazione e altri servizi infor...,23,10,6,28,67,2024
LOM,  ,K   ,Attività finanziarie e assicurative                         ,39,14,54,5,112,2024
LOM,  ,K 64,Attività di servizi finanziari (escluse le assicurazioni ...,29,6,0,4,39,2024
LOM,  ,K 65,"Assicurazioni, riassicurazioni e fondi pensione (escluse ...",0,1,0,0,1,2024
LOM,  ,K 66,Attività ausiliarie dei servizi finanziari e delle attivi...,10,7,54,1,72,2024
LOM,  ,L   ,Attivita' immobiliari                                       ,220,53,10,108,391,2024
LOM,  ,L 68,Attivita' immobiliari                                       ,220,53,10,108,391,2024
LOM,  ,M   ,"Attività professionali, scientifiche e tecniche             ",172,58,107,137,474,2024
LOM,  ,M 69,Attività legali e contabilità                               ,8,4,1,18,31,2024
LOM,  ,M 70,Attività di direzione aziendale e di consulenza gestional...,63,11,18,52,144,2024
LOM,  ,M 71,Attività degli studi di architettura e d'ingegneria; coll...,27,2,6,5,40,2024
LOM,  ,M 72,Ricerca scientifica e sviluppo                              ,10,0,0,3,13,2024
LOM,  ,M 73,Pubblicità e ricerche di mercato                            ,38,19,53,28,138,2024
LOM,  ,M 74,"Altre attività professionali, scientifiche e tecniche       ",26,22,28,31,107,2024
LOM,  ,M 75,Servizi veterinari                                          ,0,0,1,0,1,2024
LOM,  ,N   ,"Noleggio, agenzie di viaggio, servizi di supporto alle im...",85,46,229,708,1068,2024
LOM,  ,N 77,Attività di noleggio e leasing operativo                    ,7,5,6,2,20,2024
LOM,  ,N 78,"Attività di ricerca, selezione, fornitura di personale      ",3,1,0,4,8,2024
LOM,  ,N 79,"Attività dei servizi delle agenzie di viaggio, dei tour o...",11,9,3,5,28,2024
LOM,  ,N 80,Servizi di vigilanza e investigazione                       ,1,1,0,9,11,2024
LOM,  ,N 81,Attività di servizi per edifici e paesaggio                 ,20,13,63,369,465,2024
LOM,  ,N 82,Attività di supporto per le funzioni d'ufficio e altri se...,43,17,157,319,536,2024
LOM,  ,O   ,Amministrazione pubblica e difesa; assicurazione sociale ...,0,0,0,0,0,2024
LOM,  ,O 84,Amministrazione pubblica e difesa; assicurazione sociale ...,0,0,0,0,0,2024
LOM,  ,P   ,Istruzione                                                  ,8,2,5,17,32,2024
LOM,  ,P 85,Istruzione                                                  ,8,2,5,17,32,2024
LOM,  ,Q   ,Sanita' e assistenza sociale                                ,11,6,3,103,123,2024
LOM,  ,Q 86,Assistenza sanitaria                                        ,8,6,1,15,30,2024
LOM,  ,Q 87,Servizi di assistenza sociale residenziale                  ,0,0,0,4,4,2024
LOM,  ,Q 88,Assistenza sociale non residenziale                         ,3,0,2,84,89,2024
LOM,  ,R   ,"Attività artistiche, sportive, di intrattenimento e diver...",35,14,31,68,148,2024
LOM,  ,R 90,"Attività creative, artistiche e di intrattenimento          ",11,5,10,38,64,2024
LOM,  ,R 91,"Attività di biblioteche, archivi, musei ed altre attività...",0,0,0,2,2,2024
LOM,  ,R 92,"Attività riguardanti le lotterie, le scommesse, le case d...",4,1,2,0,7,2024
LOM,  ,R 93,"Attività sportive, di intrattenimento e di divertimento     ",20,8,19,28,75,2024
LOM,  ,S   ,Altre attività di servizi                                   ,29,46,82,80,237,2024
LOM,  ,S 94,Attività di organizzazioni associative                      ,1,0,0,7,8,2024
LOM,  ,S 95,Riparazione di computer e di beni per uso personale e per...,3,7,29,4,43,2024
LOM,  ,S 96,Altre attività di servizi per la persona                    ,25,39,53,69,186,2024
LOM,  ,T   ,Attività di famiglie e convivenze come datori di lavoro p...,0,0,0,1,1,2024
LOM,  ,T 97,Attività di famiglie e convivenze come datori di lavoro p...,0,0,0,1,1,2024
LOM,  ,T 98,Produzione di beni e servizi indifferenziati per uso prop...,0,0,0,0,0,2024
LOM,  ,U   ,Organizzazioni ed organismi extraterritoriali               ,0,0,0,0,0,2024
LOM,  ,U 99,Organizzazioni ed organismi extraterritoriali               ,0,0,0,0,0,2024
LOM,  ,XX  ,Imprese non classificate                                    ,527,503,128,1078,2236,2024
LOM,  ,TOT ,TOTALE                                                      ,2665,2221,3675,4908,13469,2024
LOM,VA,A   ,"Agricoltura, silvicoltura pesca                             ",0,0,23,1,24,2024
LOM,VA,A 01,"Coltivazioni agricole e produzione di prodotti animali, c...",0,0,20,1,21,2024
LOM,VA,A 02,Silvicoltura ed utilizzo di aree forestali                  ,0,0,3,0,3,2024
LOM,VA,A 03,Pesca e acquacoltura                                        ,0,0,0,0,0,2024
LOM,VA,B   ,Estrazione di minerali da cave e miniere                    ,0,0,0,0,0,2024
LOM,VA,B 05,Estrazione di carbone (esclusa torba)                       ,0,0,0,0,0,2024
LOM,VA,B 06,Estraz.di petrolio greggio e di gas naturale                ,0,0,0,0,0,2024
LOM,VA,B 07,Estrazione di minerali metalliferi                          ,0,0,0,0,0,2024
LOM,VA,B 08,Altre attività di estrazione di minerali da cave e miniere  ,0,0,0,0,0,2024
LOM,VA,B 09,Attività dei servizi di supporto all'estrazione             ,0,0,0,0,0,2024
LOM,VA,C   ,Attività manifatturiere                                     ,0,0,77,7,84,2024
LOM,VA,C 10,Industrie alimentari                                        ,0,0,5,0,5,2024
LOM,VA,C 11,Industria delle bevande                                     ,0,0,0,0,0,2024
LOM,VA,C 12,Industria del tabacco                                       ,0,0,0,0,0,2024
LOM,VA,C 13,Industrie tessili                                           ,0,0,3,0,3,2024
LOM,VA,C 14,Confezione di articoli di abbigliamento; confezione di ar...,0,0,11,1,12,2024
LOM,VA,C 15,Fabbricazione di articoli in pelle e simili                 ,0,0,4,0,4,2024
LOM,VA,C 16,Industria del legno e dei prodotti in legno e sughero (es...,0,0,4,1,5,2024
LOM,VA,C 17,Fabbricazione di carta e di prodotti di carta               ,0,0,0,0,0,2024
LOM,VA,C 18,Stampa e riproduzione di supporti registrati                ,0,0,1,1,2,2024
LOM,VA,C 19,Fabbricazione di coke e prodotti derivanti dalla raffinaz...,0,0,0,0,0,2024
LOM,VA,C 20,Fabbricazione di prodotti chimici                           ,0,0,0,0,0,2024
LOM,VA,C 21,Fabbricazione di prodotti farmaceutici di base e di prepa...,0,0,0,0,0,2024
LOM,VA,C 22,Fabbricazione di articoli in gomma e materie plastiche      ,0,0,4,0,4,2024
LOM,VA,C 23,Fabbricazione di altri prodotti della lavorazione di miner..,0,0,1,0,1,2024
LOM,VA,C 24,Metallurgia                                                 ,0,0,0,0,0,2024
LOM,VA,C 25,Fabbricazione di prodotti in metallo (esclusi macchinari ...,0,0,13,3,16,2024
LOM,VA,C 26,Fabbricazione di computer e prodotti di elettronica e ott...,0,0,1,0,1,2024
LOM,VA,C 27,Fabbricazione di apparecchiature elettriche ed apparecchi...,0,0,2,0,2,2024
LOM,VA,C 28,Fabbricazione di macchinari ed apparecchiature nca          ,0,0,2,0,2,2024
LOM,VA,C 29,"Fabbricazione di autoveicoli, rimorchi e semirimorchi       ",0,0,2,0,2,2024
LOM,VA,C 30,Fabbricazione di altri mezzi di trasporto                   ,0,0,0,0,0,2024
LOM,VA,C 31,Fabbricazione di mobili                                     ,0,0,2,0,2,2024
LOM,VA,C 32,Altre industrie manifatturiere                              ,0,0,8,0,8,2024
LOM,VA,C 33,"Riparazione, manutenzione ed installazione di macchine ed...",0,0,14,1,15,2024
LOM,VA,D   ,"Fornitura di energia elettrica, gas, vapore e aria condiz...",0,0,0,2,2,2024
LOM,VA,D 35,"Fornitura di energia elettrica, gas, vapore e aria condiz...",0,0,0,2,2,2024
LOM,VA,E   ,"Fornitura di acqua; reti fognarie, attività di gestione d...",0,0,1,0,1,2024
LOM,VA,E 36,"Raccolta, trattamento e fornitura di acqua                  ",0,0,0,0,0,2024
LOM,VA,E 37,Gestione delle reti fognarie                                ,0,0,0,0,0,2024
LOM,VA,E 38,"Attività di raccolta, trattamento e smaltimento dei rifiu...",0,0,1,0,1,2024
LOM,VA,E 39,Attività di risanamento e altri servizi di gestione dei r...,0,0,0,0,0,2024
LOM,VA,F   ,Costruzioni                                                 ,0,0,298,16,314,2024
LOM,VA,F 41,Costruzione di edifici                                      ,0,0,58,6,64,2024
LOM,VA,F 42,Ingegneria civile                                           ,0,0,1,1,2,2024
LOM,VA,F 43,Lavori di costruzione specializzati                         ,0,0,239,9,248,2024
LOM,VA,G   ,Commercio all'ingrosso e al dettaglio; riparazione di aut...,0,0,422,8,430,2024
LOM,VA,G 45,Commercio all'ingrosso e al dettaglio e riparazione di au...,0,0,179,0,179,2024
LOM,VA,G 46,Commercio all'ingrosso (escluso quello di autoveicoli e d...,0,0,91,1,92,2024
LOM,VA,G 47,Commercio al dettaglio (escluso quello di autoveicoli e d...,0,0,152,7,159,2024
LOM,VA,H   ,Trasporto e magazzinaggio                                   ,0,0,16,28,44,2024
LOM,VA,H 49,Trasporto terrestre e mediante condotte                     ,0,0,11,8,19,2024
LOM,VA,H 50,Trasporto marittimo e per vie d'acqua                       ,0,0,0,0,0,2024
LOM,VA,H 51,Trasporto aereo                                             ,0,0,0,0,0,2024
LOM,VA,H 52,Magazzinaggio e attività di supporto ai trasporti           ,0,0,5,20,25,2024
LOM,VA,H 53,Servizi postali e attività di corriere                      ,0,0,0,0,0,2024
LOM,VA,I   ,Attività dei servizi alloggio e ristorazione                ,0,0,92,11,103,2024
LOM,VA,I 55,Alloggio                                                    ,0,0,1,0,1,2024
LOM,VA,I 56,Attività dei servizi di ristorazione                        ,0,0,91,11,102,2024
LOM,VA,J   ,Servizi di informazione e comunicazione                     ,0,0,8,1,9,2024
LOM,VA,J 58,Attività editoriali                                         ,0,0,1,1,2,2024
LOM,VA,J 59,"Attività di produzione cinematografica, di video e di pro...",0,0,1,0,1,2024
LOM,VA,J 60,Attività di programmazione e trasmissione                   ,0,0,0,0,0,2024
LOM,VA,J 61,Telecomunicazioni                                           ,0,0,2,0,2,2024
LOM,VA,J 62,"Produzione di software, consulenza informatica e attività...",0,0,2,0,2,2024
LOM,VA,J 63,Attività dei servizi d'informazione e altri servizi infor...,0,0,2,0,2,2024
LOM,VA,K   ,Attività finanziarie e assicurative                         ,0,0,20,1,21,2024
LOM,VA,K 64,Attività di servizi finanziari (escluse le assicurazioni ...,0,0,0,0,0,2024
LOM,VA,K 65,"Assicurazioni, riassicurazioni e fondi pensione (escluse ...",0,0,0,0,0,2024
LOM,VA,K 66,Attività ausiliarie dei servizi finanziari e delle attivi...,0,0,20,1,21,2024
LOM,VA,L   ,Attivita' immobiliari                                       ,0,0,1,2,3,2024
LOM,VA,L 68,Attivita' immobiliari                                       ,0,0,1,2,3,2024
LOM,VA,M   ,"Attività professionali, scientifiche e tecniche             ",0,0,14,5,19,2024
LOM,VA,M 69,Attività legali e contabilità                               ,0,0,0,0,0,2024
LOM,VA,M 70,Attività di direzione aziendale e di consulenza gestional...,0,0,1,3,4,2024
LOM,VA,M 71,Attività degli studi di architettura e d'ingegneria; coll...,0,0,0,0,0,2024
LOM,VA,M 72,Ricerca scientifica e sviluppo                              ,0,0,0,0,0,2024
LOM,VA,M 73,Pubblicità e ricerche di mercato                            ,0,0,3,1,4,2024
LOM,VA,M 74,"Altre attività professionali, scientifiche e tecniche       ",0,0,9,1,10,2024
LOM,VA,M 75,Servizi veterinari                                          ,0,0,1,0,1,2024
LOM,VA,N   ,"Noleggio, agenzie di viaggio, servizi di supporto alle im...",0,0,56,16,72,2024
LOM,VA,N 77,Attività di noleggio e leasing operativo                    ,0,0,1,0,1,2024
LOM,VA,N 78,"Attività di ricerca, selezione, fornitura di personale      ",0,0,0,0,0,2024
LOM,VA,N 79,"Attività dei servizi delle agenzie di viaggio, dei tour o...",0,0,1,1,2,2024
LOM,VA,N 80,Servizi di vigilanza e investigazione                       ,0,0,0,0,0,2024
LOM,VA,N 81,Attività di servizi per edifici e paesaggio                 ,0,0,26,4,30,2024
LOM,VA,N 82,Attività di supporto per le funzioni d'ufficio e altri se...,0,0,28,11,39,2024
LOM,VA,O   ,Amministrazione pubblica e difesa; assicurazione sociale ...,0,0,0,0,0,2024
LOM,VA,O 84,Amministrazione pubblica e difesa; assicurazione sociale ...,0,0,0,0,0,2024
LOM,VA,P   ,Istruzione                                                  ,0,0,2,2,4,2024
LOM,VA,P 85,Istruzione                                                  ,0,0,2,2,4,2024
LOM,VA,Q   ,Sanita' e assistenza sociale                                ,0,0,1,12,13,2024
LOM,VA,Q 86,Assistenza sanitaria                                        ,0,0,0,3,3,2024
LOM,VA,Q 87,Servizi di assistenza sociale residenziale                  ,0,0,0,1,1,2024
LOM,VA,Q 88,Assistenza sociale non residenziale                         ,0,0,1,8,9,2024
LOM,VA,R   ,"Attività artistiche, sportive, di intrattenimento e diver...",0,0,12,3,15,2024
LOM,VA,R 90,"Attività creative, artistiche e di intrattenimento          ",0,0,4,2,6,2024
LOM,VA,R 91,"Attività di biblioteche, archivi, musei ed altre attività...",0,0,0,1,1,2024
LOM,VA,R 92,"Attività riguardanti le lotterie, le scommesse, le case d...",0,0,1,0,1,2024
LOM,VA,R 93,"Attività sportive, di intrattenimento e di divertimento     ",0,0,7,0,7,2024
LOM,VA,S   ,Altre attività di servizi                                   ,0,0,41,3,44,2024
LOM,VA,S 94,Attività di organizzazioni associative                      ,0,0,0,0,0,2024
LOM,VA,S 95,Riparazione di computer e di beni per uso personale e per...,0,0,13,0,13,2024
LOM,VA,S 96,Altre attività di servizi per la persona                    ,0,0,28,3,31,2024
LOM,VA,T   ,Attività di famiglie e convivenze come datori di lavoro p...,0,0,0,0,0,2024
LOM,VA,T 97,Attività di famiglie e convivenze come datori di lavoro p...,0,0,0,0,0,2024
LOM,VA,T 98,Produzione di beni e servizi indifferenziati per uso prop...,0,0,0,0,0,2024
LOM,VA,U   ,Organizzazioni ed organismi extraterritoriali               ,0,0,0,0,0,2024
LOM,VA,U 99,Organizzazioni ed organismi extraterritoriali               ,0,0,0,0,0,2024
LOM,VA,XX  ,Imprese non classificate                                    ,0,0,63,24,87,2024
LOM,VA,TOT ,TOTALE                                                      ,0,0,1147,142,1289,2024
LOM,CO,A   ,"Agricoltura, silvicoltura pesca                             ",0,0,0,1,1,2024
LOM,CO,A 01,"Coltivazioni agricole e produzione di prodotti animali, c...",0,0,0,1,1,2024
LOM,CO,A 02,Silvicoltura ed utilizzo di aree forestali                  ,0,0,0,0,0,2024
LOM,CO,A 03,Pesca e acquacoltura                                        ,0,0,0,0,0,2024
LOM,CO,B   ,Estrazione di minerali da cave e miniere                    ,0,0,0,0,0,2024
LOM,CO,B 05,Estrazione di carbone (esclusa torba)                       ,0,0,0,0,0,2024
LOM,CO,B 06,Estraz.di petrolio greggio e di gas naturale                ,0,0,0,0,0,2024
LOM,CO,B 07,Estrazione di minerali metalliferi                          ,0,0,0,0,0,2024
LOM,CO,B 08,Altre attività di estrazione di minerali da cave e miniere  ,0,0,0,0,0,2024
LOM,CO,B 09,Attività dei servizi di supporto all'estrazione             ,0,0,0,0,0,2024
LOM,CO,C   ,Attività manifatturiere                                     ,0,0,0,4,4,2024
LOM,CO,C 10,Industrie alimentari                                        ,0,0,0,0,0,2024
LOM,CO,C 11,Industria delle bevande                                     ,0,0,0,0,0,2024
LOM,CO,C 12,Industria del tabacco                                       ,0,0,0,0,0,2024
LOM,CO,C 13,Industrie tessili                                           ,0,0,0,0,0,2024
LOM,CO,C 14,Confezione di articoli di abbigliamento; confezione di ar...,0,0,0,0,0,2024
LOM,CO,C 15,Fabbricazione di articoli in pelle e simili                 ,0,0,0,0,0,2024
LOM,CO,C 16,Industria del legno e dei prodotti in legno e sughero (es...,0,0,0,0,0,2024
LOM,CO,C 17,Fabbricazione di carta e di prodotti di carta               ,0,0,0,0,0,2024
LOM,CO,C 18,Stampa e riproduzione di supporti registrati                ,0,0,0,1,1,2024
LOM,CO,C 19,Fabbricazione di coke e prodotti derivanti dalla raffinaz...,0,0,0,0,0,2024
LOM,CO,C 20,Fabbricazione di prodotti chimici                           ,0,0,0,0,0,2024
LOM,CO,C 21,Fabbricazione di prodotti farmaceutici di base e di prepa...,0,0,0,0,0,2024
LOM,CO,C 22,Fabbricazione di articoli in gomma e materie plastiche      ,0,0,0,0,0,2024
LOM,CO,C 23,Fabbricazione di altri prodotti della lavorazione di miner..,0,0,0,1,1,2024
LOM,CO,C 24,Metallurgia                                                 ,0,0,0,0,0,2024
LOM,CO,C 25,Fabbricazione di prodotti in metallo (esclusi macchinari ...,0,0,0,2,2,2024
LOM,CO,C 26,Fabbricazione di computer e prodotti di elettronica e ott...,0,0,0,0,0,2024
LOM,CO,C 27,Fabbricazione di apparecchiature elettriche ed apparecchi...,0,0,0,0,0,2024
LOM,CO,C 28,Fabbricazione di macchinari ed apparecchiature nca          ,0,0,0,0,0,2024
LOM,CO,C 29,"Fabbricazione di autoveicoli, rimorchi e semirimorchi       ",0,0,0,0,0,2024
LOM,CO,C 30,Fabbricazione di altri mezzi di trasporto                   ,0,0,0,0,0,2024
LOM,CO,C 31,Fabbricazione di mobili                                     ,0,0,0,0,0,2024
LOM,CO,C 32,Altre industrie manifatturiere                              ,0,0,0,0,0,2024
LOM,CO,C 33,"Riparazione, manutenzione ed installazione di macchine ed...",0,0,0,0,0,2024
LOM,CO,D   ,"Fornitura di energia elettrica, gas, vapore e aria condiz...",0,0,0,0,0,2024
LOM,CO,D 35,"Fornitura di energia elettrica, gas, vapore e aria condiz...",0,0,0,0,0,2024
LOM,CO,E   ,"Fornitura di acqua; reti fognarie, attività di gestione d...",0,0,0,0,0,2024
LOM,CO,E 36,"Raccolta, trattamento e fornitura di acqua                  ",0,0,0,0,0,2024
LOM,CO,E 37,Gestione delle reti fognarie                                ,0,0,0,0,0,2024
LOM,CO,E 38,"Attività di raccolta, trattamento e smaltimento dei rifiu...",0,0,0,0,0,2024
LOM,CO,E 39,Attività di risanamento e altri servizi di gestione dei r...,0,0,0,0,0,2024
LOM,CO,F   ,Costruzioni                                                 ,0,0,0,6,6,2024
LOM,CO,F 41,Costruzione di edifici                                      ,0,0,0,4,4,2024
LOM,CO,F 42,Ingegneria civile                                           ,0,0,0,0,0,2024
LOM,CO,F 43,Lavori di costruzione specializzati                         ,0,0,0,2,2,2024
LOM,CO,G   ,Commercio all'ingrosso e al dettaglio; riparazione di aut...,0,0,0,7,7,2024
LOM,CO,G 45,Commercio all'ingrosso e al dettaglio e riparazione di au...,0,0,0,2,2,2024
LOM,CO,G 46,Commercio all'ingrosso (escluso quello di autoveicoli e d...,0,0,0,2,2,2024
LOM,CO,G 47,Commercio al dettaglio (escluso quello di autoveicoli e d...,0,0,0,3,3,2024
LOM,CO,H   ,Trasporto e magazzinaggio                                   ,0,0,0,41,41,2024
LOM,CO,H 49,Trasporto terrestre e mediante condotte                     ,0,0,0,27,27,2024
LOM,CO,H 50,Trasporto marittimo e per vie d'acqua                       ,0,0,0,0,0,2024
LOM,CO,H 51,Trasporto aereo                                             ,0,0,0,0,0,2024
LOM,CO,H 52,Magazzinaggio e attività di supporto ai trasporti           ,0,0,0,14,14,2024
LOM,CO,H 53,Servizi postali e attività di corriere                      ,0,0,0,0,0,2024
LOM,CO,I   ,Attività dei servizi alloggio e ristorazione                ,0,0,0,1,1,2024
LOM,CO,I 55,Alloggio                                                    ,0,0,0,0,0,2024
LOM,CO,I 56,Attività dei servizi di ristorazione                        ,0,0,0,1,1,2024
LOM,CO,J   ,Servizi di informazione e comunicazione                     ,0,0,0,1,1,2024
LOM,CO,J 58,Attività editoriali                                         ,0,0,0,1,1,2024
LOM,CO,J 59,"Attività di produzione cinematografica, di video e di pro...",0,0,0,0,0,2024
LOM,CO,J 60,Attività di programmazione e trasmissione                   ,0,0,0,0,0,2024
LOM,CO,J 61,Telecomunicazioni                                           ,0,0,0,0,0,2024
LOM,CO,J 62,"Produzione di software, consulenza informatica e attività...",0,0,0,0,0,2024
LOM,CO,J 63,Attività dei servizi d'informazione e altri servizi infor...,0,0,0,0,0,2024
LOM,CO,K   ,Attività finanziarie e assicurative                         ,0,0,0,0,0,2024
LOM,CO,K 64,Attività di servizi finanziari (escluse le assicurazioni ...,0,0,0,0,0,2024
LOM,CO,K 65,"Assicurazioni, riassicurazioni e fondi pensione (escluse ...",0,0,0,0,0,2024
LOM,CO,K 66,Attività ausiliarie dei servizi finanziari e delle attivi...,0,0,0,0,0,2024
LOM,CO,L   ,Attivita' immobiliari                                       ,0,0,0,5,5,2024
LOM,CO,L 68,Attivita' immobiliari                                       ,0,0,0,5,5,2024
LOM,CO,M   ,"Attività professionali, scientifiche e tecniche             ",0,0,0,3,3,2024
LOM,CO,M 69,Attività legali e contabilità                               ,0,0,0,0,0,2024
LOM,CO,M 70,Attività di direzione aziendale e di consulenza gestional...,0,0,0,0,0,2024
LOM,CO,M 71,Attività degli studi di architettura e d'ingegneria; coll...,0,0,0,1,1,2024
LOM,CO,M 72,Ricerca scientifica e sviluppo                              ,0,0,0,0,0,2024
LOM,CO,M 73,Pubblicità e ricerche di mercato                            ,0,0,0,2,2,2024
LOM,CO,M 74,"Altre attività professionali, scientifiche e tecniche       ",0,0,0,0,0,2024
LOM,CO,M 75,Servizi veterinari                                          ,0,0,0,0,0,2024
LOM,CO,N   ,"Noleggio, agenzie di viaggio, servizi di supporto alle im...",0,0,0,6,6,2024
LOM,CO,N 77,Attività di noleggio e leasing operativo                    ,0,0,0,0,0,2024
LOM,CO,N 78,"Attività di ricerca, selezione, fornitura di personale      ",0,0,0,0,0,2024
LOM,CO,N 79,"Attività dei servizi delle agenzie di viaggio, dei tour o...",0,0,0,0,0,2024
LOM,CO,N 80,Servizi di vigilanza e investigazione                       ,0,0,0,0,0,2024
LOM,CO,N 81,Attività di servizi per edifici e paesaggio                 ,0,0,0,4,4,2024
LOM,CO,N 82,Attività di supporto per le funzioni d'ufficio e altri se...,0,0,0,2,2,2024
LOM,CO,O   ,Amministrazione pubblica e difesa; assicurazione sociale ...,0,0,0,0,0,2024
LOM,CO,O 84,Amministrazione pubblica e difesa; assicurazione sociale ...,0,0,0,0,0,2024
LOM,CO,P   ,Istruzione                                                  ,0,0,0,0,0,2024
LOM,CO,P 85,Istruzione                                                  ,0,0,0,0,0,2024
LOM,CO,Q   ,Sanita' e assistenza sociale                                ,0,0,0,3,3,2024
LOM,CO,Q 86,Assistenza sanitaria                                        ,0,0,0,1,1,2024
LOM,CO,Q 87,Servizi di assistenza sociale residenziale                  ,0,0,0,0,0,2024
LOM,CO,Q 88,Assistenza sociale non residenziale                         ,0,0,0,2,2,2024
LOM,CO,R   ,"Attività artistiche, sportive, di intrattenimento e diver...",0,0,0,1,1,2024
LOM,CO,R 90,"Attività creative, artistiche e di intrattenimento          ",0,0,0,0,0,2024
LOM,CO,R 91,"Attività di biblioteche, archivi, musei ed altre attività...",0,0,0,0,0,2024
LOM,CO,R 92,"Attività riguardanti le lotterie, le scommesse, le case d...",0,0,0,0,0,2024
LOM,CO,R 93,"Attività sportive, di intrattenimento e di divertimento     ",0,0,0,1,1,2024
LOM,CO,S   ,Altre attività di servizi                                   ,0,0,0,0,0,2024
LOM,CO,S 94,Attività di organizzazioni associative                      ,0,0,0,0,0,2024
LOM,CO,S 95,Riparazione di computer e di beni per uso personale e per...,0,0,0,0,0,2024
LOM,CO,S 96,Altre attività di servizi per la persona                    ,0,0,0,0,0,2024
LOM,CO,T   ,Attività di famiglie e convivenze come datori di lavoro p...,0,0,0,0,0,2024
LOM,CO,T 97,Attività di famiglie e convivenze come datori di lavoro p...,0,0,0,0,0,2024
LOM,CO,T 98,Produzione di beni e servizi indifferenziati per uso prop...,0,0,0,0,0,2024
LOM,CO,U   ,Organizzazioni ed organismi extraterritoriali               ,0,0,0,0,0,2024
LOM,CO,U 99,Organizzazioni ed organismi extraterritoriali               ,0,0,0,0,0,2024
LOM,CO,XX  ,Imprese non classificate                                    ,0,0,0,21,21,2024
LOM,CO,TOT ,TOTALE                                                      ,0,0,0,100,100,2024
LOM,SO,A   ,"Agricoltura, silvicoltura pesca                             ",0,0,21,2,23,2024
LOM,SO,A 01,"Coltivazioni agricole e produzione di prodotti animali, c...",0,0,19,1,20,2024
LOM,SO,A 02,Silvicoltura ed utilizzo di aree forestali                  ,0,0,2,1,3,2024
LOM,SO,A 03,Pesca e acquacoltura                                        ,0,0,0,0,0,2024
LOM,SO,B   ,Estrazione di minerali da cave e miniere                    ,0,0,0,0,0,2024
LOM,SO,B 05,Estrazione di carbone (esclusa torba)                       ,0,0,0,0,0,2024
LOM,SO,B 06,Estraz.di petrolio greggio e di gas naturale                ,0,0,0,0,0,2024
LOM,SO,B 07,Estrazione di minerali metalliferi                          ,0,0,0,0,0,2024
LOM,SO,B 08,Altre attività di estrazione di minerali da cave e miniere  ,0,0,0,0,0,2024
LOM,SO,B 09,Attività dei servizi di supporto all'estrazione             ,0,0,0,0,0,2024
LOM,SO,C   ,Attività manifatturiere                                     ,1,3,4,1,9,2024
LOM,SO,C 10,Industrie alimentari                                        ,0,2,2,0,4,2024
LOM,SO,C 11,Industria delle bevande                                     ,0,1,0,0,1,2024
LOM,SO,C 12,Industria del tabacco                                       ,0,0,0,0,0,2024
LOM,SO,C 13,Industrie tessili                                           ,0,0,1,0,1,2024
LOM,SO,C 14,Confezione di articoli di abbigliamento; confezione di ar...,0,0,0,0,0,2024
LOM,SO,C 15,Fabbricazione di articoli in pelle e simili                 ,0,0,0,0,0,2024
LOM,SO,C 16,Industria del legno e dei prodotti in legno e sughero (es...,0,0,0,0,0,2024
LOM,SO,C 17,Fabbricazione di carta e di prodotti di carta               ,0,0,0,0,0,2024
LOM,SO,C 18,Stampa e riproduzione di supporti registrati                ,0,0,1,0,1,2024
LOM,SO,C 19,Fabbricazione di coke e prodotti derivanti dalla raffinaz...,0,0,0,0,0,2024
LOM,SO,C 20,Fabbricazione di prodotti chimici                           ,0,0,0,0,0,2024
LOM,SO,C 21,Fabbricazione di prodotti farmaceutici di base e di prepa...,0,0,0,0,0,2024
LOM,SO,C 22,Fabbricazione di articoli in gomma e materie plastiche      ,0,0,0,0,0,2024
LOM,SO,C 23,Fabbricazione di altri prodotti della lavorazione di miner..,0,0,0,0,0,2024
LOM,SO,C 24,Metallurgia                                                 ,0,0,0,0,0,2024
LOM,SO,C 25,Fabbricazione di prodotti in metallo (esclusi macchinari ...,0,0,0,1,1,2024
LOM,SO,C 26,Fabbricazione di computer e prodotti di elettronica e ott...,0,0,0,0,0,2024
LOM,SO,C 27,Fabbricazione di apparecchiature elettriche ed apparecchi...,1,0,0,0,1,2024
LOM,SO,C 28,Fabbricazione di macchinari ed apparecchiature nca          ,0,0,0,0,0,2024
LOM,SO,C 29,"Fabbricazione di autoveicoli, rimorchi e semirimorchi       ",0,0,0,0,0,2024
LOM,SO,C 30,Fabbricazione di altri mezzi di trasporto                   ,0,0,0,0,0,2024
LOM,SO,C 31,Fabbricazione di mobili                                     ,0,0,0,0,0,2024
LOM,SO,C 32,Altre industrie manifatturiere                              ,0,0,0,0,0,2024
LOM,SO,C 33,"Riparazione, manutenzione ed installazione di macchine ed...",0,0,0,0,0,2024
LOM,SO,D   ,"Fornitura di energia elettrica, gas, vapore e aria condiz...",0,0,1,0,1,2024
LOM,SO,D 35,"Fornitura di energia elettrica, gas, vapore e aria condiz...",0,0,1,0,1,2024
LOM,SO,E   ,"Fornitura di acqua; reti fognarie, attività di gestione d...",0,0,0,0,0,2024
LOM,SO,E 36,"Raccolta, trattamento e fornitura di acqua                  ",0,0,0,0,0,2024
LOM,SO,E 37,Gestione delle reti fognarie                                ,0,0,0,0,0,2024
LOM,SO,E 38,"Attività di raccolta, trattamento e smaltimento dei rifiu...",0,0,0,0,0,2024
LOM,SO,E 39,Attività di risanamento e altri servizi di gestione dei r...,0,0,0,0,0,2024
LOM,SO,F   ,Costruzioni                                                 ,3,2,15,1,21,2024
LOM,SO,F 41,Costruzione di edifici                                      ,2,0,3,1,6,2024
LOM,SO,F 42,Ingegneria civile                                           ,0,0,0,0,0,2024
LOM,SO,F 43,Lavori di costruzione specializzati                         ,1,2,12,0,15,2024
LOM,SO,G   ,Commercio all'ingrosso e al dettaglio; riparazione di aut...,4,8,42,0,54,2024
LOM,SO,G 45,Commercio all'ingrosso e al dettaglio e riparazione di au...,1,1,4,0,6,2024
LOM,SO,G 46,Commercio all'ingrosso (escluso quello di autoveicoli e d...,2,2,3,0,7,2024
LOM,SO,G 47,Commercio al dettaglio (escluso quello di autoveicoli e d...,1,5,35,0,41,2024
LOM,SO,H   ,Trasporto e magazzinaggio                                   ,0,0,1,1,2,2024
LOM,SO,H 49,Trasporto terrestre e mediante condotte                     ,0,0,1,0,1,2024
LOM,SO,H 50,Trasporto marittimo e per vie d'acqua                       ,0,0,0,0,0,2024
LOM,SO,H 51,Trasporto aereo                                             ,0,0,0,0,0,2024
LOM,SO,H 52,Magazzinaggio e attività di supporto ai trasporti           ,0,0,0,1,1,2024
LOM,SO,H 53,Servizi postali e attività di corriere                      ,0,0,0,0,0,2024
LOM,SO,I   ,Attività dei servizi alloggio e ristorazione                ,1,7,10,1,19,2024
LOM,SO,I 55,Alloggio                                                    ,0,1,0,1,2,2024
LOM,SO,I 56,Attività dei servizi di ristorazione                        ,1,6,10,0,17,2024
LOM,SO,J   ,Servizi di informazione e comunicazione                     ,0,0,0,1,1,2024
LOM,SO,J 58,Attività editoriali                                         ,0,0,0,1,1,2024
LOM,SO,J 59,"Attività di produzione cinematografica, di video e di pro...",0,0,0,0,0,2024
LOM,SO,J 60,Attività di programmazione e trasmissione                   ,0,0,0,0,0,2024
LOM,SO,J 61,Telecomunicazioni                                           ,0,0,0,0,0,2024
LOM,SO,J 62,"Produzione di software, consulenza informatica e attività...",0,0,0,0,0,2024
LOM,SO,J 63,Attività dei servizi d'informazione e altri servizi infor...,0,0,0,0,0,2024
LOM,SO,K   ,Attività finanziarie e assicurative                         ,0,1,1,0,2,2024
LOM,SO,K 64,Attività di servizi finanziari (escluse le assicurazioni ...,0,1,0,0,1,2024
LOM,SO,K 65,"Assicurazioni, riassicurazioni e fondi pensione (escluse ...",0,0,0,0,0,2024
LOM,SO,K 66,Attività ausiliarie dei servizi finanziari e delle attivi...,0,0,1,0,1,2024
LOM,SO,L   ,Attivita' immobiliari                                       ,4,1,0,2,7,2024
LOM,SO,L 68,Attivita' immobiliari                                       ,4,1,0,2,7,2024
LOM,SO,M   ,"Attività professionali, scientifiche e tecniche             ",1,1,4,1,7,2024
LOM,SO,M 69,Attività legali e contabilità                               ,0,1,0,0,1,2024
LOM,SO,M 70,Attività di direzione aziendale e di consulenza gestional...,1,0,0,1,2,2024
LOM,SO,M 71,Attività degli studi di architettura e d'ingegneria; coll...,0,0,1,0,1,2024
LOM,SO,M 72,Ricerca scientifica e sviluppo                              ,0,0,0,0,0,2024
LOM,SO,M 73,Pubblicità e ricerche di mercato                            ,0,0,2,0,2,2024
LOM,SO,M 74,"Altre attività professionali, scientifiche e tecniche       ",0,0,1,0,1,2024
LOM,SO,M 75,Servizi veterinari                                          ,0,0,0,0,0,2024
LOM,SO,N   ,"Noleggio, agenzie di viaggio, servizi di supporto alle im...",0,1,2,1,4,2024
LOM,SO,N 77,Attività di noleggio e leasing operativo                    ,0,0,0,0,0,2024
LOM,SO,N 78,"Attività di ricerca, selezione, fornitura di personale      ",0,0,0,0,0,2024
LOM,SO,N 79,"Attività dei servizi delle agenzie di viaggio, dei tour o...",0,0,0,0,0,2024
LOM,SO,N 80,Servizi di vigilanza e investigazione                       ,0,0,0,0,0,2024
LOM,SO,N 81,Attività di servizi per edifici e paesaggio                 ,0,1,0,1,2,2024
LOM,SO,N 82,Attività di supporto per le funzioni d'ufficio e altri se...,0,0,2,0,2,2024
LOM,SO,O   ,Amministrazione pubblica e difesa; assicurazione sociale ...,0,0,0,0,0,2024
LOM,SO,O 84,Amministrazione pubblica e difesa; assicurazione sociale ...,0,0,0,0,0,2024
LOM,SO,P   ,Istruzione                                                  ,0,0,0,0,0,2024
LOM,SO,P 85,Istruzione                                                  ,0,0,0,0,0,2024
LOM,SO,Q   ,Sanita' e assistenza sociale                                ,0,0,0,0,0,2024
LOM,SO,Q 86,Assistenza sanitaria                                        ,0,0,0,0,0,2024
LOM,SO,Q 87,Servizi di assistenza sociale residenziale                  ,0,0,0,0,0,2024
LOM,SO,Q 88,Assistenza sociale non residenziale                         ,0,0,0,0,0,2024
LOM,SO,R   ,"Attività artistiche, sportive, di intrattenimento e diver...",0,1,0,0,1,2024
LOM,SO,R 90,"Attività creative, artistiche e di intrattenimento          ",0,0,0,0,0,2024
LOM,SO,R 91,"Attività di biblioteche, archivi, musei ed altre attività...",0,0,0,0,0,2024
LOM,SO,R 92,"Attività riguardanti le lotterie, le scommesse, le case d...",0,0,0,0,0,2024
LOM,SO,R 93,"Attività sportive, di intrattenimento e di divertimento     ",0,1,0,0,1,2024
LOM,SO,S   ,Altre attività di servizi                                   ,0,1,2,0,3,2024
LOM,SO,S 94,Attività di organizzazioni associative                      ,0,0,0,0,0,2024
LOM,SO,S 95,Riparazione di computer e di beni per uso personale e per...,0,1,2,0,3,2024
LOM,SO,S 96,Altre attività di servizi per la persona                    ,0,0,0,0,0,2024
LOM,SO,T   ,Attività di famiglie e convivenze come datori di lavoro p...,0,0,0,0,0,2024
LOM,SO,T 97,Attività di famiglie e convivenze come datori di lavoro p...,0,0,0,0,0,2024
LOM,SO,T 98,Produzione di beni e servizi indifferenziati per uso prop...,0,0,0,0,0,2024
LOM,SO,U   ,Organizzazioni ed organismi extraterritoriali               ,0,0,0,0,0,2024
LOM,SO,U 99,Organizzazioni ed organismi extraterritoriali               ,0,0,0,0,0,2024
LOM,SO,XX  ,Imprese non classificate                                    ,5,1,5,1,12,2024
LOM,SO,TOT ,TOTALE                                                      ,19,27,108,12,166,2024
LOM,MI,A   ,"Agricoltura, silvicoltura pesca                             ",2,3,0,24,29,2024
LOM,MI,A 01,"Coltivazioni agricole e produzione di prodotti animali, c...",2,3,0,24,29,2024
LOM,MI,A 02,Silvicoltura ed utilizzo di aree forestali                  ,0,0,0,0,0,2024
LOM,MI,A 03,Pesca e acquacoltura                                        ,0,0,0,0,0,2024
LOM,MI,B   ,Estrazione di minerali da cave e miniere                    ,0,1,0,2,3,2024
LOM,MI,B 05,Estrazione di carbone (esclusa torba)                       ,0,0,0,0,0,2024
LOM,MI,B 06,Estraz.di petrolio greggio e di gas naturale                ,0,1,0,0,1,2024
LOM,MI,B 07,Estrazione di minerali metalliferi                          ,0,0,0,0,0,2024
LOM,MI,B 08,Altre attività di estrazione di minerali da cave e miniere  ,0,0,0,1,1,2024
LOM,MI,B 09,Attività dei servizi di supporto all'estrazione             ,0,0,0,1,1,2024
LOM,MI,C   ,Attività manifatturiere                                     ,127,253,0,124,504,2024
LOM,MI,C 10,Industrie alimentari                                        ,3,12,0,28,43,2024
LOM,MI,C 11,Industria delle bevande                                     ,0,0,0,0,0,2024
LOM,MI,C 12,Industria del tabacco                                       ,0,0,0,0,0,2024
LOM,MI,C 13,Industrie tessili                                           ,6,11,0,3,20,2024
LOM,MI,C 14,Confezione di articoli di abbigliamento; confezione di ar...,15,26,0,3,44,2024
LOM,MI,C 15,Fabbricazione di articoli in pelle e simili                 ,2,21,0,3,26,2024
LOM,MI,C 16,Industria del legno e dei prodotti in legno e sughero (es...,1,3,0,5,9,2024
LOM,MI,C 17,Fabbricazione di carta e di prodotti di carta               ,3,4,0,2,9,2024
LOM,MI,C 18,Stampa e riproduzione di supporti registrati                ,9,37,0,18,64,2024
LOM,MI,C 19,Fabbricazione di coke e prodotti derivanti dalla raffinaz...,0,0,0,0,0,2024
LOM,MI,C 20,Fabbricazione di prodotti chimici                           ,5,10,0,0,15,2024
LOM,MI,C 21,Fabbricazione di prodotti farmaceutici di base e di prepa...,0,1,0,1,2,2024
LOM,MI,C 22,Fabbricazione di articoli in gomma e materie plastiche      ,3,15,0,3,21,2024
LOM,MI,C 23,Fabbricazione di altri prodotti della lavorazione di miner..,4,2,0,4,10,2024
LOM,MI,C 24,Metallurgia                                                 ,0,7,0,0,7,2024
LOM,MI,C 25,Fabbricazione di prodotti in metallo (esclusi macchinari ...,21,44,0,18,83,2024
LOM,MI,C 26,Fabbricazione di computer e prodotti di elettronica e ott...,7,10,0,3,20,2024
LOM,MI,C 27,Fabbricazione di apparecchiature elettriche ed apparecchi...,12,9,0,7,28,2024
LOM,MI,C 28,Fabbricazione di macchinari ed apparecchiature nca          ,18,22,0,6,46,2024
LOM,MI,C 29,"Fabbricazione di autoveicoli, rimorchi e semirimorchi       ",1,2,0,1,4,2024
LOM,MI,C 30,Fabbricazione di altri mezzi di trasporto                   ,3,2,0,1,6,2024
LOM,MI,C 31,Fabbricazione di mobili                                     ,5,5,0,2,12,2024
LOM,MI,C 32,Altre industrie manifatturiere                              ,4,6,0,6,16,2024
LOM,MI,C 33,"Riparazione, manutenzione ed installazione di macchine ed...",5,4,0,10,19,2024
LOM,MI,D   ,"Fornitura di energia elettrica, gas, vapore e aria condiz...",6,0,0,0,6,2024
LOM,MI,D 35,"Fornitura di energia elettrica, gas, vapore e aria condiz...",6,0,0,0,6,2024
LOM,MI,E   ,"Fornitura di acqua; reti fognarie, attività di gestione d...",0,3,0,1,4,2024
LOM,MI,E 36,"Raccolta, trattamento e fornitura di acqua                  ",0,1,0,0,1,2024
LOM,MI,E 37,Gestione delle reti fognarie                                ,0,0,0,0,0,2024
LOM,MI,E 38,"Attività di raccolta, trattamento e smaltimento dei rifiu...",0,2,0,1,3,2024
LOM,MI,E 39,Attività di risanamento e altri servizi di gestione dei r...,0,0,0,0,0,2024
LOM,MI,F   ,Costruzioni                                                 ,139,75,0,573,787,2024
LOM,MI,F 41,Costruzione di edifici                                      ,86,39,0,366,491,2024
LOM,MI,F 42,Ingegneria civile                                           ,1,1,0,2,4,2024
LOM,MI,F 43,Lavori di costruzione specializzati                         ,52,35,0,205,292,2024
LOM,MI,G   ,Commercio all'ingrosso e al dettaglio; riparazione di aut...,237,347,7,53,644,2024
LOM,MI,G 45,Commercio all'ingrosso e al dettaglio e riparazione di au...,15,28,0,3,46,2024
LOM,MI,G 46,Commercio all'ingrosso (escluso quello di autoveicoli e d...,148,165,7,27,347,2024
LOM,MI,G 47,Commercio al dettaglio (escluso quello di autoveicoli e d...,74,154,0,23,251,2024
LOM,MI,H   ,Trasporto e magazzinaggio                                   ,39,29,0,854,922,2024
LOM,MI,H 49,Trasporto terrestre e mediante condotte                     ,12,21,0,126,159,2024
LOM,MI,H 50,Trasporto marittimo e per vie d'acqua                       ,2,0,0,0,2,2024
LOM,MI,H 51,Trasporto aereo                                             ,0,0,0,0,0,2024
LOM,MI,H 52,Magazzinaggio e attività di supporto ai trasporti           ,22,6,0,724,752,2024
LOM,MI,H 53,Servizi postali e attività di corriere                      ,3,2,0,4,9,2024
LOM,MI,I   ,Attività dei servizi alloggio e ristorazione                ,64,103,0,27,194,2024
LOM,MI,I 55,Alloggio                                                    ,3,3,0,2,8,2024
LOM,MI,I 56,Attività dei servizi di ristorazione                        ,61,100,0,25,186,2024
LOM,MI,J   ,Servizi di informazione e comunicazione                     ,55,32,0,48,135,2024
LOM,MI,J 58,Attività editoriali                                         ,7,11,0,5,23,2024
LOM,MI,J 59,"Attività di produzione cinematografica, di video e di pro...",8,2,0,6,16,2024
LOM,MI,J 60,Attività di programmazione e trasmissione                   ,0,1,0,0,1,2024
LOM,MI,J 61,Telecomunicazioni                                           ,1,1,0,4,6,2024
LOM,MI,J 62,"Produzione di software, consulenza informatica e attività...",26,8,0,13,47,2024
LOM,MI,J 63,Attività dei servizi d'informazione e altri servizi infor...,13,9,0,20,42,2024
LOM,MI,K   ,Attività finanziarie e assicurative                         ,30,4,0,3,37,2024
LOM,MI,K 64,Attività di servizi finanziari (escluse le assicurazioni ...,21,2,0,3,26,2024
LOM,MI,K 65,"Assicurazioni, riassicurazioni e fondi pensione (escluse ...",0,0,0,0,0,2024
LOM,MI,K 66,Attività ausiliarie dei servizi finanziari e delle attivi...,9,2,0,0,11,2024
LOM,MI,L   ,Attivita' immobiliari                                       ,124,32,0,68,224,2024
LOM,MI,L 68,Attivita' immobiliari                                       ,124,32,0,68,224,2024
LOM,MI,M   ,"Attività professionali, scientifiche e tecniche             ",117,44,0,103,264,2024
LOM,MI,M 69,Attività legali e contabilità                               ,5,3,0,16,24,2024
LOM,MI,M 70,Attività di direzione aziendale e di consulenza gestional...,51,6,0,35,92,2024
LOM,MI,M 71,Attività degli studi di architettura e d'ingegneria; coll...,12,2,0,2,16,2024
LOM,MI,M 72,Ricerca scientifica e sviluppo                              ,8,0,0,1,9,2024
LOM,MI,M 73,Pubblicità e ricerche di mercato                            ,18,15,0,23,56,2024
LOM,MI,M 74,"Altre attività professionali, scientifiche e tecniche       ",23,18,0,26,67,2024
LOM,MI,M 75,Servizi veterinari                                          ,0,0,0,0,0,2024
LOM,MI,N   ,"Noleggio, agenzie di viaggio, servizi di supporto alle im...",44,33,0,509,586,2024
LOM,MI,N 77,Attività di noleggio e leasing operativo                    ,1,3,0,2,6,2024
LOM,MI,N 78,"Attività di ricerca, selezione, fornitura di personale      ",1,1,0,3,5,2024
LOM,MI,N 79,"Attività dei servizi delle agenzie di viaggio, dei tour o...",6,5,0,4,15,2024
LOM,MI,N 80,Servizi di vigilanza e investigazione                       ,0,0,0,9,9,2024
LOM,MI,N 81,Attività di servizi per edifici e paesaggio                 ,10,10,0,267,287,2024
LOM,MI,N 82,Attività di supporto per le funzioni d'ufficio e altri se...,26,14,0,224,264,2024
LOM,MI,O   ,Amministrazione pubblica e difesa; assicurazione sociale ...,0,0,0,0,0,2024
LOM,MI,O 84,Amministrazione pubblica e difesa; assicurazione sociale ...,0,0,0,0,0,2024
LOM,MI,P   ,Istruzione                                                  ,5,1,0,9,15,2024
LOM,MI,P 85,Istruzione                                                  ,5,1,0,9,15,2024
LOM,MI,Q   ,Sanita' e assistenza sociale                                ,6,4,0,54,64,2024
LOM,MI,Q 86,Assistenza sanitaria                                        ,3,4,0,6,13,2024
LOM,MI,Q 87,Servizi di assistenza sociale residenziale                  ,0,0,0,3,3,2024
LOM,MI,Q 88,Assistenza sociale non residenziale                         ,3,0,0,45,48,2024
LOM,MI,R   ,"Attività artistiche, sportive, di intrattenimento e diver...",21,7,0,47,75,2024
LOM,MI,R 90,"Attività creative, artistiche e di intrattenimento          ",8,2,0,28,38,2024
LOM,MI,R 91,"Attività di biblioteche, archivi, musei ed altre attività...",0,0,0,1,1,2024
LOM,MI,R 92,"Attività riguardanti le lotterie, le scommesse, le case d...",3,1,0,0,4,2024
LOM,MI,R 93,"Attività sportive, di intrattenimento e di divertimento     ",10,4,0,18,32,2024
LOM,MI,S   ,Altre attività di servizi                                   ,15,15,0,58,88,2024
LOM,MI,S 94,Attività di organizzazioni associative                      ,1,0,0,6,7,2024
LOM,MI,S 95,Riparazione di computer e di beni per uso personale e per...,1,5,0,3,9,2024
LOM,MI,S 96,Altre attività di servizi per la persona                    ,13,10,0,49,72,2024
LOM,MI,T   ,Attività di famiglie e convivenze come datori di lavoro p...,0,0,0,1,1,2024
LOM,MI,T 97,Attività di famiglie e convivenze come datori di lavoro p...,0,0,0,1,1,2024
LOM,MI,T 98,Produzione di beni e servizi indifferenziati per uso prop...,0,0,0,0,0,2024
LOM,MI,U   ,Organizzazioni ed organismi extraterritoriali               ,0,0,0,0,0,2024
LOM,MI,U 99,Organizzazioni ed organismi extraterritoriali               ,0,0,0,0,0,2024
LOM,MI,XX  ,Imprese non classificate                                    ,200,351,0,752,1303,2024
LOM,MI,TOT ,TOTALE                                                      ,1231,1337,7,3310,5885,2024
LOM,BG,A   ,"Agricoltura, silvicoltura pesca                             ",2,0,5,0,7,2024
LOM,BG,A 01,"Coltivazioni agricole e produzione di prodotti animali, c...",2,0,5,0,7,2024
LOM,BG,A 02,Silvicoltura ed utilizzo di aree forestali                  ,0,0,0,0,0,2024
LOM,BG,A 03,Pesca e acquacoltura                                        ,0,0,0,0,0,2024
LOM,BG,B   ,Estrazione di minerali da cave e miniere                    ,0,0,0,0,0,2024
LOM,BG,B 05,Estrazione di carbone (esclusa torba)                       ,0,0,0,0,0,2024
LOM,BG,B 06,Estraz.di petrolio greggio e di gas naturale                ,0,0,0,0,0,2024
LOM,BG,B 07,Estrazione di minerali metalliferi                          ,0,0,0,0,0,2024
LOM,BG,B 08,Altre attività di estrazione di minerali da cave e miniere  ,0,0,0,0,0,2024
LOM,BG,B 09,Attività dei servizi di supporto all'estrazione             ,0,0,0,0,0,2024
LOM,BG,C   ,Attività manifatturiere                                     ,58,16,12,30,116,2024
LOM,BG,C 10,Industrie alimentari                                        ,0,1,1,1,3,2024
LOM,BG,C 11,Industria delle bevande                                     ,0,0,0,0,0,2024
LOM,BG,C 12,Industria del tabacco                                       ,0,0,0,0,0,2024
LOM,BG,C 13,Industrie tessili                                           ,4,2,1,0,7,2024
LOM,BG,C 14,Confezione di articoli di abbigliamento; confezione di ar...,4,1,1,0,6,2024
LOM,BG,C 15,Fabbricazione di articoli in pelle e simili                 ,0,0,0,0,0,2024
LOM,BG,C 16,Industria del legno e dei prodotti in legno e sughero (es...,1,0,1,1,3,2024
LOM,BG,C 17,Fabbricazione di carta e di prodotti di carta               ,0,0,0,0,0,2024
LOM,BG,C 18,Stampa e riproduzione di supporti registrati                ,4,1,1,1,7,2024
LOM,BG,C 19,Fabbricazione di coke e prodotti derivanti dalla raffinaz...,0,0,0,0,0,2024
LOM,BG,C 20,Fabbricazione di prodotti chimici                           ,0,1,0,0,1,2024
LOM,BG,C 21,Fabbricazione di prodotti farmaceutici di base e di prepa...,0,0,0,0,0,2024
LOM,BG,C 22,Fabbricazione di articoli in gomma e materie plastiche      ,1,2,0,8,11,2024
LOM,BG,C 23,Fabbricazione di altri prodotti della lavorazione di miner..,3,0,0,1,4,2024
LOM,BG,C 24,Metallurgia                                                 ,3,1,0,0,4,2024
LOM,BG,C 25,Fabbricazione di prodotti in metallo (esclusi macchinari ...,19,5,4,14,42,2024
LOM,BG,C 26,Fabbricazione di computer e prodotti di elettronica e ott...,1,0,0,0,1,2024
LOM,BG,C 27,Fabbricazione di apparecchiature elettriche ed apparecchi...,2,1,0,0,3,2024
LOM,BG,C 28,Fabbricazione di macchinari ed apparecchiature nca          ,12,0,2,0,14,2024
LOM,BG,C 29,"Fabbricazione di autoveicoli, rimorchi e semirimorchi       ",0,0,0,0,0,2024
LOM,BG,C 30,Fabbricazione di altri mezzi di trasporto                   ,1,0,0,0,1,2024
LOM,BG,C 31,Fabbricazione di mobili                                     ,1,1,0,0,2,2024
LOM,BG,C 32,Altre industrie manifatturiere                              ,2,0,1,0,3,2024
LOM,BG,C 33,"Riparazione, manutenzione ed installazione di macchine ed...",0,0,0,4,4,2024
LOM,BG,D   ,"Fornitura di energia elettrica, gas, vapore e aria condiz...",0,0,0,0,0,2024
LOM,BG,D 35,"Fornitura di energia elettrica, gas, vapore e aria condiz...",0,0,0,0,0,2024
LOM,BG,E   ,"Fornitura di acqua; reti fognarie, attività di gestione d...",0,0,1,0,1,2024
LOM,BG,E 36,"Raccolta, trattamento e fornitura di acqua                  ",0,0,0,0,0,2024
LOM,BG,E 37,Gestione delle reti fognarie                                ,0,0,0,0,0,2024
LOM,BG,E 38,"Attività di raccolta, trattamento e smaltimento dei rifiu...",0,0,1,0,1,2024
LOM,BG,E 39,Attività di risanamento e altri servizi di gestione dei r...,0,0,0,0,0,2024
LOM,BG,F   ,Costruzioni                                                 ,101,19,18,46,184,2024
LOM,BG,F 41,Costruzione di edifici                                      ,79,5,4,34,122,2024
LOM,BG,F 42,Ingegneria civile                                           ,1,0,0,1,2,2024
LOM,BG,F 43,Lavori di costruzione specializzati                         ,21,14,14,11,60,2024
LOM,BG,G   ,Commercio all'ingrosso e al dettaglio; riparazione di aut...,85,32,35,2,154,2024
LOM,BG,G 45,Commercio all'ingrosso e al dettaglio e riparazione di au...,14,2,4,0,20,2024
LOM,BG,G 46,Commercio all'ingrosso (escluso quello di autoveicoli e d...,52,12,13,2,79,2024
LOM,BG,G 47,Commercio al dettaglio (escluso quello di autoveicoli e d...,19,18,18,0,55,2024
LOM,BG,H   ,Trasporto e magazzinaggio                                   ,1,7,47,60,115,2024
LOM,BG,H 49,Trasporto terrestre e mediante condotte                     ,0,7,45,4,56,2024
LOM,BG,H 50,Trasporto marittimo e per vie d'acqua                       ,0,0,1,0,1,2024
LOM,BG,H 51,Trasporto aereo                                             ,0,0,0,0,0,2024
LOM,BG,H 52,Magazzinaggio e attività di supporto ai trasporti           ,1,0,1,55,57,2024
LOM,BG,H 53,Servizi postali e attività di corriere                      ,0,0,0,1,1,2024
LOM,BG,I   ,Attività dei servizi alloggio e ristorazione                ,14,29,8,2,53,2024
LOM,BG,I 55,Alloggio                                                    ,0,0,0,0,0,2024
LOM,BG,I 56,Attività dei servizi di ristorazione                        ,14,29,8,2,53,2024
LOM,BG,J   ,Servizi di informazione e comunicazione                     ,15,2,2,1,20,2024
LOM,BG,J 58,Attività editoriali                                         ,1,0,0,0,1,2024
LOM,BG,J 59,"Attività di produzione cinematografica, di video e di pro...",0,0,0,0,0,2024
LOM,BG,J 60,Attività di programmazione e trasmissione                   ,0,0,0,0,0,2024
LOM,BG,J 61,Telecomunicazioni                                           ,3,1,0,1,5,2024
LOM,BG,J 62,"Produzione di software, consulenza informatica e attività...",9,1,2,0,12,2024
LOM,BG,J 63,Attività dei servizi d'informazione e altri servizi infor...,2,0,0,0,2,2024
LOM,BG,K   ,Attività finanziarie e assicurative                         ,2,1,3,0,6,2024
LOM,BG,K 64,Attività di servizi finanziari (escluse le assicurazioni ...,2,0,0,0,2,2024
LOM,BG,K 65,"Assicurazioni, riassicurazioni e fondi pensione (escluse ...",0,0,0,0,0,2024
LOM,BG,K 66,Attività ausiliarie dei servizi finanziari e delle attivi...,0,1,3,0,4,2024
LOM,BG,L   ,Attivita' immobiliari                                       ,23,6,2,1,32,2024
LOM,BG,L 68,Attivita' immobiliari                                       ,23,6,2,1,32,2024
LOM,BG,M   ,"Attività professionali, scientifiche e tecniche             ",14,4,0,4,22,2024
LOM,BG,M 69,Attività legali e contabilità                               ,2,0,0,0,2,2024
LOM,BG,M 70,Attività di direzione aziendale e di consulenza gestional...,2,2,0,3,7,2024
LOM,BG,M 71,Attività degli studi di architettura e d'ingegneria; coll...,2,0,0,1,3,2024
LOM,BG,M 72,Ricerca scientifica e sviluppo                              ,0,0,0,0,0,2024
LOM,BG,M 73,Pubblicità e ricerche di mercato                            ,7,0,0,0,7,2024
LOM,BG,M 74,"Altre attività professionali, scientifiche e tecniche       ",1,2,0,0,3,2024
LOM,BG,M 75,Servizi veterinari                                          ,0,0,0,0,0,2024
LOM,BG,N   ,"Noleggio, agenzie di viaggio, servizi di supporto alle im...",12,3,5,37,57,2024
LOM,BG,N 77,Attività di noleggio e leasing operativo                    ,1,0,1,0,2,2024
LOM,BG,N 78,"Attività di ricerca, selezione, fornitura di personale      ",1,0,0,0,1,2024
LOM,BG,N 79,"Attività dei servizi delle agenzie di viaggio, dei tour o...",2,1,0,0,3,2024
LOM,BG,N 80,Servizi di vigilanza e investigazione                       ,0,0,0,0,0,2024
LOM,BG,N 81,Attività di servizi per edifici e paesaggio                 ,3,1,3,16,23,2024
LOM,BG,N 82,Attività di supporto per le funzioni d'ufficio e altri se...,5,1,1,21,28,2024
LOM,BG,O   ,Amministrazione pubblica e difesa; assicurazione sociale ...,0,0,0,0,0,2024
LOM,BG,O 84,Amministrazione pubblica e difesa; assicurazione sociale ...,0,0,0,0,0,2024
LOM,BG,P   ,Istruzione                                                  ,1,1,0,0,2,2024
LOM,BG,P 85,Istruzione                                                  ,1,1,0,0,2,2024
LOM,BG,Q   ,Sanita' e assistenza sociale                                ,1,0,1,2,4,2024
LOM,BG,Q 86,Assistenza sanitaria                                        ,1,0,1,1,3,2024
LOM,BG,Q 87,Servizi di assistenza sociale residenziale                  ,0,0,0,0,0,2024
LOM,BG,Q 88,Assistenza sociale non residenziale                         ,0,0,0,1,1,2024
LOM,BG,R   ,"Attività artistiche, sportive, di intrattenimento e diver...",3,1,5,1,10,2024
LOM,BG,R 90,"Attività creative, artistiche e di intrattenimento          ",1,0,0,0,1,2024
LOM,BG,R 91,"Attività di biblioteche, archivi, musei ed altre attività...",0,0,0,0,0,2024
LOM,BG,R 92,"Attività riguardanti le lotterie, le scommesse, le case d...",0,0,0,0,0,2024
LOM,BG,R 93,"Attività sportive, di intrattenimento e di divertimento     ",2,1,5,1,9,2024
LOM,BG,S   ,Altre attività di servizi                                   ,10,7,4,3,24,2024
LOM,BG,S 94,Attività di organizzazioni associative                      ,0,0,0,0,0,2024
LOM,BG,S 95,Riparazione di computer e di beni per uso personale e per...,1,0,1,0,2,2024
LOM,BG,S 96,Altre attività di servizi per la persona                    ,9,7,3,3,22,2024
LOM,BG,T   ,Attività di famiglie e convivenze come datori di lavoro p...,0,0,0,0,0,2024
LOM,BG,T 97,Attività di famiglie e convivenze come datori di lavoro p...,0,0,0,0,0,2024
LOM,BG,T 98,Produzione di beni e servizi indifferenziati per uso prop...,0,0,0,0,0,2024
LOM,BG,U   ,Organizzazioni ed organismi extraterritoriali               ,0,0,0,0,0,2024
LOM,BG,U 99,Organizzazioni ed organismi extraterritoriali               ,0,0,0,0,0,2024
LOM,BG,XX  ,Imprese non classificate                                    ,125,27,3,34,189,2024
LOM,BG,TOT ,TOTALE                                                      ,467,155,151,223,996,2024
LOM,BS,A   ,"Agricoltura, silvicoltura pesca                             ",0,4,38,3,45,2024
LOM,BS,A 01,"Coltivazioni agricole e produzione di prodotti animali, c...",0,4,36,3,43,2024
LOM,BS,A 02,Silvicoltura ed utilizzo di aree forestali                  ,0,0,2,0,2,2024
LOM,BS,A 03,Pesca e acquacoltura                                        ,0,0,0,0,0,2024
LOM,BS,B   ,Estrazione di minerali da cave e miniere                    ,0,0,1,0,1,2024
LOM,BS,B 05,Estrazione di carbone (esclusa torba)                       ,0,0,0,0,0,2024
LOM,BS,B 06,Estraz.di petrolio greggio e di gas naturale                ,0,0,0,0,0,2024
LOM,BS,B 07,Estrazione di minerali metalliferi                          ,0,0,0,0,0,2024
LOM,BS,B 08,Altre attività di estrazione di minerali da cave e miniere  ,0,0,0,0,0,2024
LOM,BS,B 09,Attività dei servizi di supporto all'estrazione             ,0,0,1,0,1,2024
LOM,BS,C   ,Attività manifatturiere                                     ,3,19,148,27,197,2024
LOM,BS,C 10,Industrie alimentari                                        ,0,1,4,5,10,2024
LOM,BS,C 11,Industria delle bevande                                     ,0,0,0,0,0,2024
LOM,BS,C 12,Industria del tabacco                                       ,0,0,0,0,0,2024
LOM,BS,C 13,Industrie tessili                                           ,0,0,1,0,1,2024
LOM,BS,C 14,Confezione di articoli di abbigliamento; confezione di ar...,0,1,39,4,44,2024
LOM,BS,C 15,Fabbricazione di articoli in pelle e simili                 ,0,0,0,0,0,2024
LOM,BS,C 16,Industria del legno e dei prodotti in legno e sughero (es...,0,1,0,1,2,2024
LOM,BS,C 17,Fabbricazione di carta e di prodotti di carta               ,0,0,0,0,0,2024
LOM,BS,C 18,Stampa e riproduzione di supporti registrati                ,0,0,0,0,0,2024
LOM,BS,C 19,Fabbricazione di coke e prodotti derivanti dalla raffinaz...,0,0,0,0,0,2024
LOM,BS,C 20,Fabbricazione di prodotti chimici                           ,0,0,0,0,0,2024
LOM,BS,C 21,Fabbricazione di prodotti farmaceutici di base e di prepa...,0,0,0,0,0,2024
LOM,BS,C 22,Fabbricazione di articoli in gomma e materie plastiche      ,1,1,1,0,3,2024
LOM,BS,C 23,Fabbricazione di altri prodotti della lavorazione di miner..,1,1,2,0,4,2024
LOM,BS,C 24,Metallurgia                                                 ,0,0,1,0,1,2024
LOM,BS,C 25,Fabbricazione di prodotti in metallo (esclusi macchinari ...,0,10,56,16,82,2024
LOM,BS,C 26,Fabbricazione di computer e prodotti di elettronica e ott...,1,0,1,0,2,2024
LOM,BS,C 27,Fabbricazione di apparecchiature elettriche ed apparecchi...,0,0,2,0,2,2024
LOM,BS,C 28,Fabbricazione di macchinari ed apparecchiature nca          ,0,4,0,0,4,2024
LOM,BS,C 29,"Fabbricazione di autoveicoli, rimorchi e semirimorchi       ",0,0,1,0,1,2024
LOM,BS,C 30,Fabbricazione di altri mezzi di trasporto                   ,0,0,1,0,1,2024
LOM,BS,C 31,Fabbricazione di mobili                                     ,0,0,2,0,2,2024
LOM,BS,C 32,Altre industrie manifatturiere                              ,0,0,3,0,3,2024
LOM,BS,C 33,"Riparazione, manutenzione ed installazione di macchine ed...",0,0,34,1,35,2024
LOM,BS,D   ,"Fornitura di energia elettrica, gas, vapore e aria condiz...",0,0,0,0,0,2024
LOM,BS,D 35,"Fornitura di energia elettrica, gas, vapore e aria condiz...",0,0,0,0,0,2024
LOM,BS,E   ,"Fornitura di acqua; reti fognarie, attività di gestione d...",0,0,0,0,0,2024
LOM,BS,E 36,"Raccolta, trattamento e fornitura di acqua                  ",0,0,0,0,0,2024
LOM,BS,E 37,Gestione delle reti fognarie                                ,0,0,0,0,0,2024
LOM,BS,E 38,"Attività di raccolta, trattamento e smaltimento dei rifiu...",0,0,0,0,0,2024
LOM,BS,E 39,Attività di risanamento e altri servizi di gestione dei r...,0,0,0,0,0,2024
LOM,BS,F   ,Costruzioni                                                 ,4,35,495,33,567,2024
LOM,BS,F 41,Costruzione di edifici                                      ,4,15,100,23,142,2024
LOM,BS,F 42,Ingegneria civile                                           ,0,0,2,0,2,2024
LOM,BS,F 43,Lavori di costruzione specializzati                         ,0,20,393,10,423,2024
LOM,BS,G   ,Commercio all'ingrosso e al dettaglio; riparazione di aut...,3,94,401,7,505,2024
LOM,BS,G 45,Commercio all'ingrosso e al dettaglio e riparazione di au...,1,4,46,1,52,2024
LOM,BS,G 46,Commercio all'ingrosso (escluso quello di autoveicoli e d...,1,13,143,4,161,2024
LOM,BS,G 47,Commercio al dettaglio (escluso quello di autoveicoli e d...,1,77,212,2,292,2024
LOM,BS,H   ,Trasporto e magazzinaggio                                   ,3,1,9,42,55,2024
LOM,BS,H 49,Trasporto terrestre e mediante condotte                     ,3,1,7,2,13,2024
LOM,BS,H 50,Trasporto marittimo e per vie d'acqua                       ,0,0,0,0,0,2024
LOM,BS,H 51,Trasporto aereo                                             ,0,0,0,0,0,2024
LOM,BS,H 52,Magazzinaggio e attività di supporto ai trasporti           ,0,0,1,40,41,2024
LOM,BS,H 53,Servizi postali e attività di corriere                      ,0,0,1,0,1,2024
LOM,BS,I   ,Attività dei servizi alloggio e ristorazione                ,1,124,110,1,236,2024
LOM,BS,I 55,Alloggio                                                    ,0,1,1,0,2,2024
LOM,BS,I 56,Attività dei servizi di ristorazione                        ,1,123,109,1,234,2024
LOM,BS,J   ,Servizi di informazione e comunicazione                     ,0,2,13,5,20,2024
LOM,BS,J 58,Attività editoriali                                         ,0,0,1,0,1,2024
LOM,BS,J 59,"Attività di produzione cinematografica, di video e di pro...",0,0,0,0,0,2024
LOM,BS,J 60,Attività di programmazione e trasmissione                   ,0,0,0,0,0,2024
LOM,BS,J 61,Telecomunicazioni                                           ,0,2,6,0,8,2024
LOM,BS,J 62,"Produzione di software, consulenza informatica e attività...",0,0,3,1,4,2024
LOM,BS,J 63,Attività dei servizi d'informazione e altri servizi infor...,0,0,3,4,7,2024
LOM,BS,K   ,Attività finanziarie e assicurative                         ,0,3,21,0,24,2024
LOM,BS,K 64,Attività di servizi finanziari (escluse le assicurazioni ...,0,0,0,0,0,2024
LOM,BS,K 65,"Assicurazioni, riassicurazioni e fondi pensione (escluse ...",0,0,0,0,0,2024
LOM,BS,K 66,Attività ausiliarie dei servizi finanziari e delle attivi...,0,3,21,0,24,2024
LOM,BS,L   ,Attivita' immobiliari                                       ,4,8,5,2,19,2024
LOM,BS,L 68,Attivita' immobiliari                                       ,4,8,5,2,19,2024
LOM,BS,M   ,"Attività professionali, scientifiche e tecniche             ",1,4,61,3,69,2024
LOM,BS,M 69,Attività legali e contabilità                               ,0,0,1,0,1,2024
LOM,BS,M 70,Attività di direzione aziendale e di consulenza gestional...,1,1,13,2,17,2024
LOM,BS,M 71,Attività degli studi di architettura e d'ingegneria; coll...,0,0,0,0,0,2024
LOM,BS,M 72,Ricerca scientifica e sviluppo                              ,0,0,0,0,0,2024
LOM,BS,M 73,Pubblicità e ricerche di mercato                            ,0,3,38,1,42,2024
LOM,BS,M 74,"Altre attività professionali, scientifiche e tecniche       ",0,0,9,0,9,2024
LOM,BS,M 75,Servizi veterinari                                          ,0,0,0,0,0,2024
LOM,BS,N   ,"Noleggio, agenzie di viaggio, servizi di supporto alle im...",0,6,125,17,148,2024
LOM,BS,N 77,Attività di noleggio e leasing operativo                    ,0,2,3,0,5,2024
LOM,BS,N 78,"Attività di ricerca, selezione, fornitura di personale      ",0,0,0,0,0,2024
LOM,BS,N 79,"Attività dei servizi delle agenzie di viaggio, dei tour o...",0,1,2,0,3,2024
LOM,BS,N 80,Servizi di vigilanza e investigazione                       ,0,1,0,0,1,2024
LOM,BS,N 81,Attività di servizi per edifici e paesaggio                 ,0,1,18,13,32,2024
LOM,BS,N 82,Attività di supporto per le funzioni d'ufficio e altri se...,0,1,102,4,107,2024
LOM,BS,O   ,Amministrazione pubblica e difesa; assicurazione sociale ...,0,0,0,0,0,2024
LOM,BS,O 84,Amministrazione pubblica e difesa; assicurazione sociale ...,0,0,0,0,0,2024
LOM,BS,P   ,Istruzione                                                  ,0,0,1,1,2,2024
LOM,BS,P 85,Istruzione                                                  ,0,0,1,1,2,2024
LOM,BS,Q   ,Sanita' e assistenza sociale                                ,0,0,0,4,4,2024
LOM,BS,Q 86,Assistenza sanitaria                                        ,0,0,0,2,2,2024
LOM,BS,Q 87,Servizi di assistenza sociale residenziale                  ,0,0,0,0,0,2024
LOM,BS,Q 88,Assistenza sociale non residenziale                         ,0,0,0,2,2,2024
LOM,BS,R   ,"Attività artistiche, sportive, di intrattenimento e diver...",0,4,10,3,17,2024
LOM,BS,R 90,"Attività creative, artistiche e di intrattenimento          ",0,2,5,2,9,2024
LOM,BS,R 91,"Attività di biblioteche, archivi, musei ed altre attività...",0,0,0,0,0,2024
LOM,BS,R 92,"Attività riguardanti le lotterie, le scommesse, le case d...",0,0,0,0,0,2024
LOM,BS,R 93,"Attività sportive, di intrattenimento e di divertimento     ",0,2,5,1,8,2024
LOM,BS,S   ,Altre attività di servizi                                   ,0,19,23,3,45,2024
LOM,BS,S 94,Attività di organizzazioni associative                      ,0,0,0,0,0,2024
LOM,BS,S 95,Riparazione di computer e di beni per uso personale e per...,0,0,11,0,11,2024
LOM,BS,S 96,Altre attività di servizi per la persona                    ,0,19,12,3,34,2024
LOM,BS,T   ,Attività di famiglie e convivenze come datori di lavoro p...,0,0,0,0,0,2024
LOM,BS,T 97,Attività di famiglie e convivenze come datori di lavoro p...,0,0,0,0,0,2024
LOM,BS,T 98,Produzione di beni e servizi indifferenziati per uso prop...,0,0,0,0,0,2024
LOM,BS,U   ,Organizzazioni ed organismi extraterritoriali               ,0,0,0,0,0,2024
LOM,BS,U 99,Organizzazioni ed organismi extraterritoriali               ,0,0,0,0,0,2024
LOM,BS,XX  ,Imprese non classificate                                    ,1,42,19,49,111,2024
LOM,BS,TOT ,TOTALE                                                      ,20,365,1480,200,2065,2024
LOM,PV,A   ,"Agricoltura, silvicoltura pesca                             ",6,0,0,4,10,2024
LOM,PV,A 01,"Coltivazioni agricole e produzione di prodotti animali, c...",6,0,0,4,10,2024
LOM,PV,A 02,Silvicoltura ed utilizzo di aree forestali                  ,0,0,0,0,0,2024
LOM,PV,A 03,Pesca e acquacoltura                                        ,0,0,0,0,0,2024
LOM,PV,B   ,Estrazione di minerali da cave e miniere                    ,1,0,0,0,1,2024
LOM,PV,B 05,Estrazione di carbone (esclusa torba)                       ,0,0,0,0,0,2024
LOM,PV,B 06,Estraz.di petrolio greggio e di gas naturale                ,0,0,0,0,0,2024
LOM,PV,B 07,Estrazione di minerali metalliferi                          ,0,0,0,0,0,2024
LOM,PV,B 08,Altre attività di estrazione di minerali da cave e miniere  ,1,0,0,0,1,2024
LOM,PV,B 09,Attività dei servizi di supporto all'estrazione             ,0,0,0,0,0,2024
LOM,PV,C   ,Attività manifatturiere                                     ,49,0,0,19,68,2024
LOM,PV,C 10,Industrie alimentari                                        ,3,0,0,5,8,2024
LOM,PV,C 11,Industria delle bevande                                     ,0,0,0,0,0,2024
LOM,PV,C 12,Industria del tabacco                                       ,0,0,0,0,0,2024
LOM,PV,C 13,Industrie tessili                                           ,4,0,0,0,4,2024
LOM,PV,C 14,Confezione di articoli di abbigliamento; confezione di ar...,5,0,0,0,5,2024
LOM,PV,C 15,Fabbricazione di articoli in pelle e simili                 ,9,0,0,1,10,2024
LOM,PV,C 16,Industria del legno e dei prodotti in legno e sughero (es...,2,0,0,0,2,2024
LOM,PV,C 17,Fabbricazione di carta e di prodotti di carta               ,1,0,0,0,1,2024
LOM,PV,C 18,Stampa e riproduzione di supporti registrati                ,3,0,0,0,3,2024
LOM,PV,C 19,Fabbricazione di coke e prodotti derivanti dalla raffinaz...,0,0,0,0,0,2024
LOM,PV,C 20,Fabbricazione di prodotti chimici                           ,0,0,0,1,1,2024
LOM,PV,C 21,Fabbricazione di prodotti farmaceutici di base e di prepa...,0,0,0,0,0,2024
LOM,PV,C 22,Fabbricazione di articoli in gomma e materie plastiche      ,1,0,0,2,3,2024
LOM,PV,C 23,Fabbricazione di altri prodotti della lavorazione di miner..,1,0,0,0,1,2024
LOM,PV,C 24,Metallurgia                                                 ,1,0,0,0,1,2024
LOM,PV,C 25,Fabbricazione di prodotti in metallo (esclusi macchinari ...,6,0,0,6,12,2024
LOM,PV,C 26,Fabbricazione di computer e prodotti di elettronica e ott...,1,0,0,0,1,2024
LOM,PV,C 27,Fabbricazione di apparecchiature elettriche ed apparecchi...,0,0,0,1,1,2024
LOM,PV,C 28,Fabbricazione di macchinari ed apparecchiature nca          ,8,0,0,0,8,2024
LOM,PV,C 29,"Fabbricazione di autoveicoli, rimorchi e semirimorchi       ",0,0,0,0,0,2024
LOM,PV,C 30,Fabbricazione di altri mezzi di trasporto                   ,0,0,0,0,0,2024
LOM,PV,C 31,Fabbricazione di mobili                                     ,1,0,0,0,1,2024
LOM,PV,C 32,Altre industrie manifatturiere                              ,1,0,0,1,2,2024
LOM,PV,C 33,"Riparazione, manutenzione ed installazione di macchine ed...",2,0,0,2,4,2024
LOM,PV,D   ,"Fornitura di energia elettrica, gas, vapore e aria condiz...",0,0,0,0,0,2024
LOM,PV,D 35,"Fornitura di energia elettrica, gas, vapore e aria condiz...",0,0,0,0,0,2024
LOM,PV,E   ,"Fornitura di acqua; reti fognarie, attività di gestione d...",1,0,0,0,1,2024
LOM,PV,E 36,"Raccolta, trattamento e fornitura di acqua                  ",0,0,0,0,0,2024
LOM,PV,E 37,Gestione delle reti fognarie                                ,0,0,0,0,0,2024
LOM,PV,E 38,"Attività di raccolta, trattamento e smaltimento dei rifiu...",1,0,0,0,1,2024
LOM,PV,E 39,Attività di risanamento e altri servizi di gestione dei r...,0,0,0,0,0,2024
LOM,PV,F   ,Costruzioni                                                 ,42,0,0,37,79,2024
LOM,PV,F 41,Costruzione di edifici                                      ,20,0,0,25,45,2024
LOM,PV,F 42,Ingegneria civile                                           ,1,0,0,1,2,2024
LOM,PV,F 43,Lavori di costruzione specializzati                         ,21,0,0,11,32,2024
LOM,PV,G   ,Commercio all'ingrosso e al dettaglio; riparazione di aut...,77,0,0,8,85,2024
LOM,PV,G 45,Commercio all'ingrosso e al dettaglio e riparazione di au...,8,0,0,1,9,2024
LOM,PV,G 46,Commercio all'ingrosso (escluso quello di autoveicoli e d...,39,0,0,3,42,2024
LOM,PV,G 47,Commercio al dettaglio (escluso quello di autoveicoli e d...,30,0,0,4,34,2024
LOM,PV,H   ,Trasporto e magazzinaggio                                   ,8,0,0,27,35,2024
LOM,PV,H 49,Trasporto terrestre e mediante condotte                     ,5,0,0,6,11,2024
LOM,PV,H 50,Trasporto marittimo e per vie d'acqua                       ,0,0,0,0,0,2024
LOM,PV,H 51,Trasporto aereo                                             ,0,0,0,0,0,2024
LOM,PV,H 52,Magazzinaggio e attività di supporto ai trasporti           ,2,0,0,21,23,2024
LOM,PV,H 53,Servizi postali e attività di corriere                      ,1,0,0,0,1,2024
LOM,PV,I   ,Attività dei servizi alloggio e ristorazione                ,32,0,0,4,36,2024
LOM,PV,I 55,Alloggio                                                    ,3,0,0,0,3,2024
LOM,PV,I 56,Attività dei servizi di ristorazione                        ,29,0,0,4,33,2024
LOM,PV,J   ,Servizi di informazione e comunicazione                     ,9,0,0,3,12,2024
LOM,PV,J 58,Attività editoriali                                         ,1,0,0,0,1,2024
LOM,PV,J 59,"Attività di produzione cinematografica, di video e di pro...",0,0,0,1,1,2024
LOM,PV,J 60,Attività di programmazione e trasmissione                   ,1,0,0,0,1,2024
LOM,PV,J 61,Telecomunicazioni                                           ,0,0,0,0,0,2024
LOM,PV,J 62,"Produzione di software, consulenza informatica e attività...",5,0,0,1,6,2024
LOM,PV,J 63,Attività dei servizi d'informazione e altri servizi infor...,2,0,0,1,3,2024
LOM,PV,K   ,Attività finanziarie e assicurative                         ,4,0,0,0,4,2024
LOM,PV,K 64,Attività di servizi finanziari (escluse le assicurazioni ...,3,0,0,0,3,2024
LOM,PV,K 65,"Assicurazioni, riassicurazioni e fondi pensione (escluse ...",0,0,0,0,0,2024
LOM,PV,K 66,Attività ausiliarie dei servizi finanziari e delle attivi...,1,0,0,0,1,2024
LOM,PV,L   ,Attivita' immobiliari                                       ,19,0,0,0,19,2024
LOM,PV,L 68,Attivita' immobiliari                                       ,19,0,0,0,19,2024
LOM,PV,M   ,"Attività professionali, scientifiche e tecniche             ",19,0,0,7,26,2024
LOM,PV,M 69,Attività legali e contabilità                               ,1,0,0,1,2,2024
LOM,PV,M 70,Attività di direzione aziendale e di consulenza gestional...,4,0,0,4,8,2024
LOM,PV,M 71,Attività degli studi di architettura e d'ingegneria; coll...,6,0,0,1,7,2024
LOM,PV,M 72,Ricerca scientifica e sviluppo                              ,1,0,0,1,2,2024
LOM,PV,M 73,Pubblicità e ricerche di mercato                            ,6,0,0,0,6,2024
LOM,PV,M 74,"Altre attività professionali, scientifiche e tecniche       ",1,0,0,0,1,2024
LOM,PV,M 75,Servizi veterinari                                          ,0,0,0,0,0,2024
LOM,PV,N   ,"Noleggio, agenzie di viaggio, servizi di supporto alle im...",11,0,0,22,33,2024
LOM,PV,N 77,Attività di noleggio e leasing operativo                    ,2,0,0,0,2,2024
LOM,PV,N 78,"Attività di ricerca, selezione, fornitura di personale      ",1,0,0,0,1,2024
LOM,PV,N 79,"Attività dei servizi delle agenzie di viaggio, dei tour o...",2,0,0,0,2,2024
LOM,PV,N 80,Servizi di vigilanza e investigazione                       ,0,0,0,0,0,2024
LOM,PV,N 81,Attività di servizi per edifici e paesaggio                 ,3,0,0,14,17,2024
LOM,PV,N 82,Attività di supporto per le funzioni d'ufficio e altri se...,3,0,0,8,11,2024
LOM,PV,O   ,Amministrazione pubblica e difesa; assicurazione sociale ...,0,0,0,0,0,2024
LOM,PV,O 84,Amministrazione pubblica e difesa; assicurazione sociale ...,0,0,0,0,0,2024
LOM,PV,P   ,Istruzione                                                  ,0,0,0,2,2,2024
LOM,PV,P 85,Istruzione                                                  ,0,0,0,2,2,2024
LOM,PV,Q   ,Sanita' e assistenza sociale                                ,2,0,0,6,8,2024
LOM,PV,Q 86,Assistenza sanitaria                                        ,2,0,0,0,2,2024
LOM,PV,Q 87,Servizi di assistenza sociale residenziale                  ,0,0,0,0,0,2024
LOM,PV,Q 88,Assistenza sociale non residenziale                         ,0,0,0,6,6,2024
LOM,PV,R   ,"Attività artistiche, sportive, di intrattenimento e diver...",5,0,0,3,8,2024
LOM,PV,R 90,"Attività creative, artistiche e di intrattenimento          ",2,0,0,1,3,2024
LOM,PV,R 91,"Attività di biblioteche, archivi, musei ed altre attività...",0,0,0,0,0,2024
LOM,PV,R 92,"Attività riguardanti le lotterie, le scommesse, le case d...",0,0,0,0,0,2024
LOM,PV,R 93,"Attività sportive, di intrattenimento e di divertimento     ",3,0,0,2,5,2024
LOM,PV,S   ,Altre attività di servizi                                   ,2,0,0,4,6,2024
LOM,PV,S 94,Attività di organizzazioni associative                      ,0,0,0,0,0,2024
LOM,PV,S 95,Riparazione di computer e di beni per uso personale e per...,0,0,0,0,0,2024
LOM,PV,S 96,Altre attività di servizi per la persona                    ,2,0,0,4,6,2024
LOM,PV,T   ,Attività di famiglie e convivenze come datori di lavoro p...,0,0,0,0,0,2024
LOM,PV,T 97,Attività di famiglie e convivenze come datori di lavoro p...,0,0,0,0,0,2024
LOM,PV,T 98,Produzione di beni e servizi indifferenziati per uso prop...,0,0,0,0,0,2024
LOM,PV,U   ,Organizzazioni ed organismi extraterritoriali               ,0,0,0,0,0,2024
LOM,PV,U 99,Organizzazioni ed organismi extraterritoriali               ,0,0,0,0,0,2024
LOM,PV,XX  ,Imprese non classificate                                    ,70,0,0,37,107,2024
LOM,PV,TOT ,TOTALE                                                      ,357,0,0,183,540,2024
LOM,CR,A   ,"Agricoltura, silvicoltura pesca                             ",0,0,0,1,1,2024
LOM,CR,A 01,"Coltivazioni agricole e produzione di prodotti animali, c...",0,0,0,1,1,2024
LOM,CR,A 02,Silvicoltura ed utilizzo di aree forestali                  ,0,0,0,0,0,2024
LOM,CR,A 03,Pesca e acquacoltura                                        ,0,0,0,0,0,2024
LOM,CR,B   ,Estrazione di minerali da cave e miniere                    ,0,0,0,0,0,2024
LOM,CR,B 05,Estrazione di carbone (esclusa torba)                       ,0,0,0,0,0,2024
LOM,CR,B 06,Estraz.di petrolio greggio e di gas naturale                ,0,0,0,0,0,2024
LOM,CR,B 07,Estrazione di minerali metalliferi                          ,0,0,0,0,0,2024
LOM,CR,B 08,Altre attività di estrazione di minerali da cave e miniere  ,0,0,0,0,0,2024
LOM,CR,B 09,Attività dei servizi di supporto all'estrazione             ,0,0,0,0,0,2024
LOM,CR,C   ,Attività manifatturiere                                     ,0,0,0,14,14,2024
LOM,CR,C 10,Industrie alimentari                                        ,0,0,0,3,3,2024
LOM,CR,C 11,Industria delle bevande                                     ,0,0,0,0,0,2024
LOM,CR,C 12,Industria del tabacco                                       ,0,0,0,0,0,2024
LOM,CR,C 13,Industrie tessili                                           ,0,0,0,1,1,2024
LOM,CR,C 14,Confezione di articoli di abbigliamento; confezione di ar...,0,0,0,0,0,2024
LOM,CR,C 15,Fabbricazione di articoli in pelle e simili                 ,0,0,0,1,1,2024
LOM,CR,C 16,Industria del legno e dei prodotti in legno e sughero (es...,0,0,0,0,0,2024
LOM,CR,C 17,Fabbricazione di carta e di prodotti di carta               ,0,0,0,0,0,2024
LOM,CR,C 18,Stampa e riproduzione di supporti registrati                ,0,0,0,0,0,2024
LOM,CR,C 19,Fabbricazione di coke e prodotti derivanti dalla raffinaz...,0,0,0,0,0,2024
LOM,CR,C 20,Fabbricazione di prodotti chimici                           ,0,0,0,1,1,2024
LOM,CR,C 21,Fabbricazione di prodotti farmaceutici di base e di prepa...,0,0,0,0,0,2024
LOM,CR,C 22,Fabbricazione di articoli in gomma e materie plastiche      ,0,0,0,0,0,2024
LOM,CR,C 23,Fabbricazione di altri prodotti della lavorazione di miner..,0,0,0,0,0,2024
LOM,CR,C 24,Metallurgia                                                 ,0,0,0,0,0,2024
LOM,CR,C 25,Fabbricazione di prodotti in metallo (esclusi macchinari ...,0,0,0,6,6,2024
LOM,CR,C 26,Fabbricazione di computer e prodotti di elettronica e ott...,0,0,0,0,0,2024
LOM,CR,C 27,Fabbricazione di apparecchiature elettriche ed apparecchi...,0,0,0,1,1,2024
LOM,CR,C 28,Fabbricazione di macchinari ed apparecchiature nca          ,0,0,0,0,0,2024
LOM,CR,C 29,"Fabbricazione di autoveicoli, rimorchi e semirimorchi       ",0,0,0,0,0,2024
LOM,CR,C 30,Fabbricazione di altri mezzi di trasporto                   ,0,0,0,0,0,2024
LOM,CR,C 31,Fabbricazione di mobili                                     ,0,0,0,0,0,2024
LOM,CR,C 32,Altre industrie manifatturiere                              ,0,0,0,1,1,2024
LOM,CR,C 33,"Riparazione, manutenzione ed installazione di macchine ed...",0,0,0,0,0,2024
LOM,CR,D   ,"Fornitura di energia elettrica, gas, vapore e aria condiz...",0,0,0,0,0,2024
LOM,CR,D 35,"Fornitura di energia elettrica, gas, vapore e aria condiz...",0,0,0,0,0,2024
LOM,CR,E   ,"Fornitura di acqua; reti fognarie, attività di gestione d...",0,0,0,0,0,2024
LOM,CR,E 36,"Raccolta, trattamento e fornitura di acqua                  ",0,0,0,0,0,2024
LOM,CR,E 37,Gestione delle reti fognarie                                ,0,0,0,0,0,2024
LOM,CR,E 38,"Attività di raccolta, trattamento e smaltimento dei rifiu...",0,0,0,0,0,2024
LOM,CR,E 39,Attività di risanamento e altri servizi di gestione dei r...,0,0,0,0,0,2024
LOM,CR,F   ,Costruzioni                                                 ,0,0,0,24,24,2024
LOM,CR,F 41,Costruzione di edifici                                      ,0,0,0,19,19,2024
LOM,CR,F 42,Ingegneria civile                                           ,0,0,0,0,0,2024
LOM,CR,F 43,Lavori di costruzione specializzati                         ,0,0,0,5,5,2024
LOM,CR,G   ,Commercio all'ingrosso e al dettaglio; riparazione di aut...,0,0,0,2,2,2024
LOM,CR,G 45,Commercio all'ingrosso e al dettaglio e riparazione di au...,0,0,0,0,0,2024
LOM,CR,G 46,Commercio all'ingrosso (escluso quello di autoveicoli e d...,0,0,0,2,2,2024
LOM,CR,G 47,Commercio al dettaglio (escluso quello di autoveicoli e d...,0,0,0,0,0,2024
LOM,CR,H   ,Trasporto e magazzinaggio                                   ,0,0,0,7,7,2024
LOM,CR,H 49,Trasporto terrestre e mediante condotte                     ,0,0,0,0,0,2024
LOM,CR,H 50,Trasporto marittimo e per vie d'acqua                       ,0,0,0,0,0,2024
LOM,CR,H 51,Trasporto aereo                                             ,0,0,0,0,0,2024
LOM,CR,H 52,Magazzinaggio e attività di supporto ai trasporti           ,0,0,0,7,7,2024
LOM,CR,H 53,Servizi postali e attività di corriere                      ,0,0,0,0,0,2024
LOM,CR,I   ,Attività dei servizi alloggio e ristorazione                ,0,0,0,1,1,2024
LOM,CR,I 55,Alloggio                                                    ,0,0,0,0,0,2024
LOM,CR,I 56,Attività dei servizi di ristorazione                        ,0,0,0,1,1,2024
LOM,CR,J   ,Servizi di informazione e comunicazione                     ,0,0,0,0,0,2024
LOM,CR,J 58,Attività editoriali                                         ,0,0,0,0,0,2024
LOM,CR,J 59,"Attività di produzione cinematografica, di video e di pro...",0,0,0,0,0,2024
LOM,CR,J 60,Attività di programmazione e trasmissione                   ,0,0,0,0,0,2024
LOM,CR,J 61,Telecomunicazioni                                           ,0,0,0,0,0,2024
LOM,CR,J 62,"Produzione di software, consulenza informatica e attività...",0,0,0,0,0,2024
LOM,CR,J 63,Attività dei servizi d'informazione e altri servizi infor...,0,0,0,0,0,2024
LOM,CR,K   ,Attività finanziarie e assicurative                         ,0,0,0,0,0,2024
LOM,CR,K 64,Attività di servizi finanziari (escluse le assicurazioni ...,0,0,0,0,0,2024
LOM,CR,K 65,"Assicurazioni, riassicurazioni e fondi pensione (escluse ...",0,0,0,0,0,2024
LOM,CR,K 66,Attività ausiliarie dei servizi finanziari e delle attivi...,0,0,0,0,0,2024
LOM,CR,L   ,Attivita' immobiliari                                       ,0,0,0,1,1,2024
LOM,CR,L 68,Attivita' immobiliari                                       ,0,0,0,1,1,2024
LOM,CR,M   ,"Attività professionali, scientifiche e tecniche             ",0,0,0,1,1,2024
LOM,CR,M 69,Attività legali e contabilità                               ,0,0,0,0,0,2024
LOM,CR,M 70,Attività di direzione aziendale e di consulenza gestional...,0,0,0,0,0,2024
LOM,CR,M 71,Attività degli studi di architettura e d'ingegneria; coll...,0,0,0,0,0,2024
LOM,CR,M 72,Ricerca scientifica e sviluppo                              ,0,0,0,0,0,2024
LOM,CR,M 73,Pubblicità e ricerche di mercato                            ,0,0,0,1,1,2024
LOM,CR,M 74,"Altre attività professionali, scientifiche e tecniche       ",0,0,0,0,0,2024
LOM,CR,M 75,Servizi veterinari                                          ,0,0,0,0,0,2024
LOM,CR,N   ,"Noleggio, agenzie di viaggio, servizi di supporto alle im...",0,0,0,8,8,2024
LOM,CR,N 77,Attività di noleggio e leasing operativo                    ,0,0,0,0,0,2024
LOM,CR,N 78,"Attività di ricerca, selezione, fornitura di personale      ",0,0,0,0,0,2024
LOM,CR,N 79,"Attività dei servizi delle agenzie di viaggio, dei tour o...",0,0,0,0,0,2024
LOM,CR,N 80,Servizi di vigilanza e investigazione                       ,0,0,0,0,0,2024
LOM,CR,N 81,Attività di servizi per edifici e paesaggio                 ,0,0,0,5,5,2024
LOM,CR,N 82,Attività di supporto per le funzioni d'ufficio e altri se...,0,0,0,3,3,2024
LOM,CR,O   ,Amministrazione pubblica e difesa; assicurazione sociale ...,0,0,0,0,0,2024
LOM,CR,O 84,Amministrazione pubblica e difesa; assicurazione sociale ...,0,0,0,0,0,2024
LOM,CR,P   ,Istruzione                                                  ,0,0,0,1,1,2024
LOM,CR,P 85,Istruzione                                                  ,0,0,0,1,1,2024
LOM,CR,Q   ,Sanita' e assistenza sociale                                ,0,0,0,2,2,2024
LOM,CR,Q 86,Assistenza sanitaria                                        ,0,0,0,0,0,2024
LOM,CR,Q 87,Servizi di assistenza sociale residenziale                  ,0,0,0,0,0,2024
LOM,CR,Q 88,Assistenza sociale non residenziale                         ,0,0,0,2,2,2024
LOM,CR,R   ,"Attività artistiche, sportive, di intrattenimento e diver...",0,0,0,2,2,2024
LOM,CR,R 90,"Attività creative, artistiche e di intrattenimento          ",0,0,0,1,1,2024
LOM,CR,R 91,"Attività di biblioteche, archivi, musei ed altre attività...",0,0,0,0,0,2024
LOM,CR,R 92,"Attività riguardanti le lotterie, le scommesse, le case d...",0,0,0,0,0,2024
LOM,CR,R 93,"Attività sportive, di intrattenimento e di divertimento     ",0,0,0,1,1,2024
LOM,CR,S   ,Altre attività di servizi                                   ,0,0,0,0,0,2024
LOM,CR,S 94,Attività di organizzazioni associative                      ,0,0,0,0,0,2024
LOM,CR,S 95,Riparazione di computer e di beni per uso personale e per...,0,0,0,0,0,2024
LOM,CR,S 96,Altre attività di servizi per la persona                    ,0,0,0,0,0,2024
LOM,CR,T   ,Attività di famiglie e convivenze come datori di lavoro p...,0,0,0,0,0,2024
LOM,CR,T 97,Attività di famiglie e convivenze come datori di lavoro p...,0,0,0,0,0,2024
LOM,CR,T 98,Produzione di beni e servizi indifferenziati per uso prop...,0,0,0,0,0,2024
LOM,CR,U   ,Organizzazioni ed organismi extraterritoriali               ,0,0,0,0,0,2024
LOM,CR,U 99,Organizzazioni ed organismi extraterritoriali               ,0,0,0,0,0,2024
LOM,CR,XX  ,Imprese non classificate                                    ,0,0,0,20,20,2024
LOM,CR,TOT ,TOTALE                                                      ,0,0,0,84,84,2024
LOM,MN,A   ,"Agricoltura, silvicoltura pesca                             ",0,0,63,10,73,2024
LOM,MN,A 01,"Coltivazioni agricole e produzione di prodotti animali, c...",0,0,61,10,71,2024
LOM,MN,A 02,Silvicoltura ed utilizzo di aree forestali                  ,0,0,1,0,1,2024
LOM,MN,A 03,Pesca e acquacoltura                                        ,0,0,1,0,1,2024
LOM,MN,B   ,Estrazione di minerali da cave e miniere                    ,0,0,0,0,0,2024
LOM,MN,B 05,Estrazione di carbone (esclusa torba)                       ,0,0,0,0,0,2024
LOM,MN,B 06,Estraz.di petrolio greggio e di gas naturale                ,0,0,0,0,0,2024
LOM,MN,B 07,Estrazione di minerali metalliferi                          ,0,0,0,0,0,2024
LOM,MN,B 08,Altre attività di estrazione di minerali da cave e miniere  ,0,0,0,0,0,2024
LOM,MN,B 09,Attività dei servizi di supporto all'estrazione             ,0,0,0,0,0,2024
LOM,MN,C   ,Attività manifatturiere                                     ,10,0,97,9,116,2024
LOM,MN,C 10,Industrie alimentari                                        ,0,0,0,1,1,2024
LOM,MN,C 11,Industria delle bevande                                     ,0,0,0,0,0,2024
LOM,MN,C 12,Industria del tabacco                                       ,0,0,0,0,0,2024
LOM,MN,C 13,Industrie tessili                                           ,0,0,4,0,4,2024
LOM,MN,C 14,Confezione di articoli di abbigliamento; confezione di ar...,2,0,55,0,57,2024
LOM,MN,C 15,Fabbricazione di articoli in pelle e simili                 ,0,0,3,0,3,2024
LOM,MN,C 16,Industria del legno e dei prodotti in legno e sughero (es...,2,0,1,0,3,2024
LOM,MN,C 17,Fabbricazione di carta e di prodotti di carta               ,1,0,1,1,3,2024
LOM,MN,C 18,Stampa e riproduzione di supporti registrati                ,0,0,0,0,0,2024
LOM,MN,C 19,Fabbricazione di coke e prodotti derivanti dalla raffinaz...,0,0,0,0,0,2024
LOM,MN,C 20,Fabbricazione di prodotti chimici                           ,1,0,0,0,1,2024
LOM,MN,C 21,Fabbricazione di prodotti farmaceutici di base e di prepa...,0,0,0,0,0,2024
LOM,MN,C 22,Fabbricazione di articoli in gomma e materie plastiche      ,0,0,1,0,1,2024
LOM,MN,C 23,Fabbricazione di altri prodotti della lavorazione di miner..,1,0,1,0,2,2024
LOM,MN,C 24,Metallurgia                                                 ,0,0,0,0,0,2024
LOM,MN,C 25,Fabbricazione di prodotti in metallo (esclusi macchinari ...,2,0,20,6,28,2024
LOM,MN,C 26,Fabbricazione di computer e prodotti di elettronica e ott...,0,0,0,0,0,2024
LOM,MN,C 27,Fabbricazione di apparecchiature elettriche ed apparecchi...,0,0,0,0,0,2024
LOM,MN,C 28,Fabbricazione di macchinari ed apparecchiature nca          ,1,0,2,0,3,2024
LOM,MN,C 29,"Fabbricazione di autoveicoli, rimorchi e semirimorchi       ",0,0,0,0,0,2024
LOM,MN,C 30,Fabbricazione di altri mezzi di trasporto                   ,0,0,0,0,0,2024
LOM,MN,C 31,Fabbricazione di mobili                                     ,0,0,1,0,1,2024
LOM,MN,C 32,Altre industrie manifatturiere                              ,0,0,2,0,2,2024
LOM,MN,C 33,"Riparazione, manutenzione ed installazione di macchine ed...",0,0,6,1,7,2024
LOM,MN,D   ,"Fornitura di energia elettrica, gas, vapore e aria condiz...",0,0,1,0,1,2024
LOM,MN,D 35,"Fornitura di energia elettrica, gas, vapore e aria condiz...",0,0,1,0,1,2024
LOM,MN,E   ,"Fornitura di acqua; reti fognarie, attività di gestione d...",0,0,0,1,1,2024
LOM,MN,E 36,"Raccolta, trattamento e fornitura di acqua                  ",0,0,0,0,0,2024
LOM,MN,E 37,Gestione delle reti fognarie                                ,0,0,0,0,0,2024
LOM,MN,E 38,"Attività di raccolta, trattamento e smaltimento dei rifiu...",0,0,0,1,1,2024
LOM,MN,E 39,Attività di risanamento e altri servizi di gestione dei r...,0,0,0,0,0,2024
LOM,MN,F   ,Costruzioni                                                 ,10,0,216,11,237,2024
LOM,MN,F 41,Costruzione di edifici                                      ,5,0,23,6,34,2024
LOM,MN,F 42,Ingegneria civile                                           ,0,0,0,0,0,2024
LOM,MN,F 43,Lavori di costruzione specializzati                         ,5,0,193,5,203,2024
LOM,MN,G   ,Commercio all'ingrosso e al dettaglio; riparazione di aut...,15,0,197,3,215,2024
LOM,MN,G 45,Commercio all'ingrosso e al dettaglio e riparazione di au...,4,0,38,0,42,2024
LOM,MN,G 46,Commercio all'ingrosso (escluso quello di autoveicoli e d...,6,0,60,2,68,2024
LOM,MN,G 47,Commercio al dettaglio (escluso quello di autoveicoli e d...,5,0,99,1,105,2024
LOM,MN,H   ,Trasporto e magazzinaggio                                   ,0,0,14,21,35,2024
LOM,MN,H 49,Trasporto terrestre e mediante condotte                     ,0,0,9,2,11,2024
LOM,MN,H 50,Trasporto marittimo e per vie d'acqua                       ,0,0,0,0,0,2024
LOM,MN,H 51,Trasporto aereo                                             ,0,0,0,0,0,2024
LOM,MN,H 52,Magazzinaggio e attività di supporto ai trasporti           ,0,0,3,19,22,2024
LOM,MN,H 53,Servizi postali e attività di corriere                      ,0,0,2,0,2,2024
LOM,MN,I   ,Attività dei servizi alloggio e ristorazione                ,3,0,53,2,58,2024
LOM,MN,I 55,Alloggio                                                    ,0,0,1,0,1,2024
LOM,MN,I 56,Attività dei servizi di ristorazione                        ,3,0,52,2,57,2024
LOM,MN,J   ,Servizi di informazione e comunicazione                     ,5,0,4,1,10,2024
LOM,MN,J 58,Attività editoriali                                         ,1,0,0,0,1,2024
LOM,MN,J 59,"Attività di produzione cinematografica, di video e di pro...",0,0,1,0,1,2024
LOM,MN,J 60,Attività di programmazione e trasmissione                   ,0,0,0,0,0,2024
LOM,MN,J 61,Telecomunicazioni                                           ,0,0,0,0,0,2024
LOM,MN,J 62,"Produzione di software, consulenza informatica e attività...",2,0,2,0,4,2024
LOM,MN,J 63,Attività dei servizi d'informazione e altri servizi infor...,2,0,1,1,4,2024
LOM,MN,K   ,Attività finanziarie e assicurative                         ,0,0,9,0,9,2024
LOM,MN,K 64,Attività di servizi finanziari (escluse le assicurazioni ...,0,0,0,0,0,2024
LOM,MN,K 65,"Assicurazioni, riassicurazioni e fondi pensione (escluse ...",0,0,0,0,0,2024
LOM,MN,K 66,Attività ausiliarie dei servizi finanziari e delle attivi...,0,0,9,0,9,2024
LOM,MN,L   ,Attivita' immobiliari                                       ,1,0,2,1,4,2024
LOM,MN,L 68,Attivita' immobiliari                                       ,1,0,2,1,4,2024
LOM,MN,M   ,"Attività professionali, scientifiche e tecniche             ",1,0,28,1,30,2024
LOM,MN,M 69,Attività legali e contabilità                               ,0,0,0,0,0,2024
LOM,MN,M 70,Attività di direzione aziendale e di consulenza gestional...,1,0,4,0,5,2024
LOM,MN,M 71,Attività degli studi di architettura e d'ingegneria; coll...,0,0,5,0,5,2024
LOM,MN,M 72,Ricerca scientifica e sviluppo                              ,0,0,0,0,0,2024
LOM,MN,M 73,Pubblicità e ricerche di mercato                            ,0,0,10,0,10,2024
LOM,MN,M 74,"Altre attività professionali, scientifiche e tecniche       ",0,0,9,1,10,2024
LOM,MN,M 75,Servizi veterinari                                          ,0,0,0,0,0,2024
LOM,MN,N   ,"Noleggio, agenzie di viaggio, servizi di supporto alle im...",1,0,41,6,48,2024
LOM,MN,N 77,Attività di noleggio e leasing operativo                    ,0,0,1,0,1,2024
LOM,MN,N 78,"Attività di ricerca, selezione, fornitura di personale      ",0,0,0,0,0,2024
LOM,MN,N 79,"Attività dei servizi delle agenzie di viaggio, dei tour o...",0,0,0,0,0,2024
LOM,MN,N 80,Servizi di vigilanza e investigazione                       ,1,0,0,0,1,2024
LOM,MN,N 81,Attività di servizi per edifici e paesaggio                 ,0,0,16,5,21,2024
LOM,MN,N 82,Attività di supporto per le funzioni d'ufficio e altri se...,0,0,24,1,25,2024
LOM,MN,O   ,Amministrazione pubblica e difesa; assicurazione sociale ...,0,0,0,0,0,2024
LOM,MN,O 84,Amministrazione pubblica e difesa; assicurazione sociale ...,0,0,0,0,0,2024
LOM,MN,P   ,Istruzione                                                  ,0,0,2,1,3,2024
LOM,MN,P 85,Istruzione                                                  ,0,0,2,1,3,2024
LOM,MN,Q   ,Sanita' e assistenza sociale                                ,0,0,1,3,4,2024
LOM,MN,Q 86,Assistenza sanitaria                                        ,0,0,0,0,0,2024
LOM,MN,Q 87,Servizi di assistenza sociale residenziale                  ,0,0,0,0,0,2024
LOM,MN,Q 88,Assistenza sociale non residenziale                         ,0,0,1,3,4,2024
LOM,MN,R   ,"Attività artistiche, sportive, di intrattenimento e diver...",0,0,4,5,9,2024
LOM,MN,R 90,"Attività creative, artistiche e di intrattenimento          ",0,0,1,3,4,2024
LOM,MN,R 91,"Attività di biblioteche, archivi, musei ed altre attività...",0,0,0,0,0,2024
LOM,MN,R 92,"Attività riguardanti le lotterie, le scommesse, le case d...",0,0,1,0,1,2024
LOM,MN,R 93,"Attività sportive, di intrattenimento e di divertimento     ",0,0,2,2,4,2024
LOM,MN,S   ,Altre attività di servizi                                   ,0,0,12,2,14,2024
LOM,MN,S 94,Attività di organizzazioni associative                      ,0,0,0,0,0,2024
LOM,MN,S 95,Riparazione di computer e di beni per uso personale e per...,0,0,2,1,3,2024
LOM,MN,S 96,Altre attività di servizi per la persona                    ,0,0,10,1,11,2024
LOM,MN,T   ,Attività di famiglie e convivenze come datori di lavoro p...,0,0,0,0,0,2024
LOM,MN,T 97,Attività di famiglie e convivenze come datori di lavoro p...,0,0,0,0,0,2024
LOM,MN,T 98,Produzione di beni e servizi indifferenziati per uso prop...,0,0,0,0,0,2024
LOM,MN,U   ,Organizzazioni ed organismi extraterritoriali               ,0,0,0,0,0,2024
LOM,MN,U 99,Organizzazioni ed organismi extraterritoriali               ,0,0,0,0,0,2024
LOM,MN,XX  ,Imprese non classificate                                    ,8,0,38,7,53,2024
LOM,MN,TOT ,TOTALE                                                      ,54,0,782,84,920,2024
LOM,LC,A   ,"Agricoltura, silvicoltura pesca                             ",0,0,0,0,0,2024
LOM,LC,A 01,"Coltivazioni agricole e produzione di prodotti animali, c...",0,0,0,0,0,2024
LOM,LC,A 02,Silvicoltura ed utilizzo di aree forestali                  ,0,0,0,0,0,2024
LOM,LC,A 03,Pesca e acquacoltura                                        ,0,0,0,0,0,2024
LOM,LC,B   ,Estrazione di minerali da cave e miniere                    ,0,0,0,0,0,2024
LOM,LC,B 05,Estrazione di carbone (esclusa torba)                       ,0,0,0,0,0,2024
LOM,LC,B 06,Estraz.di petrolio greggio e di gas naturale                ,0,0,0,0,0,2024
LOM,LC,B 07,Estrazione di minerali metalliferi                          ,0,0,0,0,0,2024
LOM,LC,B 08,Altre attività di estrazione di minerali da cave e miniere  ,0,0,0,0,0,2024
LOM,LC,B 09,Attività dei servizi di supporto all'estrazione             ,0,0,0,0,0,2024
LOM,LC,C   ,Attività manifatturiere                                     ,0,0,0,3,3,2024
LOM,LC,C 10,Industrie alimentari                                        ,0,0,0,1,1,2024
LOM,LC,C 11,Industria delle bevande                                     ,0,0,0,0,0,2024
LOM,LC,C 12,Industria del tabacco                                       ,0,0,0,0,0,2024
LOM,LC,C 13,Industrie tessili                                           ,0,0,0,0,0,2024
LOM,LC,C 14,Confezione di articoli di abbigliamento; confezione di ar...,0,0,0,0,0,2024
LOM,LC,C 15,Fabbricazione di articoli in pelle e simili                 ,0,0,0,0,0,2024
LOM,LC,C 16,Industria del legno e dei prodotti in legno e sughero (es...,0,0,0,0,0,2024
LOM,LC,C 17,Fabbricazione di carta e di prodotti di carta               ,0,0,0,0,0,2024
LOM,LC,C 18,Stampa e riproduzione di supporti registrati                ,0,0,0,0,0,2024
LOM,LC,C 19,Fabbricazione di coke e prodotti derivanti dalla raffinaz...,0,0,0,0,0,2024
LOM,LC,C 20,Fabbricazione di prodotti chimici                           ,0,0,0,0,0,2024
LOM,LC,C 21,Fabbricazione di prodotti farmaceutici di base e di prepa...,0,0,0,0,0,2024
LOM,LC,C 22,Fabbricazione di articoli in gomma e materie plastiche      ,0,0,0,0,0,2024
LOM,LC,C 23,Fabbricazione di altri prodotti della lavorazione di miner..,0,0,0,0,0,2024
LOM,LC,C 24,Metallurgia                                                 ,0,0,0,0,0,2024
LOM,LC,C 25,Fabbricazione di prodotti in metallo (esclusi macchinari ...,0,0,0,2,2,2024
LOM,LC,C 26,Fabbricazione di computer e prodotti di elettronica e ott...,0,0,0,0,0,2024
LOM,LC,C 27,Fabbricazione di apparecchiature elettriche ed apparecchi...,0,0,0,0,0,2024
LOM,LC,C 28,Fabbricazione di macchinari ed apparecchiature nca          ,0,0,0,0,0,2024
LOM,LC,C 29,"Fabbricazione di autoveicoli, rimorchi e semirimorchi       ",0,0,0,0,0,2024
LOM,LC,C 30,Fabbricazione di altri mezzi di trasporto                   ,0,0,0,0,0,2024
LOM,LC,C 31,Fabbricazione di mobili                                     ,0,0,0,0,0,2024
LOM,LC,C 32,Altre industrie manifatturiere                              ,0,0,0,0,0,2024
LOM,LC,C 33,"Riparazione, manutenzione ed installazione di macchine ed...",0,0,0,0,0,2024
LOM,LC,D   ,"Fornitura di energia elettrica, gas, vapore e aria condiz...",0,0,0,0,0,2024
LOM,LC,D 35,"Fornitura di energia elettrica, gas, vapore e aria condiz...",0,0,0,0,0,2024
LOM,LC,E   ,"Fornitura di acqua; reti fognarie, attività di gestione d...",0,0,0,0,0,2024
LOM,LC,E 36,"Raccolta, trattamento e fornitura di acqua                  ",0,0,0,0,0,2024
LOM,LC,E 37,Gestione delle reti fognarie                                ,0,0,0,0,0,2024
LOM,LC,E 38,"Attività di raccolta, trattamento e smaltimento dei rifiu...",0,0,0,0,0,2024
LOM,LC,E 39,Attività di risanamento e altri servizi di gestione dei r...,0,0,0,0,0,2024
LOM,LC,F   ,Costruzioni                                                 ,0,0,0,12,12,2024
LOM,LC,F 41,Costruzione di edifici                                      ,0,0,0,9,9,2024
LOM,LC,F 42,Ingegneria civile                                           ,0,0,0,0,0,2024
LOM,LC,F 43,Lavori di costruzione specializzati                         ,0,0,0,3,3,2024
LOM,LC,G   ,Commercio all'ingrosso e al dettaglio; riparazione di aut...,1,0,0,1,2,2024
LOM,LC,G 45,Commercio all'ingrosso e al dettaglio e riparazione di au...,0,0,0,0,0,2024
LOM,LC,G 46,Commercio all'ingrosso (escluso quello di autoveicoli e d...,0,0,0,0,0,2024
LOM,LC,G 47,Commercio al dettaglio (escluso quello di autoveicoli e d...,1,0,0,1,2,2024
LOM,LC,H   ,Trasporto e magazzinaggio                                   ,0,0,0,2,2,2024
LOM,LC,H 49,Trasporto terrestre e mediante condotte                     ,0,0,0,0,0,2024
LOM,LC,H 50,Trasporto marittimo e per vie d'acqua                       ,0,0,0,0,0,2024
LOM,LC,H 51,Trasporto aereo                                             ,0,0,0,0,0,2024
LOM,LC,H 52,Magazzinaggio e attività di supporto ai trasporti           ,0,0,0,2,2,2024
LOM,LC,H 53,Servizi postali e attività di corriere                      ,0,0,0,0,0,2024
LOM,LC,I   ,Attività dei servizi alloggio e ristorazione                ,0,0,0,0,0,2024
LOM,LC,I 55,Alloggio                                                    ,0,0,0,0,0,2024
LOM,LC,I 56,Attività dei servizi di ristorazione                        ,0,0,0,0,0,2024
LOM,LC,J   ,Servizi di informazione e comunicazione                     ,0,0,0,1,1,2024
LOM,LC,J 58,Attività editoriali                                         ,0,0,0,0,0,2024
LOM,LC,J 59,"Attività di produzione cinematografica, di video e di pro...",0,0,0,0,0,2024
LOM,LC,J 60,Attività di programmazione e trasmissione                   ,0,0,0,0,0,2024
LOM,LC,J 61,Telecomunicazioni                                           ,0,0,0,0,0,2024
LOM,LC,J 62,"Produzione di software, consulenza informatica e attività...",0,0,0,1,1,2024
LOM,LC,J 63,Attività dei servizi d'informazione e altri servizi infor...,0,0,0,0,0,2024
LOM,LC,K   ,Attività finanziarie e assicurative                         ,0,0,0,0,0,2024
LOM,LC,K 64,Attività di servizi finanziari (escluse le assicurazioni ...,0,0,0,0,0,2024
LOM,LC,K 65,"Assicurazioni, riassicurazioni e fondi pensione (escluse ...",0,0,0,0,0,2024
LOM,LC,K 66,Attività ausiliarie dei servizi finanziari e delle attivi...,0,0,0,0,0,2024
LOM,LC,L   ,Attivita' immobiliari                                       ,0,0,0,1,1,2024
LOM,LC,L 68,Attivita' immobiliari                                       ,0,0,0,1,1,2024
LOM,LC,M   ,"Attività professionali, scientifiche e tecniche             ",0,0,0,2,2,2024
LOM,LC,M 69,Attività legali e contabilità                               ,0,0,0,1,1,2024
LOM,LC,M 70,Attività di direzione aziendale e di consulenza gestional...,0,0,0,0,0,2024
LOM,LC,M 71,Attività degli studi di architettura e d'ingegneria; coll...,0,0,0,0,0,2024
LOM,LC,M 72,Ricerca scientifica e sviluppo                              ,0,0,0,1,1,2024
LOM,LC,M 73,Pubblicità e ricerche di mercato                            ,0,0,0,0,0,2024
LOM,LC,M 74,"Altre attività professionali, scientifiche e tecniche       ",0,0,0,0,0,2024
LOM,LC,M 75,Servizi veterinari                                          ,0,0,0,0,0,2024
LOM,LC,N   ,"Noleggio, agenzie di viaggio, servizi di supporto alle im...",0,0,0,5,5,2024
LOM,LC,N 77,Attività di noleggio e leasing operativo                    ,0,0,0,0,0,2024
LOM,LC,N 78,"Attività di ricerca, selezione, fornitura di personale      ",0,0,0,0,0,2024
LOM,LC,N 79,"Attività dei servizi delle agenzie di viaggio, dei tour o...",0,0,0,0,0,2024
LOM,LC,N 80,Servizi di vigilanza e investigazione                       ,0,0,0,0,0,2024
LOM,LC,N 81,Attività di servizi per edifici e paesaggio                 ,0,0,0,3,3,2024
LOM,LC,N 82,Attività di supporto per le funzioni d'ufficio e altri se...,0,0,0,2,2,2024
LOM,LC,O   ,Amministrazione pubblica e difesa; assicurazione sociale ...,0,0,0,0,0,2024
LOM,LC,O 84,Amministrazione pubblica e difesa; assicurazione sociale ...,0,0,0,0,0,2024
LOM,LC,P   ,Istruzione                                                  ,0,0,0,0,0,2024
LOM,LC,P 85,Istruzione                                                  ,0,0,0,0,0,2024
LOM,LC,Q   ,Sanita' e assistenza sociale                                ,0,0,0,2,2,2024
LOM,LC,Q 86,Assistenza sanitaria                                        ,0,0,0,1,1,2024
LOM,LC,Q 87,Servizi di assistenza sociale residenziale                  ,0,0,0,0,0,2024
LOM,LC,Q 88,Assistenza sociale non residenziale                         ,0,0,0,1,1,2024
LOM,LC,R   ,"Attività artistiche, sportive, di intrattenimento e diver...",0,0,0,0,0,2024
LOM,LC,R 90,"Attività creative, artistiche e di intrattenimento          ",0,0,0,0,0,2024
LOM,LC,R 91,"Attività di biblioteche, archivi, musei ed altre attività...",0,0,0,0,0,2024
LOM,LC,R 92,"Attività riguardanti le lotterie, le scommesse, le case d...",0,0,0,0,0,2024
LOM,LC,R 93,"Attività sportive, di intrattenimento e di divertimento     ",0,0,0,0,0,2024
LOM,LC,S   ,Altre attività di servizi                                   ,0,0,0,0,0,2024
LOM,LC,S 94,Attività di organizzazioni associative                      ,0,0,0,0,0,2024
LOM,LC,S 95,Riparazione di computer e di beni per uso personale e per...,0,0,0,0,0,2024
LOM,LC,S 96,Altre attività di servizi per la persona                    ,0,0,0,0,0,2024
LOM,LC,T   ,Attività di famiglie e convivenze come datori di lavoro p...,0,0,0,0,0,2024
LOM,LC,T 97,Attività di famiglie e convivenze come datori di lavoro p...,0,0,0,0,0,2024
LOM,LC,T 98,Produzione di beni e servizi indifferenziati per uso prop...,0,0,0,0,0,2024
LOM,LC,U   ,Organizzazioni ed organismi extraterritoriali               ,0,0,0,0,0,2024
LOM,LC,U 99,Organizzazioni ed organismi extraterritoriali               ,0,0,0,0,0,2024
LOM,LC,XX  ,Imprese non classificate                                    ,0,0,0,11,11,2024
LOM,LC,TOT ,TOTALE                                                      ,1,0,0,40,41,2024
LOM,LO,A   ,"Agricoltura, silvicoltura pesca                             ",0,0,0,3,3,2024
LOM,LO,A 01,"Coltivazioni agricole e produzione di prodotti animali, c...",0,0,0,3,3,2024
LOM,LO,A 02,Silvicoltura ed utilizzo di aree forestali                  ,0,0,0,0,0,2024
LOM,LO,A 03,Pesca e acquacoltura                                        ,0,0,0,0,0,2024
LOM,LO,B   ,Estrazione di minerali da cave e miniere                    ,0,0,0,0,0,2024
LOM,LO,B 05,Estrazione di carbone (esclusa torba)                       ,0,0,0,0,0,2024
LOM,LO,B 06,Estraz.di petrolio greggio e di gas naturale                ,0,0,0,0,0,2024
LOM,LO,B 07,Estrazione di minerali metalliferi                          ,0,0,0,0,0,2024
LOM,LO,B 08,Altre attività di estrazione di minerali da cave e miniere  ,0,0,0,0,0,2024
LOM,LO,B 09,Attività dei servizi di supporto all'estrazione             ,0,0,0,0,0,2024
LOM,LO,C   ,Attività manifatturiere                                     ,16,13,0,4,33,2024
LOM,LO,C 10,Industrie alimentari                                        ,0,2,0,1,3,2024
LOM,LO,C 11,Industria delle bevande                                     ,0,0,0,0,0,2024
LOM,LO,C 12,Industria del tabacco                                       ,0,0,0,0,0,2024
LOM,LO,C 13,Industrie tessili                                           ,0,0,0,0,0,2024
LOM,LO,C 14,Confezione di articoli di abbigliamento; confezione di ar...,1,1,0,0,2,2024
LOM,LO,C 15,Fabbricazione di articoli in pelle e simili                 ,1,0,0,0,1,2024
LOM,LO,C 16,Industria del legno e dei prodotti in legno e sughero (es...,0,1,0,0,1,2024
LOM,LO,C 17,Fabbricazione di carta e di prodotti di carta               ,1,1,0,0,2,2024
LOM,LO,C 18,Stampa e riproduzione di supporti registrati                ,1,0,0,0,1,2024
LOM,LO,C 19,Fabbricazione di coke e prodotti derivanti dalla raffinaz...,0,0,0,0,0,2024
LOM,LO,C 20,Fabbricazione di prodotti chimici                           ,0,0,0,0,0,2024
LOM,LO,C 21,Fabbricazione di prodotti farmaceutici di base e di prepa...,0,0,0,0,0,2024
LOM,LO,C 22,Fabbricazione di articoli in gomma e materie plastiche      ,0,0,0,0,0,2024
LOM,LO,C 23,Fabbricazione di altri prodotti della lavorazione di miner..,1,3,0,0,4,2024
LOM,LO,C 24,Metallurgia                                                 ,0,0,0,0,0,2024
LOM,LO,C 25,Fabbricazione di prodotti in metallo (esclusi macchinari ...,5,1,0,0,6,2024
LOM,LO,C 26,Fabbricazione di computer e prodotti di elettronica e ott...,0,0,0,1,1,2024
LOM,LO,C 27,Fabbricazione di apparecchiature elettriche ed apparecchi...,2,2,0,1,5,2024
LOM,LO,C 28,Fabbricazione di macchinari ed apparecchiature nca          ,3,2,0,0,5,2024
LOM,LO,C 29,"Fabbricazione di autoveicoli, rimorchi e semirimorchi       ",0,0,0,0,0,2024
LOM,LO,C 30,Fabbricazione di altri mezzi di trasporto                   ,0,0,0,0,0,2024
LOM,LO,C 31,Fabbricazione di mobili                                     ,0,0,0,0,0,2024
LOM,LO,C 32,Altre industrie manifatturiere                              ,1,0,0,0,1,2024
LOM,LO,C 33,"Riparazione, manutenzione ed installazione di macchine ed...",0,0,0,1,1,2024
LOM,LO,D   ,"Fornitura di energia elettrica, gas, vapore e aria condiz...",0,0,0,0,0,2024
LOM,LO,D 35,"Fornitura di energia elettrica, gas, vapore e aria condiz...",0,0,0,0,0,2024
LOM,LO,E   ,"Fornitura di acqua; reti fognarie, attività di gestione d...",0,0,0,0,0,2024
LOM,LO,E 36,"Raccolta, trattamento e fornitura di acqua                  ",0,0,0,0,0,2024
LOM,LO,E 37,Gestione delle reti fognarie                                ,0,0,0,0,0,2024
LOM,LO,E 38,"Attività di raccolta, trattamento e smaltimento dei rifiu...",0,0,0,0,0,2024
LOM,LO,E 39,Attività di risanamento e altri servizi di gestione dei r...,0,0,0,0,0,2024
LOM,LO,F   ,Costruzioni                                                 ,4,4,0,31,39,2024
LOM,LO,F 41,Costruzione di edifici                                      ,2,3,0,23,28,2024
LOM,LO,F 42,Ingegneria civile                                           ,0,0,0,0,0,2024
LOM,LO,F 43,Lavori di costruzione specializzati                         ,2,1,0,8,11,2024
LOM,LO,G   ,Commercio all'ingrosso e al dettaglio; riparazione di aut...,12,13,0,2,27,2024
LOM,LO,G 45,Commercio all'ingrosso e al dettaglio e riparazione di au...,0,2,0,0,2,2024
LOM,LO,G 46,Commercio all'ingrosso (escluso quello di autoveicoli e d...,6,7,0,2,15,2024
LOM,LO,G 47,Commercio al dettaglio (escluso quello di autoveicoli e d...,6,4,0,0,10,2024
LOM,LO,H   ,Trasporto e magazzinaggio                                   ,2,1,0,24,27,2024
LOM,LO,H 49,Trasporto terrestre e mediante condotte                     ,2,1,0,7,10,2024
LOM,LO,H 50,Trasporto marittimo e per vie d'acqua                       ,0,0,0,0,0,2024
LOM,LO,H 51,Trasporto aereo                                             ,0,0,0,0,0,2024
LOM,LO,H 52,Magazzinaggio e attività di supporto ai trasporti           ,0,0,0,16,16,2024
LOM,LO,H 53,Servizi postali e attività di corriere                      ,0,0,0,1,1,2024
LOM,LO,I   ,Attività dei servizi alloggio e ristorazione                ,3,3,0,0,6,2024
LOM,LO,I 55,Alloggio                                                    ,0,0,0,0,0,2024
LOM,LO,I 56,Attività dei servizi di ristorazione                        ,3,3,0,0,6,2024
LOM,LO,J   ,Servizi di informazione e comunicazione                     ,0,0,0,1,1,2024
LOM,LO,J 58,Attività editoriali                                         ,0,0,0,0,0,2024
LOM,LO,J 59,"Attività di produzione cinematografica, di video e di pro...",0,0,0,0,0,2024
LOM,LO,J 60,Attività di programmazione e trasmissione                   ,0,0,0,0,0,2024
LOM,LO,J 61,Telecomunicazioni                                           ,0,0,0,1,1,2024
LOM,LO,J 62,"Produzione di software, consulenza informatica e attività...",0,0,0,0,0,2024
LOM,LO,J 63,Attività dei servizi d'informazione e altri servizi infor...,0,0,0,0,0,2024
LOM,LO,K   ,Attività finanziarie e assicurative                         ,0,2,0,0,2,2024
LOM,LO,K 64,Attività di servizi finanziari (escluse le assicurazioni ...,0,2,0,0,2,2024
LOM,LO,K 65,"Assicurazioni, riassicurazioni e fondi pensione (escluse ...",0,0,0,0,0,2024
LOM,LO,K 66,Attività ausiliarie dei servizi finanziari e delle attivi...,0,0,0,0,0,2024
LOM,LO,L   ,Attivita' immobiliari                                       ,7,2,0,8,17,2024
LOM,LO,L 68,Attivita' immobiliari                                       ,7,2,0,8,17,2024
LOM,LO,M   ,"Attività professionali, scientifiche e tecniche             ",0,0,0,0,0,2024
LOM,LO,M 69,Attività legali e contabilità                               ,0,0,0,0,0,2024
LOM,LO,M 70,Attività di direzione aziendale e di consulenza gestional...,0,0,0,0,0,2024
LOM,LO,M 71,Attività degli studi di architettura e d'ingegneria; coll...,0,0,0,0,0,2024
LOM,LO,M 72,Ricerca scientifica e sviluppo                              ,0,0,0,0,0,2024
LOM,LO,M 73,Pubblicità e ricerche di mercato                            ,0,0,0,0,0,2024
LOM,LO,M 74,"Altre attività professionali, scientifiche e tecniche       ",0,0,0,0,0,2024
LOM,LO,M 75,Servizi veterinari                                          ,0,0,0,0,0,2024
LOM,LO,N   ,"Noleggio, agenzie di viaggio, servizi di supporto alle im...",0,0,0,15,15,2024
LOM,LO,N 77,Attività di noleggio e leasing operativo                    ,0,0,0,0,0,2024
LOM,LO,N 78,"Attività di ricerca, selezione, fornitura di personale      ",0,0,0,1,1,2024
LOM,LO,N 79,"Attività dei servizi delle agenzie di viaggio, dei tour o...",0,0,0,0,0,2024
LOM,LO,N 80,Servizi di vigilanza e investigazione                       ,0,0,0,0,0,2024
LOM,LO,N 81,Attività di servizi per edifici e paesaggio                 ,0,0,0,7,7,2024
LOM,LO,N 82,Attività di supporto per le funzioni d'ufficio e altri se...,0,0,0,7,7,2024
LOM,LO,O   ,Amministrazione pubblica e difesa; assicurazione sociale ...,0,0,0,0,0,2024
LOM,LO,O 84,Amministrazione pubblica e difesa; assicurazione sociale ...,0,0,0,0,0,2024
LOM,LO,P   ,Istruzione                                                  ,0,0,0,0,0,2024
LOM,LO,P 85,Istruzione                                                  ,0,0,0,0,0,2024
LOM,LO,Q   ,Sanita' e assistenza sociale                                ,1,1,0,5,7,2024
LOM,LO,Q 86,Assistenza sanitaria                                        ,1,1,0,0,2,2024
LOM,LO,Q 87,Servizi di assistenza sociale residenziale                  ,0,0,0,0,0,2024
LOM,LO,Q 88,Assistenza sociale non residenziale                         ,0,0,0,5,5,2024
LOM,LO,R   ,"Attività artistiche, sportive, di intrattenimento e diver...",2,1,0,1,4,2024
LOM,LO,R 90,"Attività creative, artistiche e di intrattenimento          ",0,1,0,0,1,2024
LOM,LO,R 91,"Attività di biblioteche, archivi, musei ed altre attività...",0,0,0,0,0,2024
LOM,LO,R 92,"Attività riguardanti le lotterie, le scommesse, le case d...",1,0,0,0,1,2024
LOM,LO,R 93,"Attività sportive, di intrattenimento e di divertimento     ",1,0,0,1,2,2024
LOM,LO,S   ,Altre attività di servizi                                   ,0,1,0,3,4,2024
LOM,LO,S 94,Attività di organizzazioni associative                      ,0,0,0,0,0,2024
LOM,LO,S 95,Riparazione di computer e di beni per uso personale e per...,0,0,0,0,0,2024
LOM,LO,S 96,Altre attività di servizi per la persona                    ,0,1,0,3,4,2024
LOM,LO,T   ,Attività di famiglie e convivenze come datori di lavoro p...,0,0,0,0,0,2024
LOM,LO,T 97,Attività di famiglie e convivenze come datori di lavoro p...,0,0,0,0,0,2024
LOM,LO,T 98,Produzione di beni e servizi indifferenziati per uso prop...,0,0,0,0,0,2024
LOM,LO,U   ,Organizzazioni ed organismi extraterritoriali               ,0,0,0,0,0,2024
LOM,LO,U 99,Organizzazioni ed organismi extraterritoriali               ,0,0,0,0,0,2024
LOM,LO,XX  ,Imprese non classificate                                    ,7,10,0,29,46,2024
LOM,LO,TOT ,TOTALE                                                      ,54,51,0,126,231,2024
LOM,MB,A   ,"Agricoltura, silvicoltura pesca                             ",1,0,0,6,7,2024
LOM,MB,A 01,"Coltivazioni agricole e produzione di prodotti animali, c...",1,0,0,6,7,2024
LOM,MB,A 02,Silvicoltura ed utilizzo di aree forestali                  ,0,0,0,0,0,2024
LOM,MB,A 03,Pesca e acquacoltura                                        ,0,0,0,0,0,2024
LOM,MB,B   ,Estrazione di minerali da cave e miniere                    ,1,0,0,0,1,2024
LOM,MB,B 05,Estrazione di carbone (esclusa torba)                       ,0,0,0,0,0,2024
LOM,MB,B 06,Estraz.di petrolio greggio e di gas naturale                ,0,0,0,0,0,2024
LOM,MB,B 07,Estrazione di minerali metalliferi                          ,0,0,0,0,0,2024
LOM,MB,B 08,Altre attività di estrazione di minerali da cave e miniere  ,1,0,0,0,1,2024
LOM,MB,B 09,Attività dei servizi di supporto all'estrazione             ,0,0,0,0,0,2024
LOM,MB,C   ,Attività manifatturiere                                     ,109,74,0,15,198,2024
LOM,MB,C 10,Industrie alimentari                                        ,1,1,0,0,2,2024
LOM,MB,C 11,Industria delle bevande                                     ,0,0,0,0,0,2024
LOM,MB,C 12,Industria del tabacco                                       ,0,0,0,0,0,2024
LOM,MB,C 13,Industrie tessili                                           ,3,0,0,0,3,2024
LOM,MB,C 14,Confezione di articoli di abbigliamento; confezione di ar...,5,9,0,3,17,2024
LOM,MB,C 15,Fabbricazione di articoli in pelle e simili                 ,1,0,0,0,1,2024
LOM,MB,C 16,Industria del legno e dei prodotti in legno e sughero (es...,6,5,0,0,11,2024
LOM,MB,C 17,Fabbricazione di carta e di prodotti di carta               ,2,2,0,0,4,2024
LOM,MB,C 18,Stampa e riproduzione di supporti registrati                ,5,6,0,0,11,2024
LOM,MB,C 19,Fabbricazione di coke e prodotti derivanti dalla raffinaz...,0,0,0,0,0,2024
LOM,MB,C 20,Fabbricazione di prodotti chimici                           ,2,2,0,0,4,2024
LOM,MB,C 21,Fabbricazione di prodotti farmaceutici di base e di prepa...,1,0,0,0,1,2024
LOM,MB,C 22,Fabbricazione di articoli in gomma e materie plastiche      ,6,5,0,0,11,2024
LOM,MB,C 23,Fabbricazione di altri prodotti della lavorazione di miner..,3,4,0,0,7,2024
LOM,MB,C 24,Metallurgia                                                 ,1,1,0,0,2,2024
LOM,MB,C 25,Fabbricazione di prodotti in metallo (esclusi macchinari ...,17,8,0,8,33,2024
LOM,MB,C 26,Fabbricazione di computer e prodotti di elettronica e ott...,5,6,0,0,11,2024
LOM,MB,C 27,Fabbricazione di apparecchiature elettriche ed apparecchi...,12,2,0,0,14,2024
LOM,MB,C 28,Fabbricazione di macchinari ed apparecchiature nca          ,13,5,0,0,18,2024
LOM,MB,C 29,"Fabbricazione di autoveicoli, rimorchi e semirimorchi       ",0,1,0,0,1,2024
LOM,MB,C 30,Fabbricazione di altri mezzi di trasporto                   ,0,1,0,0,1,2024
LOM,MB,C 31,Fabbricazione di mobili                                     ,22,16,0,0,38,2024
LOM,MB,C 32,Altre industrie manifatturiere                              ,2,0,0,1,3,2024
LOM,MB,C 33,"Riparazione, manutenzione ed installazione di macchine ed...",2,0,0,3,5,2024
LOM,MB,D   ,"Fornitura di energia elettrica, gas, vapore e aria condiz...",1,0,0,0,1,2024
LOM,MB,D 35,"Fornitura di energia elettrica, gas, vapore e aria condiz...",1,0,0,0,1,2024
LOM,MB,E   ,"Fornitura di acqua; reti fognarie, attività di gestione d...",0,0,0,0,0,2024
LOM,MB,E 36,"Raccolta, trattamento e fornitura di acqua                  ",0,0,0,0,0,2024
LOM,MB,E 37,Gestione delle reti fognarie                                ,0,0,0,0,0,2024
LOM,MB,E 38,"Attività di raccolta, trattamento e smaltimento dei rifiu...",0,0,0,0,0,2024
LOM,MB,E 39,Attività di risanamento e altri servizi di gestione dei r...,0,0,0,0,0,2024
LOM,MB,F   ,Costruzioni                                                 ,49,32,0,69,150,2024
LOM,MB,F 41,Costruzione di edifici                                      ,33,10,0,49,92,2024
LOM,MB,F 42,Ingegneria civile                                           ,0,1,0,0,1,2024
LOM,MB,F 43,Lavori di costruzione specializzati                         ,16,21,0,20,57,2024
LOM,MB,G   ,Commercio all'ingrosso e al dettaglio; riparazione di aut...,74,57,0,7,138,2024
LOM,MB,G 45,Commercio all'ingrosso e al dettaglio e riparazione di au...,7,4,0,0,11,2024
LOM,MB,G 46,Commercio all'ingrosso (escluso quello di autoveicoli e d...,42,14,0,4,60,2024
LOM,MB,G 47,Commercio al dettaglio (escluso quello di autoveicoli e d...,25,39,0,3,67,2024
LOM,MB,H   ,Trasporto e magazzinaggio                                   ,5,9,0,99,113,2024
LOM,MB,H 49,Trasporto terrestre e mediante condotte                     ,3,8,0,10,21,2024
LOM,MB,H 50,Trasporto marittimo e per vie d'acqua                       ,0,0,0,0,0,2024
LOM,MB,H 51,Trasporto aereo                                             ,1,0,0,0,1,2024
LOM,MB,H 52,Magazzinaggio e attività di supporto ai trasporti           ,1,1,0,89,91,2024
LOM,MB,H 53,Servizi postali e attività di corriere                      ,0,0,0,0,0,2024
LOM,MB,I   ,Attività dei servizi alloggio e ristorazione                ,13,20,0,2,35,2024
LOM,MB,I 55,Alloggio                                                    ,2,0,0,0,2,2024
LOM,MB,I 56,Attività dei servizi di ristorazione                        ,11,20,0,2,33,2024
LOM,MB,J   ,Servizi di informazione e comunicazione                     ,12,3,0,5,20,2024
LOM,MB,J 58,Attività editoriali                                         ,2,0,0,0,2,2024
LOM,MB,J 59,"Attività di produzione cinematografica, di video e di pro...",0,0,0,0,0,2024
LOM,MB,J 60,Attività di programmazione e trasmissione                   ,0,0,0,0,0,2024
LOM,MB,J 61,Telecomunicazioni                                           ,0,1,0,0,1,2024
LOM,MB,J 62,"Produzione di software, consulenza informatica e attività...",6,1,0,3,10,2024
LOM,MB,J 63,Attività dei servizi d'informazione e altri servizi infor...,4,1,0,2,7,2024
LOM,MB,K   ,Attività finanziarie e assicurative                         ,3,3,0,1,7,2024
LOM,MB,K 64,Attività di servizi finanziari (escluse le assicurazioni ...,3,1,0,1,5,2024
LOM,MB,K 65,"Assicurazioni, riassicurazioni e fondi pensione (escluse ...",0,1,0,0,1,2024
LOM,MB,K 66,Attività ausiliarie dei servizi finanziari e delle attivi...,0,1,0,0,1,2024
LOM,MB,L   ,Attivita' immobiliari                                       ,38,4,0,17,59,2024
LOM,MB,L 68,Attivita' immobiliari                                       ,38,4,0,17,59,2024
LOM,MB,M   ,"Attività professionali, scientifiche e tecniche             ",19,5,0,7,31,2024
LOM,MB,M 69,Attività legali e contabilità                               ,0,0,0,0,0,2024
LOM,MB,M 70,Attività di direzione aziendale e di consulenza gestional...,3,2,0,4,9,2024
LOM,MB,M 71,Attività degli studi di architettura e d'ingegneria; coll...,7,0,0,0,7,2024
LOM,MB,M 72,Ricerca scientifica e sviluppo                              ,1,0,0,0,1,2024
LOM,MB,M 73,Pubblicità e ricerche di mercato                            ,7,1,0,0,8,2024
LOM,MB,M 74,"Altre attività professionali, scientifiche e tecniche       ",1,2,0,3,6,2024
LOM,MB,M 75,Servizi veterinari                                          ,0,0,0,0,0,2024
LOM,MB,N   ,"Noleggio, agenzie di viaggio, servizi di supporto alle im...",17,3,0,66,86,2024
LOM,MB,N 77,Attività di noleggio e leasing operativo                    ,3,0,0,0,3,2024
LOM,MB,N 78,"Attività di ricerca, selezione, fornitura di personale      ",0,0,0,0,0,2024
LOM,MB,N 79,"Attività dei servizi delle agenzie di viaggio, dei tour o...",1,2,0,0,3,2024
LOM,MB,N 80,Servizi di vigilanza e investigazione                       ,0,0,0,0,0,2024
LOM,MB,N 81,Attività di servizi per edifici e paesaggio                 ,4,0,0,30,34,2024
LOM,MB,N 82,Attività di supporto per le funzioni d'ufficio e altri se...,9,1,0,36,46,2024
LOM,MB,O   ,Amministrazione pubblica e difesa; assicurazione sociale ...,0,0,0,0,0,2024
LOM,MB,O 84,Amministrazione pubblica e difesa; assicurazione sociale ...,0,0,0,0,0,2024
LOM,MB,P   ,Istruzione                                                  ,2,0,0,1,3,2024
LOM,MB,P 85,Istruzione                                                  ,2,0,0,1,3,2024
LOM,MB,Q   ,Sanita' e assistenza sociale                                ,1,1,0,10,12,2024
LOM,MB,Q 86,Assistenza sanitaria                                        ,1,1,0,1,3,2024
LOM,MB,Q 87,Servizi di assistenza sociale residenziale                  ,0,0,0,0,0,2024
LOM,MB,Q 88,Assistenza sociale non residenziale                         ,0,0,0,9,9,2024
LOM,MB,R   ,"Attività artistiche, sportive, di intrattenimento e diver...",4,0,0,2,6,2024
LOM,MB,R 90,"Attività creative, artistiche e di intrattenimento          ",0,0,0,1,1,2024
LOM,MB,R 91,"Attività di biblioteche, archivi, musei ed altre attività...",0,0,0,0,0,2024
LOM,MB,R 92,"Attività riguardanti le lotterie, le scommesse, le case d...",0,0,0,0,0,2024
LOM,MB,R 93,"Attività sportive, di intrattenimento e di divertimento     ",4,0,0,1,5,2024
LOM,MB,S   ,Altre attività di servizi                                   ,2,3,0,4,9,2024
LOM,MB,S 94,Attività di organizzazioni associative                      ,0,0,0,1,1,2024
LOM,MB,S 95,Riparazione di computer e di beni per uso personale e per...,1,1,0,0,2,2024
LOM,MB,S 96,Altre attività di servizi per la persona                    ,1,2,0,3,6,2024
LOM,MB,T   ,Attività di famiglie e convivenze come datori di lavoro p...,0,0,0,0,0,2024
LOM,MB,T 97,Attività di famiglie e convivenze come datori di lavoro p...,0,0,0,0,0,2024
LOM,MB,T 98,Produzione di beni e servizi indifferenziati per uso prop...,0,0,0,0,0,2024
LOM,MB,U   ,Organizzazioni ed organismi extraterritoriali               ,0,0,0,0,0,2024
LOM,MB,U 99,Organizzazioni ed organismi extraterritoriali               ,0,0,0,0,0,2024
LOM,MB,XX  ,Imprese non classificate                                    ,111,72,0,93,276,2024
LOM,MB,TOT ,TOTALE                                                      ,462,286,0,404,1152,2024
TAA,  ,A   ,"Agricoltura, silvicoltura pesca                             ",0,0,24,0,24,2024
TAA,  ,A 01,"Coltivazioni agricole e produzione di prodotti animali, c...",0,0,22,0,22,2024
TAA,  ,A 02,Silvicoltura ed utilizzo di aree forestali                  ,0,0,2,0,2,2024
TAA,  ,A 03,Pesca e acquacoltura                                        ,0,0,0,0,0,2024
TAA,  ,B   ,Estrazione di minerali da cave e miniere                    ,0,0,0,0,0,2024
TAA,  ,B 05,Estrazione di carbone (esclusa torba)                       ,0,0,0,0,0,2024
TAA,  ,B 06,Estraz.di petrolio greggio e di gas naturale                ,0,0,0,0,0,2024
TAA,  ,B 07,Estrazione di minerali metalliferi                          ,0,0,0,0,0,2024
TAA,  ,B 08,Altre attività di estrazione di minerali da cave e miniere  ,0,0,0,0,0,2024
TAA,  ,B 09,Attività dei servizi di supporto all'estrazione             ,0,0,0,0,0,2024
TAA,  ,C   ,Attività manifatturiere                                     ,6,0,11,0,17,2024
TAA,  ,C 10,Industrie alimentari                                        ,0,0,2,0,2,2024
TAA,  ,C 11,Industria delle bevande                                     ,0,0,0,0,0,2024
TAA,  ,C 12,Industria del tabacco                                       ,0,0,0,0,0,2024
TAA,  ,C 13,Industrie tessili                                           ,0,0,0,0,0,2024
TAA,  ,C 14,Confezione di articoli di abbigliamento; confezione di ar...,1,0,0,0,1,2024
TAA,  ,C 15,Fabbricazione di articoli in pelle e simili                 ,0,0,0,0,0,2024
TAA,  ,C 16,Industria del legno e dei prodotti in legno e sughero (es...,0,0,2,0,2,2024
TAA,  ,C 17,Fabbricazione di carta e di prodotti di carta               ,0,0,0,0,0,2024
TAA,  ,C 18,Stampa e riproduzione di supporti registrati                ,0,0,0,0,0,2024
TAA,  ,C 19,Fabbricazione di coke e prodotti derivanti dalla raffinaz...,0,0,0,0,0,2024
TAA,  ,C 20,Fabbricazione di prodotti chimici                           ,0,0,0,0,0,2024
TAA,  ,C 21,Fabbricazione di prodotti farmaceutici di base e di prepa...,0,0,0,0,0,2024
TAA,  ,C 22,Fabbricazione di articoli in gomma e materie plastiche      ,1,0,0,0,1,2024
TAA,  ,C 23,Fabbricazione di altri prodotti della lavorazione di miner..,2,0,1,0,3,2024
TAA,  ,C 24,Metallurgia                                                 ,0,0,0,0,0,2024
TAA,  ,C 25,Fabbricazione di prodotti in metallo (esclusi macchinari ...,0,0,3,0,3,2024
TAA,  ,C 26,Fabbricazione di computer e prodotti di elettronica e ott...,1,0,0,0,1,2024
TAA,  ,C 27,Fabbricazione di apparecchiature elettriche ed apparecchi...,0,0,0,0,0,2024
TAA,  ,C 28,Fabbricazione di macchinari ed apparecchiature nca          ,1,0,1,0,2,2024
TAA,  ,C 29,"Fabbricazione di autoveicoli, rimorchi e semirimorchi       ",0,0,0,0,0,2024
TAA,  ,C 30,Fabbricazione di altri mezzi di trasporto                   ,0,0,0,0,0,2024
TAA,  ,C 31,Fabbricazione di mobili                                     ,0,0,0,0,0,2024
TAA,  ,C 32,Altre industrie manifatturiere                              ,0,0,2,0,2,2024
TAA,  ,C 33,"Riparazione, manutenzione ed installazione di macchine ed...",0,0,0,0,0,2024
TAA,  ,D   ,"Fornitura di energia elettrica, gas, vapore e aria condiz...",0,0,0,0,0,2024
TAA,  ,D 35,"Fornitura di energia elettrica, gas, vapore e aria condiz...",0,0,0,0,0,2024
TAA,  ,E   ,"Fornitura di acqua; reti fognarie, attività di gestione d...",1,0,0,0,1,2024
TAA,  ,E 36,"Raccolta, trattamento e fornitura di acqua                  ",0,0,0,0,0,2024
TAA,  ,E 37,Gestione delle reti fognarie                                ,0,0,0,0,0,2024
TAA,  ,E 38,"Attività di raccolta, trattamento e smaltimento dei rifiu...",0,0,0,0,0,2024
TAA,  ,E 39,Attività di risanamento e altri servizi di gestione dei r...,1,0,0,0,1,2024
TAA,  ,F   ,Costruzioni                                                 ,19,0,69,5,93,2024
TAA,  ,F 41,Costruzione di edifici                                      ,12,0,2,4,18,2024
TAA,  ,F 42,Ingegneria civile                                           ,0,0,1,0,1,2024
TAA,  ,F 43,Lavori di costruzione specializzati                         ,7,0,66,1,74,2024
TAA,  ,G   ,Commercio all'ingrosso e al dettaglio; riparazione di aut...,22,0,54,0,76,2024
TAA,  ,G 45,Commercio all'ingrosso e al dettaglio e riparazione di au...,3,0,4,0,7,2024
TAA,  ,G 46,Commercio all'ingrosso (escluso quello di autoveicoli e d...,9,0,17,0,26,2024
TAA,  ,G 47,Commercio al dettaglio (escluso quello di autoveicoli e d...,10,0,33,0,43,2024
TAA,  ,H   ,Trasporto e magazzinaggio                                   ,3,0,6,0,9,2024
TAA,  ,H 49,Trasporto terrestre e mediante condotte                     ,3,0,5,0,8,2024
TAA,  ,H 50,Trasporto marittimo e per vie d'acqua                       ,0,0,0,0,0,2024
TAA,  ,H 51,Trasporto aereo                                             ,0,0,0,0,0,2024
TAA,  ,H 52,Magazzinaggio e attività di supporto ai trasporti           ,0,0,1,0,1,2024
TAA,  ,H 53,Servizi postali e attività di corriere                      ,0,0,0,0,0,2024
TAA,  ,I   ,Attività dei servizi alloggio e ristorazione                ,8,0,19,0,27,2024
TAA,  ,I 55,Alloggio                                                    ,4,0,1,0,5,2024
TAA,  ,I 56,Attività dei servizi di ristorazione                        ,4,0,18,0,22,2024
TAA,  ,J   ,Servizi di informazione e comunicazione                     ,5,0,2,0,7,2024
TAA,  ,J 58,Attività editoriali                                         ,0,0,0,0,0,2024
TAA,  ,J 59,"Attività di produzione cinematografica, di video e di pro...",0,0,2,0,2,2024
TAA,  ,J 60,Attività di programmazione e trasmissione                   ,0,0,0,0,0,2024
TAA,  ,J 61,Telecomunicazioni                                           ,0,0,0,0,0,2024
TAA,  ,J 62,"Produzione di software, consulenza informatica e attività...",3,0,0,0,3,2024
TAA,  ,J 63,Attività dei servizi d'informazione e altri servizi infor...,2,0,0,0,2,2024
TAA,  ,K   ,Attività finanziarie e assicurative                         ,1,0,3,0,4,2024
TAA,  ,K 64,Attività di servizi finanziari (escluse le assicurazioni ...,1,0,0,0,1,2024
TAA,  ,K 65,"Assicurazioni, riassicurazioni e fondi pensione (escluse ...",0,0,0,0,0,2024
TAA,  ,K 66,Attività ausiliarie dei servizi finanziari e delle attivi...,0,0,3,0,3,2024
TAA,  ,L   ,Attivita' immobiliari                                       ,6,0,2,0,8,2024
TAA,  ,L 68,Attivita' immobiliari                                       ,6,0,2,0,8,2024
TAA,  ,M   ,"Attività professionali, scientifiche e tecniche             ",5,0,2,2,9,2024
TAA,  ,M 69,Attività legali e contabilità                               ,1,0,0,0,1,2024
TAA,  ,M 70,Attività di direzione aziendale e di consulenza gestional...,1,0,0,0,1,2024
TAA,  ,M 71,Attività degli studi di architettura e d'ingegneria; coll...,1,0,0,2,3,2024
TAA,  ,M 72,Ricerca scientifica e sviluppo                              ,0,0,0,0,0,2024
TAA,  ,M 73,Pubblicità e ricerche di mercato                            ,1,0,2,0,3,2024
TAA,  ,M 74,"Altre attività professionali, scientifiche e tecniche       ",1,0,0,0,1,2024
TAA,  ,M 75,Servizi veterinari                                          ,0,0,0,0,0,2024
TAA,  ,N   ,"Noleggio, agenzie di viaggio, servizi di supporto alle im...",3,0,18,3,24,2024
TAA,  ,N 77,Attività di noleggio e leasing operativo                    ,0,0,1,0,1,2024
TAA,  ,N 78,"Attività di ricerca, selezione, fornitura di personale      ",0,0,0,0,0,2024
TAA,  ,N 79,"Attività dei servizi delle agenzie di viaggio, dei tour o...",0,0,1,0,1,2024
TAA,  ,N 80,Servizi di vigilanza e investigazione                       ,0,0,0,0,0,2024
TAA,  ,N 81,Attività di servizi per edifici e paesaggio                 ,2,0,14,2,18,2024
TAA,  ,N 82,Attività di supporto per le funzioni d'ufficio e altri se...,1,0,2,1,4,2024
TAA,  ,O   ,Amministrazione pubblica e difesa; assicurazione sociale ...,0,0,0,0,0,2024
TAA,  ,O 84,Amministrazione pubblica e difesa; assicurazione sociale ...,0,0,0,0,0,2024
TAA,  ,P   ,Istruzione                                                  ,0,0,0,1,1,2024
TAA,  ,P 85,Istruzione                                                  ,0,0,0,1,1,2024
TAA,  ,Q   ,Sanita' e assistenza sociale                                ,2,0,0,0,2,2024
TAA,  ,Q 86,Assistenza sanitaria                                        ,1,0,0,0,1,2024
TAA,  ,Q 87,Servizi di assistenza sociale residenziale                  ,0,0,0,0,0,2024
TAA,  ,Q 88,Assistenza sociale non residenziale                         ,1,0,0,0,1,2024
TAA,  ,R   ,"Attività artistiche, sportive, di intrattenimento e diver...",3,0,0,2,5,2024
TAA,  ,R 90,"Attività creative, artistiche e di intrattenimento          ",0,0,0,1,1,2024
TAA,  ,R 91,"Attività di biblioteche, archivi, musei ed altre attività...",0,0,0,0,0,2024
TAA,  ,R 92,"Attività riguardanti le lotterie, le scommesse, le case d...",1,0,0,0,1,2024
TAA,  ,R 93,"Attività sportive, di intrattenimento e di divertimento     ",2,0,0,1,3,2024
TAA,  ,S   ,Altre attività di servizi                                   ,2,0,6,3,11,2024
TAA,  ,S 94,Attività di organizzazioni associative                      ,0,0,0,0,0,2024
TAA,  ,S 95,Riparazione di computer e di beni per uso personale e per...,0,0,3,0,3,2024
TAA,  ,S 96,Altre attività di servizi per la persona                    ,2,0,3,3,8,2024
TAA,  ,T   ,Attività di famiglie e convivenze come datori di lavoro p...,0,0,0,0,0,2024
TAA,  ,T 97,Attività di famiglie e convivenze come datori di lavoro p...,0,0,0,0,0,2024
TAA,  ,T 98,Produzione di beni e servizi indifferenziati per uso prop...,0,0,0,0,0,2024
TAA,  ,U   ,Organizzazioni ed organismi extraterritoriali               ,0,0,0,0,0,2024
TAA,  ,U 99,Organizzazioni ed organismi extraterritoriali               ,0,0,0,0,0,2024
TAA,  ,XX  ,Imprese non classificate                                    ,12,0,8,0,20,2024
TAA,  ,TOT ,TOTALE                                                      ,98,0,224,16,338,2024
TAA,BZ,A   ,"Agricoltura, silvicoltura pesca                             ",0,0,24,0,24,2024
TAA,BZ,A 01,"Coltivazioni agricole e produzione di prodotti animali, c...",0,0,22,0,22,2024
TAA,BZ,A 02,Silvicoltura ed utilizzo di aree forestali                  ,0,0,2,0,2,2024
TAA,BZ,A 03,Pesca e acquacoltura                                        ,0,0,0,0,0,2024
TAA,BZ,B   ,Estrazione di minerali da cave e miniere                    ,0,0,0,0,0,2024
TAA,BZ,B 05,Estrazione di carbone (esclusa torba)                       ,0,0,0,0,0,2024
TAA,BZ,B 06,Estraz.di petrolio greggio e di gas naturale                ,0,0,0,0,0,2024
TAA,BZ,B 07,Estrazione di minerali metalliferi                          ,0,0,0,0,0,2024
TAA,BZ,B 08,Altre attività di estrazione di minerali da cave e miniere  ,0,0,0,0,0,2024
TAA,BZ,B 09,Attività dei servizi di supporto all'estrazione             ,0,0,0,0,0,2024
TAA,BZ,C   ,Attività manifatturiere                                     ,0,0,11,0,11,2024
TAA,BZ,C 10,Industrie alimentari                                        ,0,0,2,0,2,2024
TAA,BZ,C 11,Industria delle bevande                                     ,0,0,0,0,0,2024
TAA,BZ,C 12,Industria del tabacco                                       ,0,0,0,0,0,2024
TAA,BZ,C 13,Industrie tessili                                           ,0,0,0,0,0,2024
TAA,BZ,C 14,Confezione di articoli di abbigliamento; confezione di ar...,0,0,0,0,0,2024
TAA,BZ,C 15,Fabbricazione di articoli in pelle e simili                 ,0,0,0,0,0,2024
TAA,BZ,C 16,Industria del legno e dei prodotti in legno e sughero (es...,0,0,2,0,2,2024
TAA,BZ,C 17,Fabbricazione di carta e di prodotti di carta               ,0,0,0,0,0,2024
TAA,BZ,C 18,Stampa e riproduzione di supporti registrati                ,0,0,0,0,0,2024
TAA,BZ,C 19,Fabbricazione di coke e prodotti derivanti dalla raffinaz...,0,0,0,0,0,2024
TAA,BZ,C 20,Fabbricazione di prodotti chimici                           ,0,0,0,0,0,2024
TAA,BZ,C 21,Fabbricazione di prodotti farmaceutici di base e di prepa...,0,0,0,0,0,2024
TAA,BZ,C 22,Fabbricazione di articoli in gomma e materie plastiche      ,0,0,0,0,0,2024
TAA,BZ,C 23,Fabbricazione di altri prodotti della lavorazione di miner..,0,0,1,0,1,2024
TAA,BZ,C 24,Metallurgia                                                 ,0,0,0,0,0,2024
TAA,BZ,C 25,Fabbricazione di prodotti in metallo (esclusi macchinari ...,0,0,3,0,3,2024
TAA,BZ,C 26,Fabbricazione di computer e prodotti di elettronica e ott...,0,0,0,0,0,2024
TAA,BZ,C 27,Fabbricazione di apparecchiature elettriche ed apparecchi...,0,0,0,0,0,2024
TAA,BZ,C 28,Fabbricazione di macchinari ed apparecchiature nca          ,0,0,1,0,1,2024
TAA,BZ,C 29,"Fabbricazione di autoveicoli, rimorchi e semirimorchi       ",0,0,0,0,0,2024
TAA,BZ,C 30,Fabbricazione di altri mezzi di trasporto                   ,0,0,0,0,0,2024
TAA,BZ,C 31,Fabbricazione di mobili                                     ,0,0,0,0,0,2024
TAA,BZ,C 32,Altre industrie manifatturiere                              ,0,0,2,0,2,2024
TAA,BZ,C 33,"Riparazione, manutenzione ed installazione di macchine ed...",0,0,0,0,0,2024
TAA,BZ,D   ,"Fornitura di energia elettrica, gas, vapore e aria condiz...",0,0,0,0,0,2024
TAA,BZ,D 35,"Fornitura di energia elettrica, gas, vapore e aria condiz...",0,0,0,0,0,2024
TAA,BZ,E   ,"Fornitura di acqua; reti fognarie, attività di gestione d...",0,0,0,0,0,2024
TAA,BZ,E 36,"Raccolta, trattamento e fornitura di acqua                  ",0,0,0,0,0,2024
TAA,BZ,E 37,Gestione delle reti fognarie                                ,0,0,0,0,0,2024
TAA,BZ,E 38,"Attività di raccolta, trattamento e smaltimento dei rifiu...",0,0,0,0,0,2024
TAA,BZ,E 39,Attività di risanamento e altri servizi di gestione dei r...,0,0,0,0,0,2024
TAA,BZ,F   ,Costruzioni                                                 ,0,0,69,3,72,2024
TAA,BZ,F 41,Costruzione di edifici                                      ,0,0,2,2,4,2024
TAA,BZ,F 42,Ingegneria civile                                           ,0,0,1,0,1,2024
TAA,BZ,F 43,Lavori di costruzione specializzati                         ,0,0,66,1,67,2024
TAA,BZ,G   ,Commercio all'ingrosso e al dettaglio; riparazione di aut...,0,0,54,0,54,2024
TAA,BZ,G 45,Commercio all'ingrosso e al dettaglio e riparazione di au...,0,0,4,0,4,2024
TAA,BZ,G 46,Commercio all'ingrosso (escluso quello di autoveicoli e d...,0,0,17,0,17,2024
TAA,BZ,G 47,Commercio al dettaglio (escluso quello di autoveicoli e d...,0,0,33,0,33,2024
TAA,BZ,H   ,Trasporto e magazzinaggio                                   ,0,0,6,0,6,2024
TAA,BZ,H 49,Trasporto terrestre e mediante condotte                     ,0,0,5,0,5,2024
TAA,BZ,H 50,Trasporto marittimo e per vie d'acqua                       ,0,0,0,0,0,2024
TAA,BZ,H 51,Trasporto aereo                                             ,0,0,0,0,0,2024
TAA,BZ,H 52,Magazzinaggio e attività di supporto ai trasporti           ,0,0,1,0,1,2024
TAA,BZ,H 53,Servizi postali e attività di corriere                      ,0,0,0,0,0,2024
TAA,BZ,I   ,Attività dei servizi alloggio e ristorazione                ,0,0,19,0,19,2024
TAA,BZ,I 55,Alloggio                                                    ,0,0,1,0,1,2024
TAA,BZ,I 56,Attività dei servizi di ristorazione                        ,0,0,18,0,18,2024
TAA,BZ,J   ,Servizi di informazione e comunicazione                     ,0,0,2,0,2,2024
TAA,BZ,J 58,Attività editoriali                                         ,0,0,0,0,0,2024
TAA,BZ,J 59,"Attività di produzione cinematografica, di video e di pro...",0,0,2,0,2,2024
TAA,BZ,J 60,Attività di programmazione e trasmissione                   ,0,0,0,0,0,2024
TAA,BZ,J 61,Telecomunicazioni                                           ,0,0,0,0,0,2024
TAA,BZ,J 62,"Produzione di software, consulenza informatica e attività...",0,0,0,0,0,2024
TAA,BZ,J 63,Attività dei servizi d'informazione e altri servizi infor...,0,0,0,0,0,2024
TAA,BZ,K   ,Attività finanziarie e assicurative                         ,0,0,3,0,3,2024
TAA,BZ,K 64,Attività di servizi finanziari (escluse le assicurazioni ...,0,0,0,0,0,2024
TAA,BZ,K 65,"Assicurazioni, riassicurazioni e fondi pensione (escluse ...",0,0,0,0,0,2024
TAA,BZ,K 66,Attività ausiliarie dei servizi finanziari e delle attivi...,0,0,3,0,3,2024
TAA,BZ,L   ,Attivita' immobiliari                                       ,0,0,2,0,2,2024
TAA,BZ,L 68,Attivita' immobiliari                                       ,0,0,2,0,2,2024
TAA,BZ,M   ,"Attività professionali, scientifiche e tecniche             ",0,0,2,2,4,2024
TAA,BZ,M 69,Attività legali e contabilità                               ,0,0,0,0,0,2024
TAA,BZ,M 70,Attività di direzione aziendale e di consulenza gestional...,0,0,0,0,0,2024
TAA,BZ,M 71,Attività degli studi di architettura e d'ingegneria; coll...,0,0,0,2,2,2024
TAA,BZ,M 72,Ricerca scientifica e sviluppo                              ,0,0,0,0,0,2024
TAA,BZ,M 73,Pubblicità e ricerche di mercato                            ,0,0,2,0,2,2024
TAA,BZ,M 74,"Altre attività professionali, scientifiche e tecniche       ",0,0,0,0,0,2024
TAA,BZ,M 75,Servizi veterinari                                          ,0,0,0,0,0,2024
TAA,BZ,N   ,"Noleggio, agenzie di viaggio, servizi di supporto alle im...",0,0,17,3,20,2024
TAA,BZ,N 77,Attività di noleggio e leasing operativo                    ,0,0,1,0,1,2024
TAA,BZ,N 78,"Attività di ricerca, selezione, fornitura di personale      ",0,0,0,0,0,2024
TAA,BZ,N 79,"Attività dei servizi delle agenzie di viaggio, dei tour o...",0,0,0,0,0,2024
TAA,BZ,N 80,Servizi di vigilanza e investigazione                       ,0,0,0,0,0,2024
TAA,BZ,N 81,Attività di servizi per edifici e paesaggio                 ,0,0,14,2,16,2024
TAA,BZ,N 82,Attività di supporto per le funzioni d'ufficio e altri se...,0,0,2,1,3,2024
TAA,BZ,O   ,Amministrazione pubblica e difesa; assicurazione sociale ...,0,0,0,0,0,2024
TAA,BZ,O 84,Amministrazione pubblica e difesa; assicurazione sociale ...,0,0,0,0,0,2024
TAA,BZ,P   ,Istruzione                                                  ,0,0,0,1,1,2024
TAA,BZ,P 85,Istruzione                                                  ,0,0,0,1,1,2024
TAA,BZ,Q   ,Sanita' e assistenza sociale                                ,0,0,0,0,0,2024
TAA,BZ,Q 86,Assistenza sanitaria                                        ,0,0,0,0,0,2024
TAA,BZ,Q 87,Servizi di assistenza sociale residenziale                  ,0,0,0,0,0,2024
TAA,BZ,Q 88,Assistenza sociale non residenziale                         ,0,0,0,0,0,2024
TAA,BZ,R   ,"Attività artistiche, sportive, di intrattenimento e diver...",0,0,0,2,2,2024
TAA,BZ,R 90,"Attività creative, artistiche e di intrattenimento          ",0,0,0,1,1,2024
TAA,BZ,R 91,"Attività di biblioteche, archivi, musei ed altre attività...",0,0,0,0,0,2024
TAA,BZ,R 92,"Attività riguardanti le lotterie, le scommesse, le case d...",0,0,0,0,0,2024
TAA,BZ,R 93,"Attività sportive, di intrattenimento e di divertimento     ",0,0,0,1,1,2024
TAA,BZ,S   ,Altre attività di servizi                                   ,0,0,6,3,9,2024
TAA,BZ,S 94,Attività di organizzazioni associative                      ,0,0,0,0,0,2024
TAA,BZ,S 95,Riparazione di computer e di beni per uso personale e per...,0,0,3,0,3,2024
TAA,BZ,S 96,Altre attività di servizi per la persona                    ,0,0,3,3,6,2024
TAA,BZ,T   ,Attività di famiglie e convivenze come datori di lavoro p...,0,0,0,0,0,2024
TAA,BZ,T 97,Attività di famiglie e convivenze come datori di lavoro p...,0,0,0,0,0,2024
TAA,BZ,T 98,Produzione di beni e servizi indifferenziati per uso prop...,0,0,0,0,0,2024
TAA,BZ,U   ,Organizzazioni ed organismi extraterritoriali               ,0,0,0,0,0,2024
TAA,BZ,U 99,Organizzazioni ed organismi extraterritoriali               ,0,0,0,0,0,2024
TAA,BZ,XX  ,Imprese non classificate                                    ,0,0,8,0,8,2024
TAA,BZ,TOT ,TOTALE                                                      ,0,0,223,14,237,2024
TAA,TN,A   ,"Agricoltura, silvicoltura pesca                             ",0,0,0,0,0,2024
TAA,TN,A 01,"Coltivazioni agricole e produzione di prodotti animali, c...",0,0,0,0,0,2024
TAA,TN,A 02,Silvicoltura ed utilizzo di aree forestali                  ,0,0,0,0,0,2024
TAA,TN,A 03,Pesca e acquacoltura                                        ,0,0,0,0,0,2024
TAA,TN,B   ,Estrazione di minerali da cave e miniere                    ,0,0,0,0,0,2024
TAA,TN,B 05,Estrazione di carbone (esclusa torba)                       ,0,0,0,0,0,2024
TAA,TN,B 06,Estraz.di petrolio greggio e di gas naturale                ,0,0,0,0,0,2024
TAA,TN,B 07,Estrazione di minerali metalliferi                          ,0,0,0,0,0,2024
TAA,TN,B 08,Altre attività di estrazione di minerali da cave e miniere  ,0,0,0,0,0,2024
TAA,TN,B 09,Attività dei servizi di supporto all'estrazione             ,0,0,0,0,0,2024
TAA,TN,C   ,Attività manifatturiere                                     ,6,0,0,0,6,2024
TAA,TN,C 10,Industrie alimentari                                        ,0,0,0,0,0,2024
TAA,TN,C 11,Industria delle bevande                                     ,0,0,0,0,0,2024
TAA,TN,C 12,Industria del tabacco                                       ,0,0,0,0,0,2024
TAA,TN,C 13,Industrie tessili                                           ,0,0,0,0,0,2024
TAA,TN,C 14,Confezione di articoli di abbigliamento; confezione di ar...,1,0,0,0,1,2024
TAA,TN,C 15,Fabbricazione di articoli in pelle e simili                 ,0,0,0,0,0,2024
TAA,TN,C 16,Industria del legno e dei prodotti in legno e sughero (es...,0,0,0,0,0,2024
TAA,TN,C 17,Fabbricazione di carta e di prodotti di carta               ,0,0,0,0,0,2024
TAA,TN,C 18,Stampa e riproduzione di supporti registrati                ,0,0,0,0,0,2024
TAA,TN,C 19,Fabbricazione di coke e prodotti derivanti dalla raffinaz...,0,0,0,0,0,2024
TAA,TN,C 20,Fabbricazione di prodotti chimici                           ,0,0,0,0,0,2024
TAA,TN,C 21,Fabbricazione di prodotti farmaceutici di base e di prepa...,0,0,0,0,0,2024
TAA,TN,C 22,Fabbricazione di articoli in gomma e materie plastiche      ,1,0,0,0,1,2024
TAA,TN,C 23,Fabbricazione di altri prodotti della lavorazione di miner..,2,0,0,0,2,2024
TAA,TN,C 24,Metallurgia                                                 ,0,0,0,0,0,2024
TAA,TN,C 25,Fabbricazione di prodotti in metallo (esclusi macchinari ...,0,0,0,0,0,2024
TAA,TN,C 26,Fabbricazione di computer e prodotti di elettronica e ott...,1,0,0,0,1,2024
TAA,TN,C 27,Fabbricazione di apparecchiature elettriche ed apparecchi...,0,0,0,0,0,2024
TAA,TN,C 28,Fabbricazione di macchinari ed apparecchiature nca          ,1,0,0,0,1,2024
TAA,TN,C 29,"Fabbricazione di autoveicoli, rimorchi e semirimorchi       ",0,0,0,0,0,2024
TAA,TN,C 30,Fabbricazione di altri mezzi di trasporto                   ,0,0,0,0,0,2024
TAA,TN,C 31,Fabbricazione di mobili                                     ,0,0,0,0,0,2024
TAA,TN,C 32,Altre industrie manifatturiere                              ,0,0,0,0,0,2024
TAA,TN,C 33,"Riparazione, manutenzione ed installazione di macchine ed...",0,0,0,0,0,2024
TAA,TN,D   ,"Fornitura di energia elettrica, gas, vapore e aria condiz...",0,0,0,0,0,2024
TAA,TN,D 35,"Fornitura di energia elettrica, gas, vapore e aria condiz...",0,0,0,0,0,2024
TAA,TN,E   ,"Fornitura di acqua; reti fognarie, attività di gestione d...",1,0,0,0,1,2024
TAA,TN,E 36,"Raccolta, trattamento e fornitura di acqua                  ",0,0,0,0,0,2024
TAA,TN,E 37,Gestione delle reti fognarie                                ,0,0,0,0,0,2024
TAA,TN,E 38,"Attività di raccolta, trattamento e smaltimento dei rifiu...",0,0,0,0,0,2024
TAA,TN,E 39,Attività di risanamento e altri servizi di gestione dei r...,1,0,0,0,1,2024
TAA,TN,F   ,Costruzioni                                                 ,19,0,0,2,21,2024
TAA,TN,F 41,Costruzione di edifici                                      ,12,0,0,2,14,2024
TAA,TN,F 42,Ingegneria civile                                           ,0,0,0,0,0,2024
TAA,TN,F 43,Lavori di costruzione specializzati                         ,7,0,0,0,7,2024
TAA,TN,G   ,Commercio all'ingrosso e al dettaglio; riparazione di aut...,22,0,0,0,22,2024
TAA,TN,G 45,Commercio all'ingrosso e al dettaglio e riparazione di au...,3,0,0,0,3,2024
TAA,TN,G 46,Commercio all'ingrosso (escluso quello di autoveicoli e d...,9,0,0,0,9,2024
TAA,TN,G 47,Commercio al dettaglio (escluso quello di autoveicoli e d...,10,0,0,0,10,2024
TAA,TN,H   ,Trasporto e magazzinaggio                                   ,3,0,0,0,3,2024
TAA,TN,H 49,Trasporto terrestre e mediante condotte                     ,3,0,0,0,3,2024
TAA,TN,H 50,Trasporto marittimo e per vie d'acqua                       ,0,0,0,0,0,2024
TAA,TN,H 51,Trasporto aereo                                             ,0,0,0,0,0,2024
TAA,TN,H 52,Magazzinaggio e attività di supporto ai trasporti           ,0,0,0,0,0,2024
TAA,TN,H 53,Servizi postali e attività di corriere                      ,0,0,0,0,0,2024
TAA,TN,I   ,Attività dei servizi alloggio e ristorazione                ,8,0,0,0,8,2024
TAA,TN,I 55,Alloggio                                                    ,4,0,0,0,4,2024
TAA,TN,I 56,Attività dei servizi di ristorazione                        ,4,0,0,0,4,2024
TAA,TN,J   ,Servizi di informazione e comunicazione                     ,5,0,0,0,5,2024
TAA,TN,J 58,Attività editoriali                                         ,0,0,0,0,0,2024
TAA,TN,J 59,"Attività di produzione cinematografica, di video e di pro...",0,0,0,0,0,2024
TAA,TN,J 60,Attività di programmazione e trasmissione                   ,0,0,0,0,0,2024
TAA,TN,J 61,Telecomunicazioni                                           ,0,0,0,0,0,2024
TAA,TN,J 62,"Produzione di software, consulenza informatica e attività...",3,0,0,0,3,2024
TAA,TN,J 63,Attività dei servizi d'informazione e altri servizi infor...,2,0,0,0,2,2024
TAA,TN,K   ,Attività finanziarie e assicurative                         ,1,0,0,0,1,2024
TAA,TN,K 64,Attività di servizi finanziari (escluse le assicurazioni ...,1,0,0,0,1,2024
TAA,TN,K 65,"Assicurazioni, riassicurazioni e fondi pensione (escluse ...",0,0,0,0,0,2024
TAA,TN,K 66,Attività ausiliarie dei servizi finanziari e delle attivi...,0,0,0,0,0,2024
TAA,TN,L   ,Attivita' immobiliari                                       ,6,0,0,0,6,2024
TAA,TN,L 68,Attivita' immobiliari                                       ,6,0,0,0,6,2024
TAA,TN,M   ,"Attività professionali, scientifiche e tecniche             ",5,0,0,0,5,2024
TAA,TN,M 69,Attività legali e contabilità                               ,1,0,0,0,1,2024
TAA,TN,M 70,Attività di direzione aziendale e di consulenza gestional...,1,0,0,0,1,2024
TAA,TN,M 71,Attività degli studi di architettura e d'ingegneria; coll...,1,0,0,0,1,2024
TAA,TN,M 72,Ricerca scientifica e sviluppo                              ,0,0,0,0,0,2024
TAA,TN,M 73,Pubblicità e ricerche di mercato                            ,1,0,0,0,1,2024
TAA,TN,M 74,"Altre attività professionali, scientifiche e tecniche       ",1,0,0,0,1,2024
TAA,TN,M 75,Servizi veterinari                                          ,0,0,0,0,0,2024
TAA,TN,N   ,"Noleggio, agenzie di viaggio, servizi di supporto alle im...",3,0,1,0,4,2024
TAA,TN,N 77,Attività di noleggio e leasing operativo                    ,0,0,0,0,0,2024
TAA,TN,N 78,"Attività di ricerca, selezione, fornitura di personale      ",0,0,0,0,0,2024
TAA,TN,N 79,"Attività dei servizi delle agenzie di viaggio, dei tour o...",0,0,1,0,1,2024
TAA,TN,N 80,Servizi di vigilanza e investigazione                       ,0,0,0,0,0,2024
TAA,TN,N 81,Attività di servizi per edifici e paesaggio                 ,2,0,0,0,2,2024
TAA,TN,N 82,Attività di supporto per le funzioni d'ufficio e altri se...,1,0,0,0,1,2024
TAA,TN,O   ,Amministrazione pubblica e difesa; assicurazione sociale ...,0,0,0,0,0,2024
TAA,TN,O 84,Amministrazione pubblica e difesa; assicurazione sociale ...,0,0,0,0,0,2024
TAA,TN,P   ,Istruzione                                                  ,0,0,0,0,0,2024
TAA,TN,P 85,Istruzione                                                  ,0,0,0,0,0,2024
TAA,TN,Q   ,Sanita' e assistenza sociale                                ,2,0,0,0,2,2024
TAA,TN,Q 86,Assistenza sanitaria                                        ,1,0,0,0,1,2024
TAA,TN,Q 87,Servizi di assistenza sociale residenziale                  ,0,0,0,0,0,2024
TAA,TN,Q 88,Assistenza sociale non residenziale                         ,1,0,0,0,1,2024
TAA,TN,R   ,"Attività artistiche, sportive, di intrattenimento e diver...",3,0,0,0,3,2024
TAA,TN,R 90,"Attività creative, artistiche e di intrattenimento          ",0,0,0,0,0,2024
TAA,TN,R 91,"Attività di biblioteche, archivi, musei ed altre attività...",0,0,0,0,0,2024
TAA,TN,R 92,"Attività riguardanti le lotterie, le scommesse, le case d...",1,0,0,0,1,2024
TAA,TN,R 93,"Attività sportive, di intrattenimento e di divertimento     ",2,0,0,0,2,2024
TAA,TN,S   ,Altre attività di servizi                                   ,2,0,0,0,2,2024
TAA,TN,S 94,Attività di organizzazioni associative                      ,0,0,0,0,0,2024
TAA,TN,S 95,Riparazione di computer e di beni per uso personale e per...,0,0,0,0,0,2024
TAA,TN,S 96,Altre attività di servizi per la persona                    ,2,0,0,0,2,2024
TAA,TN,T   ,Attività di famiglie e convivenze come datori di lavoro p...,0,0,0,0,0,2024
TAA,TN,T 97,Attività di famiglie e convivenze come datori di lavoro p...,0,0,0,0,0,2024
TAA,TN,T 98,Produzione di beni e servizi indifferenziati per uso prop...,0,0,0,0,0,2024
TAA,TN,U   ,Organizzazioni ed organismi extraterritoriali               ,0,0,0,0,0,2024
TAA,TN,U 99,Organizzazioni ed organismi extraterritoriali               ,0,0,0,0,0,2024
TAA,TN,XX  ,Imprese non classificate                                    ,12,0,0,0,12,2024
TAA,TN,TOT ,TOTALE                                                      ,98,0,1,2,101,2024
VEN,  ,A   ,"Agricoltura, silvicoltura pesca                             ",15,109,280,70,474,2024
VEN,  ,A 01,"Coltivazioni agricole e produzione di prodotti animali, c...",14,104,255,61,434,2024
VEN,  ,A 02,Silvicoltura ed utilizzo di aree forestali                  ,0,2,20,1,23,2024
VEN,  ,A 03,Pesca e acquacoltura                                        ,1,3,5,8,17,2024
VEN,  ,B   ,Estrazione di minerali da cave e miniere                    ,6,0,0,0,6,2024
VEN,  ,B 05,Estrazione di carbone (esclusa torba)                       ,0,0,0,0,0,2024
VEN,  ,B 06,Estraz.di petrolio greggio e di gas naturale                ,1,0,0,0,1,2024
VEN,  ,B 07,Estrazione di minerali metalliferi                          ,1,0,0,0,1,2024
VEN,  ,B 08,Altre attività di estrazione di minerali da cave e miniere  ,4,0,0,0,4,2024
VEN,  ,B 09,Attività dei servizi di supporto all'estrazione             ,0,0,0,0,0,2024
VEN,  ,C   ,Attività manifatturiere                                     ,437,233,270,96,1036,2024
VEN,  ,C 10,Industrie alimentari                                        ,15,20,9,11,55,2024
VEN,  ,C 11,Industria delle bevande                                     ,1,2,0,0,3,2024
VEN,  ,C 12,Industria del tabacco                                       ,0,0,0,0,0,2024
VEN,  ,C 13,Industrie tessili                                           ,13,4,6,2,25,2024
VEN,  ,C 14,Confezione di articoli di abbigliamento; confezione di ar...,70,21,69,6,166,2024
VEN,  ,C 15,Fabbricazione di articoli in pelle e simili                 ,38,5,12,1,56,2024
VEN,  ,C 16,Industria del legno e dei prodotti in legno e sughero (es...,17,16,18,10,61,2024
VEN,  ,C 17,Fabbricazione di carta e di prodotti di carta               ,8,1,0,1,10,2024
VEN,  ,C 18,Stampa e riproduzione di supporti registrati                ,13,11,3,4,31,2024
VEN,  ,C 19,Fabbricazione di coke e prodotti derivanti dalla raffinaz...,0,0,0,0,0,2024
VEN,  ,C 20,Fabbricazione di prodotti chimici                           ,9,3,1,0,13,2024
VEN,  ,C 21,Fabbricazione di prodotti farmaceutici di base e di prepa...,0,0,0,0,0,2024
VEN,  ,C 22,Fabbricazione di articoli in gomma e materie plastiche      ,12,4,5,2,23,2024
VEN,  ,C 23,Fabbricazione di altri prodotti della lavorazione di miner..,20,9,7,2,38,2024
VEN,  ,C 24,Metallurgia                                                 ,7,0,2,0,9,2024
VEN,  ,C 25,Fabbricazione di prodotti in metallo (esclusi macchinari ...,58,49,62,36,205,2024
VEN,  ,C 26,Fabbricazione di computer e prodotti di elettronica e ott...,15,7,4,3,29,2024
VEN,  ,C 27,Fabbricazione di apparecchiature elettriche ed apparecchi...,19,5,6,4,34,2024
VEN,  ,C 28,Fabbricazione di macchinari ed apparecchiature nca          ,49,15,11,2,77,2024
VEN,  ,C 29,"Fabbricazione di autoveicoli, rimorchi e semirimorchi       ",3,4,0,0,7,2024
VEN,  ,C 30,Fabbricazione di altri mezzi di trasporto                   ,4,1,1,0,6,2024
VEN,  ,C 31,Fabbricazione di mobili                                     ,40,27,6,3,76,2024
VEN,  ,C 32,Altre industrie manifatturiere                              ,21,25,26,1,73,2024
VEN,  ,C 33,"Riparazione, manutenzione ed installazione di macchine ed...",5,4,22,8,39,2024
VEN,  ,D   ,"Fornitura di energia elettrica, gas, vapore e aria condiz...",2,0,1,0,3,2024
VEN,  ,D 35,"Fornitura di energia elettrica, gas, vapore e aria condiz...",2,0,1,0,3,2024
VEN,  ,E   ,"Fornitura di acqua; reti fognarie, attività di gestione d...",5,1,2,2,10,2024
VEN,  ,E 36,"Raccolta, trattamento e fornitura di acqua                  ",0,0,0,0,0,2024
VEN,  ,E 37,Gestione delle reti fognarie                                ,0,0,0,0,0,2024
VEN,  ,E 38,"Attività di raccolta, trattamento e smaltimento dei rifiu...",5,1,2,2,10,2024
VEN,  ,E 39,Attività di risanamento e altri servizi di gestione dei r...,0,0,0,0,0,2024
VEN,  ,F   ,Costruzioni                                                 ,224,269,799,155,1447,2024
VEN,  ,F 41,Costruzione di edifici                                      ,142,118,114,74,448,2024
VEN,  ,F 42,Ingegneria civile                                           ,5,1,2,3,11,2024
VEN,  ,F 43,Lavori di costruzione specializzati                         ,77,150,683,78,988,2024
VEN,  ,G   ,Commercio all'ingrosso e al dettaglio; riparazione di aut...,497,481,888,32,1898,2024
VEN,  ,G 45,Commercio all'ingrosso e al dettaglio e riparazione di au...,39,52,123,6,220,2024
VEN,  ,G 46,Commercio all'ingrosso (escluso quello di autoveicoli e d...,320,125,241,11,697,2024
VEN,  ,G 47,Commercio al dettaglio (escluso quello di autoveicoli e d...,138,304,524,15,981,2024
VEN,  ,H   ,Trasporto e magazzinaggio                                   ,48,44,102,275,469,2024
VEN,  ,H 49,Trasporto terrestre e mediante condotte                     ,24,37,80,37,178,2024
VEN,  ,H 50,Trasporto marittimo e per vie d'acqua                       ,2,0,6,2,10,2024
VEN,  ,H 51,Trasporto aereo                                             ,3,0,0,0,3,2024
VEN,  ,H 52,Magazzinaggio e attività di supporto ai trasporti           ,18,6,15,236,275,2024
VEN,  ,H 53,Servizi postali e attività di corriere                      ,1,1,1,0,3,2024
VEN,  ,I   ,Attività dei servizi alloggio e ristorazione                ,115,715,180,23,1033,2024
VEN,  ,I 55,Alloggio                                                    ,18,20,6,3,47,2024
VEN,  ,I 56,Attività dei servizi di ristorazione                        ,97,695,174,20,986,2024
VEN,  ,J   ,Servizi di informazione e comunicazione                     ,70,58,31,11,170,2024
VEN,  ,J 58,Attività editoriali                                         ,9,4,1,1,15,2024
VEN,  ,J 59,"Attività di produzione cinematografica, di video e di pro...",4,1,4,0,9,2024
VEN,  ,J 60,Attività di programmazione e trasmissione                   ,3,1,0,1,5,2024
VEN,  ,J 61,Telecomunicazioni                                           ,3,11,16,0,30,2024
VEN,  ,J 62,"Produzione di software, consulenza informatica e attività...",30,18,5,6,59,2024
VEN,  ,J 63,Attività dei servizi d'informazione e altri servizi infor...,21,23,5,3,52,2024
VEN,  ,K   ,Attività finanziarie e assicurative                         ,29,26,45,3,103,2024
VEN,  ,K 64,Attività di servizi finanziari (escluse le assicurazioni ...,18,7,0,3,28,2024
VEN,  ,K 65,"Assicurazioni, riassicurazioni e fondi pensione (escluse ...",0,0,0,0,0,2024
VEN,  ,K 66,Attività ausiliarie dei servizi finanziari e delle attivi...,11,19,45,0,75,2024
VEN,  ,L   ,Attivita' immobiliari                                       ,169,170,13,15,367,2024
VEN,  ,L 68,Attivita' immobiliari                                       ,169,170,13,15,367,2024
VEN,  ,M   ,"Attività professionali, scientifiche e tecniche             ",124,95,70,26,315,2024
VEN,  ,M 69,Attività legali e contabilità                               ,1,4,0,2,7,2024
VEN,  ,M 70,Attività di direzione aziendale e di consulenza gestional...,41,26,14,13,94,2024
VEN,  ,M 71,Attività degli studi di architettura e d'ingegneria; coll...,7,4,2,0,13,2024
VEN,  ,M 72,Ricerca scientifica e sviluppo                              ,3,1,0,3,7,2024
VEN,  ,M 73,Pubblicità e ricerche di mercato                            ,30,19,23,7,79,2024
VEN,  ,M 74,"Altre attività professionali, scientifiche e tecniche       ",42,40,31,1,114,2024
VEN,  ,M 75,Servizi veterinari                                          ,0,1,0,0,1,2024
VEN,  ,N   ,"Noleggio, agenzie di viaggio, servizi di supporto alle im...",62,47,79,96,284,2024
VEN,  ,N 77,Attività di noleggio e leasing operativo                    ,14,6,4,2,26,2024
VEN,  ,N 78,"Attività di ricerca, selezione, fornitura di personale      ",1,2,0,1,4,2024
VEN,  ,N 79,"Attività dei servizi delle agenzie di viaggio, dei tour o...",12,6,1,1,20,2024
VEN,  ,N 80,Servizi di vigilanza e investigazione                       ,3,2,0,2,7,2024
VEN,  ,N 81,Attività di servizi per edifici e paesaggio                 ,9,14,41,58,122,2024
VEN,  ,N 82,Attività di supporto per le funzioni d'ufficio e altri se...,23,17,33,32,105,2024
VEN,  ,O   ,Amministrazione pubblica e difesa; assicurazione sociale ...,0,0,0,0,0,2024
VEN,  ,O 84,Amministrazione pubblica e difesa; assicurazione sociale ...,0,0,0,0,0,2024
VEN,  ,P   ,Istruzione                                                  ,6,6,1,8,21,2024
VEN,  ,P 85,Istruzione                                                  ,6,6,1,8,21,2024
VEN,  ,Q   ,Sanita' e assistenza sociale                                ,7,3,0,27,37,2024
VEN,  ,Q 86,Assistenza sanitaria                                        ,7,3,0,3,13,2024
VEN,  ,Q 87,Servizi di assistenza sociale residenziale                  ,0,0,0,4,4,2024
VEN,  ,Q 88,Assistenza sociale non residenziale                         ,0,0,0,20,20,2024
VEN,  ,R   ,"Attività artistiche, sportive, di intrattenimento e diver...",64,41,26,27,158,2024
VEN,  ,R 90,"Attività creative, artistiche e di intrattenimento          ",14,5,7,12,38,2024
VEN,  ,R 91,"Attività di biblioteche, archivi, musei ed altre attività...",0,0,0,2,2,2024
VEN,  ,R 92,"Attività riguardanti le lotterie, le scommesse, le case d...",4,9,2,0,15,2024
VEN,  ,R 93,"Attività sportive, di intrattenimento e di divertimento     ",46,27,17,13,103,2024
VEN,  ,S   ,Altre attività di servizi                                   ,22,69,51,18,160,2024
VEN,  ,S 94,Attività di organizzazioni associative                      ,0,0,0,0,0,2024
VEN,  ,S 95,Riparazione di computer e di beni per uso personale e per...,3,14,23,1,41,2024
VEN,  ,S 96,Altre attività di servizi per la persona                    ,19,55,28,17,119,2024
VEN,  ,T   ,Attività di famiglie e convivenze come datori di lavoro p...,0,0,0,0,0,2024
VEN,  ,T 97,Attività di famiglie e convivenze come datori di lavoro p...,0,0,0,0,0,2024
VEN,  ,T 98,Produzione di beni e servizi indifferenziati per uso prop...,0,0,0,0,0,2024
VEN,  ,U   ,Organizzazioni ed organismi extraterritoriali               ,0,0,0,0,0,2024
VEN,  ,U 99,Organizzazioni ed organismi extraterritoriali               ,0,0,0,0,0,2024
VEN,  ,XX  ,Imprese non classificate                                    ,357,335,117,161,970,2024
VEN,  ,TOT ,TOTALE                                                      ,2259,2702,2955,1045,8961,2024
VEN,VR,A   ,"Agricoltura, silvicoltura pesca                             ",5,31,36,16,88,2024
VEN,VR,A 01,"Coltivazioni agricole e produzione di prodotti animali, c...",4,31,35,16,86,2024
VEN,VR,A 02,Silvicoltura ed utilizzo di aree forestali                  ,0,0,1,0,1,2024
VEN,VR,A 03,Pesca e acquacoltura                                        ,1,0,0,0,1,2024
VEN,VR,B   ,Estrazione di minerali da cave e miniere                    ,0,0,0,0,0,2024
VEN,VR,B 05,Estrazione di carbone (esclusa torba)                       ,0,0,0,0,0,2024
VEN,VR,B 06,Estraz.di petrolio greggio e di gas naturale                ,0,0,0,0,0,2024
VEN,VR,B 07,Estrazione di minerali metalliferi                          ,0,0,0,0,0,2024
VEN,VR,B 08,Altre attività di estrazione di minerali da cave e miniere  ,0,0,0,0,0,2024
VEN,VR,B 09,Attività dei servizi di supporto all'estrazione             ,0,0,0,0,0,2024
VEN,VR,C   ,Attività manifatturiere                                     ,50,44,45,43,182,2024
VEN,VR,C 10,Industrie alimentari                                        ,1,3,0,2,6,2024
VEN,VR,C 11,Industria delle bevande                                     ,0,0,0,0,0,2024
VEN,VR,C 12,Industria del tabacco                                       ,0,0,0,0,0,2024
VEN,VR,C 13,Industrie tessili                                           ,1,0,0,0,1,2024
VEN,VR,C 14,Confezione di articoli di abbigliamento; confezione di ar...,6,3,11,2,22,2024
VEN,VR,C 15,Fabbricazione di articoli in pelle e simili                 ,8,0,2,1,11,2024
VEN,VR,C 16,Industria del legno e dei prodotti in legno e sughero (es...,3,7,1,4,15,2024
VEN,VR,C 17,Fabbricazione di carta e di prodotti di carta               ,2,0,0,0,2,2024
VEN,VR,C 18,Stampa e riproduzione di supporti registrati                ,2,3,1,2,8,2024
VEN,VR,C 19,Fabbricazione di coke e prodotti derivanti dalla raffinaz...,0,0,0,0,0,2024
VEN,VR,C 20,Fabbricazione di prodotti chimici                           ,3,0,0,0,3,2024
VEN,VR,C 21,Fabbricazione di prodotti farmaceutici di base e di prepa...,0,0,0,0,0,2024
VEN,VR,C 22,Fabbricazione di articoli in gomma e materie plastiche      ,2,0,0,0,2,2024
VEN,VR,C 23,Fabbricazione di altri prodotti della lavorazione di miner..,2,2,1,2,7,2024
VEN,VR,C 24,Metallurgia                                                 ,4,0,0,0,4,2024
VEN,VR,C 25,Fabbricazione di prodotti in metallo (esclusi macchinari ...,7,14,15,21,57,2024
VEN,VR,C 26,Fabbricazione di computer e prodotti di elettronica e ott...,0,2,0,1,3,2024
VEN,VR,C 27,Fabbricazione di apparecchiature elettriche ed apparecchi...,1,1,0,2,4,2024
VEN,VR,C 28,Fabbricazione di macchinari ed apparecchiature nca          ,4,3,1,0,8,2024
VEN,VR,C 29,"Fabbricazione di autoveicoli, rimorchi e semirimorchi       ",1,1,0,0,2,2024
VEN,VR,C 30,Fabbricazione di altri mezzi di trasporto                   ,0,0,0,0,0,2024
VEN,VR,C 31,Fabbricazione di mobili                                     ,3,5,3,1,12,2024
VEN,VR,C 32,Altre industrie manifatturiere                              ,0,0,4,1,5,2024
VEN,VR,C 33,"Riparazione, manutenzione ed installazione di macchine ed...",0,0,6,4,10,2024
VEN,VR,D   ,"Fornitura di energia elettrica, gas, vapore e aria condiz...",0,0,0,0,0,2024
VEN,VR,D 35,"Fornitura di energia elettrica, gas, vapore e aria condiz...",0,0,0,0,0,2024
VEN,VR,E   ,"Fornitura di acqua; reti fognarie, attività di gestione d...",0,0,0,2,2,2024
VEN,VR,E 36,"Raccolta, trattamento e fornitura di acqua                  ",0,0,0,0,0,2024
VEN,VR,E 37,Gestione delle reti fognarie                                ,0,0,0,0,0,2024
VEN,VR,E 38,"Attività di raccolta, trattamento e smaltimento dei rifiu...",0,0,0,2,2,2024
VEN,VR,E 39,Attività di risanamento e altri servizi di gestione dei r...,0,0,0,0,0,2024
VEN,VR,F   ,Costruzioni                                                 ,31,122,202,74,429,2024
VEN,VR,F 41,Costruzione di edifici                                      ,16,69,31,33,149,2024
VEN,VR,F 42,Ingegneria civile                                           ,1,0,1,2,4,2024
VEN,VR,F 43,Lavori di costruzione specializzati                         ,14,53,170,39,276,2024
VEN,VR,G   ,Commercio all'ingrosso e al dettaglio; riparazione di aut...,60,170,179,12,421,2024
VEN,VR,G 45,Commercio all'ingrosso e al dettaglio e riparazione di au...,4,15,24,2,45,2024
VEN,VR,G 46,Commercio all'ingrosso (escluso quello di autoveicoli e d...,43,33,41,5,122,2024
VEN,VR,G 47,Commercio al dettaglio (escluso quello di autoveicoli e d...,13,122,114,5,254,2024
VEN,VR,H   ,Trasporto e magazzinaggio                                   ,6,15,23,157,201,2024
VEN,VR,H 49,Trasporto terrestre e mediante condotte                     ,3,12,18,18,51,2024
VEN,VR,H 50,Trasporto marittimo e per vie d'acqua                       ,0,0,0,0,0,2024
VEN,VR,H 51,Trasporto aereo                                             ,0,0,0,0,0,2024
VEN,VR,H 52,Magazzinaggio e attività di supporto ai trasporti           ,3,3,5,139,150,2024
VEN,VR,H 53,Servizi postali e attività di corriere                      ,0,0,0,0,0,2024
VEN,VR,I   ,Attività dei servizi alloggio e ristorazione                ,8,391,26,8,433,2024
VEN,VR,I 55,Alloggio                                                    ,1,10,2,0,13,2024
VEN,VR,I 56,Attività dei servizi di ristorazione                        ,7,381,24,8,420,2024
VEN,VR,J   ,Servizi di informazione e comunicazione                     ,9,19,6,4,38,2024
VEN,VR,J 58,Attività editoriali                                         ,3,0,0,0,3,2024
VEN,VR,J 59,"Attività di produzione cinematografica, di video e di pro...",1,1,0,0,2,2024
VEN,VR,J 60,Attività di programmazione e trasmissione                   ,0,1,0,0,1,2024
VEN,VR,J 61,Telecomunicazioni                                           ,0,9,4,0,13,2024
VEN,VR,J 62,"Produzione di software, consulenza informatica e attività...",2,4,2,2,10,2024
VEN,VR,J 63,Attività dei servizi d'informazione e altri servizi infor...,3,4,0,2,9,2024
VEN,VR,K   ,Attività finanziarie e assicurative                         ,2,3,8,0,13,2024
VEN,VR,K 64,Attività di servizi finanziari (escluse le assicurazioni ...,2,0,0,0,2,2024
VEN,VR,K 65,"Assicurazioni, riassicurazioni e fondi pensione (escluse ...",0,0,0,0,0,2024
VEN,VR,K 66,Attività ausiliarie dei servizi finanziari e delle attivi...,0,3,8,0,11,2024
VEN,VR,L   ,Attivita' immobiliari                                       ,18,28,1,10,57,2024
VEN,VR,L 68,Attivita' immobiliari                                       ,18,28,1,10,57,2024
VEN,VR,M   ,"Attività professionali, scientifiche e tecniche             ",13,20,16,4,53,2024
VEN,VR,M 69,Attività legali e contabilità                               ,1,1,0,0,2,2024
VEN,VR,M 70,Attività di direzione aziendale e di consulenza gestional...,3,4,2,3,12,2024
VEN,VR,M 71,Attività degli studi di architettura e d'ingegneria; coll...,0,1,0,0,1,2024
VEN,VR,M 72,Ricerca scientifica e sviluppo                              ,0,0,0,0,0,2024
VEN,VR,M 73,Pubblicità e ricerche di mercato                            ,5,5,7,1,18,2024
VEN,VR,M 74,"Altre attività professionali, scientifiche e tecniche       ",4,9,7,0,20,2024
VEN,VR,M 75,Servizi veterinari                                          ,0,0,0,0,0,2024
VEN,VR,N   ,"Noleggio, agenzie di viaggio, servizi di supporto alle im...",8,22,17,47,94,2024
VEN,VR,N 77,Attività di noleggio e leasing operativo                    ,1,4,1,1,7,2024
VEN,VR,N 78,"Attività di ricerca, selezione, fornitura di personale      ",0,1,0,1,2,2024
VEN,VR,N 79,"Attività dei servizi delle agenzie di viaggio, dei tour o...",1,3,0,0,4,2024
VEN,VR,N 80,Servizi di vigilanza e investigazione                       ,0,1,0,1,2,2024
VEN,VR,N 81,Attività di servizi per edifici e paesaggio                 ,4,8,11,28,51,2024
VEN,VR,N 82,Attività di supporto per le funzioni d'ufficio e altri se...,2,5,5,16,28,2024
VEN,VR,O   ,Amministrazione pubblica e difesa; assicurazione sociale ...,0,0,0,0,0,2024
VEN,VR,O 84,Amministrazione pubblica e difesa; assicurazione sociale ...,0,0,0,0,0,2024
VEN,VR,P   ,Istruzione                                                  ,0,2,0,2,4,2024
VEN,VR,P 85,Istruzione                                                  ,0,2,0,2,4,2024
VEN,VR,Q   ,Sanita' e assistenza sociale                                ,0,0,0,6,6,2024
VEN,VR,Q 86,Assistenza sanitaria                                        ,0,0,0,0,0,2024
VEN,VR,Q 87,Servizi di assistenza sociale residenziale                  ,0,0,0,0,0,2024
VEN,VR,Q 88,Assistenza sociale non residenziale                         ,0,0,0,6,6,2024
VEN,VR,R   ,"Attività artistiche, sportive, di intrattenimento e diver...",6,22,8,9,45,2024
VEN,VR,R 90,"Attività creative, artistiche e di intrattenimento          ",1,0,1,3,5,2024
VEN,VR,R 91,"Attività di biblioteche, archivi, musei ed altre attività...",0,0,0,0,0,2024
VEN,VR,R 92,"Attività riguardanti le lotterie, le scommesse, le case d...",1,7,1,0,9,2024
VEN,VR,R 93,"Attività sportive, di intrattenimento e di divertimento     ",4,15,6,6,31,2024
VEN,VR,S   ,Altre attività di servizi                                   ,2,30,9,12,53,2024
VEN,VR,S 94,Attività di organizzazioni associative                      ,0,0,0,0,0,2024
VEN,VR,S 95,Riparazione di computer e di beni per uso personale e per...,0,2,6,1,9,2024
VEN,VR,S 96,Altre attività di servizi per la persona                    ,2,28,3,11,44,2024
VEN,VR,T   ,Attività di famiglie e convivenze come datori di lavoro p...,0,0,0,0,0,2024
VEN,VR,T 97,Attività di famiglie e convivenze come datori di lavoro p...,0,0,0,0,0,2024
VEN,VR,T 98,Produzione di beni e servizi indifferenziati per uso prop...,0,0,0,0,0,2024
VEN,VR,U   ,Organizzazioni ed organismi extraterritoriali               ,0,0,0,0,0,2024
VEN,VR,U 99,Organizzazioni ed organismi extraterritoriali               ,0,0,0,0,0,2024
VEN,VR,XX  ,Imprese non classificate                                    ,33,246,24,75,378,2024
VEN,VR,TOT ,TOTALE                                                      ,251,1165,600,481,2497,2024
VEN,VI,A   ,"Agricoltura, silvicoltura pesca                             ",1,0,19,10,30,2024
VEN,VI,A 01,"Coltivazioni agricole e produzione di prodotti animali, c...",1,0,17,9,27,2024
VEN,VI,A 02,Silvicoltura ed utilizzo di aree forestali                  ,0,0,2,1,3,2024
VEN,VI,A 03,Pesca e acquacoltura                                        ,0,0,0,0,0,2024
VEN,VI,B   ,Estrazione di minerali da cave e miniere                    ,1,0,0,0,1,2024
VEN,VI,B 05,Estrazione di carbone (esclusa torba)                       ,0,0,0,0,0,2024
VEN,VI,B 06,Estraz.di petrolio greggio e di gas naturale                ,0,0,0,0,0,2024
VEN,VI,B 07,Estrazione di minerali metalliferi                          ,0,0,0,0,0,2024
VEN,VI,B 08,Altre attività di estrazione di minerali da cave e miniere  ,1,0,0,0,1,2024
VEN,VI,B 09,Attività dei servizi di supporto all'estrazione             ,0,0,0,0,0,2024
VEN,VI,C   ,Attività manifatturiere                                     ,50,0,36,14,100,2024
VEN,VI,C 10,Industrie alimentari                                        ,0,0,2,4,6,2024
VEN,VI,C 11,Industria delle bevande                                     ,0,0,0,0,0,2024
VEN,VI,C 12,Industria del tabacco                                       ,0,0,0,0,0,2024
VEN,VI,C 13,Industrie tessili                                           ,0,0,1,1,2,2024
VEN,VI,C 14,Confezione di articoli di abbigliamento; confezione di ar...,11,0,10,2,23,2024
VEN,VI,C 15,Fabbricazione di articoli in pelle e simili                 ,8,0,3,0,11,2024
VEN,VI,C 16,Industria del legno e dei prodotti in legno e sughero (es...,2,0,0,0,2,2024
VEN,VI,C 17,Fabbricazione di carta e di prodotti di carta               ,1,0,0,1,2,2024
VEN,VI,C 18,Stampa e riproduzione di supporti registrati                ,0,0,0,0,0,2024
VEN,VI,C 19,Fabbricazione di coke e prodotti derivanti dalla raffinaz...,0,0,0,0,0,2024
VEN,VI,C 20,Fabbricazione di prodotti chimici                           ,0,0,0,0,0,2024
VEN,VI,C 21,Fabbricazione di prodotti farmaceutici di base e di prepa...,0,0,0,0,0,2024
VEN,VI,C 22,Fabbricazione di articoli in gomma e materie plastiche      ,4,0,1,0,5,2024
VEN,VI,C 23,Fabbricazione di altri prodotti della lavorazione di miner..,1,0,0,0,1,2024
VEN,VI,C 24,Metallurgia                                                 ,0,0,0,0,0,2024
VEN,VI,C 25,Fabbricazione di prodotti in metallo (esclusi macchinari ...,8,0,6,4,18,2024
VEN,VI,C 26,Fabbricazione di computer e prodotti di elettronica e ott...,1,0,0,1,2,2024
VEN,VI,C 27,Fabbricazione di apparecchiature elettriche ed apparecchi...,1,0,2,1,4,2024
VEN,VI,C 28,Fabbricazione di macchinari ed apparecchiature nca          ,8,0,3,0,11,2024
VEN,VI,C 29,"Fabbricazione di autoveicoli, rimorchi e semirimorchi       ",0,0,0,0,0,2024
VEN,VI,C 30,Fabbricazione di altri mezzi di trasporto                   ,0,0,0,0,0,2024
VEN,VI,C 31,Fabbricazione di mobili                                     ,1,0,0,0,1,2024
VEN,VI,C 32,Altre industrie manifatturiere                              ,4,0,4,0,8,2024
VEN,VI,C 33,"Riparazione, manutenzione ed installazione di macchine ed...",0,0,4,0,4,2024
VEN,VI,D   ,"Fornitura di energia elettrica, gas, vapore e aria condiz...",1,0,0,0,1,2024
VEN,VI,D 35,"Fornitura di energia elettrica, gas, vapore e aria condiz...",1,0,0,0,1,2024
VEN,VI,E   ,"Fornitura di acqua; reti fognarie, attività di gestione d...",1,0,2,0,3,2024
VEN,VI,E 36,"Raccolta, trattamento e fornitura di acqua                  ",0,0,0,0,0,2024
VEN,VI,E 37,Gestione delle reti fognarie                                ,0,0,0,0,0,2024
VEN,VI,E 38,"Attività di raccolta, trattamento e smaltimento dei rifiu...",1,0,2,0,3,2024
VEN,VI,E 39,Attività di risanamento e altri servizi di gestione dei r...,0,0,0,0,0,2024
VEN,VI,F   ,Costruzioni                                                 ,18,0,104,10,132,2024
VEN,VI,F 41,Costruzione di edifici                                      ,13,0,7,7,27,2024
VEN,VI,F 42,Ingegneria civile                                           ,0,0,1,0,1,2024
VEN,VI,F 43,Lavori di costruzione specializzati                         ,5,0,96,3,104,2024
VEN,VI,G   ,Commercio all'ingrosso e al dettaglio; riparazione di aut...,34,2,84,6,126,2024
VEN,VI,G 45,Commercio all'ingrosso e al dettaglio e riparazione di au...,2,1,18,0,21,2024
VEN,VI,G 46,Commercio all'ingrosso (escluso quello di autoveicoli e d...,23,1,25,2,51,2024
VEN,VI,G 47,Commercio al dettaglio (escluso quello di autoveicoli e d...,9,0,41,4,54,2024
VEN,VI,H   ,Trasporto e magazzinaggio                                   ,4,0,8,26,38,2024
VEN,VI,H 49,Trasporto terrestre e mediante condotte                     ,2,0,7,3,12,2024
VEN,VI,H 50,Trasporto marittimo e per vie d'acqua                       ,0,0,0,0,0,2024
VEN,VI,H 51,Trasporto aereo                                             ,0,0,0,0,0,2024
VEN,VI,H 52,Magazzinaggio e attività di supporto ai trasporti           ,2,0,1,23,26,2024
VEN,VI,H 53,Servizi postali e attività di corriere                      ,0,0,0,0,0,2024
VEN,VI,I   ,Attività dei servizi alloggio e ristorazione                ,9,1,7,5,22,2024
VEN,VI,I 55,Alloggio                                                    ,1,0,0,0,1,2024
VEN,VI,I 56,Attività dei servizi di ristorazione                        ,8,1,7,5,21,2024
VEN,VI,J   ,Servizi di informazione e comunicazione                     ,2,1,2,1,6,2024
VEN,VI,J 58,Attività editoriali                                         ,0,1,0,0,1,2024
VEN,VI,J 59,"Attività di produzione cinematografica, di video e di pro...",0,0,0,0,0,2024
VEN,VI,J 60,Attività di programmazione e trasmissione                   ,0,0,0,0,0,2024
VEN,VI,J 61,Telecomunicazioni                                           ,0,0,2,0,2,2024
VEN,VI,J 62,"Produzione di software, consulenza informatica e attività...",1,0,0,1,2,2024
VEN,VI,J 63,Attività dei servizi d'informazione e altri servizi infor...,1,0,0,0,1,2024
VEN,VI,K   ,Attività finanziarie e assicurative                         ,1,0,4,0,5,2024
VEN,VI,K 64,Attività di servizi finanziari (escluse le assicurazioni ...,0,0,0,0,0,2024
VEN,VI,K 65,"Assicurazioni, riassicurazioni e fondi pensione (escluse ...",0,0,0,0,0,2024
VEN,VI,K 66,Attività ausiliarie dei servizi finanziari e delle attivi...,1,0,4,0,5,2024
VEN,VI,L   ,Attivita' immobiliari                                       ,14,0,4,1,19,2024
VEN,VI,L 68,Attivita' immobiliari                                       ,14,0,4,1,19,2024
VEN,VI,M   ,"Attività professionali, scientifiche e tecniche             ",4,0,8,2,14,2024
VEN,VI,M 69,Attività legali e contabilità                               ,0,0,0,0,0,2024
VEN,VI,M 70,Attività di direzione aziendale e di consulenza gestional...,2,0,0,0,2,2024
VEN,VI,M 71,Attività degli studi di architettura e d'ingegneria; coll...,1,0,0,0,1,2024
VEN,VI,M 72,Ricerca scientifica e sviluppo                              ,0,0,0,1,1,2024
VEN,VI,M 73,Pubblicità e ricerche di mercato                            ,1,0,2,0,3,2024
VEN,VI,M 74,"Altre attività professionali, scientifiche e tecniche       ",0,0,6,1,7,2024
VEN,VI,M 75,Servizi veterinari                                          ,0,0,0,0,0,2024
VEN,VI,N   ,"Noleggio, agenzie di viaggio, servizi di supporto alle im...",6,0,11,12,29,2024
VEN,VI,N 77,Attività di noleggio e leasing operativo                    ,3,0,1,0,4,2024
VEN,VI,N 78,"Attività di ricerca, selezione, fornitura di personale      ",0,0,0,0,0,2024
VEN,VI,N 79,"Attività dei servizi delle agenzie di viaggio, dei tour o...",2,0,0,0,2,2024
VEN,VI,N 80,Servizi di vigilanza e investigazione                       ,0,0,0,0,0,2024
VEN,VI,N 81,Attività di servizi per edifici e paesaggio                 ,0,0,6,5,11,2024
VEN,VI,N 82,Attività di supporto per le funzioni d'ufficio e altri se...,1,0,4,7,12,2024
VEN,VI,O   ,Amministrazione pubblica e difesa; assicurazione sociale ...,0,0,0,0,0,2024
VEN,VI,O 84,Amministrazione pubblica e difesa; assicurazione sociale ...,0,0,0,0,0,2024
VEN,VI,P   ,Istruzione                                                  ,0,0,0,0,0,2024
VEN,VI,P 85,Istruzione                                                  ,0,0,0,0,0,2024
VEN,VI,Q   ,Sanita' e assistenza sociale                                ,2,0,0,3,5,2024
VEN,VI,Q 86,Assistenza sanitaria                                        ,2,0,0,0,2,2024
VEN,VI,Q 87,Servizi di assistenza sociale residenziale                  ,0,0,0,0,0,2024
VEN,VI,Q 88,Assistenza sociale non residenziale                         ,0,0,0,3,3,2024
VEN,VI,R   ,"Attività artistiche, sportive, di intrattenimento e diver...",2,0,1,1,4,2024
VEN,VI,R 90,"Attività creative, artistiche e di intrattenimento          ",0,0,0,1,1,2024
VEN,VI,R 91,"Attività di biblioteche, archivi, musei ed altre attività...",0,0,0,0,0,2024
VEN,VI,R 92,"Attività riguardanti le lotterie, le scommesse, le case d...",0,0,0,0,0,2024
VEN,VI,R 93,"Attività sportive, di intrattenimento e di divertimento     ",2,0,1,0,3,2024
VEN,VI,S   ,Altre attività di servizi                                   ,0,0,4,1,5,2024
VEN,VI,S 94,Attività di organizzazioni associative                      ,0,0,0,0,0,2024
VEN,VI,S 95,Riparazione di computer e di beni per uso personale e per...,0,0,1,0,1,2024
VEN,VI,S 96,Altre attività di servizi per la persona                    ,0,0,3,1,4,2024
VEN,VI,T   ,Attività di famiglie e convivenze come datori di lavoro p...,0,0,0,0,0,2024
VEN,VI,T 97,Attività di famiglie e convivenze come datori di lavoro p...,0,0,0,0,0,2024
VEN,VI,T 98,Produzione di beni e servizi indifferenziati per uso prop...,0,0,0,0,0,2024
VEN,VI,U   ,Organizzazioni ed organismi extraterritoriali               ,0,0,0,0,0,2024
VEN,VI,U 99,Organizzazioni ed organismi extraterritoriali               ,0,0,0,0,0,2024
VEN,VI,XX  ,Imprese non classificate                                    ,83,0,1,23,107,2024
VEN,VI,TOT ,TOTALE                                                      ,233,4,295,115,647,2024
VEN,BL,A   ,"Agricoltura, silvicoltura pesca                             ",0,17,104,0,121,2024
VEN,BL,A 01,"Coltivazioni agricole e produzione di prodotti animali, c...",0,14,88,0,102,2024
VEN,BL,A 02,Silvicoltura ed utilizzo di aree forestali                  ,0,2,16,0,18,2024
VEN,BL,A 03,Pesca e acquacoltura                                        ,0,1,0,0,1,2024
VEN,BL,B   ,Estrazione di minerali da cave e miniere                    ,1,0,0,0,1,2024
VEN,BL,B 05,Estrazione di carbone (esclusa torba)                       ,0,0,0,0,0,2024
VEN,BL,B 06,Estraz.di petrolio greggio e di gas naturale                ,0,0,0,0,0,2024
VEN,BL,B 07,Estrazione di minerali metalliferi                          ,0,0,0,0,0,2024
VEN,BL,B 08,Altre attività di estrazione di minerali da cave e miniere  ,1,0,0,0,1,2024
VEN,BL,B 09,Attività dei servizi di supporto all'estrazione             ,0,0,0,0,0,2024
VEN,BL,C   ,Attività manifatturiere                                     ,9,31,44,1,85,2024
VEN,BL,C 10,Industrie alimentari                                        ,0,3,1,0,4,2024
VEN,BL,C 11,Industria delle bevande                                     ,0,0,0,0,0,2024
VEN,BL,C 12,Industria del tabacco                                       ,0,0,0,0,0,2024
VEN,BL,C 13,Industrie tessili                                           ,0,0,2,0,2,2024
VEN,BL,C 14,Confezione di articoli di abbigliamento; confezione di ar...,0,1,3,0,4,2024
VEN,BL,C 15,Fabbricazione di articoli in pelle e simili                 ,0,3,0,0,3,2024
VEN,BL,C 16,Industria del legno e dei prodotti in legno e sughero (es...,0,2,8,1,11,2024
VEN,BL,C 17,Fabbricazione di carta e di prodotti di carta               ,0,0,0,0,0,2024
VEN,BL,C 18,Stampa e riproduzione di supporti registrati                ,0,0,0,0,0,2024
VEN,BL,C 19,Fabbricazione di coke e prodotti derivanti dalla raffinaz...,0,0,0,0,0,2024
VEN,BL,C 20,Fabbricazione di prodotti chimici                           ,0,1,0,0,1,2024
VEN,BL,C 21,Fabbricazione di prodotti farmaceutici di base e di prepa...,0,0,0,0,0,2024
VEN,BL,C 22,Fabbricazione di articoli in gomma e materie plastiche      ,0,0,0,0,0,2024
VEN,BL,C 23,Fabbricazione di altri prodotti della lavorazione di miner..,0,1,2,0,3,2024
VEN,BL,C 24,Metallurgia                                                 ,1,0,1,0,2,2024
VEN,BL,C 25,Fabbricazione di prodotti in metallo (esclusi macchinari ...,1,4,12,0,17,2024
VEN,BL,C 26,Fabbricazione di computer e prodotti di elettronica e ott...,2,2,3,0,7,2024
VEN,BL,C 27,Fabbricazione di apparecchiature elettriche ed apparecchi...,0,0,0,0,0,2024
VEN,BL,C 28,Fabbricazione di macchinari ed apparecchiature nca          ,0,1,3,0,4,2024
VEN,BL,C 29,"Fabbricazione di autoveicoli, rimorchi e semirimorchi       ",0,0,0,0,0,2024
VEN,BL,C 30,Fabbricazione di altri mezzi di trasporto                   ,0,0,0,0,0,2024
VEN,BL,C 31,Fabbricazione di mobili                                     ,0,0,1,0,1,2024
VEN,BL,C 32,Altre industrie manifatturiere                              ,5,13,8,0,26,2024
VEN,BL,C 33,"Riparazione, manutenzione ed installazione di macchine ed...",0,0,0,0,0,2024
VEN,BL,D   ,"Fornitura di energia elettrica, gas, vapore e aria condiz...",0,0,1,0,1,2024
VEN,BL,D 35,"Fornitura di energia elettrica, gas, vapore e aria condiz...",0,0,1,0,1,2024
VEN,BL,E   ,"Fornitura di acqua; reti fognarie, attività di gestione d...",1,1,0,0,2,2024
VEN,BL,E 36,"Raccolta, trattamento e fornitura di acqua                  ",0,0,0,0,0,2024
VEN,BL,E 37,Gestione delle reti fognarie                                ,0,0,0,0,0,2024
VEN,BL,E 38,"Attività di raccolta, trattamento e smaltimento dei rifiu...",1,1,0,0,2,2024
VEN,BL,E 39,Attività di risanamento e altri servizi di gestione dei r...,0,0,0,0,0,2024
VEN,BL,F   ,Costruzioni                                                 ,5,29,104,1,139,2024
VEN,BL,F 41,Costruzione di edifici                                      ,5,5,12,0,22,2024
VEN,BL,F 42,Ingegneria civile                                           ,0,0,0,0,0,2024
VEN,BL,F 43,Lavori di costruzione specializzati                         ,0,24,92,1,117,2024
VEN,BL,G   ,Commercio all'ingrosso e al dettaglio; riparazione di aut...,12,63,141,1,217,2024
VEN,BL,G 45,Commercio all'ingrosso e al dettaglio e riparazione di au...,1,7,8,0,16,2024
VEN,BL,G 46,Commercio all'ingrosso (escluso quello di autoveicoli e d...,7,13,43,1,64,2024
VEN,BL,G 47,Commercio al dettaglio (escluso quello di autoveicoli e d...,4,43,90,0,137,2024
VEN,BL,H   ,Trasporto e magazzinaggio                                   ,3,4,6,0,13,2024
VEN,BL,H 49,Trasporto terrestre e mediante condotte                     ,2,3,6,0,11,2024
VEN,BL,H 50,Trasporto marittimo e per vie d'acqua                       ,0,0,0,0,0,2024
VEN,BL,H 51,Trasporto aereo                                             ,0,0,0,0,0,2024
VEN,BL,H 52,Magazzinaggio e attività di supporto ai trasporti           ,1,1,0,0,2,2024
VEN,BL,H 53,Servizi postali e attività di corriere                      ,0,0,0,0,0,2024
VEN,BL,I   ,Attività dei servizi alloggio e ristorazione                ,8,120,39,0,167,2024
VEN,BL,I 55,Alloggio                                                    ,1,6,3,0,10,2024
VEN,BL,I 56,Attività dei servizi di ristorazione                        ,7,114,36,0,157,2024
VEN,BL,J   ,Servizi di informazione e comunicazione                     ,2,7,4,0,13,2024
VEN,BL,J 58,Attività editoriali                                         ,0,0,0,0,0,2024
VEN,BL,J 59,"Attività di produzione cinematografica, di video e di pro...",0,0,0,0,0,2024
VEN,BL,J 60,Attività di programmazione e trasmissione                   ,1,0,0,0,1,2024
VEN,BL,J 61,Telecomunicazioni                                           ,0,0,2,0,2,2024
VEN,BL,J 62,"Produzione di software, consulenza informatica e attività...",0,3,2,0,5,2024
VEN,BL,J 63,Attività dei servizi d'informazione e altri servizi infor...,1,4,0,0,5,2024
VEN,BL,K   ,Attività finanziarie e assicurative                         ,1,1,10,0,12,2024
VEN,BL,K 64,Attività di servizi finanziari (escluse le assicurazioni ...,1,0,0,0,1,2024
VEN,BL,K 65,"Assicurazioni, riassicurazioni e fondi pensione (escluse ...",0,0,0,0,0,2024
VEN,BL,K 66,Attività ausiliarie dei servizi finanziari e delle attivi...,0,1,10,0,11,2024
VEN,BL,L   ,Attivita' immobiliari                                       ,6,8,2,0,16,2024
VEN,BL,L 68,Attivita' immobiliari                                       ,6,8,2,0,16,2024
VEN,BL,M   ,"Attività professionali, scientifiche e tecniche             ",4,6,11,0,21,2024
VEN,BL,M 69,Attività legali e contabilità                               ,0,0,0,0,0,2024
VEN,BL,M 70,Attività di direzione aziendale e di consulenza gestional...,2,1,2,0,5,2024
VEN,BL,M 71,Attività degli studi di architettura e d'ingegneria; coll...,0,1,1,0,2,2024
VEN,BL,M 72,Ricerca scientifica e sviluppo                              ,0,0,0,0,0,2024
VEN,BL,M 73,Pubblicità e ricerche di mercato                            ,1,3,2,0,6,2024
VEN,BL,M 74,"Altre attività professionali, scientifiche e tecniche       ",1,1,6,0,8,2024
VEN,BL,M 75,Servizi veterinari                                          ,0,0,0,0,0,2024
VEN,BL,N   ,"Noleggio, agenzie di viaggio, servizi di supporto alle im...",0,4,11,0,15,2024
VEN,BL,N 77,Attività di noleggio e leasing operativo                    ,0,0,0,0,0,2024
VEN,BL,N 78,"Attività di ricerca, selezione, fornitura di personale      ",0,0,0,0,0,2024
VEN,BL,N 79,"Attività dei servizi delle agenzie di viaggio, dei tour o...",0,0,0,0,0,2024
VEN,BL,N 80,Servizi di vigilanza e investigazione                       ,0,0,0,0,0,2024
VEN,BL,N 81,Attività di servizi per edifici e paesaggio                 ,0,3,6,0,9,2024
VEN,BL,N 82,Attività di supporto per le funzioni d'ufficio e altri se...,0,1,5,0,6,2024
VEN,BL,O   ,Amministrazione pubblica e difesa; assicurazione sociale ...,0,0,0,0,0,2024
VEN,BL,O 84,Amministrazione pubblica e difesa; assicurazione sociale ...,0,0,0,0,0,2024
VEN,BL,P   ,Istruzione                                                  ,1,1,0,0,2,2024
VEN,BL,P 85,Istruzione                                                  ,1,1,0,0,2,2024
VEN,BL,Q   ,Sanita' e assistenza sociale                                ,0,0,0,2,2,2024
VEN,BL,Q 86,Assistenza sanitaria                                        ,0,0,0,0,0,2024
VEN,BL,Q 87,Servizi di assistenza sociale residenziale                  ,0,0,0,1,1,2024
VEN,BL,Q 88,Assistenza sociale non residenziale                         ,0,0,0,1,1,2024
VEN,BL,R   ,"Attività artistiche, sportive, di intrattenimento e diver...",5,5,7,1,18,2024
VEN,BL,R 90,"Attività creative, artistiche e di intrattenimento          ",1,1,2,1,5,2024
VEN,BL,R 91,"Attività di biblioteche, archivi, musei ed altre attività...",0,0,0,0,0,2024
VEN,BL,R 92,"Attività riguardanti le lotterie, le scommesse, le case d...",0,0,0,0,0,2024
VEN,BL,R 93,"Attività sportive, di intrattenimento e di divertimento     ",4,4,5,0,13,2024
VEN,BL,S   ,Altre attività di servizi                                   ,1,7,9,0,17,2024
VEN,BL,S 94,Attività di organizzazioni associative                      ,0,0,0,0,0,2024
VEN,BL,S 95,Riparazione di computer e di beni per uso personale e per...,0,3,2,0,5,2024
VEN,BL,S 96,Altre attività di servizi per la persona                    ,1,4,7,0,12,2024
VEN,BL,T   ,Attività di famiglie e convivenze come datori di lavoro p...,0,0,0,0,0,2024
VEN,BL,T 97,Attività di famiglie e convivenze come datori di lavoro p...,0,0,0,0,0,2024
VEN,BL,T 98,Produzione di beni e servizi indifferenziati per uso prop...,0,0,0,0,0,2024
VEN,BL,U   ,Organizzazioni ed organismi extraterritoriali               ,0,0,0,0,0,2024
VEN,BL,U 99,Organizzazioni ed organismi extraterritoriali               ,0,0,0,0,0,2024
VEN,BL,XX  ,Imprese non classificate                                    ,9,30,14,2,55,2024
VEN,BL,TOT ,TOTALE                                                      ,68,334,507,8,917,2024
VEN,TV,A   ,"Agricoltura, silvicoltura pesca                             ",4,13,59,9,85,2024
VEN,TV,A 01,"Coltivazioni agricole e produzione di prodotti animali, c...",4,13,59,9,85,2024
VEN,TV,A 02,Silvicoltura ed utilizzo di aree forestali                  ,0,0,0,0,0,2024
VEN,TV,A 03,Pesca e acquacoltura                                        ,0,0,0,0,0,2024
VEN,TV,B   ,Estrazione di minerali da cave e miniere                    ,1,0,0,0,1,2024
VEN,TV,B 05,Estrazione di carbone (esclusa torba)                       ,0,0,0,0,0,2024
VEN,TV,B 06,Estraz.di petrolio greggio e di gas naturale                ,0,0,0,0,0,2024
VEN,TV,B 07,Estrazione di minerali metalliferi                          ,1,0,0,0,1,2024
VEN,TV,B 08,Altre attività di estrazione di minerali da cave e miniere  ,0,0,0,0,0,2024
VEN,TV,B 09,Attività dei servizi di supporto all'estrazione             ,0,0,0,0,0,2024
VEN,TV,C   ,Attività manifatturiere                                     ,124,64,44,16,248,2024
VEN,TV,C 10,Industrie alimentari                                        ,3,5,1,3,12,2024
VEN,TV,C 11,Industria delle bevande                                     ,0,2,0,0,2,2024
VEN,TV,C 12,Industria del tabacco                                       ,0,0,0,0,0,2024
VEN,TV,C 13,Industrie tessili                                           ,4,1,3,1,9,2024
VEN,TV,C 14,Confezione di articoli di abbigliamento; confezione di ar...,12,4,10,0,26,2024
VEN,TV,C 15,Fabbricazione di articoli in pelle e simili                 ,4,1,1,0,6,2024
VEN,TV,C 16,Industria del legno e dei prodotti in legno e sughero (es...,10,3,3,2,18,2024
VEN,TV,C 17,Fabbricazione di carta e di prodotti di carta               ,2,1,0,0,3,2024
VEN,TV,C 18,Stampa e riproduzione di supporti registrati                ,5,3,1,1,10,2024
VEN,TV,C 19,Fabbricazione di coke e prodotti derivanti dalla raffinaz...,0,0,0,0,0,2024
VEN,TV,C 20,Fabbricazione di prodotti chimici                           ,3,0,0,0,3,2024
VEN,TV,C 21,Fabbricazione di prodotti farmaceutici di base e di prepa...,0,0,0,0,0,2024
VEN,TV,C 22,Fabbricazione di articoli in gomma e materie plastiche      ,2,4,3,0,9,2024
VEN,TV,C 23,Fabbricazione di altri prodotti della lavorazione di miner..,4,3,0,0,7,2024
VEN,TV,C 24,Metallurgia                                                 ,0,0,0,0,0,2024
VEN,TV,C 25,Fabbricazione di prodotti in metallo (esclusi macchinari ...,24,14,10,4,52,2024
VEN,TV,C 26,Fabbricazione di computer e prodotti di elettronica e ott...,5,1,0,0,6,2024
VEN,TV,C 27,Fabbricazione di apparecchiature elettriche ed apparecchi...,6,1,2,0,9,2024
VEN,TV,C 28,Fabbricazione di macchinari ed apparecchiature nca          ,14,5,1,1,21,2024
VEN,TV,C 29,"Fabbricazione di autoveicoli, rimorchi e semirimorchi       ",1,1,0,0,2,2024
VEN,TV,C 30,Fabbricazione di altri mezzi di trasporto                   ,1,0,1,0,2,2024
VEN,TV,C 31,Fabbricazione di mobili                                     ,17,11,1,1,30,2024
VEN,TV,C 32,Altre industrie manifatturiere                              ,4,4,2,0,10,2024
VEN,TV,C 33,"Riparazione, manutenzione ed installazione di macchine ed...",3,0,5,3,11,2024
VEN,TV,D   ,"Fornitura di energia elettrica, gas, vapore e aria condiz...",0,0,0,0,0,2024
VEN,TV,D 35,"Fornitura di energia elettrica, gas, vapore e aria condiz...",0,0,0,0,0,2024
VEN,TV,E   ,"Fornitura di acqua; reti fognarie, attività di gestione d...",1,0,0,0,1,2024
VEN,TV,E 36,"Raccolta, trattamento e fornitura di acqua                  ",0,0,0,0,0,2024
VEN,TV,E 37,Gestione delle reti fognarie                                ,0,0,0,0,0,2024
VEN,TV,E 38,"Attività di raccolta, trattamento e smaltimento dei rifiu...",1,0,0,0,1,2024
VEN,TV,E 39,Attività di risanamento e altri servizi di gestione dei r...,0,0,0,0,0,2024
VEN,TV,F   ,Costruzioni                                                 ,53,19,155,25,252,2024
VEN,TV,F 41,Costruzione di edifici                                      ,35,8,24,10,77,2024
VEN,TV,F 42,Ingegneria civile                                           ,1,1,0,0,2,2024
VEN,TV,F 43,Lavori di costruzione specializzati                         ,17,10,131,15,173,2024
VEN,TV,G   ,Commercio all'ingrosso e al dettaglio; riparazione di aut...,150,79,179,6,414,2024
VEN,TV,G 45,Commercio all'ingrosso e al dettaglio e riparazione di au...,18,12,21,2,53,2024
VEN,TV,G 46,Commercio all'ingrosso (escluso quello di autoveicoli e d...,104,24,67,2,197,2024
VEN,TV,G 47,Commercio al dettaglio (escluso quello di autoveicoli e d...,28,43,91,2,164,2024
VEN,TV,H   ,Trasporto e magazzinaggio                                   ,8,6,17,16,47,2024
VEN,TV,H 49,Trasporto terrestre e mediante condotte                     ,6,5,17,6,34,2024
VEN,TV,H 50,Trasporto marittimo e per vie d'acqua                       ,0,0,0,0,0,2024
VEN,TV,H 51,Trasporto aereo                                             ,1,0,0,0,1,2024
VEN,TV,H 52,Magazzinaggio e attività di supporto ai trasporti           ,1,1,0,10,12,2024
VEN,TV,H 53,Servizi postali e attività di corriere                      ,0,0,0,0,0,2024
VEN,TV,I   ,Attività dei servizi alloggio e ristorazione                ,23,41,25,2,91,2024
VEN,TV,I 55,Alloggio                                                    ,2,0,0,0,2,2024
VEN,TV,I 56,Attività dei servizi di ristorazione                        ,21,41,25,2,89,2024
VEN,TV,J   ,Servizi di informazione e comunicazione                     ,21,4,7,4,36,2024
VEN,TV,J 58,Attività editoriali                                         ,1,1,0,1,3,2024
VEN,TV,J 59,"Attività di produzione cinematografica, di video e di pro...",1,0,1,0,2,2024
VEN,TV,J 60,Attività di programmazione e trasmissione                   ,0,0,0,0,0,2024
VEN,TV,J 61,Telecomunicazioni                                           ,2,0,4,0,6,2024
VEN,TV,J 62,"Produzione di software, consulenza informatica e attività...",11,2,0,2,15,2024
VEN,TV,J 63,Attività dei servizi d'informazione e altri servizi infor...,6,1,2,1,10,2024
VEN,TV,K   ,Attività finanziarie e assicurative                         ,9,5,12,0,26,2024
VEN,TV,K 64,Attività di servizi finanziari (escluse le assicurazioni ...,2,2,0,0,4,2024
VEN,TV,K 65,"Assicurazioni, riassicurazioni e fondi pensione (escluse ...",0,0,0,0,0,2024
VEN,TV,K 66,Attività ausiliarie dei servizi finanziari e delle attivi...,7,3,12,0,22,2024
VEN,TV,L   ,Attivita' immobiliari                                       ,61,23,4,0,88,2024
VEN,TV,L 68,Attivita' immobiliari                                       ,61,23,4,0,88,2024
VEN,TV,M   ,"Attività professionali, scientifiche e tecniche             ",41,17,10,2,70,2024
VEN,TV,M 69,Attività legali e contabilità                               ,0,1,0,0,1,2024
VEN,TV,M 70,Attività di direzione aziendale e di consulenza gestional...,14,3,4,1,22,2024
VEN,TV,M 71,Attività degli studi di architettura e d'ingegneria; coll...,1,0,1,0,2,2024
VEN,TV,M 72,Ricerca scientifica e sviluppo                              ,1,0,0,0,1,2024
VEN,TV,M 73,Pubblicità e ricerche di mercato                            ,9,3,3,1,16,2024
VEN,TV,M 74,"Altre attività professionali, scientifiche e tecniche       ",16,10,2,0,28,2024
VEN,TV,M 75,Servizi veterinari                                          ,0,0,0,0,0,2024
VEN,TV,N   ,"Noleggio, agenzie di viaggio, servizi di supporto alle im...",12,3,20,7,42,2024
VEN,TV,N 77,Attività di noleggio e leasing operativo                    ,3,0,0,0,3,2024
VEN,TV,N 78,"Attività di ricerca, selezione, fornitura di personale      ",0,0,0,0,0,2024
VEN,TV,N 79,"Attività dei servizi delle agenzie di viaggio, dei tour o...",2,0,0,0,2,2024
VEN,TV,N 80,Servizi di vigilanza e investigazione                       ,1,1,0,0,2,2024
VEN,TV,N 81,Attività di servizi per edifici e paesaggio                 ,1,1,9,5,16,2024
VEN,TV,N 82,Attività di supporto per le funzioni d'ufficio e altri se...,5,1,11,2,19,2024
VEN,TV,O   ,Amministrazione pubblica e difesa; assicurazione sociale ...,0,0,0,0,0,2024
VEN,TV,O 84,Amministrazione pubblica e difesa; assicurazione sociale ...,0,0,0,0,0,2024
VEN,TV,P   ,Istruzione                                                  ,1,0,1,4,6,2024
VEN,TV,P 85,Istruzione                                                  ,1,0,1,4,6,2024
VEN,TV,Q   ,Sanita' e assistenza sociale                                ,3,2,0,4,9,2024
VEN,TV,Q 86,Assistenza sanitaria                                        ,3,2,0,0,5,2024
VEN,TV,Q 87,Servizi di assistenza sociale residenziale                  ,0,0,0,3,3,2024
VEN,TV,Q 88,Assistenza sociale non residenziale                         ,0,0,0,1,1,2024
VEN,TV,R   ,"Attività artistiche, sportive, di intrattenimento e diver...",17,5,7,5,34,2024
VEN,TV,R 90,"Attività creative, artistiche e di intrattenimento          ",5,2,4,2,13,2024
VEN,TV,R 91,"Attività di biblioteche, archivi, musei ed altre attività...",0,0,0,1,1,2024
VEN,TV,R 92,"Attività riguardanti le lotterie, le scommesse, le case d...",1,0,0,0,1,2024
VEN,TV,R 93,"Attività sportive, di intrattenimento e di divertimento     ",11,3,3,2,19,2024
VEN,TV,S   ,Altre attività di servizi                                   ,10,4,13,1,28,2024
VEN,TV,S 94,Attività di organizzazioni associative                      ,0,0,0,0,0,2024
VEN,TV,S 95,Riparazione di computer e di beni per uso personale e per...,1,2,7,0,10,2024
VEN,TV,S 96,Altre attività di servizi per la persona                    ,9,2,6,1,18,2024
VEN,TV,T   ,Attività di famiglie e convivenze come datori di lavoro p...,0,0,0,0,0,2024
VEN,TV,T 97,Attività di famiglie e convivenze come datori di lavoro p...,0,0,0,0,0,2024
VEN,TV,T 98,Produzione di beni e servizi indifferenziati per uso prop...,0,0,0,0,0,2024
VEN,TV,U   ,Organizzazioni ed organismi extraterritoriali               ,0,0,0,0,0,2024
VEN,TV,U 99,Organizzazioni ed organismi extraterritoriali               ,0,0,0,0,0,2024
VEN,TV,XX  ,Imprese non classificate                                    ,64,11,25,12,112,2024
VEN,TV,TOT ,TOTALE                                                      ,603,296,578,113,1590,2024
VEN,VE,A   ,"Agricoltura, silvicoltura pesca                             ",1,3,34,7,45,2024
VEN,VE,A 01,"Coltivazioni agricole e produzione di prodotti animali, c...",1,1,30,0,32,2024
VEN,VE,A 02,Silvicoltura ed utilizzo di aree forestali                  ,0,0,0,0,0,2024
VEN,VE,A 03,Pesca e acquacoltura                                        ,0,2,4,7,13,2024
VEN,VE,B   ,Estrazione di minerali da cave e miniere                    ,0,0,0,0,0,2024
VEN,VE,B 05,Estrazione di carbone (esclusa torba)                       ,0,0,0,0,0,2024
VEN,VE,B 06,Estraz.di petrolio greggio e di gas naturale                ,0,0,0,0,0,2024
VEN,VE,B 07,Estrazione di minerali metalliferi                          ,0,0,0,0,0,2024
VEN,VE,B 08,Altre attività di estrazione di minerali da cave e miniere  ,0,0,0,0,0,2024
VEN,VE,B 09,Attività dei servizi di supporto all'estrazione             ,0,0,0,0,0,2024
VEN,VE,C   ,Attività manifatturiere                                     ,41,6,48,4,99,2024
VEN,VE,C 10,Industrie alimentari                                        ,1,2,3,1,7,2024
VEN,VE,C 11,Industria delle bevande                                     ,0,0,0,0,0,2024
VEN,VE,C 12,Industria del tabacco                                       ,0,0,0,0,0,2024
VEN,VE,C 13,Industrie tessili                                           ,1,0,0,0,1,2024
VEN,VE,C 14,Confezione di articoli di abbigliamento; confezione di ar...,7,0,13,0,20,2024
VEN,VE,C 15,Fabbricazione di articoli in pelle e simili                 ,4,0,4,0,8,2024
VEN,VE,C 16,Industria del legno e dei prodotti in legno e sughero (es...,1,2,3,1,7,2024
VEN,VE,C 17,Fabbricazione di carta e di prodotti di carta               ,1,0,0,0,1,2024
VEN,VE,C 18,Stampa e riproduzione di supporti registrati                ,2,1,0,0,3,2024
VEN,VE,C 19,Fabbricazione di coke e prodotti derivanti dalla raffinaz...,0,0,0,0,0,2024
VEN,VE,C 20,Fabbricazione di prodotti chimici                           ,0,0,0,0,0,2024
VEN,VE,C 21,Fabbricazione di prodotti farmaceutici di base e di prepa...,0,0,0,0,0,2024
VEN,VE,C 22,Fabbricazione di articoli in gomma e materie plastiche      ,0,0,0,1,1,2024
VEN,VE,C 23,Fabbricazione di altri prodotti della lavorazione di miner..,6,0,4,0,10,2024
VEN,VE,C 24,Metallurgia                                                 ,0,0,1,0,1,2024
VEN,VE,C 25,Fabbricazione di prodotti in metallo (esclusi macchinari ...,3,0,11,0,14,2024
VEN,VE,C 26,Fabbricazione di computer e prodotti di elettronica e ott...,1,0,0,0,1,2024
VEN,VE,C 27,Fabbricazione di apparecchiature elettriche ed apparecchi...,2,0,1,0,3,2024
VEN,VE,C 28,Fabbricazione di macchinari ed apparecchiature nca          ,4,0,0,0,4,2024
VEN,VE,C 29,"Fabbricazione di autoveicoli, rimorchi e semirimorchi       ",1,0,0,0,1,2024
VEN,VE,C 30,Fabbricazione di altri mezzi di trasporto                   ,1,0,0,0,1,2024
VEN,VE,C 31,Fabbricazione di mobili                                     ,2,0,0,1,3,2024
VEN,VE,C 32,Altre industrie manifatturiere                              ,2,0,4,0,6,2024
VEN,VE,C 33,"Riparazione, manutenzione ed installazione di macchine ed...",2,1,4,0,7,2024
VEN,VE,D   ,"Fornitura di energia elettrica, gas, vapore e aria condiz...",0,0,0,0,0,2024
VEN,VE,D 35,"Fornitura di energia elettrica, gas, vapore e aria condiz...",0,0,0,0,0,2024
VEN,VE,E   ,"Fornitura di acqua; reti fognarie, attività di gestione d...",0,0,0,0,0,2024
VEN,VE,E 36,"Raccolta, trattamento e fornitura di acqua                  ",0,0,0,0,0,2024
VEN,VE,E 37,Gestione delle reti fognarie                                ,0,0,0,0,0,2024
VEN,VE,E 38,"Attività di raccolta, trattamento e smaltimento dei rifiu...",0,0,0,0,0,2024
VEN,VE,E 39,Attività di risanamento e altri servizi di gestione dei r...,0,0,0,0,0,2024
VEN,VE,F   ,Costruzioni                                                 ,35,9,94,16,154,2024
VEN,VE,F 41,Costruzione di edifici                                      ,25,2,16,10,53,2024
VEN,VE,F 42,Ingegneria civile                                           ,1,0,0,0,1,2024
VEN,VE,F 43,Lavori di costruzione specializzati                         ,9,7,78,6,100,2024
VEN,VE,G   ,Commercio all'ingrosso e al dettaglio; riparazione di aut...,78,18,147,0,243,2024
VEN,VE,G 45,Commercio all'ingrosso e al dettaglio e riparazione di au...,7,3,17,0,27,2024
VEN,VE,G 46,Commercio all'ingrosso (escluso quello di autoveicoli e d...,37,2,36,0,75,2024
VEN,VE,G 47,Commercio al dettaglio (escluso quello di autoveicoli e d...,34,13,94,0,141,2024
VEN,VE,H   ,Trasporto e magazzinaggio                                   ,16,4,23,24,67,2024
VEN,VE,H 49,Trasporto terrestre e mediante condotte                     ,5,4,10,3,22,2024
VEN,VE,H 50,Trasporto marittimo e per vie d'acqua                       ,2,0,6,2,10,2024
VEN,VE,H 51,Trasporto aereo                                             ,2,0,0,0,2,2024
VEN,VE,H 52,Magazzinaggio e attività di supporto ai trasporti           ,6,0,6,19,31,2024
VEN,VE,H 53,Servizi postali e attività di corriere                      ,1,0,1,0,2,2024
VEN,VE,I   ,Attività dei servizi alloggio e ristorazione                ,32,36,53,7,128,2024
VEN,VE,I 55,Alloggio                                                    ,9,1,1,3,14,2024
VEN,VE,I 56,Attività dei servizi di ristorazione                        ,23,35,52,4,114,2024
VEN,VE,J   ,Servizi di informazione e comunicazione                     ,12,5,5,1,23,2024
VEN,VE,J 58,Attività editoriali                                         ,3,0,0,0,3,2024
VEN,VE,J 59,"Attività di produzione cinematografica, di video e di pro...",1,0,2,0,3,2024
VEN,VE,J 60,Attività di programmazione e trasmissione                   ,0,0,0,1,1,2024
VEN,VE,J 61,Telecomunicazioni                                           ,0,1,2,0,3,2024
VEN,VE,J 62,"Produzione di software, consulenza informatica e attività...",4,1,0,0,5,2024
VEN,VE,J 63,Attività dei servizi d'informazione e altri servizi infor...,4,3,1,0,8,2024
VEN,VE,K   ,Attività finanziarie e assicurative                         ,6,0,8,0,14,2024
VEN,VE,K 64,Attività di servizi finanziari (escluse le assicurazioni ...,3,0,0,0,3,2024
VEN,VE,K 65,"Assicurazioni, riassicurazioni e fondi pensione (escluse ...",0,0,0,0,0,2024
VEN,VE,K 66,Attività ausiliarie dei servizi finanziari e delle attivi...,3,0,8,0,11,2024
VEN,VE,L   ,Attivita' immobiliari                                       ,26,7,1,0,34,2024
VEN,VE,L 68,Attivita' immobiliari                                       ,26,7,1,0,34,2024
VEN,VE,M   ,"Attività professionali, scientifiche e tecniche             ",28,5,13,6,52,2024
VEN,VE,M 69,Attività legali e contabilità                               ,0,0,0,1,1,2024
VEN,VE,M 70,Attività di direzione aziendale e di consulenza gestional...,7,2,4,4,17,2024
VEN,VE,M 71,Attività degli studi di architettura e d'ingegneria; coll...,3,0,0,0,3,2024
VEN,VE,M 72,Ricerca scientifica e sviluppo                              ,2,0,0,1,3,2024
VEN,VE,M 73,Pubblicità e ricerche di mercato                            ,6,1,3,0,10,2024
VEN,VE,M 74,"Altre attività professionali, scientifiche e tecniche       ",10,2,6,0,18,2024
VEN,VE,M 75,Servizi veterinari                                          ,0,0,0,0,0,2024
VEN,VE,N   ,"Noleggio, agenzie di viaggio, servizi di supporto alle im...",16,2,10,7,35,2024
VEN,VE,N 77,Attività di noleggio e leasing operativo                    ,3,1,2,1,7,2024
VEN,VE,N 78,"Attività di ricerca, selezione, fornitura di personale      ",1,0,0,0,1,2024
VEN,VE,N 79,"Attività dei servizi delle agenzie di viaggio, dei tour o...",5,1,1,1,8,2024
VEN,VE,N 80,Servizi di vigilanza e investigazione                       ,1,0,0,1,2,2024
VEN,VE,N 81,Attività di servizi per edifici e paesaggio                 ,2,0,3,2,7,2024
VEN,VE,N 82,Attività di supporto per le funzioni d'ufficio e altri se...,4,0,4,2,10,2024
VEN,VE,O   ,Amministrazione pubblica e difesa; assicurazione sociale ...,0,0,0,0,0,2024
VEN,VE,O 84,Amministrazione pubblica e difesa; assicurazione sociale ...,0,0,0,0,0,2024
VEN,VE,P   ,Istruzione                                                  ,3,1,0,1,5,2024
VEN,VE,P 85,Istruzione                                                  ,3,1,0,1,5,2024
VEN,VE,Q   ,Sanita' e assistenza sociale                                ,1,0,0,3,4,2024
VEN,VE,Q 86,Assistenza sanitaria                                        ,1,0,0,1,2,2024
VEN,VE,Q 87,Servizi di assistenza sociale residenziale                  ,0,0,0,0,0,2024
VEN,VE,Q 88,Assistenza sociale non residenziale                         ,0,0,0,2,2,2024
VEN,VE,R   ,"Attività artistiche, sportive, di intrattenimento e diver...",16,0,1,3,20,2024
VEN,VE,R 90,"Attività creative, artistiche e di intrattenimento          ",4,0,0,2,6,2024
VEN,VE,R 91,"Attività di biblioteche, archivi, musei ed altre attività...",0,0,0,0,0,2024
VEN,VE,R 92,"Attività riguardanti le lotterie, le scommesse, le case d...",0,0,1,0,1,2024
VEN,VE,R 93,"Attività sportive, di intrattenimento e di divertimento     ",12,0,0,1,13,2024
VEN,VE,S   ,Altre attività di servizi                                   ,2,3,8,2,15,2024
VEN,VE,S 94,Attività di organizzazioni associative                      ,0,0,0,0,0,2024
VEN,VE,S 95,Riparazione di computer e di beni per uso personale e per...,1,1,3,0,5,2024
VEN,VE,S 96,Altre attività di servizi per la persona                    ,1,2,5,2,10,2024
VEN,VE,T   ,Attività di famiglie e convivenze come datori di lavoro p...,0,0,0,0,0,2024
VEN,VE,T 97,Attività di famiglie e convivenze come datori di lavoro p...,0,0,0,0,0,2024
VEN,VE,T 98,Produzione di beni e servizi indifferenziati per uso prop...,0,0,0,0,0,2024
VEN,VE,U   ,Organizzazioni ed organismi extraterritoriali               ,0,0,0,0,0,2024
VEN,VE,U 99,Organizzazioni ed organismi extraterritoriali               ,0,0,0,0,0,2024
VEN,VE,XX  ,Imprese non classificate                                    ,56,11,27,12,106,2024
VEN,VE,TOT ,TOTALE                                                      ,369,110,472,93,1044,2024
VEN,PD,A   ,"Agricoltura, silvicoltura pesca                             ",3,43,21,15,82,2024
VEN,PD,A 01,"Coltivazioni agricole e produzione di prodotti animali, c...",3,43,20,15,81,2024
VEN,PD,A 02,Silvicoltura ed utilizzo di aree forestali                  ,0,0,1,0,1,2024
VEN,PD,A 03,Pesca e acquacoltura                                        ,0,0,0,0,0,2024
VEN,PD,B   ,Estrazione di minerali da cave e miniere                    ,2,0,0,0,2,2024
VEN,PD,B 05,Estrazione di carbone (esclusa torba)                       ,0,0,0,0,0,2024
VEN,PD,B 06,Estraz.di petrolio greggio e di gas naturale                ,0,0,0,0,0,2024
VEN,PD,B 07,Estrazione di minerali metalliferi                          ,0,0,0,0,0,2024
VEN,PD,B 08,Altre attività di estrazione di minerali da cave e miniere  ,2,0,0,0,2,2024
VEN,PD,B 09,Attività dei servizi di supporto all'estrazione             ,0,0,0,0,0,2024
VEN,PD,C   ,Attività manifatturiere                                     ,149,79,47,15,290,2024
VEN,PD,C 10,Industrie alimentari                                        ,7,6,2,1,16,2024
VEN,PD,C 11,Industria delle bevande                                     ,1,0,0,0,1,2024
VEN,PD,C 12,Industria del tabacco                                       ,0,0,0,0,0,2024
VEN,PD,C 13,Industrie tessili                                           ,7,3,0,0,10,2024
VEN,PD,C 14,Confezione di articoli di abbigliamento; confezione di ar...,30,10,18,2,60,2024
VEN,PD,C 15,Fabbricazione di articoli in pelle e simili                 ,14,1,2,0,17,2024
VEN,PD,C 16,Industria del legno e dei prodotti in legno e sughero (es...,1,2,3,2,8,2024
VEN,PD,C 17,Fabbricazione di carta e di prodotti di carta               ,2,0,0,0,2,2024
VEN,PD,C 18,Stampa e riproduzione di supporti registrati                ,4,4,1,1,10,2024
VEN,PD,C 19,Fabbricazione di coke e prodotti derivanti dalla raffinaz...,0,0,0,0,0,2024
VEN,PD,C 20,Fabbricazione di prodotti chimici                           ,2,2,0,0,4,2024
VEN,PD,C 21,Fabbricazione di prodotti farmaceutici di base e di prepa...,0,0,0,0,0,2024
VEN,PD,C 22,Fabbricazione di articoli in gomma e materie plastiche      ,4,0,1,1,6,2024
VEN,PD,C 23,Fabbricazione di altri prodotti della lavorazione di miner..,6,1,0,0,7,2024
VEN,PD,C 24,Metallurgia                                                 ,1,0,0,0,1,2024
VEN,PD,C 25,Fabbricazione di prodotti in metallo (esclusi macchinari ...,13,17,8,4,42,2024
VEN,PD,C 26,Fabbricazione di computer e prodotti di elettronica e ott...,5,2,1,1,9,2024
VEN,PD,C 27,Fabbricazione di apparecchiature elettriche ed apparecchi...,9,2,1,1,13,2024
VEN,PD,C 28,Fabbricazione di macchinari ed apparecchiature nca          ,18,5,3,1,27,2024
VEN,PD,C 29,"Fabbricazione di autoveicoli, rimorchi e semirimorchi       ",0,2,0,0,2,2024
VEN,PD,C 30,Fabbricazione di altri mezzi di trasporto                   ,2,1,0,0,3,2024
VEN,PD,C 31,Fabbricazione di mobili                                     ,17,10,1,0,28,2024
VEN,PD,C 32,Altre industrie manifatturiere                              ,6,8,3,0,17,2024
VEN,PD,C 33,"Riparazione, manutenzione ed installazione di macchine ed...",0,3,3,1,7,2024
VEN,PD,D   ,"Fornitura di energia elettrica, gas, vapore e aria condiz...",1,0,0,0,1,2024
VEN,PD,D 35,"Fornitura di energia elettrica, gas, vapore e aria condiz...",1,0,0,0,1,2024
VEN,PD,E   ,"Fornitura di acqua; reti fognarie, attività di gestione d...",1,0,0,0,1,2024
VEN,PD,E 36,"Raccolta, trattamento e fornitura di acqua                  ",0,0,0,0,0,2024
VEN,PD,E 37,Gestione delle reti fognarie                                ,0,0,0,0,0,2024
VEN,PD,E 38,"Attività di raccolta, trattamento e smaltimento dei rifiu...",1,0,0,0,1,2024
VEN,PD,E 39,Attività di risanamento e altri servizi di gestione dei r...,0,0,0,0,0,2024
VEN,PD,F   ,Costruzioni                                                 ,64,86,133,22,305,2024
VEN,PD,F 41,Costruzione di edifici                                      ,35,31,23,8,97,2024
VEN,PD,F 42,Ingegneria civile                                           ,2,0,0,0,2,2024
VEN,PD,F 43,Lavori di costruzione specializzati                         ,27,55,110,14,206,2024
VEN,PD,G   ,Commercio all'ingrosso e al dettaglio; riparazione di aut...,140,144,141,6,431,2024
VEN,PD,G 45,Commercio all'ingrosso e al dettaglio e riparazione di au...,5,13,30,1,49,2024
VEN,PD,G 46,Commercio all'ingrosso (escluso quello di autoveicoli e d...,95,51,28,1,175,2024
VEN,PD,G 47,Commercio al dettaglio (escluso quello di autoveicoli e d...,40,80,83,4,207,2024
VEN,PD,H   ,Trasporto e magazzinaggio                                   ,10,15,24,46,95,2024
VEN,PD,H 49,Trasporto terrestre e mediante condotte                     ,5,13,21,5,44,2024
VEN,PD,H 50,Trasporto marittimo e per vie d'acqua                       ,0,0,0,0,0,2024
VEN,PD,H 51,Trasporto aereo                                             ,0,0,0,0,0,2024
VEN,PD,H 52,Magazzinaggio e attività di supporto ai trasporti           ,5,1,3,41,50,2024
VEN,PD,H 53,Servizi postali e attività di corriere                      ,0,1,0,0,1,2024
VEN,PD,I   ,Attività dei servizi alloggio e ristorazione                ,28,123,27,1,179,2024
VEN,PD,I 55,Alloggio                                                    ,4,3,0,0,7,2024
VEN,PD,I 56,Attività dei servizi di ristorazione                        ,24,120,27,1,172,2024
VEN,PD,J   ,Servizi di informazione e comunicazione                     ,22,22,6,1,51,2024
VEN,PD,J 58,Attività editoriali                                         ,2,2,1,0,5,2024
VEN,PD,J 59,"Attività di produzione cinematografica, di video e di pro...",1,0,1,0,2,2024
VEN,PD,J 60,Attività di programmazione e trasmissione                   ,2,0,0,0,2,2024
VEN,PD,J 61,Telecomunicazioni                                           ,1,1,2,0,4,2024
VEN,PD,J 62,"Produzione di software, consulenza informatica e attività...",12,8,1,1,22,2024
VEN,PD,J 63,Attività dei servizi d'informazione e altri servizi infor...,4,11,1,0,16,2024
VEN,PD,K   ,Attività finanziarie e assicurative                         ,8,17,3,2,30,2024
VEN,PD,K 64,Attività di servizi finanziari (escluse le assicurazioni ...,8,5,0,2,15,2024
VEN,PD,K 65,"Assicurazioni, riassicurazioni e fondi pensione (escluse ...",0,0,0,0,0,2024
VEN,PD,K 66,Attività ausiliarie dei servizi finanziari e delle attivi...,0,12,3,0,15,2024
VEN,PD,L   ,Attivita' immobiliari                                       ,35,104,1,3,143,2024
VEN,PD,L 68,Attivita' immobiliari                                       ,35,104,1,3,143,2024
VEN,PD,M   ,"Attività professionali, scientifiche e tecniche             ",29,44,11,11,95,2024
VEN,PD,M 69,Attività legali e contabilità                               ,0,2,0,1,3,2024
VEN,PD,M 70,Attività di direzione aziendale e di consulenza gestional...,10,16,2,5,33,2024
VEN,PD,M 71,Attività degli studi di architettura e d'ingegneria; coll...,2,2,0,0,4,2024
VEN,PD,M 72,Ricerca scientifica e sviluppo                              ,0,1,0,1,2,2024
VEN,PD,M 73,Pubblicità e ricerche di mercato                            ,8,7,5,4,24,2024
VEN,PD,M 74,"Altre attività professionali, scientifiche e tecniche       ",9,16,4,0,29,2024
VEN,PD,M 75,Servizi veterinari                                          ,0,0,0,0,0,2024
VEN,PD,N   ,"Noleggio, agenzie di viaggio, servizi di supporto alle im...",17,16,10,15,58,2024
VEN,PD,N 77,Attività di noleggio e leasing operativo                    ,3,1,0,0,4,2024
VEN,PD,N 78,"Attività di ricerca, selezione, fornitura di personale      ",0,1,0,0,1,2024
VEN,PD,N 79,"Attività dei servizi delle agenzie di viaggio, dei tour o...",2,2,0,0,4,2024
VEN,PD,N 80,Servizi di vigilanza e investigazione                       ,1,0,0,0,1,2024
VEN,PD,N 81,Attività di servizi per edifici e paesaggio                 ,2,2,6,12,22,2024
VEN,PD,N 82,Attività di supporto per le funzioni d'ufficio e altri se...,9,10,4,3,26,2024
VEN,PD,O   ,Amministrazione pubblica e difesa; assicurazione sociale ...,0,0,0,0,0,2024
VEN,PD,O 84,Amministrazione pubblica e difesa; assicurazione sociale ...,0,0,0,0,0,2024
VEN,PD,P   ,Istruzione                                                  ,1,2,0,1,4,2024
VEN,PD,P 85,Istruzione                                                  ,1,2,0,1,4,2024
VEN,PD,Q   ,Sanita' e assistenza sociale                                ,1,1,0,7,9,2024
VEN,PD,Q 86,Assistenza sanitaria                                        ,1,1,0,2,4,2024
VEN,PD,Q 87,Servizi di assistenza sociale residenziale                  ,0,0,0,0,0,2024
VEN,PD,Q 88,Assistenza sociale non residenziale                         ,0,0,0,5,5,2024
VEN,PD,R   ,"Attività artistiche, sportive, di intrattenimento e diver...",12,8,2,4,26,2024
VEN,PD,R 90,"Attività creative, artistiche e di intrattenimento          ",1,2,0,1,4,2024
VEN,PD,R 91,"Attività di biblioteche, archivi, musei ed altre attività...",0,0,0,0,0,2024
VEN,PD,R 92,"Attività riguardanti le lotterie, le scommesse, le case d...",1,2,0,0,3,2024
VEN,PD,R 93,"Attività sportive, di intrattenimento e di divertimento     ",10,4,2,3,19,2024
VEN,PD,S   ,Altre attività di servizi                                   ,7,25,7,2,41,2024
VEN,PD,S 94,Attività di organizzazioni associative                      ,0,0,0,0,0,2024
VEN,PD,S 95,Riparazione di computer e di beni per uso personale e per...,1,6,4,0,11,2024
VEN,PD,S 96,Altre attività di servizi per la persona                    ,6,19,3,2,30,2024
VEN,PD,T   ,Attività di famiglie e convivenze come datori di lavoro p...,0,0,0,0,0,2024
VEN,PD,T 97,Attività di famiglie e convivenze come datori di lavoro p...,0,0,0,0,0,2024
VEN,PD,T 98,Produzione di beni e servizi indifferenziati per uso prop...,0,0,0,0,0,2024
VEN,PD,U   ,Organizzazioni ed organismi extraterritoriali               ,0,0,0,0,0,2024
VEN,PD,U 99,Organizzazioni ed organismi extraterritoriali               ,0,0,0,0,0,2024
VEN,PD,XX  ,Imprese non classificate                                    ,75,23,24,26,148,2024
VEN,PD,TOT ,TOTALE                                                      ,605,752,457,177,1991,2024
VEN,RO,A   ,"Agricoltura, silvicoltura pesca                             ",1,2,7,13,23,2024
VEN,RO,A 01,"Coltivazioni agricole e produzione di prodotti animali, c...",1,2,6,12,21,2024
VEN,RO,A 02,Silvicoltura ed utilizzo di aree forestali                  ,0,0,0,0,0,2024
VEN,RO,A 03,Pesca e acquacoltura                                        ,0,0,1,1,2,2024
VEN,RO,B   ,Estrazione di minerali da cave e miniere                    ,1,0,0,0,1,2024
VEN,RO,B 05,Estrazione di carbone (esclusa torba)                       ,0,0,0,0,0,2024
VEN,RO,B 06,Estraz.di petrolio greggio e di gas naturale                ,1,0,0,0,1,2024
VEN,RO,B 07,Estrazione di minerali metalliferi                          ,0,0,0,0,0,2024
VEN,RO,B 08,Altre attività di estrazione di minerali da cave e miniere  ,0,0,0,0,0,2024
VEN,RO,B 09,Attività dei servizi di supporto all'estrazione             ,0,0,0,0,0,2024
VEN,RO,C   ,Attività manifatturiere                                     ,14,9,6,3,32,2024
VEN,RO,C 10,Industrie alimentari                                        ,3,1,0,0,4,2024
VEN,RO,C 11,Industria delle bevande                                     ,0,0,0,0,0,2024
VEN,RO,C 12,Industria del tabacco                                       ,0,0,0,0,0,2024
VEN,RO,C 13,Industrie tessili                                           ,0,0,0,0,0,2024
VEN,RO,C 14,Confezione di articoli di abbigliamento; confezione di ar...,4,3,4,0,11,2024
VEN,RO,C 15,Fabbricazione di articoli in pelle e simili                 ,0,0,0,0,0,2024
VEN,RO,C 16,Industria del legno e dei prodotti in legno e sughero (es...,0,0,0,0,0,2024
VEN,RO,C 17,Fabbricazione di carta e di prodotti di carta               ,0,0,0,0,0,2024
VEN,RO,C 18,Stampa e riproduzione di supporti registrati                ,0,0,0,0,0,2024
VEN,RO,C 19,Fabbricazione di coke e prodotti derivanti dalla raffinaz...,0,0,0,0,0,2024
VEN,RO,C 20,Fabbricazione di prodotti chimici                           ,1,0,1,0,2,2024
VEN,RO,C 21,Fabbricazione di prodotti farmaceutici di base e di prepa...,0,0,0,0,0,2024
VEN,RO,C 22,Fabbricazione di articoli in gomma e materie plastiche      ,0,0,0,0,0,2024
VEN,RO,C 23,Fabbricazione di altri prodotti della lavorazione di miner..,1,2,0,0,3,2024
VEN,RO,C 24,Metallurgia                                                 ,1,0,0,0,1,2024
VEN,RO,C 25,Fabbricazione di prodotti in metallo (esclusi macchinari ...,2,0,0,3,5,2024
VEN,RO,C 26,Fabbricazione di computer e prodotti di elettronica e ott...,1,0,0,0,1,2024
VEN,RO,C 27,Fabbricazione di apparecchiature elettriche ed apparecchi...,0,1,0,0,1,2024
VEN,RO,C 28,Fabbricazione di macchinari ed apparecchiature nca          ,1,1,0,0,2,2024
VEN,RO,C 29,"Fabbricazione di autoveicoli, rimorchi e semirimorchi       ",0,0,0,0,0,2024
VEN,RO,C 30,Fabbricazione di altri mezzi di trasporto                   ,0,0,0,0,0,2024
VEN,RO,C 31,Fabbricazione di mobili                                     ,0,1,0,0,1,2024
VEN,RO,C 32,Altre industrie manifatturiere                              ,0,0,1,0,1,2024
VEN,RO,C 33,"Riparazione, manutenzione ed installazione di macchine ed...",0,0,0,0,0,2024
VEN,RO,D   ,"Fornitura di energia elettrica, gas, vapore e aria condiz...",0,0,0,0,0,2024
VEN,RO,D 35,"Fornitura di energia elettrica, gas, vapore e aria condiz...",0,0,0,0,0,2024
VEN,RO,E   ,"Fornitura di acqua; reti fognarie, attività di gestione d...",1,0,0,0,1,2024
VEN,RO,E 36,"Raccolta, trattamento e fornitura di acqua                  ",0,0,0,0,0,2024
VEN,RO,E 37,Gestione delle reti fognarie                                ,0,0,0,0,0,2024
VEN,RO,E 38,"Attività di raccolta, trattamento e smaltimento dei rifiu...",1,0,0,0,1,2024
VEN,RO,E 39,Attività di risanamento e altri servizi di gestione dei r...,0,0,0,0,0,2024
VEN,RO,F   ,Costruzioni                                                 ,18,4,7,7,36,2024
VEN,RO,F 41,Costruzione di edifici                                      ,13,3,1,6,23,2024
VEN,RO,F 42,Ingegneria civile                                           ,0,0,0,1,1,2024
VEN,RO,F 43,Lavori di costruzione specializzati                         ,5,1,6,0,12,2024
VEN,RO,G   ,Commercio all'ingrosso e al dettaglio; riparazione di aut...,23,5,17,1,46,2024
VEN,RO,G 45,Commercio all'ingrosso e al dettaglio e riparazione di au...,2,1,5,1,9,2024
VEN,RO,G 46,Commercio all'ingrosso (escluso quello di autoveicoli e d...,11,1,1,0,13,2024
VEN,RO,G 47,Commercio al dettaglio (escluso quello di autoveicoli e d...,10,3,11,0,24,2024
VEN,RO,H   ,Trasporto e magazzinaggio                                   ,1,0,1,6,8,2024
VEN,RO,H 49,Trasporto terrestre e mediante condotte                     ,1,0,1,2,4,2024
VEN,RO,H 50,Trasporto marittimo e per vie d'acqua                       ,0,0,0,0,0,2024
VEN,RO,H 51,Trasporto aereo                                             ,0,0,0,0,0,2024
VEN,RO,H 52,Magazzinaggio e attività di supporto ai trasporti           ,0,0,0,4,4,2024
VEN,RO,H 53,Servizi postali e attività di corriere                      ,0,0,0,0,0,2024
VEN,RO,I   ,Attività dei servizi alloggio e ristorazione                ,7,3,3,0,13,2024
VEN,RO,I 55,Alloggio                                                    ,0,0,0,0,0,2024
VEN,RO,I 56,Attività dei servizi di ristorazione                        ,7,3,3,0,13,2024
VEN,RO,J   ,Servizi di informazione e comunicazione                     ,2,0,1,0,3,2024
VEN,RO,J 58,Attività editoriali                                         ,0,0,0,0,0,2024
VEN,RO,J 59,"Attività di produzione cinematografica, di video e di pro...",0,0,0,0,0,2024
VEN,RO,J 60,Attività di programmazione e trasmissione                   ,0,0,0,0,0,2024
VEN,RO,J 61,Telecomunicazioni                                           ,0,0,0,0,0,2024
VEN,RO,J 62,"Produzione di software, consulenza informatica e attività...",0,0,0,0,0,2024
VEN,RO,J 63,Attività dei servizi d'informazione e altri servizi infor...,2,0,1,0,3,2024
VEN,RO,K   ,Attività finanziarie e assicurative                         ,2,0,0,1,3,2024
VEN,RO,K 64,Attività di servizi finanziari (escluse le assicurazioni ...,2,0,0,1,3,2024
VEN,RO,K 65,"Assicurazioni, riassicurazioni e fondi pensione (escluse ...",0,0,0,0,0,2024
VEN,RO,K 66,Attività ausiliarie dei servizi finanziari e delle attivi...,0,0,0,0,0,2024
VEN,RO,L   ,Attivita' immobiliari                                       ,9,0,0,1,10,2024
VEN,RO,L 68,Attivita' immobiliari                                       ,9,0,0,1,10,2024
VEN,RO,M   ,"Attività professionali, scientifiche e tecniche             ",5,3,1,1,10,2024
VEN,RO,M 69,Attività legali e contabilità                               ,0,0,0,0,0,2024
VEN,RO,M 70,Attività di direzione aziendale e di consulenza gestional...,3,0,0,0,3,2024
VEN,RO,M 71,Attività degli studi di architettura e d'ingegneria; coll...,0,0,0,0,0,2024
VEN,RO,M 72,Ricerca scientifica e sviluppo                              ,0,0,0,0,0,2024
VEN,RO,M 73,Pubblicità e ricerche di mercato                            ,0,0,1,1,2,2024
VEN,RO,M 74,"Altre attività professionali, scientifiche e tecniche       ",2,2,0,0,4,2024
VEN,RO,M 75,Servizi veterinari                                          ,0,1,0,0,1,2024
VEN,RO,N   ,"Noleggio, agenzie di viaggio, servizi di supporto alle im...",3,0,0,8,11,2024
VEN,RO,N 77,Attività di noleggio e leasing operativo                    ,1,0,0,0,1,2024
VEN,RO,N 78,"Attività di ricerca, selezione, fornitura di personale      ",0,0,0,0,0,2024
VEN,RO,N 79,"Attività dei servizi delle agenzie di viaggio, dei tour o...",0,0,0,0,0,2024
VEN,RO,N 80,Servizi di vigilanza e investigazione                       ,0,0,0,0,0,2024
VEN,RO,N 81,Attività di servizi per edifici e paesaggio                 ,0,0,0,6,6,2024
VEN,RO,N 82,Attività di supporto per le funzioni d'ufficio e altri se...,2,0,0,2,4,2024
VEN,RO,O   ,Amministrazione pubblica e difesa; assicurazione sociale ...,0,0,0,0,0,2024
VEN,RO,O 84,Amministrazione pubblica e difesa; assicurazione sociale ...,0,0,0,0,0,2024
VEN,RO,P   ,Istruzione                                                  ,0,0,0,0,0,2024
VEN,RO,P 85,Istruzione                                                  ,0,0,0,0,0,2024
VEN,RO,Q   ,Sanita' e assistenza sociale                                ,0,0,0,2,2,2024
VEN,RO,Q 86,Assistenza sanitaria                                        ,0,0,0,0,0,2024
VEN,RO,Q 87,Servizi di assistenza sociale residenziale                  ,0,0,0,0,0,2024
VEN,RO,Q 88,Assistenza sociale non residenziale                         ,0,0,0,2,2,2024
VEN,RO,R   ,"Attività artistiche, sportive, di intrattenimento e diver...",6,1,0,4,11,2024
VEN,RO,R 90,"Attività creative, artistiche e di intrattenimento          ",2,0,0,2,4,2024
VEN,RO,R 91,"Attività di biblioteche, archivi, musei ed altre attività...",0,0,0,1,1,2024
VEN,RO,R 92,"Attività riguardanti le lotterie, le scommesse, le case d...",1,0,0,0,1,2024
VEN,RO,R 93,"Attività sportive, di intrattenimento e di divertimento     ",3,1,0,1,5,2024
VEN,RO,S   ,Altre attività di servizi                                   ,0,0,1,0,1,2024
VEN,RO,S 94,Attività di organizzazioni associative                      ,0,0,0,0,0,2024
VEN,RO,S 95,Riparazione di computer e di beni per uso personale e per...,0,0,0,0,0,2024
VEN,RO,S 96,Altre attività di servizi per la persona                    ,0,0,1,0,1,2024
VEN,RO,T   ,Attività di famiglie e convivenze come datori di lavoro p...,0,0,0,0,0,2024
VEN,RO,T 97,Attività di famiglie e convivenze come datori di lavoro p...,0,0,0,0,0,2024
VEN,RO,T 98,Produzione di beni e servizi indifferenziati per uso prop...,0,0,0,0,0,2024
VEN,RO,U   ,Organizzazioni ed organismi extraterritoriali               ,0,0,0,0,0,2024
VEN,RO,U 99,Organizzazioni ed organismi extraterritoriali               ,0,0,0,0,0,2024
VEN,RO,XX  ,Imprese non classificate                                    ,37,14,2,11,64,2024
VEN,RO,TOT ,TOTALE                                                      ,130,41,46,58,275,2024
FVG,  ,A   ,"Agricoltura, silvicoltura pesca                             ",7,1,2,1,11,2024
FVG,  ,A 01,"Coltivazioni agricole e produzione di prodotti animali, c...",7,1,2,0,10,2024
FVG,  ,A 02,Silvicoltura ed utilizzo di aree forestali                  ,0,0,0,0,0,2024
FVG,  ,A 03,Pesca e acquacoltura                                        ,0,0,0,1,1,2024
FVG,  ,B   ,Estrazione di minerali da cave e miniere                    ,2,0,0,0,2,2024
FVG,  ,B 05,Estrazione di carbone (esclusa torba)                       ,0,0,0,0,0,2024
FVG,  ,B 06,Estraz.di petrolio greggio e di gas naturale                ,0,0,0,0,0,2024
FVG,  ,B 07,Estrazione di minerali metalliferi                          ,1,0,0,0,1,2024
FVG,  ,B 08,Altre attività di estrazione di minerali da cave e miniere  ,1,0,0,0,1,2024
FVG,  ,B 09,Attività dei servizi di supporto all'estrazione             ,0,0,0,0,0,2024
FVG,  ,C   ,Attività manifatturiere                                     ,220,0,9,0,229,2024
FVG,  ,C 10,Industrie alimentari                                        ,15,0,1,0,16,2024
FVG,  ,C 11,Industria delle bevande                                     ,0,0,0,0,0,2024
FVG,  ,C 12,Industria del tabacco                                       ,0,0,0,0,0,2024
FVG,  ,C 13,Industrie tessili                                           ,2,0,0,0,2,2024
FVG,  ,C 14,Confezione di articoli di abbigliamento; confezione di ar...,15,0,0,0,15,2024
FVG,  ,C 15,Fabbricazione di articoli in pelle e simili                 ,2,0,0,0,2,2024
FVG,  ,C 16,Industria del legno e dei prodotti in legno e sughero (es...,11,0,0,0,11,2024
FVG,  ,C 17,Fabbricazione di carta e di prodotti di carta               ,1,0,0,0,1,2024
FVG,  ,C 18,Stampa e riproduzione di supporti registrati                ,8,0,1,0,9,2024
FVG,  ,C 19,Fabbricazione di coke e prodotti derivanti dalla raffinaz...,0,0,0,0,0,2024
FVG,  ,C 20,Fabbricazione di prodotti chimici                           ,5,0,0,0,5,2024
FVG,  ,C 21,Fabbricazione di prodotti farmaceutici di base e di prepa...,0,0,0,0,0,2024
FVG,  ,C 22,Fabbricazione di articoli in gomma e materie plastiche      ,5,0,0,0,5,2024
FVG,  ,C 23,Fabbricazione di altri prodotti della lavorazione di miner..,8,0,0,0,8,2024
FVG,  ,C 24,Metallurgia                                                 ,3,0,0,0,3,2024
FVG,  ,C 25,Fabbricazione di prodotti in metallo (esclusi macchinari ...,37,0,4,0,41,2024
FVG,  ,C 26,Fabbricazione di computer e prodotti di elettronica e ott...,6,0,0,0,6,2024
FVG,  ,C 27,Fabbricazione di apparecchiature elettriche ed apparecchi...,6,0,0,0,6,2024
FVG,  ,C 28,Fabbricazione di macchinari ed apparecchiature nca          ,32,0,0,0,32,2024
FVG,  ,C 29,"Fabbricazione di autoveicoli, rimorchi e semirimorchi       ",3,0,0,0,3,2024
FVG,  ,C 30,Fabbricazione di altri mezzi di trasporto                   ,5,0,0,0,5,2024
FVG,  ,C 31,Fabbricazione di mobili                                     ,51,0,0,0,51,2024
FVG,  ,C 32,Altre industrie manifatturiere                              ,3,0,2,0,5,2024
FVG,  ,C 33,"Riparazione, manutenzione ed installazione di macchine ed...",2,0,1,0,3,2024
FVG,  ,D   ,"Fornitura di energia elettrica, gas, vapore e aria condiz...",1,0,0,0,1,2024
FVG,  ,D 35,"Fornitura di energia elettrica, gas, vapore e aria condiz...",1,0,0,0,1,2024
FVG,  ,E   ,"Fornitura di acqua; reti fognarie, attività di gestione d...",3,0,1,0,4,2024
FVG,  ,E 36,"Raccolta, trattamento e fornitura di acqua                  ",1,0,0,0,1,2024
FVG,  ,E 37,Gestione delle reti fognarie                                ,0,0,0,0,0,2024
FVG,  ,E 38,"Attività di raccolta, trattamento e smaltimento dei rifiu...",2,0,0,0,2,2024
FVG,  ,E 39,Attività di risanamento e altri servizi di gestione dei r...,0,0,1,0,1,2024
FVG,  ,F   ,Costruzioni                                                 ,82,8,23,1,114,2024
FVG,  ,F 41,Costruzione di edifici                                      ,79,4,5,1,89,2024
FVG,  ,F 42,Ingegneria civile                                           ,1,0,0,0,1,2024
FVG,  ,F 43,Lavori di costruzione specializzati                         ,2,4,18,0,24,2024
FVG,  ,G   ,Commercio all'ingrosso e al dettaglio; riparazione di aut...,242,8,46,0,296,2024
FVG,  ,G 45,Commercio all'ingrosso e al dettaglio e riparazione di au...,13,1,7,0,21,2024
FVG,  ,G 46,Commercio all'ingrosso (escluso quello di autoveicoli e d...,164,0,11,0,175,2024
FVG,  ,G 47,Commercio al dettaglio (escluso quello di autoveicoli e d...,65,7,28,0,100,2024
FVG,  ,H   ,Trasporto e magazzinaggio                                   ,15,0,5,0,20,2024
FVG,  ,H 49,Trasporto terrestre e mediante condotte                     ,7,0,4,0,11,2024
FVG,  ,H 50,Trasporto marittimo e per vie d'acqua                       ,0,0,1,0,1,2024
FVG,  ,H 51,Trasporto aereo                                             ,0,0,0,0,0,2024
FVG,  ,H 52,Magazzinaggio e attività di supporto ai trasporti           ,8,0,0,0,8,2024
FVG,  ,H 53,Servizi postali e attività di corriere                      ,0,0,0,0,0,2024
FVG,  ,I   ,Attività dei servizi alloggio e ristorazione                ,55,17,16,0,88,2024
FVG,  ,I 55,Alloggio                                                    ,6,0,0,0,6,2024
FVG,  ,I 56,Attività dei servizi di ristorazione                        ,49,17,16,0,82,2024
FVG,  ,J   ,Servizi di informazione e comunicazione                     ,24,0,2,0,26,2024
FVG,  ,J 58,Attività editoriali                                         ,3,0,0,0,3,2024
FVG,  ,J 59,"Attività di produzione cinematografica, di video e di pro...",0,0,0,0,0,2024
FVG,  ,J 60,Attività di programmazione e trasmissione                   ,0,0,0,0,0,2024
FVG,  ,J 61,Telecomunicazioni                                           ,1,0,1,0,2,2024
FVG,  ,J 62,"Produzione di software, consulenza informatica e attività...",14,0,1,0,15,2024
FVG,  ,J 63,Attività dei servizi d'informazione e altri servizi infor...,6,0,0,0,6,2024
FVG,  ,K   ,Attività finanziarie e assicurative                         ,18,0,0,0,18,2024
FVG,  ,K 64,Attività di servizi finanziari (escluse le assicurazioni ...,16,0,0,0,16,2024
FVG,  ,K 65,"Assicurazioni, riassicurazioni e fondi pensione (escluse ...",1,0,0,0,1,2024
FVG,  ,K 66,Attività ausiliarie dei servizi finanziari e delle attivi...,1,0,0,0,1,2024
FVG,  ,L   ,Attivita' immobiliari                                       ,66,3,1,0,70,2024
FVG,  ,L 68,Attivita' immobiliari                                       ,66,3,1,0,70,2024
FVG,  ,M   ,"Attività professionali, scientifiche e tecniche             ",47,0,1,0,48,2024
FVG,  ,M 69,Attività legali e contabilità                               ,3,0,0,0,3,2024
FVG,  ,M 70,Attività di direzione aziendale e di consulenza gestional...,7,0,0,0,7,2024
FVG,  ,M 71,Attività degli studi di architettura e d'ingegneria; coll...,2,0,0,0,2,2024
FVG,  ,M 72,Ricerca scientifica e sviluppo                              ,1,0,0,0,1,2024
FVG,  ,M 73,Pubblicità e ricerche di mercato                            ,6,0,1,0,7,2024
FVG,  ,M 74,"Altre attività professionali, scientifiche e tecniche       ",28,0,0,0,28,2024
FVG,  ,M 75,Servizi veterinari                                          ,0,0,0,0,0,2024
FVG,  ,N   ,"Noleggio, agenzie di viaggio, servizi di supporto alle im...",5,0,6,0,11,2024
FVG,  ,N 77,Attività di noleggio e leasing operativo                    ,2,0,1,0,3,2024
FVG,  ,N 78,"Attività di ricerca, selezione, fornitura di personale      ",0,0,0,0,0,2024
FVG,  ,N 79,"Attività dei servizi delle agenzie di viaggio, dei tour o...",0,0,0,0,0,2024
FVG,  ,N 80,Servizi di vigilanza e investigazione                       ,0,0,0,0,0,2024
FVG,  ,N 81,Attività di servizi per edifici e paesaggio                 ,0,0,2,0,2,2024
FVG,  ,N 82,Attività di supporto per le funzioni d'ufficio e altri se...,3,0,3,0,6,2024
FVG,  ,O   ,Amministrazione pubblica e difesa; assicurazione sociale ...,0,0,0,0,0,2024
FVG,  ,O 84,Amministrazione pubblica e difesa; assicurazione sociale ...,0,0,0,0,0,2024
FVG,  ,P   ,Istruzione                                                  ,3,0,0,0,3,2024
FVG,  ,P 85,Istruzione                                                  ,3,0,0,0,3,2024
FVG,  ,Q   ,Sanita' e assistenza sociale                                ,4,0,1,1,6,2024
FVG,  ,Q 86,Assistenza sanitaria                                        ,4,0,0,0,4,2024
FVG,  ,Q 87,Servizi di assistenza sociale residenziale                  ,0,0,0,0,0,2024
FVG,  ,Q 88,Assistenza sociale non residenziale                         ,0,0,1,1,2,2024
FVG,  ,R   ,"Attività artistiche, sportive, di intrattenimento e diver...",23,0,0,1,24,2024
FVG,  ,R 90,"Attività creative, artistiche e di intrattenimento          ",13,0,0,0,13,2024
FVG,  ,R 91,"Attività di biblioteche, archivi, musei ed altre attività...",0,0,0,1,1,2024
FVG,  ,R 92,"Attività riguardanti le lotterie, le scommesse, le case d...",0,0,0,0,0,2024
FVG,  ,R 93,"Attività sportive, di intrattenimento e di divertimento     ",10,0,0,0,10,2024
FVG,  ,S   ,Altre attività di servizi                                   ,3,3,6,0,12,2024
FVG,  ,S 94,Attività di organizzazioni associative                      ,0,0,0,0,0,2024
FVG,  ,S 95,Riparazione di computer e di beni per uso personale e per...,2,0,4,0,6,2024
FVG,  ,S 96,Altre attività di servizi per la persona                    ,1,3,2,0,6,2024
FVG,  ,T   ,Attività di famiglie e convivenze come datori di lavoro p...,0,0,0,0,0,2024
FVG,  ,T 97,Attività di famiglie e convivenze come datori di lavoro p...,0,0,0,0,0,2024
FVG,  ,T 98,Produzione di beni e servizi indifferenziati per uso prop...,0,0,0,0,0,2024
FVG,  ,U   ,Organizzazioni ed organismi extraterritoriali               ,0,0,0,0,0,2024
FVG,  ,U 99,Organizzazioni ed organismi extraterritoriali               ,0,0,0,0,0,2024
FVG,  ,XX  ,Imprese non classificate                                    ,24,4,6,0,34,2024
FVG,  ,TOT ,TOTALE                                                      ,844,44,125,4,1017,2024
FVG,UD,A   ,"Agricoltura, silvicoltura pesca                             ",3,0,0,0,3,2024
FVG,UD,A 01,"Coltivazioni agricole e produzione di prodotti animali, c...",3,0,0,0,3,2024
FVG,UD,A 02,Silvicoltura ed utilizzo di aree forestali                  ,0,0,0,0,0,2024
FVG,UD,A 03,Pesca e acquacoltura                                        ,0,0,0,0,0,2024
FVG,UD,B   ,Estrazione di minerali da cave e miniere                    ,1,0,0,0,1,2024
FVG,UD,B 05,Estrazione di carbone (esclusa torba)                       ,0,0,0,0,0,2024
FVG,UD,B 06,Estraz.di petrolio greggio e di gas naturale                ,0,0,0,0,0,2024
FVG,UD,B 07,Estrazione di minerali metalliferi                          ,0,0,0,0,0,2024
FVG,UD,B 08,Altre attività di estrazione di minerali da cave e miniere  ,1,0,0,0,1,2024
FVG,UD,B 09,Attività dei servizi di supporto all'estrazione             ,0,0,0,0,0,2024
FVG,UD,C   ,Attività manifatturiere                                     ,177,0,0,0,177,2024
FVG,UD,C 10,Industrie alimentari                                        ,14,0,0,0,14,2024
FVG,UD,C 11,Industria delle bevande                                     ,0,0,0,0,0,2024
FVG,UD,C 12,Industria del tabacco                                       ,0,0,0,0,0,2024
FVG,UD,C 13,Industrie tessili                                           ,2,0,0,0,2,2024
FVG,UD,C 14,Confezione di articoli di abbigliamento; confezione di ar...,11,0,0,0,11,2024
FVG,UD,C 15,Fabbricazione di articoli in pelle e simili                 ,2,0,0,0,2,2024
FVG,UD,C 16,Industria del legno e dei prodotti in legno e sughero (es...,7,0,0,0,7,2024
FVG,UD,C 17,Fabbricazione di carta e di prodotti di carta               ,0,0,0,0,0,2024
FVG,UD,C 18,Stampa e riproduzione di supporti registrati                ,8,0,0,0,8,2024
FVG,UD,C 19,Fabbricazione di coke e prodotti derivanti dalla raffinaz...,0,0,0,0,0,2024
FVG,UD,C 20,Fabbricazione di prodotti chimici                           ,5,0,0,0,5,2024
FVG,UD,C 21,Fabbricazione di prodotti farmaceutici di base e di prepa...,0,0,0,0,0,2024
FVG,UD,C 22,Fabbricazione di articoli in gomma e materie plastiche      ,2,0,0,0,2,2024
FVG,UD,C 23,Fabbricazione di altri prodotti della lavorazione di miner..,7,0,0,0,7,2024
FVG,UD,C 24,Metallurgia                                                 ,3,0,0,0,3,2024
FVG,UD,C 25,Fabbricazione di prodotti in metallo (esclusi macchinari ...,26,0,0,0,26,2024
FVG,UD,C 26,Fabbricazione di computer e prodotti di elettronica e ott...,4,0,0,0,4,2024
FVG,UD,C 27,Fabbricazione di apparecchiature elettriche ed apparecchi...,6,0,0,0,6,2024
FVG,UD,C 28,Fabbricazione di macchinari ed apparecchiature nca          ,26,0,0,0,26,2024
FVG,UD,C 29,"Fabbricazione di autoveicoli, rimorchi e semirimorchi       ",2,0,0,0,2,2024
FVG,UD,C 30,Fabbricazione di altri mezzi di trasporto                   ,4,0,0,0,4,2024
FVG,UD,C 31,Fabbricazione di mobili                                     ,46,0,0,0,46,2024
FVG,UD,C 32,Altre industrie manifatturiere                              ,0,0,0,0,0,2024
FVG,UD,C 33,"Riparazione, manutenzione ed installazione di macchine ed...",2,0,0,0,2,2024
FVG,UD,D   ,"Fornitura di energia elettrica, gas, vapore e aria condiz...",1,0,0,0,1,2024
FVG,UD,D 35,"Fornitura di energia elettrica, gas, vapore e aria condiz...",1,0,0,0,1,2024
FVG,UD,E   ,"Fornitura di acqua; reti fognarie, attività di gestione d...",2,0,0,0,2,2024
FVG,UD,E 36,"Raccolta, trattamento e fornitura di acqua                  ",1,0,0,0,1,2024
FVG,UD,E 37,Gestione delle reti fognarie                                ,0,0,0,0,0,2024
FVG,UD,E 38,"Attività di raccolta, trattamento e smaltimento dei rifiu...",1,0,0,0,1,2024
FVG,UD,E 39,Attività di risanamento e altri servizi di gestione dei r...,0,0,0,0,0,2024
FVG,UD,F   ,Costruzioni                                                 ,68,0,0,0,68,2024
FVG,UD,F 41,Costruzione di edifici                                      ,67,0,0,0,67,2024
FVG,UD,F 42,Ingegneria civile                                           ,0,0,0,0,0,2024
FVG,UD,F 43,Lavori di costruzione specializzati                         ,1,0,0,0,1,2024
FVG,UD,G   ,Commercio all'ingrosso e al dettaglio; riparazione di aut...,195,0,0,0,195,2024
FVG,UD,G 45,Commercio all'ingrosso e al dettaglio e riparazione di au...,12,0,0,0,12,2024
FVG,UD,G 46,Commercio all'ingrosso (escluso quello di autoveicoli e d...,129,0,0,0,129,2024
FVG,UD,G 47,Commercio al dettaglio (escluso quello di autoveicoli e d...,54,0,0,0,54,2024
FVG,UD,H   ,Trasporto e magazzinaggio                                   ,11,0,0,0,11,2024
FVG,UD,H 49,Trasporto terrestre e mediante condotte                     ,4,0,0,0,4,2024
FVG,UD,H 50,Trasporto marittimo e per vie d'acqua                       ,0,0,0,0,0,2024
FVG,UD,H 51,Trasporto aereo                                             ,0,0,0,0,0,2024
FVG,UD,H 52,Magazzinaggio e attività di supporto ai trasporti           ,7,0,0,0,7,2024
FVG,UD,H 53,Servizi postali e attività di corriere                      ,0,0,0,0,0,2024
FVG,UD,I   ,Attività dei servizi alloggio e ristorazione                ,49,0,0,0,49,2024
FVG,UD,I 55,Alloggio                                                    ,6,0,0,0,6,2024
FVG,UD,I 56,Attività dei servizi di ristorazione                        ,43,0,0,0,43,2024
FVG,UD,J   ,Servizi di informazione e comunicazione                     ,19,0,0,0,19,2024
FVG,UD,J 58,Attività editoriali                                         ,1,0,0,0,1,2024
FVG,UD,J 59,"Attività di produzione cinematografica, di video e di pro...",0,0,0,0,0,2024
FVG,UD,J 60,Attività di programmazione e trasmissione                   ,0,0,0,0,0,2024
FVG,UD,J 61,Telecomunicazioni                                           ,0,0,0,0,0,2024
FVG,UD,J 62,"Produzione di software, consulenza informatica e attività...",14,0,0,0,14,2024
FVG,UD,J 63,Attività dei servizi d'informazione e altri servizi infor...,4,0,0,0,4,2024
FVG,UD,K   ,Attività finanziarie e assicurative                         ,14,0,0,0,14,2024
FVG,UD,K 64,Attività di servizi finanziari (escluse le assicurazioni ...,13,0,0,0,13,2024
FVG,UD,K 65,"Assicurazioni, riassicurazioni e fondi pensione (escluse ...",0,0,0,0,0,2024
FVG,UD,K 66,Attività ausiliarie dei servizi finanziari e delle attivi...,1,0,0,0,1,2024
FVG,UD,L   ,Attivita' immobiliari                                       ,50,0,0,0,50,2024
FVG,UD,L 68,Attivita' immobiliari                                       ,50,0,0,0,50,2024
FVG,UD,M   ,"Attività professionali, scientifiche e tecniche             ",33,0,0,0,33,2024
FVG,UD,M 69,Attività legali e contabilità                               ,0,0,0,0,0,2024
FVG,UD,M 70,Attività di direzione aziendale e di consulenza gestional...,4,0,0,0,4,2024
FVG,UD,M 71,Attività degli studi di architettura e d'ingegneria; coll...,1,0,0,0,1,2024
FVG,UD,M 72,Ricerca scientifica e sviluppo                              ,1,0,0,0,1,2024
FVG,UD,M 73,Pubblicità e ricerche di mercato                            ,3,0,0,0,3,2024
FVG,UD,M 74,"Altre attività professionali, scientifiche e tecniche       ",24,0,0,0,24,2024
FVG,UD,M 75,Servizi veterinari                                          ,0,0,0,0,0,2024
FVG,UD,N   ,"Noleggio, agenzie di viaggio, servizi di supporto alle im...",4,0,0,0,4,2024
FVG,UD,N 77,Attività di noleggio e leasing operativo                    ,2,0,0,0,2,2024
FVG,UD,N 78,"Attività di ricerca, selezione, fornitura di personale      ",0,0,0,0,0,2024
FVG,UD,N 79,"Attività dei servizi delle agenzie di viaggio, dei tour o...",0,0,0,0,0,2024
FVG,UD,N 80,Servizi di vigilanza e investigazione                       ,0,0,0,0,0,2024
FVG,UD,N 81,Attività di servizi per edifici e paesaggio                 ,0,0,0,0,0,2024
FVG,UD,N 82,Attività di supporto per le funzioni d'ufficio e altri se...,2,0,0,0,2,2024
FVG,UD,O   ,Amministrazione pubblica e difesa; assicurazione sociale ...,0,0,0,0,0,2024
FVG,UD,O 84,Amministrazione pubblica e difesa; assicurazione sociale ...,0,0,0,0,0,2024
FVG,UD,P   ,Istruzione                                                  ,3,0,0,0,3,2024
FVG,UD,P 85,Istruzione                                                  ,3,0,0,0,3,2024
FVG,UD,Q   ,Sanita' e assistenza sociale                                ,2,0,0,0,2,2024
FVG,UD,Q 86,Assistenza sanitaria                                        ,2,0,0,0,2,2024
FVG,UD,Q 87,Servizi di assistenza sociale residenziale                  ,0,0,0,0,0,2024
FVG,UD,Q 88,Assistenza sociale non residenziale                         ,0,0,0,0,0,2024
FVG,UD,R   ,"Attività artistiche, sportive, di intrattenimento e diver...",18,0,0,0,18,2024
FVG,UD,R 90,"Attività creative, artistiche e di intrattenimento          ",9,0,0,0,9,2024
FVG,UD,R 91,"Attività di biblioteche, archivi, musei ed altre attività...",0,0,0,0,0,2024
FVG,UD,R 92,"Attività riguardanti le lotterie, le scommesse, le case d...",0,0,0,0,0,2024
FVG,UD,R 93,"Attività sportive, di intrattenimento e di divertimento     ",9,0,0,0,9,2024
FVG,UD,S   ,Altre attività di servizi                                   ,1,0,0,0,1,2024
FVG,UD,S 94,Attività di organizzazioni associative                      ,0,0,0,0,0,2024
FVG,UD,S 95,Riparazione di computer e di beni per uso personale e per...,1,0,0,0,1,2024
FVG,UD,S 96,Altre attività di servizi per la persona                    ,0,0,0,0,0,2024
FVG,UD,T   ,Attività di famiglie e convivenze come datori di lavoro p...,0,0,0,0,0,2024
FVG,UD,T 97,Attività di famiglie e convivenze come datori di lavoro p...,0,0,0,0,0,2024
FVG,UD,T 98,Produzione di beni e servizi indifferenziati per uso prop...,0,0,0,0,0,2024
FVG,UD,U   ,Organizzazioni ed organismi extraterritoriali               ,0,0,0,0,0,2024
FVG,UD,U 99,Organizzazioni ed organismi extraterritoriali               ,0,0,0,0,0,2024
FVG,UD,XX  ,Imprese non classificate                                    ,5,0,0,0,5,2024
FVG,UD,TOT ,TOTALE                                                      ,656,0,0,0,656,2024
FVG,GO,A   ,"Agricoltura, silvicoltura pesca                             ",0,0,2,0,2,2024
FVG,GO,A 01,"Coltivazioni agricole e produzione di prodotti animali, c...",0,0,2,0,2,2024
FVG,GO,A 02,Silvicoltura ed utilizzo di aree forestali                  ,0,0,0,0,0,2024
FVG,GO,A 03,Pesca e acquacoltura                                        ,0,0,0,0,0,2024
FVG,GO,B   ,Estrazione di minerali da cave e miniere                    ,0,0,0,0,0,2024
FVG,GO,B 05,Estrazione di carbone (esclusa torba)                       ,0,0,0,0,0,2024
FVG,GO,B 06,Estraz.di petrolio greggio e di gas naturale                ,0,0,0,0,0,2024
FVG,GO,B 07,Estrazione di minerali metalliferi                          ,0,0,0,0,0,2024
FVG,GO,B 08,Altre attività di estrazione di minerali da cave e miniere  ,0,0,0,0,0,2024
FVG,GO,B 09,Attività dei servizi di supporto all'estrazione             ,0,0,0,0,0,2024
FVG,GO,C   ,Attività manifatturiere                                     ,0,0,3,0,3,2024
FVG,GO,C 10,Industrie alimentari                                        ,0,0,0,0,0,2024
FVG,GO,C 11,Industria delle bevande                                     ,0,0,0,0,0,2024
FVG,GO,C 12,Industria del tabacco                                       ,0,0,0,0,0,2024
FVG,GO,C 13,Industrie tessili                                           ,0,0,0,0,0,2024
FVG,GO,C 14,Confezione di articoli di abbigliamento; confezione di ar...,0,0,0,0,0,2024
FVG,GO,C 15,Fabbricazione di articoli in pelle e simili                 ,0,0,0,0,0,2024
FVG,GO,C 16,Industria del legno e dei prodotti in legno e sughero (es...,0,0,0,0,0,2024
FVG,GO,C 17,Fabbricazione di carta e di prodotti di carta               ,0,0,0,0,0,2024
FVG,GO,C 18,Stampa e riproduzione di supporti registrati                ,0,0,1,0,1,2024
FVG,GO,C 19,Fabbricazione di coke e prodotti derivanti dalla raffinaz...,0,0,0,0,0,2024
FVG,GO,C 20,Fabbricazione di prodotti chimici                           ,0,0,0,0,0,2024
FVG,GO,C 21,Fabbricazione di prodotti farmaceutici di base e di prepa...,0,0,0,0,0,2024
FVG,GO,C 22,Fabbricazione di articoli in gomma e materie plastiche      ,0,0,0,0,0,2024
FVG,GO,C 23,Fabbricazione di altri prodotti della lavorazione di miner..,0,0,0,0,0,2024
FVG,GO,C 24,Metallurgia                                                 ,0,0,0,0,0,2024
FVG,GO,C 25,Fabbricazione di prodotti in metallo (esclusi macchinari ...,0,0,0,0,0,2024
FVG,GO,C 26,Fabbricazione di computer e prodotti di elettronica e ott...,0,0,0,0,0,2024
FVG,GO,C 27,Fabbricazione di apparecchiature elettriche ed apparecchi...,0,0,0,0,0,2024
FVG,GO,C 28,Fabbricazione di macchinari ed apparecchiature nca          ,0,0,0,0,0,2024
FVG,GO,C 29,"Fabbricazione di autoveicoli, rimorchi e semirimorchi       ",0,0,0,0,0,2024
FVG,GO,C 30,Fabbricazione di altri mezzi di trasporto                   ,0,0,0,0,0,2024
FVG,GO,C 31,Fabbricazione di mobili                                     ,0,0,0,0,0,2024
FVG,GO,C 32,Altre industrie manifatturiere                              ,0,0,1,0,1,2024
FVG,GO,C 33,"Riparazione, manutenzione ed installazione di macchine ed...",0,0,1,0,1,2024
FVG,GO,D   ,"Fornitura di energia elettrica, gas, vapore e aria condiz...",0,0,0,0,0,2024
FVG,GO,D 35,"Fornitura di energia elettrica, gas, vapore e aria condiz...",0,0,0,0,0,2024
FVG,GO,E   ,"Fornitura di acqua; reti fognarie, attività di gestione d...",0,0,0,0,0,2024
FVG,GO,E 36,"Raccolta, trattamento e fornitura di acqua                  ",0,0,0,0,0,2024
FVG,GO,E 37,Gestione delle reti fognarie                                ,0,0,0,0,0,2024
FVG,GO,E 38,"Attività di raccolta, trattamento e smaltimento dei rifiu...",0,0,0,0,0,2024
FVG,GO,E 39,Attività di risanamento e altri servizi di gestione dei r...,0,0,0,0,0,2024
FVG,GO,F   ,Costruzioni                                                 ,0,5,4,0,9,2024
FVG,GO,F 41,Costruzione di edifici                                      ,0,2,1,0,3,2024
FVG,GO,F 42,Ingegneria civile                                           ,0,0,0,0,0,2024
FVG,GO,F 43,Lavori di costruzione specializzati                         ,0,3,3,0,6,2024
FVG,GO,G   ,Commercio all'ingrosso e al dettaglio; riparazione di aut...,0,5,15,0,20,2024
FVG,GO,G 45,Commercio all'ingrosso e al dettaglio e riparazione di au...,0,1,1,0,2,2024
FVG,GO,G 46,Commercio all'ingrosso (escluso quello di autoveicoli e d...,0,0,3,0,3,2024
FVG,GO,G 47,Commercio al dettaglio (escluso quello di autoveicoli e d...,0,4,11,0,15,2024
FVG,GO,H   ,Trasporto e magazzinaggio                                   ,0,0,1,0,1,2024
FVG,GO,H 49,Trasporto terrestre e mediante condotte                     ,0,0,1,0,1,2024
FVG,GO,H 50,Trasporto marittimo e per vie d'acqua                       ,0,0,0,0,0,2024
FVG,GO,H 51,Trasporto aereo                                             ,0,0,0,0,0,2024
FVG,GO,H 52,Magazzinaggio e attività di supporto ai trasporti           ,0,0,0,0,0,2024
FVG,GO,H 53,Servizi postali e attività di corriere                      ,0,0,0,0,0,2024
FVG,GO,I   ,Attività dei servizi alloggio e ristorazione                ,0,11,9,0,20,2024
FVG,GO,I 55,Alloggio                                                    ,0,0,0,0,0,2024
FVG,GO,I 56,Attività dei servizi di ristorazione                        ,0,11,9,0,20,2024
FVG,GO,J   ,Servizi di informazione e comunicazione                     ,0,0,0,0,0,2024
FVG,GO,J 58,Attività editoriali                                         ,0,0,0,0,0,2024
FVG,GO,J 59,"Attività di produzione cinematografica, di video e di pro...",0,0,0,0,0,2024
FVG,GO,J 60,Attività di programmazione e trasmissione                   ,0,0,0,0,0,2024
FVG,GO,J 61,Telecomunicazioni                                           ,0,0,0,0,0,2024
FVG,GO,J 62,"Produzione di software, consulenza informatica e attività...",0,0,0,0,0,2024
FVG,GO,J 63,Attività dei servizi d'informazione e altri servizi infor...,0,0,0,0,0,2024
FVG,GO,K   ,Attività finanziarie e assicurative                         ,0,0,0,0,0,2024
FVG,GO,K 64,Attività di servizi finanziari (escluse le assicurazioni ...,0,0,0,0,0,2024
FVG,GO,K 65,"Assicurazioni, riassicurazioni e fondi pensione (escluse ...",0,0,0,0,0,2024
FVG,GO,K 66,Attività ausiliarie dei servizi finanziari e delle attivi...,0,0,0,0,0,2024
FVG,GO,L   ,Attivita' immobiliari                                       ,0,1,1,0,2,2024
FVG,GO,L 68,Attivita' immobiliari                                       ,0,1,1,0,2,2024
FVG,GO,M   ,"Attività professionali, scientifiche e tecniche             ",0,0,0,0,0,2024
FVG,GO,M 69,Attività legali e contabilità                               ,0,0,0,0,0,2024
FVG,GO,M 70,Attività di direzione aziendale e di consulenza gestional...,0,0,0,0,0,2024
FVG,GO,M 71,Attività degli studi di architettura e d'ingegneria; coll...,0,0,0,0,0,2024
FVG,GO,M 72,Ricerca scientifica e sviluppo                              ,0,0,0,0,0,2024
FVG,GO,M 73,Pubblicità e ricerche di mercato                            ,0,0,0,0,0,2024
FVG,GO,M 74,"Altre attività professionali, scientifiche e tecniche       ",0,0,0,0,0,2024
FVG,GO,M 75,Servizi veterinari                                          ,0,0,0,0,0,2024
FVG,GO,N   ,"Noleggio, agenzie di viaggio, servizi di supporto alle im...",0,0,2,0,2,2024
FVG,GO,N 77,Attività di noleggio e leasing operativo                    ,0,0,0,0,0,2024
FVG,GO,N 78,"Attività di ricerca, selezione, fornitura di personale      ",0,0,0,0,0,2024
FVG,GO,N 79,"Attività dei servizi delle agenzie di viaggio, dei tour o...",0,0,0,0,0,2024
FVG,GO,N 80,Servizi di vigilanza e investigazione                       ,0,0,0,0,0,2024
FVG,GO,N 81,Attività di servizi per edifici e paesaggio                 ,0,0,1,0,1,2024
FVG,GO,N 82,Attività di supporto per le funzioni d'ufficio e altri se...,0,0,1,0,1,2024
FVG,GO,O   ,Amministrazione pubblica e difesa; assicurazione sociale ...,0,0,0,0,0,2024
FVG,GO,O 84,Amministrazione pubblica e difesa; assicurazione sociale ...,0,0,0,0,0,2024
FVG,GO,P   ,Istruzione                                                  ,0,0,0,0,0,2024
FVG,GO,P 85,Istruzione                                                  ,0,0,0,0,0,2024
FVG,GO,Q   ,Sanita' e assistenza sociale                                ,0,0,0,1,1,2024
FVG,GO,Q 86,Assistenza sanitaria                                        ,0,0,0,0,0,2024
FVG,GO,Q 87,Servizi di assistenza sociale residenziale                  ,0,0,0,0,0,2024
FVG,GO,Q 88,Assistenza sociale non residenziale                         ,0,0,0,1,1,2024
FVG,GO,R   ,"Attività artistiche, sportive, di intrattenimento e diver...",0,0,0,0,0,2024
FVG,GO,R 90,"Attività creative, artistiche e di intrattenimento          ",0,0,0,0,0,2024
FVG,GO,R 91,"Attività di biblioteche, archivi, musei ed altre attività...",0,0,0,0,0,2024
FVG,GO,R 92,"Attività riguardanti le lotterie, le scommesse, le case d...",0,0,0,0,0,2024
FVG,GO,R 93,"Attività sportive, di intrattenimento e di divertimento     ",0,0,0,0,0,2024
FVG,GO,S   ,Altre attività di servizi                                   ,0,1,2,0,3,2024
FVG,GO,S 94,Attività di organizzazioni associative                      ,0,0,0,0,0,2024
FVG,GO,S 95,Riparazione di computer e di beni per uso personale e per...,0,0,2,0,2,2024
FVG,GO,S 96,Altre attività di servizi per la persona                    ,0,1,0,0,1,2024
FVG,GO,T   ,Attività di famiglie e convivenze come datori di lavoro p...,0,0,0,0,0,2024
FVG,GO,T 97,Attività di famiglie e convivenze come datori di lavoro p...,0,0,0,0,0,2024
FVG,GO,T 98,Produzione di beni e servizi indifferenziati per uso prop...,0,0,0,0,0,2024
FVG,GO,U   ,Organizzazioni ed organismi extraterritoriali               ,0,0,0,0,0,2024
FVG,GO,U 99,Organizzazioni ed organismi extraterritoriali               ,0,0,0,0,0,2024
FVG,GO,XX  ,Imprese non classificate                                    ,0,1,2,0,3,2024
FVG,GO,TOT ,TOTALE                                                      ,0,24,41,1,66,2024
FVG,TS,A   ,"Agricoltura, silvicoltura pesca                             ",0,0,0,1,1,2024
FVG,TS,A 01,"Coltivazioni agricole e produzione di prodotti animali, c...",0,0,0,0,0,2024
FVG,TS,A 02,Silvicoltura ed utilizzo di aree forestali                  ,0,0,0,0,0,2024
FVG,TS,A 03,Pesca e acquacoltura                                        ,0,0,0,1,1,2024
FVG,TS,B   ,Estrazione di minerali da cave e miniere                    ,0,0,0,0,0,2024
FVG,TS,B 05,Estrazione di carbone (esclusa torba)                       ,0,0,0,0,0,2024
FVG,TS,B 06,Estraz.di petrolio greggio e di gas naturale                ,0,0,0,0,0,2024
FVG,TS,B 07,Estrazione di minerali metalliferi                          ,0,0,0,0,0,2024
FVG,TS,B 08,Altre attività di estrazione di minerali da cave e miniere  ,0,0,0,0,0,2024
FVG,TS,B 09,Attività dei servizi di supporto all'estrazione             ,0,0,0,0,0,2024
FVG,TS,C   ,Attività manifatturiere                                     ,0,0,6,0,6,2024
FVG,TS,C 10,Industrie alimentari                                        ,0,0,1,0,1,2024
FVG,TS,C 11,Industria delle bevande                                     ,0,0,0,0,0,2024
FVG,TS,C 12,Industria del tabacco                                       ,0,0,0,0,0,2024
FVG,TS,C 13,Industrie tessili                                           ,0,0,0,0,0,2024
FVG,TS,C 14,Confezione di articoli di abbigliamento; confezione di ar...,0,0,0,0,0,2024
FVG,TS,C 15,Fabbricazione di articoli in pelle e simili                 ,0,0,0,0,0,2024
FVG,TS,C 16,Industria del legno e dei prodotti in legno e sughero (es...,0,0,0,0,0,2024
FVG,TS,C 17,Fabbricazione di carta e di prodotti di carta               ,0,0,0,0,0,2024
FVG,TS,C 18,Stampa e riproduzione di supporti registrati                ,0,0,0,0,0,2024
FVG,TS,C 19,Fabbricazione di coke e prodotti derivanti dalla raffinaz...,0,0,0,0,0,2024
FVG,TS,C 20,Fabbricazione di prodotti chimici                           ,0,0,0,0,0,2024
FVG,TS,C 21,Fabbricazione di prodotti farmaceutici di base e di prepa...,0,0,0,0,0,2024
FVG,TS,C 22,Fabbricazione di articoli in gomma e materie plastiche      ,0,0,0,0,0,2024
FVG,TS,C 23,Fabbricazione di altri prodotti della lavorazione di miner..,0,0,0,0,0,2024
FVG,TS,C 24,Metallurgia                                                 ,0,0,0,0,0,2024
FVG,TS,C 25,Fabbricazione di prodotti in metallo (esclusi macchinari ...,0,0,4,0,4,2024
FVG,TS,C 26,Fabbricazione di computer e prodotti di elettronica e ott...,0,0,0,0,0,2024
FVG,TS,C 27,Fabbricazione di apparecchiature elettriche ed apparecchi...,0,0,0,0,0,2024
FVG,TS,C 28,Fabbricazione di macchinari ed apparecchiature nca          ,0,0,0,0,0,2024
FVG,TS,C 29,"Fabbricazione di autoveicoli, rimorchi e semirimorchi       ",0,0,0,0,0,2024
FVG,TS,C 30,Fabbricazione di altri mezzi di trasporto                   ,0,0,0,0,0,2024
FVG,TS,C 31,Fabbricazione di mobili                                     ,0,0,0,0,0,2024
FVG,TS,C 32,Altre industrie manifatturiere                              ,0,0,1,0,1,2024
FVG,TS,C 33,"Riparazione, manutenzione ed installazione di macchine ed...",0,0,0,0,0,2024
FVG,TS,D   ,"Fornitura di energia elettrica, gas, vapore e aria condiz...",0,0,0,0,0,2024
FVG,TS,D 35,"Fornitura di energia elettrica, gas, vapore e aria condiz...",0,0,0,0,0,2024
FVG,TS,E   ,"Fornitura di acqua; reti fognarie, attività di gestione d...",0,0,1,0,1,2024
FVG,TS,E 36,"Raccolta, trattamento e fornitura di acqua                  ",0,0,0,0,0,2024
FVG,TS,E 37,Gestione delle reti fognarie                                ,0,0,0,0,0,2024
FVG,TS,E 38,"Attività di raccolta, trattamento e smaltimento dei rifiu...",0,0,0,0,0,2024
FVG,TS,E 39,Attività di risanamento e altri servizi di gestione dei r...,0,0,1,0,1,2024
FVG,TS,F   ,Costruzioni                                                 ,0,3,19,1,23,2024
FVG,TS,F 41,Costruzione di edifici                                      ,0,2,4,1,7,2024
FVG,TS,F 42,Ingegneria civile                                           ,0,0,0,0,0,2024
FVG,TS,F 43,Lavori di costruzione specializzati                         ,0,1,15,0,16,2024
FVG,TS,G   ,Commercio all'ingrosso e al dettaglio; riparazione di aut...,0,3,31,0,34,2024
FVG,TS,G 45,Commercio all'ingrosso e al dettaglio e riparazione di au...,0,0,6,0,6,2024
FVG,TS,G 46,Commercio all'ingrosso (escluso quello di autoveicoli e d...,0,0,8,0,8,2024
FVG,TS,G 47,Commercio al dettaglio (escluso quello di autoveicoli e d...,0,3,17,0,20,2024
FVG,TS,H   ,Trasporto e magazzinaggio                                   ,0,0,4,0,4,2024
FVG,TS,H 49,Trasporto terrestre e mediante condotte                     ,0,0,3,0,3,2024
FVG,TS,H 50,Trasporto marittimo e per vie d'acqua                       ,0,0,1,0,1,2024
FVG,TS,H 51,Trasporto aereo                                             ,0,0,0,0,0,2024
FVG,TS,H 52,Magazzinaggio e attività di supporto ai trasporti           ,0,0,0,0,0,2024
FVG,TS,H 53,Servizi postali e attività di corriere                      ,0,0,0,0,0,2024
FVG,TS,I   ,Attività dei servizi alloggio e ristorazione                ,0,6,7,0,13,2024
FVG,TS,I 55,Alloggio                                                    ,0,0,0,0,0,2024
FVG,TS,I 56,Attività dei servizi di ristorazione                        ,0,6,7,0,13,2024
FVG,TS,J   ,Servizi di informazione e comunicazione                     ,0,0,2,0,2,2024
FVG,TS,J 58,Attività editoriali                                         ,0,0,0,0,0,2024
FVG,TS,J 59,"Attività di produzione cinematografica, di video e di pro...",0,0,0,0,0,2024
FVG,TS,J 60,Attività di programmazione e trasmissione                   ,0,0,0,0,0,2024
FVG,TS,J 61,Telecomunicazioni                                           ,0,0,1,0,1,2024
FVG,TS,J 62,"Produzione di software, consulenza informatica e attività...",0,0,1,0,1,2024
FVG,TS,J 63,Attività dei servizi d'informazione e altri servizi infor...,0,0,0,0,0,2024
FVG,TS,K   ,Attività finanziarie e assicurative                         ,0,0,0,0,0,2024
FVG,TS,K 64,Attività di servizi finanziari (escluse le assicurazioni ...,0,0,0,0,0,2024
FVG,TS,K 65,"Assicurazioni, riassicurazioni e fondi pensione (escluse ...",0,0,0,0,0,2024
FVG,TS,K 66,Attività ausiliarie dei servizi finanziari e delle attivi...,0,0,0,0,0,2024
FVG,TS,L   ,Attivita' immobiliari                                       ,0,2,0,0,2,2024
FVG,TS,L 68,Attivita' immobiliari                                       ,0,2,0,0,2,2024
FVG,TS,M   ,"Attività professionali, scientifiche e tecniche             ",0,0,1,0,1,2024
FVG,TS,M 69,Attività legali e contabilità                               ,0,0,0,0,0,2024
FVG,TS,M 70,Attività di direzione aziendale e di consulenza gestional...,0,0,0,0,0,2024
FVG,TS,M 71,Attività degli studi di architettura e d'ingegneria; coll...,0,0,0,0,0,2024
FVG,TS,M 72,Ricerca scientifica e sviluppo                              ,0,0,0,0,0,2024
FVG,TS,M 73,Pubblicità e ricerche di mercato                            ,0,0,1,0,1,2024
FVG,TS,M 74,"Altre attività professionali, scientifiche e tecniche       ",0,0,0,0,0,2024
FVG,TS,M 75,Servizi veterinari                                          ,0,0,0,0,0,2024
FVG,TS,N   ,"Noleggio, agenzie di viaggio, servizi di supporto alle im...",0,0,4,0,4,2024
FVG,TS,N 77,Attività di noleggio e leasing operativo                    ,0,0,1,0,1,2024
FVG,TS,N 78,"Attività di ricerca, selezione, fornitura di personale      ",0,0,0,0,0,2024
FVG,TS,N 79,"Attività dei servizi delle agenzie di viaggio, dei tour o...",0,0,0,0,0,2024
FVG,TS,N 80,Servizi di vigilanza e investigazione                       ,0,0,0,0,0,2024
FVG,TS,N 81,Attività di servizi per edifici e paesaggio                 ,0,0,1,0,1,2024
FVG,TS,N 82,Attività di supporto per le funzioni d'ufficio e altri se...,0,0,2,0,2,2024
FVG,TS,O   ,Amministrazione pubblica e difesa; assicurazione sociale ...,0,0,0,0,0,2024
FVG,TS,O 84,Amministrazione pubblica e difesa; assicurazione sociale ...,0,0,0,0,0,2024
FVG,TS,P   ,Istruzione                                                  ,0,0,0,0,0,2024
FVG,TS,P 85,Istruzione                                                  ,0,0,0,0,0,2024
FVG,TS,Q   ,Sanita' e assistenza sociale                                ,0,0,1,0,1,2024
FVG,TS,Q 86,Assistenza sanitaria                                        ,0,0,0,0,0,2024
FVG,TS,Q 87,Servizi di assistenza sociale residenziale                  ,0,0,0,0,0,2024
FVG,TS,Q 88,Assistenza sociale non residenziale                         ,0,0,1,0,1,2024
FVG,TS,R   ,"Attività artistiche, sportive, di intrattenimento e diver...",0,0,0,1,1,2024
FVG,TS,R 90,"Attività creative, artistiche e di intrattenimento          ",0,0,0,0,0,2024
FVG,TS,R 91,"Attività di biblioteche, archivi, musei ed altre attività...",0,0,0,1,1,2024
FVG,TS,R 92,"Attività riguardanti le lotterie, le scommesse, le case d...",0,0,0,0,0,2024
FVG,TS,R 93,"Attività sportive, di intrattenimento e di divertimento     ",0,0,0,0,0,2024
FVG,TS,S   ,Altre attività di servizi                                   ,0,2,4,0,6,2024
FVG,TS,S 94,Attività di organizzazioni associative                      ,0,0,0,0,0,2024
FVG,TS,S 95,Riparazione di computer e di beni per uso personale e per...,0,0,2,0,2,2024
FVG,TS,S 96,Altre attività di servizi per la persona                    ,0,2,2,0,4,2024
FVG,TS,T   ,Attività di famiglie e convivenze come datori di lavoro p...,0,0,0,0,0,2024
FVG,TS,T 97,Attività di famiglie e convivenze come datori di lavoro p...,0,0,0,0,0,2024
FVG,TS,T 98,Produzione di beni e servizi indifferenziati per uso prop...,0,0,0,0,0,2024
FVG,TS,U   ,Organizzazioni ed organismi extraterritoriali               ,0,0,0,0,0,2024
FVG,TS,U 99,Organizzazioni ed organismi extraterritoriali               ,0,0,0,0,0,2024
FVG,TS,XX  ,Imprese non classificate                                    ,0,3,4,0,7,2024
FVG,TS,TOT ,TOTALE                                                      ,0,19,84,3,106,2024
FVG,PN,A   ,"Agricoltura, silvicoltura pesca                             ",4,1,0,0,5,2024
FVG,PN,A 01,"Coltivazioni agricole e produzione di prodotti animali, c...",4,1,0,0,5,2024
FVG,PN,A 02,Silvicoltura ed utilizzo di aree forestali                  ,0,0,0,0,0,2024
FVG,PN,A 03,Pesca e acquacoltura                                        ,0,0,0,0,0,2024
FVG,PN,B   ,Estrazione di minerali da cave e miniere                    ,1,0,0,0,1,2024
FVG,PN,B 05,Estrazione di carbone (esclusa torba)                       ,0,0,0,0,0,2024
FVG,PN,B 06,Estraz.di petrolio greggio e di gas naturale                ,0,0,0,0,0,2024
FVG,PN,B 07,Estrazione di minerali metalliferi                          ,1,0,0,0,1,2024
FVG,PN,B 08,Altre attività di estrazione di minerali da cave e miniere  ,0,0,0,0,0,2024
FVG,PN,B 09,Attività dei servizi di supporto all'estrazione             ,0,0,0,0,0,2024
FVG,PN,C   ,Attività manifatturiere                                     ,43,0,0,0,43,2024
FVG,PN,C 10,Industrie alimentari                                        ,1,0,0,0,1,2024
FVG,PN,C 11,Industria delle bevande                                     ,0,0,0,0,0,2024
FVG,PN,C 12,Industria del tabacco                                       ,0,0,0,0,0,2024
FVG,PN,C 13,Industrie tessili                                           ,0,0,0,0,0,2024
FVG,PN,C 14,Confezione di articoli di abbigliamento; confezione di ar...,4,0,0,0,4,2024
FVG,PN,C 15,Fabbricazione di articoli in pelle e simili                 ,0,0,0,0,0,2024
FVG,PN,C 16,Industria del legno e dei prodotti in legno e sughero (es...,4,0,0,0,4,2024
FVG,PN,C 17,Fabbricazione di carta e di prodotti di carta               ,1,0,0,0,1,2024
FVG,PN,C 18,Stampa e riproduzione di supporti registrati                ,0,0,0,0,0,2024
FVG,PN,C 19,Fabbricazione di coke e prodotti derivanti dalla raffinaz...,0,0,0,0,0,2024
FVG,PN,C 20,Fabbricazione di prodotti chimici                           ,0,0,0,0,0,2024
FVG,PN,C 21,Fabbricazione di prodotti farmaceutici di base e di prepa...,0,0,0,0,0,2024
FVG,PN,C 22,Fabbricazione di articoli in gomma e materie plastiche      ,3,0,0,0,3,2024
FVG,PN,C 23,Fabbricazione di altri prodotti della lavorazione di miner..,1,0,0,0,1,2024
FVG,PN,C 24,Metallurgia                                                 ,0,0,0,0,0,2024
FVG,PN,C 25,Fabbricazione di prodotti in metallo (esclusi macchinari ...,11,0,0,0,11,2024
FVG,PN,C 26,Fabbricazione di computer e prodotti di elettronica e ott...,2,0,0,0,2,2024
FVG,PN,C 27,Fabbricazione di apparecchiature elettriche ed apparecchi...,0,0,0,0,0,2024
FVG,PN,C 28,Fabbricazione di macchinari ed apparecchiature nca          ,6,0,0,0,6,2024
FVG,PN,C 29,"Fabbricazione di autoveicoli, rimorchi e semirimorchi       ",1,0,0,0,1,2024
FVG,PN,C 30,Fabbricazione di altri mezzi di trasporto                   ,1,0,0,0,1,2024
FVG,PN,C 31,Fabbricazione di mobili                                     ,5,0,0,0,5,2024
FVG,PN,C 32,Altre industrie manifatturiere                              ,3,0,0,0,3,2024
FVG,PN,C 33,"Riparazione, manutenzione ed installazione di macchine ed...",0,0,0,0,0,2024
FVG,PN,D   ,"Fornitura di energia elettrica, gas, vapore e aria condiz...",0,0,0,0,0,2024
FVG,PN,D 35,"Fornitura di energia elettrica, gas, vapore e aria condiz...",0,0,0,0,0,2024
FVG,PN,E   ,"Fornitura di acqua; reti fognarie, attività di gestione d...",1,0,0,0,1,2024
FVG,PN,E 36,"Raccolta, trattamento e fornitura di acqua                  ",0,0,0,0,0,2024
FVG,PN,E 37,Gestione delle reti fognarie                                ,0,0,0,0,0,2024
FVG,PN,E 38,"Attività di raccolta, trattamento e smaltimento dei rifiu...",1,0,0,0,1,2024
FVG,PN,E 39,Attività di risanamento e altri servizi di gestione dei r...,0,0,0,0,0,2024
FVG,PN,F   ,Costruzioni                                                 ,14,0,0,0,14,2024
FVG,PN,F 41,Costruzione di edifici                                      ,12,0,0,0,12,2024
FVG,PN,F 42,Ingegneria civile                                           ,1,0,0,0,1,2024
FVG,PN,F 43,Lavori di costruzione specializzati                         ,1,0,0,0,1,2024
FVG,PN,G   ,Commercio all'ingrosso e al dettaglio; riparazione di aut...,47,0,0,0,47,2024
FVG,PN,G 45,Commercio all'ingrosso e al dettaglio e riparazione di au...,1,0,0,0,1,2024
FVG,PN,G 46,Commercio all'ingrosso (escluso quello di autoveicoli e d...,35,0,0,0,35,2024
FVG,PN,G 47,Commercio al dettaglio (escluso quello di autoveicoli e d...,11,0,0,0,11,2024
FVG,PN,H   ,Trasporto e magazzinaggio                                   ,4,0,0,0,4,2024
FVG,PN,H 49,Trasporto terrestre e mediante condotte                     ,3,0,0,0,3,2024
FVG,PN,H 50,Trasporto marittimo e per vie d'acqua                       ,0,0,0,0,0,2024
FVG,PN,H 51,Trasporto aereo                                             ,0,0,0,0,0,2024
FVG,PN,H 52,Magazzinaggio e attività di supporto ai trasporti           ,1,0,0,0,1,2024
FVG,PN,H 53,Servizi postali e attività di corriere                      ,0,0,0,0,0,2024
FVG,PN,I   ,Attività dei servizi alloggio e ristorazione                ,6,0,0,0,6,2024
FVG,PN,I 55,Alloggio                                                    ,0,0,0,0,0,2024
FVG,PN,I 56,Attività dei servizi di ristorazione                        ,6,0,0,0,6,2024
FVG,PN,J   ,Servizi di informazione e comunicazione                     ,5,0,0,0,5,2024
FVG,PN,J 58,Attività editoriali                                         ,2,0,0,0,2,2024
FVG,PN,J 59,"Attività di produzione cinematografica, di video e di pro...",0,0,0,0,0,2024
FVG,PN,J 60,Attività di programmazione e trasmissione                   ,0,0,0,0,0,2024
FVG,PN,J 61,Telecomunicazioni                                           ,1,0,0,0,1,2024
FVG,PN,J 62,"Produzione di software, consulenza informatica e attività...",0,0,0,0,0,2024
FVG,PN,J 63,Attività dei servizi d'informazione e altri servizi infor...,2,0,0,0,2,2024
FVG,PN,K   ,Attività finanziarie e assicurative                         ,4,0,0,0,4,2024
FVG,PN,K 64,Attività di servizi finanziari (escluse le assicurazioni ...,3,0,0,0,3,2024
FVG,PN,K 65,"Assicurazioni, riassicurazioni e fondi pensione (escluse ...",1,0,0,0,1,2024
FVG,PN,K 66,Attività ausiliarie dei servizi finanziari e delle attivi...,0,0,0,0,0,2024
FVG,PN,L   ,Attivita' immobiliari                                       ,16,0,0,0,16,2024
FVG,PN,L 68,Attivita' immobiliari                                       ,16,0,0,0,16,2024
FVG,PN,M   ,"Attività professionali, scientifiche e tecniche             ",14,0,0,0,14,2024
FVG,PN,M 69,Attività legali e contabilità                               ,3,0,0,0,3,2024
FVG,PN,M 70,Attività di direzione aziendale e di consulenza gestional...,3,0,0,0,3,2024
FVG,PN,M 71,Attività degli studi di architettura e d'ingegneria; coll...,1,0,0,0,1,2024
FVG,PN,M 72,Ricerca scientifica e sviluppo                              ,0,0,0,0,0,2024
FVG,PN,M 73,Pubblicità e ricerche di mercato                            ,3,0,0,0,3,2024
FVG,PN,M 74,"Altre attività professionali, scientifiche e tecniche       ",4,0,0,0,4,2024
FVG,PN,M 75,Servizi veterinari                                          ,0,0,0,0,0,2024
FVG,PN,N   ,"Noleggio, agenzie di viaggio, servizi di supporto alle im...",1,0,0,0,1,2024
FVG,PN,N 77,Attività di noleggio e leasing operativo                    ,0,0,0,0,0,2024
FVG,PN,N 78,"Attività di ricerca, selezione, fornitura di personale      ",0,0,0,0,0,2024
FVG,PN,N 79,"Attività dei servizi delle agenzie di viaggio, dei tour o...",0,0,0,0,0,2024
FVG,PN,N 80,Servizi di vigilanza e investigazione                       ,0,0,0,0,0,2024
FVG,PN,N 81,Attività di servizi per edifici e paesaggio                 ,0,0,0,0,0,2024
FVG,PN,N 82,Attività di supporto per le funzioni d'ufficio e altri se...,1,0,0,0,1,2024
FVG,PN,O   ,Amministrazione pubblica e difesa; assicurazione sociale ...,0,0,0,0,0,2024
FVG,PN,O 84,Amministrazione pubblica e difesa; assicurazione sociale ...,0,0,0,0,0,2024
FVG,PN,P   ,Istruzione                                                  ,0,0,0,0,0,2024
FVG,PN,P 85,Istruzione                                                  ,0,0,0,0,0,2024
FVG,PN,Q   ,Sanita' e assistenza sociale                                ,2,0,0,0,2,2024
FVG,PN,Q 86,Assistenza sanitaria                                        ,2,0,0,0,2,2024
FVG,PN,Q 87,Servizi di assistenza sociale residenziale                  ,0,0,0,0,0,2024
FVG,PN,Q 88,Assistenza sociale non residenziale                         ,0,0,0,0,0,2024
FVG,PN,R   ,"Attività artistiche, sportive, di intrattenimento e diver...",5,0,0,0,5,2024
FVG,PN,R 90,"Attività creative, artistiche e di intrattenimento          ",4,0,0,0,4,2024
FVG,PN,R 91,"Attività di biblioteche, archivi, musei ed altre attività...",0,0,0,0,0,2024
FVG,PN,R 92,"Attività riguardanti le lotterie, le scommesse, le case d...",0,0,0,0,0,2024
FVG,PN,R 93,"Attività sportive, di intrattenimento e di divertimento     ",1,0,0,0,1,2024
FVG,PN,S   ,Altre attività di servizi                                   ,2,0,0,0,2,2024
FVG,PN,S 94,Attività di organizzazioni associative                      ,0,0,0,0,0,2024
FVG,PN,S 95,Riparazione di computer e di beni per uso personale e per...,1,0,0,0,1,2024
FVG,PN,S 96,Altre attività di servizi per la persona                    ,1,0,0,0,1,2024
FVG,PN,T   ,Attività di famiglie e convivenze come datori di lavoro p...,0,0,0,0,0,2024
FVG,PN,T 97,Attività di famiglie e convivenze come datori di lavoro p...,0,0,0,0,0,2024
FVG,PN,T 98,Produzione di beni e servizi indifferenziati per uso prop...,0,0,0,0,0,2024
FVG,PN,U   ,Organizzazioni ed organismi extraterritoriali               ,0,0,0,0,0,2024
FVG,PN,U 99,Organizzazioni ed organismi extraterritoriali               ,0,0,0,0,0,2024
FVG,PN,XX  ,Imprese non classificate                                    ,19,0,0,0,19,2024
FVG,PN,TOT ,TOTALE                                                      ,188,1,0,0,189,2024
LIG,  ,A   ,"Agricoltura, silvicoltura pesca                             ",1,0,12,8,21,2024
LIG,  ,A 01,"Coltivazioni agricole e produzione di prodotti animali, c...",1,0,11,5,17,2024
LIG,  ,A 02,Silvicoltura ed utilizzo di aree forestali                  ,0,0,0,1,1,2024
LIG,  ,A 03,Pesca e acquacoltura                                        ,0,0,1,2,3,2024
LIG,  ,B   ,Estrazione di minerali da cave e miniere                    ,0,0,0,1,1,2024
LIG,  ,B 05,Estrazione di carbone (esclusa torba)                       ,0,0,0,0,0,2024
LIG,  ,B 06,Estraz.di petrolio greggio e di gas naturale                ,0,0,0,0,0,2024
LIG,  ,B 07,Estrazione di minerali metalliferi                          ,0,0,0,0,0,2024
LIG,  ,B 08,Altre attività di estrazione di minerali da cave e miniere  ,0,0,0,1,1,2024
LIG,  ,B 09,Attività dei servizi di supporto all'estrazione             ,0,0,0,0,0,2024
LIG,  ,C   ,Attività manifatturiere                                     ,6,3,22,17,48,2024
LIG,  ,C 10,Industrie alimentari                                        ,1,1,1,2,5,2024
LIG,  ,C 11,Industria delle bevande                                     ,0,0,0,0,0,2024
LIG,  ,C 12,Industria del tabacco                                       ,0,0,0,0,0,2024
LIG,  ,C 13,Industrie tessili                                           ,0,0,0,0,0,2024
LIG,  ,C 14,Confezione di articoli di abbigliamento; confezione di ar...,0,0,2,0,2,2024
LIG,  ,C 15,Fabbricazione di articoli in pelle e simili                 ,0,0,0,0,0,2024
LIG,  ,C 16,Industria del legno e dei prodotti in legno e sughero (es...,0,0,3,4,7,2024
LIG,  ,C 17,Fabbricazione di carta e di prodotti di carta               ,0,0,0,0,0,2024
LIG,  ,C 18,Stampa e riproduzione di supporti registrati                ,0,0,1,0,1,2024
LIG,  ,C 19,Fabbricazione di coke e prodotti derivanti dalla raffinaz...,0,0,0,0,0,2024
LIG,  ,C 20,Fabbricazione di prodotti chimici                           ,0,0,0,0,0,2024
LIG,  ,C 21,Fabbricazione di prodotti farmaceutici di base e di prepa...,0,0,0,0,0,2024
LIG,  ,C 22,Fabbricazione di articoli in gomma e materie plastiche      ,0,0,1,0,1,2024
LIG,  ,C 23,Fabbricazione di altri prodotti della lavorazione di miner..,0,0,0,2,2,2024
LIG,  ,C 24,Metallurgia                                                 ,0,0,0,0,0,2024
LIG,  ,C 25,Fabbricazione di prodotti in metallo (esclusi macchinari ...,0,1,7,2,10,2024
LIG,  ,C 26,Fabbricazione di computer e prodotti di elettronica e ott...,0,0,2,0,2,2024
LIG,  ,C 27,Fabbricazione di apparecchiature elettriche ed apparecchi...,0,0,0,1,1,2024
LIG,  ,C 28,Fabbricazione di macchinari ed apparecchiature nca          ,1,0,0,0,1,2024
LIG,  ,C 29,"Fabbricazione di autoveicoli, rimorchi e semirimorchi       ",0,0,0,0,0,2024
LIG,  ,C 30,Fabbricazione di altri mezzi di trasporto                   ,0,0,1,3,4,2024
LIG,  ,C 31,Fabbricazione di mobili                                     ,2,0,1,0,3,2024
LIG,  ,C 32,Altre industrie manifatturiere                              ,1,0,1,0,2,2024
LIG,  ,C 33,"Riparazione, manutenzione ed installazione di macchine ed...",1,1,2,3,7,2024
LIG,  ,D   ,"Fornitura di energia elettrica, gas, vapore e aria condiz...",0,0,1,0,1,2024
LIG,  ,D 35,"Fornitura di energia elettrica, gas, vapore e aria condiz...",0,0,1,0,1,2024
LIG,  ,E   ,"Fornitura di acqua; reti fognarie, attività di gestione d...",0,0,0,3,3,2024
LIG,  ,E 36,"Raccolta, trattamento e fornitura di acqua                  ",0,0,0,0,0,2024
LIG,  ,E 37,Gestione delle reti fognarie                                ,0,0,0,0,0,2024
LIG,  ,E 38,"Attività di raccolta, trattamento e smaltimento dei rifiu...",0,0,0,2,2,2024
LIG,  ,E 39,Attività di risanamento e altri servizi di gestione dei r...,0,0,0,1,1,2024
LIG,  ,F   ,Costruzioni                                                 ,17,2,85,68,172,2024
LIG,  ,F 41,Costruzione di edifici                                      ,12,2,10,40,64,2024
LIG,  ,F 42,Ingegneria civile                                           ,0,0,0,2,2,2024
LIG,  ,F 43,Lavori di costruzione specializzati                         ,5,0,75,26,106,2024
LIG,  ,G   ,Commercio all'ingrosso e al dettaglio; riparazione di aut...,12,7,110,12,141,2024
LIG,  ,G 45,Commercio all'ingrosso e al dettaglio e riparazione di au...,1,0,19,0,20,2024
LIG,  ,G 46,Commercio all'ingrosso (escluso quello di autoveicoli e d...,5,0,18,5,28,2024
LIG,  ,G 47,Commercio al dettaglio (escluso quello di autoveicoli e d...,6,7,73,7,93,2024
LIG,  ,H   ,Trasporto e magazzinaggio                                   ,0,0,6,26,32,2024
LIG,  ,H 49,Trasporto terrestre e mediante condotte                     ,0,0,6,14,20,2024
LIG,  ,H 50,Trasporto marittimo e per vie d'acqua                       ,0,0,0,3,3,2024
LIG,  ,H 51,Trasporto aereo                                             ,0,0,0,0,0,2024
LIG,  ,H 52,Magazzinaggio e attività di supporto ai trasporti           ,0,0,0,9,9,2024
LIG,  ,H 53,Servizi postali e attività di corriere                      ,0,0,0,0,0,2024
LIG,  ,I   ,Attività dei servizi alloggio e ristorazione                ,7,4,22,11,44,2024
LIG,  ,I 55,Alloggio                                                    ,0,0,0,2,2,2024
LIG,  ,I 56,Attività dei servizi di ristorazione                        ,7,4,22,9,42,2024
LIG,  ,J   ,Servizi di informazione e comunicazione                     ,2,1,0,6,9,2024
LIG,  ,J 58,Attività editoriali                                         ,0,0,0,3,3,2024
LIG,  ,J 59,"Attività di produzione cinematografica, di video e di pro...",0,0,0,1,1,2024
LIG,  ,J 60,Attività di programmazione e trasmissione                   ,0,0,0,1,1,2024
LIG,  ,J 61,Telecomunicazioni                                           ,1,0,0,0,1,2024
LIG,  ,J 62,"Produzione di software, consulenza informatica e attività...",1,0,0,1,2,2024
LIG,  ,J 63,Attività dei servizi d'informazione e altri servizi infor...,0,1,0,0,1,2024
LIG,  ,K   ,Attività finanziarie e assicurative                         ,1,0,5,2,8,2024
LIG,  ,K 64,Attività di servizi finanziari (escluse le assicurazioni ...,0,0,0,0,0,2024
LIG,  ,K 65,"Assicurazioni, riassicurazioni e fondi pensione (escluse ...",0,0,0,0,0,2024
LIG,  ,K 66,Attività ausiliarie dei servizi finanziari e delle attivi...,1,0,5,2,8,2024
LIG,  ,L   ,Attivita' immobiliari                                       ,3,2,0,0,5,2024
LIG,  ,L 68,Attivita' immobiliari                                       ,3,2,0,0,5,2024
LIG,  ,M   ,"Attività professionali, scientifiche e tecniche             ",5,1,5,9,20,2024
LIG,  ,M 69,Attività legali e contabilità                               ,0,0,0,1,1,2024
LIG,  ,M 70,Attività di direzione aziendale e di consulenza gestional...,1,1,1,1,4,2024
LIG,  ,M 71,Attività degli studi di architettura e d'ingegneria; coll...,0,0,0,3,3,2024
LIG,  ,M 72,Ricerca scientifica e sviluppo                              ,0,0,0,0,0,2024
LIG,  ,M 73,Pubblicità e ricerche di mercato                            ,2,0,2,1,5,2024
LIG,  ,M 74,"Altre attività professionali, scientifiche e tecniche       ",2,0,2,3,7,2024
LIG,  ,M 75,Servizi veterinari                                          ,0,0,0,0,0,2024
LIG,  ,N   ,"Noleggio, agenzie di viaggio, servizi di supporto alle im...",5,2,15,35,57,2024
LIG,  ,N 77,Attività di noleggio e leasing operativo                    ,1,0,0,1,2,2024
LIG,  ,N 78,"Attività di ricerca, selezione, fornitura di personale      ",0,0,0,0,0,2024
LIG,  ,N 79,"Attività dei servizi delle agenzie di viaggio, dei tour o...",0,0,0,3,3,2024
LIG,  ,N 80,Servizi di vigilanza e investigazione                       ,0,0,0,1,1,2024
LIG,  ,N 81,Attività di servizi per edifici e paesaggio                 ,1,1,13,20,35,2024
LIG,  ,N 82,Attività di supporto per le funzioni d'ufficio e altri se...,3,1,2,10,16,2024
LIG,  ,O   ,Amministrazione pubblica e difesa; assicurazione sociale ...,0,0,0,0,0,2024
LIG,  ,O 84,Amministrazione pubblica e difesa; assicurazione sociale ...,0,0,0,0,0,2024
LIG,  ,P   ,Istruzione                                                  ,1,0,0,3,4,2024
LIG,  ,P 85,Istruzione                                                  ,1,0,0,3,4,2024
LIG,  ,Q   ,Sanita' e assistenza sociale                                ,0,0,0,12,12,2024
LIG,  ,Q 86,Assistenza sanitaria                                        ,0,0,0,2,2,2024
LIG,  ,Q 87,Servizi di assistenza sociale residenziale                  ,0,0,0,2,2,2024
LIG,  ,Q 88,Assistenza sociale non residenziale                         ,0,0,0,8,8,2024
LIG,  ,R   ,"Attività artistiche, sportive, di intrattenimento e diver...",2,0,1,8,11,2024
LIG,  ,R 90,"Attività creative, artistiche e di intrattenimento          ",1,0,0,7,8,2024
LIG,  ,R 91,"Attività di biblioteche, archivi, musei ed altre attività...",0,0,0,0,0,2024
LIG,  ,R 92,"Attività riguardanti le lotterie, le scommesse, le case d...",0,0,0,0,0,2024
LIG,  ,R 93,"Attività sportive, di intrattenimento e di divertimento     ",1,0,1,1,3,2024
LIG,  ,S   ,Altre attività di servizi                                   ,2,0,8,9,19,2024
LIG,  ,S 94,Attività di organizzazioni associative                      ,0,0,0,0,0,2024
LIG,  ,S 95,Riparazione di computer e di beni per uso personale e per...,0,0,2,1,3,2024
LIG,  ,S 96,Altre attività di servizi per la persona                    ,2,0,6,8,16,2024
LIG,  ,T   ,Attività di famiglie e convivenze come datori di lavoro p...,0,0,0,0,0,2024
LIG,  ,T 97,Attività di famiglie e convivenze come datori di lavoro p...,0,0,0,0,0,2024
LIG,  ,T 98,Produzione di beni e servizi indifferenziati per uso prop...,0,0,0,0,0,2024
LIG,  ,U   ,Organizzazioni ed organismi extraterritoriali               ,0,0,0,0,0,2024
LIG,  ,U 99,Organizzazioni ed organismi extraterritoriali               ,0,0,0,0,0,2024
LIG,  ,XX  ,Imprese non classificate                                    ,17,3,15,50,85,2024
LIG,  ,TOT ,TOTALE                                                      ,81,25,307,280,693,2024
LIG,IM,A   ,"Agricoltura, silvicoltura pesca                             ",1,0,3,5,9,2024
LIG,IM,A 01,"Coltivazioni agricole e produzione di prodotti animali, c...",1,0,2,3,6,2024
LIG,IM,A 02,Silvicoltura ed utilizzo di aree forestali                  ,0,0,0,1,1,2024
LIG,IM,A 03,Pesca e acquacoltura                                        ,0,0,1,1,2,2024
LIG,IM,B   ,Estrazione di minerali da cave e miniere                    ,0,0,0,0,0,2024
LIG,IM,B 05,Estrazione di carbone (esclusa torba)                       ,0,0,0,0,0,2024
LIG,IM,B 06,Estraz.di petrolio greggio e di gas naturale                ,0,0,0,0,0,2024
LIG,IM,B 07,Estrazione di minerali metalliferi                          ,0,0,0,0,0,2024
LIG,IM,B 08,Altre attività di estrazione di minerali da cave e miniere  ,0,0,0,0,0,2024
LIG,IM,B 09,Attività dei servizi di supporto all'estrazione             ,0,0,0,0,0,2024
LIG,IM,C   ,Attività manifatturiere                                     ,1,0,2,0,3,2024
LIG,IM,C 10,Industrie alimentari                                        ,0,0,0,0,0,2024
LIG,IM,C 11,Industria delle bevande                                     ,0,0,0,0,0,2024
LIG,IM,C 12,Industria del tabacco                                       ,0,0,0,0,0,2024
LIG,IM,C 13,Industrie tessili                                           ,0,0,0,0,0,2024
LIG,IM,C 14,Confezione di articoli di abbigliamento; confezione di ar...,0,0,2,0,2,2024
LIG,IM,C 15,Fabbricazione di articoli in pelle e simili                 ,0,0,0,0,0,2024
LIG,IM,C 16,Industria del legno e dei prodotti in legno e sughero (es...,0,0,0,0,0,2024
LIG,IM,C 17,Fabbricazione di carta e di prodotti di carta               ,0,0,0,0,0,2024
LIG,IM,C 18,Stampa e riproduzione di supporti registrati                ,0,0,0,0,0,2024
LIG,IM,C 19,Fabbricazione di coke e prodotti derivanti dalla raffinaz...,0,0,0,0,0,2024
LIG,IM,C 20,Fabbricazione di prodotti chimici                           ,0,0,0,0,0,2024
LIG,IM,C 21,Fabbricazione di prodotti farmaceutici di base e di prepa...,0,0,0,0,0,2024
LIG,IM,C 22,Fabbricazione di articoli in gomma e materie plastiche      ,0,0,0,0,0,2024
LIG,IM,C 23,Fabbricazione di altri prodotti della lavorazione di miner..,0,0,0,0,0,2024
LIG,IM,C 24,Metallurgia                                                 ,0,0,0,0,0,2024
LIG,IM,C 25,Fabbricazione di prodotti in metallo (esclusi macchinari ...,0,0,0,0,0,2024
LIG,IM,C 26,Fabbricazione di computer e prodotti di elettronica e ott...,0,0,0,0,0,2024
LIG,IM,C 27,Fabbricazione di apparecchiature elettriche ed apparecchi...,0,0,0,0,0,2024
LIG,IM,C 28,Fabbricazione di macchinari ed apparecchiature nca          ,0,0,0,0,0,2024
LIG,IM,C 29,"Fabbricazione di autoveicoli, rimorchi e semirimorchi       ",0,0,0,0,0,2024
LIG,IM,C 30,Fabbricazione di altri mezzi di trasporto                   ,0,0,0,0,0,2024
LIG,IM,C 31,Fabbricazione di mobili                                     ,0,0,0,0,0,2024
LIG,IM,C 32,Altre industrie manifatturiere                              ,1,0,0,0,1,2024
LIG,IM,C 33,"Riparazione, manutenzione ed installazione di macchine ed...",0,0,0,0,0,2024
LIG,IM,D   ,"Fornitura di energia elettrica, gas, vapore e aria condiz...",0,0,0,0,0,2024
LIG,IM,D 35,"Fornitura di energia elettrica, gas, vapore e aria condiz...",0,0,0,0,0,2024
LIG,IM,E   ,"Fornitura di acqua; reti fognarie, attività di gestione d...",0,0,0,2,2,2024
LIG,IM,E 36,"Raccolta, trattamento e fornitura di acqua                  ",0,0,0,0,0,2024
LIG,IM,E 37,Gestione delle reti fognarie                                ,0,0,0,0,0,2024
LIG,IM,E 38,"Attività di raccolta, trattamento e smaltimento dei rifiu...",0,0,0,1,1,2024
LIG,IM,E 39,Attività di risanamento e altri servizi di gestione dei r...,0,0,0,1,1,2024
LIG,IM,F   ,Costruzioni                                                 ,2,1,5,4,12,2024
LIG,IM,F 41,Costruzione di edifici                                      ,0,1,2,3,6,2024
LIG,IM,F 42,Ingegneria civile                                           ,0,0,0,0,0,2024
LIG,IM,F 43,Lavori di costruzione specializzati                         ,2,0,3,1,6,2024
LIG,IM,G   ,Commercio all'ingrosso e al dettaglio; riparazione di aut...,3,5,8,1,17,2024
LIG,IM,G 45,Commercio all'ingrosso e al dettaglio e riparazione di au...,0,0,0,0,0,2024
LIG,IM,G 46,Commercio all'ingrosso (escluso quello di autoveicoli e d...,1,0,3,1,5,2024
LIG,IM,G 47,Commercio al dettaglio (escluso quello di autoveicoli e d...,2,5,5,0,12,2024
LIG,IM,H   ,Trasporto e magazzinaggio                                   ,0,0,1,2,3,2024
LIG,IM,H 49,Trasporto terrestre e mediante condotte                     ,0,0,1,2,3,2024
LIG,IM,H 50,Trasporto marittimo e per vie d'acqua                       ,0,0,0,0,0,2024
LIG,IM,H 51,Trasporto aereo                                             ,0,0,0,0,0,2024
LIG,IM,H 52,Magazzinaggio e attività di supporto ai trasporti           ,0,0,0,0,0,2024
LIG,IM,H 53,Servizi postali e attività di corriere                      ,0,0,0,0,0,2024
LIG,IM,I   ,Attività dei servizi alloggio e ristorazione                ,0,0,3,0,3,2024
LIG,IM,I 55,Alloggio                                                    ,0,0,0,0,0,2024
LIG,IM,I 56,Attività dei servizi di ristorazione                        ,0,0,3,0,3,2024
LIG,IM,J   ,Servizi di informazione e comunicazione                     ,0,1,0,1,2,2024
LIG,IM,J 58,Attività editoriali                                         ,0,0,0,0,0,2024
LIG,IM,J 59,"Attività di produzione cinematografica, di video e di pro...",0,0,0,1,1,2024
LIG,IM,J 60,Attività di programmazione e trasmissione                   ,0,0,0,0,0,2024
LIG,IM,J 61,Telecomunicazioni                                           ,0,0,0,0,0,2024
LIG,IM,J 62,"Produzione di software, consulenza informatica e attività...",0,0,0,0,0,2024
LIG,IM,J 63,Attività dei servizi d'informazione e altri servizi infor...,0,1,0,0,1,2024
LIG,IM,K   ,Attività finanziarie e assicurative                         ,0,0,1,1,2,2024
LIG,IM,K 64,Attività di servizi finanziari (escluse le assicurazioni ...,0,0,0,0,0,2024
LIG,IM,K 65,"Assicurazioni, riassicurazioni e fondi pensione (escluse ...",0,0,0,0,0,2024
LIG,IM,K 66,Attività ausiliarie dei servizi finanziari e delle attivi...,0,0,1,1,2,2024
LIG,IM,L   ,Attivita' immobiliari                                       ,0,0,0,0,0,2024
LIG,IM,L 68,Attivita' immobiliari                                       ,0,0,0,0,0,2024
LIG,IM,M   ,"Attività professionali, scientifiche e tecniche             ",1,0,1,0,2,2024
LIG,IM,M 69,Attività legali e contabilità                               ,0,0,0,0,0,2024
LIG,IM,M 70,Attività di direzione aziendale e di consulenza gestional...,0,0,0,0,0,2024
LIG,IM,M 71,Attività degli studi di architettura e d'ingegneria; coll...,0,0,0,0,0,2024
LIG,IM,M 72,Ricerca scientifica e sviluppo                              ,0,0,0,0,0,2024
LIG,IM,M 73,Pubblicità e ricerche di mercato                            ,1,0,1,0,2,2024
LIG,IM,M 74,"Altre attività professionali, scientifiche e tecniche       ",0,0,0,0,0,2024
LIG,IM,M 75,Servizi veterinari                                          ,0,0,0,0,0,2024
LIG,IM,N   ,"Noleggio, agenzie di viaggio, servizi di supporto alle im...",1,0,2,1,4,2024
LIG,IM,N 77,Attività di noleggio e leasing operativo                    ,0,0,0,0,0,2024
LIG,IM,N 78,"Attività di ricerca, selezione, fornitura di personale      ",0,0,0,0,0,2024
LIG,IM,N 79,"Attività dei servizi delle agenzie di viaggio, dei tour o...",0,0,0,1,1,2024
LIG,IM,N 80,Servizi di vigilanza e investigazione                       ,0,0,0,0,0,2024
LIG,IM,N 81,Attività di servizi per edifici e paesaggio                 ,0,0,2,0,2,2024
LIG,IM,N 82,Attività di supporto per le funzioni d'ufficio e altri se...,1,0,0,0,1,2024
LIG,IM,O   ,Amministrazione pubblica e difesa; assicurazione sociale ...,0,0,0,0,0,2024
LIG,IM,O 84,Amministrazione pubblica e difesa; assicurazione sociale ...,0,0,0,0,0,2024
LIG,IM,P   ,Istruzione                                                  ,0,0,0,1,1,2024
LIG,IM,P 85,Istruzione                                                  ,0,0,0,1,1,2024
LIG,IM,Q   ,Sanita' e assistenza sociale                                ,0,0,0,0,0,2024
LIG,IM,Q 86,Assistenza sanitaria                                        ,0,0,0,0,0,2024
LIG,IM,Q 87,Servizi di assistenza sociale residenziale                  ,0,0,0,0,0,2024
LIG,IM,Q 88,Assistenza sociale non residenziale                         ,0,0,0,0,0,2024
LIG,IM,R   ,"Attività artistiche, sportive, di intrattenimento e diver...",0,0,0,1,1,2024
LIG,IM,R 90,"Attività creative, artistiche e di intrattenimento          ",0,0,0,1,1,2024
LIG,IM,R 91,"Attività di biblioteche, archivi, musei ed altre attività...",0,0,0,0,0,2024
LIG,IM,R 92,"Attività riguardanti le lotterie, le scommesse, le case d...",0,0,0,0,0,2024
LIG,IM,R 93,"Attività sportive, di intrattenimento e di divertimento     ",0,0,0,0,0,2024
LIG,IM,S   ,Altre attività di servizi                                   ,0,0,0,2,2,2024
LIG,IM,S 94,Attività di organizzazioni associative                      ,0,0,0,0,0,2024
LIG,IM,S 95,Riparazione di computer e di beni per uso personale e per...,0,0,0,0,0,2024
LIG,IM,S 96,Altre attività di servizi per la persona                    ,0,0,0,2,2,2024
LIG,IM,T   ,Attività di famiglie e convivenze come datori di lavoro p...,0,0,0,0,0,2024
LIG,IM,T 97,Attività di famiglie e convivenze come datori di lavoro p...,0,0,0,0,0,2024
LIG,IM,T 98,Produzione di beni e servizi indifferenziati per uso prop...,0,0,0,0,0,2024
LIG,IM,U   ,Organizzazioni ed organismi extraterritoriali               ,0,0,0,0,0,2024
LIG,IM,U 99,Organizzazioni ed organismi extraterritoriali               ,0,0,0,0,0,2024
LIG,IM,XX  ,Imprese non classificate                                    ,8,2,1,7,18,2024
LIG,IM,TOT ,TOTALE                                                      ,17,9,27,28,81,2024
LIG,SV,A   ,"Agricoltura, silvicoltura pesca                             ",0,0,1,0,1,2024
LIG,SV,A 01,"Coltivazioni agricole e produzione di prodotti animali, c...",0,0,1,0,1,2024
LIG,SV,A 02,Silvicoltura ed utilizzo di aree forestali                  ,0,0,0,0,0,2024
LIG,SV,A 03,Pesca e acquacoltura                                        ,0,0,0,0,0,2024
LIG,SV,B   ,Estrazione di minerali da cave e miniere                    ,0,0,0,0,0,2024
LIG,SV,B 05,Estrazione di carbone (esclusa torba)                       ,0,0,0,0,0,2024
LIG,SV,B 06,Estraz.di petrolio greggio e di gas naturale                ,0,0,0,0,0,2024
LIG,SV,B 07,Estrazione di minerali metalliferi                          ,0,0,0,0,0,2024
LIG,SV,B 08,Altre attività di estrazione di minerali da cave e miniere  ,0,0,0,0,0,2024
LIG,SV,B 09,Attività dei servizi di supporto all'estrazione             ,0,0,0,0,0,2024
LIG,SV,C   ,Attività manifatturiere                                     ,1,1,2,2,6,2024
LIG,SV,C 10,Industrie alimentari                                        ,1,0,0,0,1,2024
LIG,SV,C 11,Industria delle bevande                                     ,0,0,0,0,0,2024
LIG,SV,C 12,Industria del tabacco                                       ,0,0,0,0,0,2024
LIG,SV,C 13,Industrie tessili                                           ,0,0,0,0,0,2024
LIG,SV,C 14,Confezione di articoli di abbigliamento; confezione di ar...,0,0,0,0,0,2024
LIG,SV,C 15,Fabbricazione di articoli in pelle e simili                 ,0,0,0,0,0,2024
LIG,SV,C 16,Industria del legno e dei prodotti in legno e sughero (es...,0,0,0,1,1,2024
LIG,SV,C 17,Fabbricazione di carta e di prodotti di carta               ,0,0,0,0,0,2024
LIG,SV,C 18,Stampa e riproduzione di supporti registrati                ,0,0,0,0,0,2024
LIG,SV,C 19,Fabbricazione di coke e prodotti derivanti dalla raffinaz...,0,0,0,0,0,2024
LIG,SV,C 20,Fabbricazione di prodotti chimici                           ,0,0,0,0,0,2024
LIG,SV,C 21,Fabbricazione di prodotti farmaceutici di base e di prepa...,0,0,0,0,0,2024
LIG,SV,C 22,Fabbricazione di articoli in gomma e materie plastiche      ,0,0,0,0,0,2024
LIG,SV,C 23,Fabbricazione di altri prodotti della lavorazione di miner..,0,0,0,1,1,2024
LIG,SV,C 24,Metallurgia                                                 ,0,0,0,0,0,2024
LIG,SV,C 25,Fabbricazione di prodotti in metallo (esclusi macchinari ...,0,0,1,0,1,2024
LIG,SV,C 26,Fabbricazione di computer e prodotti di elettronica e ott...,0,0,0,0,0,2024
LIG,SV,C 27,Fabbricazione di apparecchiature elettriche ed apparecchi...,0,0,0,0,0,2024
LIG,SV,C 28,Fabbricazione di macchinari ed apparecchiature nca          ,0,0,0,0,0,2024
LIG,SV,C 29,"Fabbricazione di autoveicoli, rimorchi e semirimorchi       ",0,0,0,0,0,2024
LIG,SV,C 30,Fabbricazione di altri mezzi di trasporto                   ,0,0,0,0,0,2024
LIG,SV,C 31,Fabbricazione di mobili                                     ,0,0,0,0,0,2024
LIG,SV,C 32,Altre industrie manifatturiere                              ,0,0,1,0,1,2024
LIG,SV,C 33,"Riparazione, manutenzione ed installazione di macchine ed...",0,1,0,0,1,2024
LIG,SV,D   ,"Fornitura di energia elettrica, gas, vapore e aria condiz...",0,0,0,0,0,2024
LIG,SV,D 35,"Fornitura di energia elettrica, gas, vapore e aria condiz...",0,0,0,0,0,2024
LIG,SV,E   ,"Fornitura di acqua; reti fognarie, attività di gestione d...",0,0,0,1,1,2024
LIG,SV,E 36,"Raccolta, trattamento e fornitura di acqua                  ",0,0,0,0,0,2024
LIG,SV,E 37,Gestione delle reti fognarie                                ,0,0,0,0,0,2024
LIG,SV,E 38,"Attività di raccolta, trattamento e smaltimento dei rifiu...",0,0,0,1,1,2024
LIG,SV,E 39,Attività di risanamento e altri servizi di gestione dei r...,0,0,0,0,0,2024
LIG,SV,F   ,Costruzioni                                                 ,8,0,6,8,22,2024
LIG,SV,F 41,Costruzione di edifici                                      ,6,0,1,8,15,2024
LIG,SV,F 42,Ingegneria civile                                           ,0,0,0,0,0,2024
LIG,SV,F 43,Lavori di costruzione specializzati                         ,2,0,5,0,7,2024
LIG,SV,G   ,Commercio all'ingrosso e al dettaglio; riparazione di aut...,0,1,14,4,19,2024
LIG,SV,G 45,Commercio all'ingrosso e al dettaglio e riparazione di au...,0,0,3,0,3,2024
LIG,SV,G 46,Commercio all'ingrosso (escluso quello di autoveicoli e d...,0,0,1,0,1,2024
LIG,SV,G 47,Commercio al dettaglio (escluso quello di autoveicoli e d...,0,1,10,4,15,2024
LIG,SV,H   ,Trasporto e magazzinaggio                                   ,0,0,1,2,3,2024
LIG,SV,H 49,Trasporto terrestre e mediante condotte                     ,0,0,1,1,2,2024
LIG,SV,H 50,Trasporto marittimo e per vie d'acqua                       ,0,0,0,0,0,2024
LIG,SV,H 51,Trasporto aereo                                             ,0,0,0,0,0,2024
LIG,SV,H 52,Magazzinaggio e attività di supporto ai trasporti           ,0,0,0,1,1,2024
LIG,SV,H 53,Servizi postali e attività di corriere                      ,0,0,0,0,0,2024
LIG,SV,I   ,Attività dei servizi alloggio e ristorazione                ,3,2,5,5,15,2024
LIG,SV,I 55,Alloggio                                                    ,0,0,0,2,2,2024
LIG,SV,I 56,Attività dei servizi di ristorazione                        ,3,2,5,3,13,2024
LIG,SV,J   ,Servizi di informazione e comunicazione                     ,2,0,0,0,2,2024
LIG,SV,J 58,Attività editoriali                                         ,0,0,0,0,0,2024
LIG,SV,J 59,"Attività di produzione cinematografica, di video e di pro...",0,0,0,0,0,2024
LIG,SV,J 60,Attività di programmazione e trasmissione                   ,0,0,0,0,0,2024
LIG,SV,J 61,Telecomunicazioni                                           ,1,0,0,0,1,2024
LIG,SV,J 62,"Produzione di software, consulenza informatica e attività...",1,0,0,0,1,2024
LIG,SV,J 63,Attività dei servizi d'informazione e altri servizi infor...,0,0,0,0,0,2024
LIG,SV,K   ,Attività finanziarie e assicurative                         ,0,0,1,1,2,2024
LIG,SV,K 64,Attività di servizi finanziari (escluse le assicurazioni ...,0,0,0,0,0,2024
LIG,SV,K 65,"Assicurazioni, riassicurazioni e fondi pensione (escluse ...",0,0,0,0,0,2024
LIG,SV,K 66,Attività ausiliarie dei servizi finanziari e delle attivi...,0,0,1,1,2,2024
LIG,SV,L   ,Attivita' immobiliari                                       ,2,1,0,0,3,2024
LIG,SV,L 68,Attivita' immobiliari                                       ,2,1,0,0,3,2024
LIG,SV,M   ,"Attività professionali, scientifiche e tecniche             ",1,0,1,0,2,2024
LIG,SV,M 69,Attività legali e contabilità                               ,0,0,0,0,0,2024
LIG,SV,M 70,Attività di direzione aziendale e di consulenza gestional...,1,0,0,0,1,2024
LIG,SV,M 71,Attività degli studi di architettura e d'ingegneria; coll...,0,0,0,0,0,2024
LIG,SV,M 72,Ricerca scientifica e sviluppo                              ,0,0,0,0,0,2024
LIG,SV,M 73,Pubblicità e ricerche di mercato                            ,0,0,1,0,1,2024
LIG,SV,M 74,"Altre attività professionali, scientifiche e tecniche       ",0,0,0,0,0,2024
LIG,SV,M 75,Servizi veterinari                                          ,0,0,0,0,0,2024
LIG,SV,N   ,"Noleggio, agenzie di viaggio, servizi di supporto alle im...",2,1,0,7,10,2024
LIG,SV,N 77,Attività di noleggio e leasing operativo                    ,1,0,0,0,1,2024
LIG,SV,N 78,"Attività di ricerca, selezione, fornitura di personale      ",0,0,0,0,0,2024
LIG,SV,N 79,"Attività dei servizi delle agenzie di viaggio, dei tour o...",0,0,0,1,1,2024
LIG,SV,N 80,Servizi di vigilanza e investigazione                       ,0,0,0,0,0,2024
LIG,SV,N 81,Attività di servizi per edifici e paesaggio                 ,1,1,0,3,5,2024
LIG,SV,N 82,Attività di supporto per le funzioni d'ufficio e altri se...,0,0,0,3,3,2024
LIG,SV,O   ,Amministrazione pubblica e difesa; assicurazione sociale ...,0,0,0,0,0,2024
LIG,SV,O 84,Amministrazione pubblica e difesa; assicurazione sociale ...,0,0,0,0,0,2024
LIG,SV,P   ,Istruzione                                                  ,1,0,0,0,1,2024
LIG,SV,P 85,Istruzione                                                  ,1,0,0,0,1,2024
LIG,SV,Q   ,Sanita' e assistenza sociale                                ,0,0,0,2,2,2024
LIG,SV,Q 86,Assistenza sanitaria                                        ,0,0,0,0,0,2024
LIG,SV,Q 87,Servizi di assistenza sociale residenziale                  ,0,0,0,0,0,2024
LIG,SV,Q 88,Assistenza sociale non residenziale                         ,0,0,0,2,2,2024
LIG,SV,R   ,"Attività artistiche, sportive, di intrattenimento e diver...",1,0,1,4,6,2024
LIG,SV,R 90,"Attività creative, artistiche e di intrattenimento          ",1,0,0,3,4,2024
LIG,SV,R 91,"Attività di biblioteche, archivi, musei ed altre attività...",0,0,0,0,0,2024
LIG,SV,R 92,"Attività riguardanti le lotterie, le scommesse, le case d...",0,0,0,0,0,2024
LIG,SV,R 93,"Attività sportive, di intrattenimento e di divertimento     ",0,0,1,1,2,2024
LIG,SV,S   ,Altre attività di servizi                                   ,0,0,1,1,2,2024
LIG,SV,S 94,Attività di organizzazioni associative                      ,0,0,0,0,0,2024
LIG,SV,S 95,Riparazione di computer e di beni per uso personale e per...,0,0,0,1,1,2024
LIG,SV,S 96,Altre attività di servizi per la persona                    ,0,0,1,0,1,2024
LIG,SV,T   ,Attività di famiglie e convivenze come datori di lavoro p...,0,0,0,0,0,2024
LIG,SV,T 97,Attività di famiglie e convivenze come datori di lavoro p...,0,0,0,0,0,2024
LIG,SV,T 98,Produzione di beni e servizi indifferenziati per uso prop...,0,0,0,0,0,2024
LIG,SV,U   ,Organizzazioni ed organismi extraterritoriali               ,0,0,0,0,0,2024
LIG,SV,U 99,Organizzazioni ed organismi extraterritoriali               ,0,0,0,0,0,2024
LIG,SV,XX  ,Imprese non classificate                                    ,3,1,3,12,19,2024
LIG,SV,TOT ,TOTALE                                                      ,24,7,36,49,116,2024
LIG,GE,A   ,"Agricoltura, silvicoltura pesca                             ",0,0,1,2,3,2024
LIG,GE,A 01,"Coltivazioni agricole e produzione di prodotti animali, c...",0,0,1,1,2,2024
LIG,GE,A 02,Silvicoltura ed utilizzo di aree forestali                  ,0,0,0,0,0,2024
LIG,GE,A 03,Pesca e acquacoltura                                        ,0,0,0,1,1,2024
LIG,GE,B   ,Estrazione di minerali da cave e miniere                    ,0,0,0,0,0,2024
LIG,GE,B 05,Estrazione di carbone (esclusa torba)                       ,0,0,0,0,0,2024
LIG,GE,B 06,Estraz.di petrolio greggio e di gas naturale                ,0,0,0,0,0,2024
LIG,GE,B 07,Estrazione di minerali metalliferi                          ,0,0,0,0,0,2024
LIG,GE,B 08,Altre attività di estrazione di minerali da cave e miniere  ,0,0,0,0,0,2024
LIG,GE,B 09,Attività dei servizi di supporto all'estrazione             ,0,0,0,0,0,2024
LIG,GE,C   ,Attività manifatturiere                                     ,1,1,2,2,6,2024
LIG,GE,C 10,Industrie alimentari                                        ,0,0,0,0,0,2024
LIG,GE,C 11,Industria delle bevande                                     ,0,0,0,0,0,2024
LIG,GE,C 12,Industria del tabacco                                       ,0,0,0,0,0,2024
LIG,GE,C 13,Industrie tessili                                           ,0,0,0,0,0,2024
LIG,GE,C 14,Confezione di articoli di abbigliamento; confezione di ar...,0,0,0,0,0,2024
LIG,GE,C 15,Fabbricazione di articoli in pelle e simili                 ,0,0,0,0,0,2024
LIG,GE,C 16,Industria del legno e dei prodotti in legno e sughero (es...,0,0,1,1,2,2024
LIG,GE,C 17,Fabbricazione di carta e di prodotti di carta               ,0,0,0,0,0,2024
LIG,GE,C 18,Stampa e riproduzione di supporti registrati                ,0,0,0,0,0,2024
LIG,GE,C 19,Fabbricazione di coke e prodotti derivanti dalla raffinaz...,0,0,0,0,0,2024
LIG,GE,C 20,Fabbricazione di prodotti chimici                           ,0,0,0,0,0,2024
LIG,GE,C 21,Fabbricazione di prodotti farmaceutici di base e di prepa...,0,0,0,0,0,2024
LIG,GE,C 22,Fabbricazione di articoli in gomma e materie plastiche      ,0,0,0,0,0,2024
LIG,GE,C 23,Fabbricazione di altri prodotti della lavorazione di miner..,0,0,0,0,0,2024
LIG,GE,C 24,Metallurgia                                                 ,0,0,0,0,0,2024
LIG,GE,C 25,Fabbricazione di prodotti in metallo (esclusi macchinari ...,0,1,0,0,1,2024
LIG,GE,C 26,Fabbricazione di computer e prodotti di elettronica e ott...,0,0,1,0,1,2024
LIG,GE,C 27,Fabbricazione di apparecchiature elettriche ed apparecchi...,0,0,0,0,0,2024
LIG,GE,C 28,Fabbricazione di macchinari ed apparecchiature nca          ,0,0,0,0,0,2024
LIG,GE,C 29,"Fabbricazione di autoveicoli, rimorchi e semirimorchi       ",0,0,0,0,0,2024
LIG,GE,C 30,Fabbricazione di altri mezzi di trasporto                   ,0,0,0,0,0,2024
LIG,GE,C 31,Fabbricazione di mobili                                     ,1,0,0,0,1,2024
LIG,GE,C 32,Altre industrie manifatturiere                              ,0,0,0,0,0,2024
LIG,GE,C 33,"Riparazione, manutenzione ed installazione di macchine ed...",0,0,0,1,1,2024
LIG,GE,D   ,"Fornitura di energia elettrica, gas, vapore e aria condiz...",0,0,0,0,0,2024
LIG,GE,D 35,"Fornitura di energia elettrica, gas, vapore e aria condiz...",0,0,0,0,0,2024
LIG,GE,E   ,"Fornitura di acqua; reti fognarie, attività di gestione d...",0,0,0,0,0,2024
LIG,GE,E 36,"Raccolta, trattamento e fornitura di acqua                  ",0,0,0,0,0,2024
LIG,GE,E 37,Gestione delle reti fognarie                                ,0,0,0,0,0,2024
LIG,GE,E 38,"Attività di raccolta, trattamento e smaltimento dei rifiu...",0,0,0,0,0,2024
LIG,GE,E 39,Attività di risanamento e altri servizi di gestione dei r...,0,0,0,0,0,2024
LIG,GE,F   ,Costruzioni                                                 ,0,0,8,19,27,2024
LIG,GE,F 41,Costruzione di edifici                                      ,0,0,1,7,8,2024
LIG,GE,F 42,Ingegneria civile                                           ,0,0,0,2,2,2024
LIG,GE,F 43,Lavori di costruzione specializzati                         ,0,0,7,10,17,2024
LIG,GE,G   ,Commercio all'ingrosso e al dettaglio; riparazione di aut...,0,0,26,2,28,2024
LIG,GE,G 45,Commercio all'ingrosso e al dettaglio e riparazione di au...,0,0,13,0,13,2024
LIG,GE,G 46,Commercio all'ingrosso (escluso quello di autoveicoli e d...,0,0,2,1,3,2024
LIG,GE,G 47,Commercio al dettaglio (escluso quello di autoveicoli e d...,0,0,11,1,12,2024
LIG,GE,H   ,Trasporto e magazzinaggio                                   ,0,0,0,11,11,2024
LIG,GE,H 49,Trasporto terrestre e mediante condotte                     ,0,0,0,5,5,2024
LIG,GE,H 50,Trasporto marittimo e per vie d'acqua                       ,0,0,0,1,1,2024
LIG,GE,H 51,Trasporto aereo                                             ,0,0,0,0,0,2024
LIG,GE,H 52,Magazzinaggio e attività di supporto ai trasporti           ,0,0,0,5,5,2024
LIG,GE,H 53,Servizi postali e attività di corriere                      ,0,0,0,0,0,2024
LIG,GE,I   ,Attività dei servizi alloggio e ristorazione                ,0,0,1,4,5,2024
LIG,GE,I 55,Alloggio                                                    ,0,0,0,0,0,2024
LIG,GE,I 56,Attività dei servizi di ristorazione                        ,0,0,1,4,5,2024
LIG,GE,J   ,Servizi di informazione e comunicazione                     ,0,0,0,3,3,2024
LIG,GE,J 58,Attività editoriali                                         ,0,0,0,2,2,2024
LIG,GE,J 59,"Attività di produzione cinematografica, di video e di pro...",0,0,0,0,0,2024
LIG,GE,J 60,Attività di programmazione e trasmissione                   ,0,0,0,0,0,2024
LIG,GE,J 61,Telecomunicazioni                                           ,0,0,0,0,0,2024
LIG,GE,J 62,"Produzione di software, consulenza informatica e attività...",0,0,0,1,1,2024
LIG,GE,J 63,Attività dei servizi d'informazione e altri servizi infor...,0,0,0,0,0,2024
LIG,GE,K   ,Attività finanziarie e assicurative                         ,1,0,1,0,2,2024
LIG,GE,K 64,Attività di servizi finanziari (escluse le assicurazioni ...,0,0,0,0,0,2024
LIG,GE,K 65,"Assicurazioni, riassicurazioni e fondi pensione (escluse ...",0,0,0,0,0,2024
LIG,GE,K 66,Attività ausiliarie dei servizi finanziari e delle attivi...,1,0,1,0,2,2024
LIG,GE,L   ,Attivita' immobiliari                                       ,0,0,0,0,0,2024
LIG,GE,L 68,Attivita' immobiliari                                       ,0,0,0,0,0,2024
LIG,GE,M   ,"Attività professionali, scientifiche e tecniche             ",0,0,1,3,4,2024
LIG,GE,M 69,Attività legali e contabilità                               ,0,0,0,0,0,2024
LIG,GE,M 70,Attività di direzione aziendale e di consulenza gestional...,0,0,0,1,1,2024
LIG,GE,M 71,Attività degli studi di architettura e d'ingegneria; coll...,0,0,0,1,1,2024
LIG,GE,M 72,Ricerca scientifica e sviluppo                              ,0,0,0,0,0,2024
LIG,GE,M 73,Pubblicità e ricerche di mercato                            ,0,0,0,0,0,2024
LIG,GE,M 74,"Altre attività professionali, scientifiche e tecniche       ",0,0,1,1,2,2024
LIG,GE,M 75,Servizi veterinari                                          ,0,0,0,0,0,2024
LIG,GE,N   ,"Noleggio, agenzie di viaggio, servizi di supporto alle im...",0,0,0,9,9,2024
LIG,GE,N 77,Attività di noleggio e leasing operativo                    ,0,0,0,1,1,2024
LIG,GE,N 78,"Attività di ricerca, selezione, fornitura di personale      ",0,0,0,0,0,2024
LIG,GE,N 79,"Attività dei servizi delle agenzie di viaggio, dei tour o...",0,0,0,1,1,2024
LIG,GE,N 80,Servizi di vigilanza e investigazione                       ,0,0,0,0,0,2024
LIG,GE,N 81,Attività di servizi per edifici e paesaggio                 ,0,0,0,4,4,2024
LIG,GE,N 82,Attività di supporto per le funzioni d'ufficio e altri se...,0,0,0,3,3,2024
LIG,GE,O   ,Amministrazione pubblica e difesa; assicurazione sociale ...,0,0,0,0,0,2024
LIG,GE,O 84,Amministrazione pubblica e difesa; assicurazione sociale ...,0,0,0,0,0,2024
LIG,GE,P   ,Istruzione                                                  ,0,0,0,1,1,2024
LIG,GE,P 85,Istruzione                                                  ,0,0,0,1,1,2024
LIG,GE,Q   ,Sanita' e assistenza sociale                                ,0,0,0,6,6,2024
LIG,GE,Q 86,Assistenza sanitaria                                        ,0,0,0,1,1,2024
LIG,GE,Q 87,Servizi di assistenza sociale residenziale                  ,0,0,0,2,2,2024
LIG,GE,Q 88,Assistenza sociale non residenziale                         ,0,0,0,3,3,2024
LIG,GE,R   ,"Attività artistiche, sportive, di intrattenimento e diver...",0,0,0,2,2,2024
LIG,GE,R 90,"Attività creative, artistiche e di intrattenimento          ",0,0,0,2,2,2024
LIG,GE,R 91,"Attività di biblioteche, archivi, musei ed altre attività...",0,0,0,0,0,2024
LIG,GE,R 92,"Attività riguardanti le lotterie, le scommesse, le case d...",0,0,0,0,0,2024
LIG,GE,R 93,"Attività sportive, di intrattenimento e di divertimento     ",0,0,0,0,0,2024
LIG,GE,S   ,Altre attività di servizi                                   ,0,0,0,1,1,2024
LIG,GE,S 94,Attività di organizzazioni associative                      ,0,0,0,0,0,2024
LIG,GE,S 95,Riparazione di computer e di beni per uso personale e per...,0,0,0,0,0,2024
LIG,GE,S 96,Altre attività di servizi per la persona                    ,0,0,0,1,1,2024
LIG,GE,T   ,Attività di famiglie e convivenze come datori di lavoro p...,0,0,0,0,0,2024
LIG,GE,T 97,Attività di famiglie e convivenze come datori di lavoro p...,0,0,0,0,0,2024
LIG,GE,T 98,Produzione di beni e servizi indifferenziati per uso prop...,0,0,0,0,0,2024
LIG,GE,U   ,Organizzazioni ed organismi extraterritoriali               ,0,0,0,0,0,2024
LIG,GE,U 99,Organizzazioni ed organismi extraterritoriali               ,0,0,0,0,0,2024
LIG,GE,XX  ,Imprese non classificate                                    ,0,0,0,13,13,2024
LIG,GE,TOT ,TOTALE                                                      ,2,1,40,78,121,2024
LIG,SP,A   ,"Agricoltura, silvicoltura pesca                             ",0,0,7,1,8,2024
LIG,SP,A 01,"Coltivazioni agricole e produzione di prodotti animali, c...",0,0,7,1,8,2024
LIG,SP,A 02,Silvicoltura ed utilizzo di aree forestali                  ,0,0,0,0,0,2024
LIG,SP,A 03,Pesca e acquacoltura                                        ,0,0,0,0,0,2024
LIG,SP,B   ,Estrazione di minerali da cave e miniere                    ,0,0,0,1,1,2024
LIG,SP,B 05,Estrazione di carbone (esclusa torba)                       ,0,0,0,0,0,2024
LIG,SP,B 06,Estraz.di petrolio greggio e di gas naturale                ,0,0,0,0,0,2024
LIG,SP,B 07,Estrazione di minerali metalliferi                          ,0,0,0,0,0,2024
LIG,SP,B 08,Altre attività di estrazione di minerali da cave e miniere  ,0,0,0,1,1,2024
LIG,SP,B 09,Attività dei servizi di supporto all'estrazione             ,0,0,0,0,0,2024
LIG,SP,C   ,Attività manifatturiere                                     ,3,1,16,13,33,2024
LIG,SP,C 10,Industrie alimentari                                        ,0,1,1,2,4,2024
LIG,SP,C 11,Industria delle bevande                                     ,0,0,0,0,0,2024
LIG,SP,C 12,Industria del tabacco                                       ,0,0,0,0,0,2024
LIG,SP,C 13,Industrie tessili                                           ,0,0,0,0,0,2024
LIG,SP,C 14,Confezione di articoli di abbigliamento; confezione di ar...,0,0,0,0,0,2024
LIG,SP,C 15,Fabbricazione di articoli in pelle e simili                 ,0,0,0,0,0,2024
LIG,SP,C 16,Industria del legno e dei prodotti in legno e sughero (es...,0,0,2,2,4,2024
LIG,SP,C 17,Fabbricazione di carta e di prodotti di carta               ,0,0,0,0,0,2024
LIG,SP,C 18,Stampa e riproduzione di supporti registrati                ,0,0,1,0,1,2024
LIG,SP,C 19,Fabbricazione di coke e prodotti derivanti dalla raffinaz...,0,0,0,0,0,2024
LIG,SP,C 20,Fabbricazione di prodotti chimici                           ,0,0,0,0,0,2024
LIG,SP,C 21,Fabbricazione di prodotti farmaceutici di base e di prepa...,0,0,0,0,0,2024
LIG,SP,C 22,Fabbricazione di articoli in gomma e materie plastiche      ,0,0,1,0,1,2024
LIG,SP,C 23,Fabbricazione di altri prodotti della lavorazione di miner..,0,0,0,1,1,2024
LIG,SP,C 24,Metallurgia                                                 ,0,0,0,0,0,2024
LIG,SP,C 25,Fabbricazione di prodotti in metallo (esclusi macchinari ...,0,0,6,2,8,2024
LIG,SP,C 26,Fabbricazione di computer e prodotti di elettronica e ott...,0,0,1,0,1,2024
LIG,SP,C 27,Fabbricazione di apparecchiature elettriche ed apparecchi...,0,0,0,1,1,2024
LIG,SP,C 28,Fabbricazione di macchinari ed apparecchiature nca          ,1,0,0,0,1,2024
LIG,SP,C 29,"Fabbricazione di autoveicoli, rimorchi e semirimorchi       ",0,0,0,0,0,2024
LIG,SP,C 30,Fabbricazione di altri mezzi di trasporto                   ,0,0,1,3,4,2024
LIG,SP,C 31,Fabbricazione di mobili                                     ,1,0,1,0,2,2024
LIG,SP,C 32,Altre industrie manifatturiere                              ,0,0,0,0,0,2024
LIG,SP,C 33,"Riparazione, manutenzione ed installazione di macchine ed...",1,0,2,2,5,2024
LIG,SP,D   ,"Fornitura di energia elettrica, gas, vapore e aria condiz...",0,0,1,0,1,2024
LIG,SP,D 35,"Fornitura di energia elettrica, gas, vapore e aria condiz...",0,0,1,0,1,2024
LIG,SP,E   ,"Fornitura di acqua; reti fognarie, attività di gestione d...",0,0,0,0,0,2024
LIG,SP,E 36,"Raccolta, trattamento e fornitura di acqua                  ",0,0,0,0,0,2024
LIG,SP,E 37,Gestione delle reti fognarie                                ,0,0,0,0,0,2024
LIG,SP,E 38,"Attività di raccolta, trattamento e smaltimento dei rifiu...",0,0,0,0,0,2024
LIG,SP,E 39,Attività di risanamento e altri servizi di gestione dei r...,0,0,0,0,0,2024
LIG,SP,F   ,Costruzioni                                                 ,7,1,66,37,111,2024
LIG,SP,F 41,Costruzione di edifici                                      ,6,1,6,22,35,2024
LIG,SP,F 42,Ingegneria civile                                           ,0,0,0,0,0,2024
LIG,SP,F 43,Lavori di costruzione specializzati                         ,1,0,60,15,76,2024
LIG,SP,G   ,Commercio all'ingrosso e al dettaglio; riparazione di aut...,9,1,62,5,77,2024
LIG,SP,G 45,Commercio all'ingrosso e al dettaglio e riparazione di au...,1,0,3,0,4,2024
LIG,SP,G 46,Commercio all'ingrosso (escluso quello di autoveicoli e d...,4,0,12,3,19,2024
LIG,SP,G 47,Commercio al dettaglio (escluso quello di autoveicoli e d...,4,1,47,2,54,2024
LIG,SP,H   ,Trasporto e magazzinaggio                                   ,0,0,4,11,15,2024
LIG,SP,H 49,Trasporto terrestre e mediante condotte                     ,0,0,4,6,10,2024
LIG,SP,H 50,Trasporto marittimo e per vie d'acqua                       ,0,0,0,2,2,2024
LIG,SP,H 51,Trasporto aereo                                             ,0,0,0,0,0,2024
LIG,SP,H 52,Magazzinaggio e attività di supporto ai trasporti           ,0,0,0,3,3,2024
LIG,SP,H 53,Servizi postali e attività di corriere                      ,0,0,0,0,0,2024
LIG,SP,I   ,Attività dei servizi alloggio e ristorazione                ,4,2,13,2,21,2024
LIG,SP,I 55,Alloggio                                                    ,0,0,0,0,0,2024
LIG,SP,I 56,Attività dei servizi di ristorazione                        ,4,2,13,2,21,2024
LIG,SP,J   ,Servizi di informazione e comunicazione                     ,0,0,0,2,2,2024
LIG,SP,J 58,Attività editoriali                                         ,0,0,0,1,1,2024
LIG,SP,J 59,"Attività di produzione cinematografica, di video e di pro...",0,0,0,0,0,2024
LIG,SP,J 60,Attività di programmazione e trasmissione                   ,0,0,0,1,1,2024
LIG,SP,J 61,Telecomunicazioni                                           ,0,0,0,0,0,2024
LIG,SP,J 62,"Produzione di software, consulenza informatica e attività...",0,0,0,0,0,2024
LIG,SP,J 63,Attività dei servizi d'informazione e altri servizi infor...,0,0,0,0,0,2024
LIG,SP,K   ,Attività finanziarie e assicurative                         ,0,0,2,0,2,2024
LIG,SP,K 64,Attività di servizi finanziari (escluse le assicurazioni ...,0,0,0,0,0,2024
LIG,SP,K 65,"Assicurazioni, riassicurazioni e fondi pensione (escluse ...",0,0,0,0,0,2024
LIG,SP,K 66,Attività ausiliarie dei servizi finanziari e delle attivi...,0,0,2,0,2,2024
LIG,SP,L   ,Attivita' immobiliari                                       ,1,1,0,0,2,2024
LIG,SP,L 68,Attivita' immobiliari                                       ,1,1,0,0,2,2024
LIG,SP,M   ,"Attività professionali, scientifiche e tecniche             ",3,1,2,6,12,2024
LIG,SP,M 69,Attività legali e contabilità                               ,0,0,0,1,1,2024
LIG,SP,M 70,Attività di direzione aziendale e di consulenza gestional...,0,1,1,0,2,2024
LIG,SP,M 71,Attività degli studi di architettura e d'ingegneria; coll...,0,0,0,2,2,2024
LIG,SP,M 72,Ricerca scientifica e sviluppo                              ,0,0,0,0,0,2024
LIG,SP,M 73,Pubblicità e ricerche di mercato                            ,1,0,0,1,2,2024
LIG,SP,M 74,"Altre attività professionali, scientifiche e tecniche       ",2,0,1,2,5,2024
LIG,SP,M 75,Servizi veterinari                                          ,0,0,0,0,0,2024
LIG,SP,N   ,"Noleggio, agenzie di viaggio, servizi di supporto alle im...",2,1,13,18,34,2024
LIG,SP,N 77,Attività di noleggio e leasing operativo                    ,0,0,0,0,0,2024
LIG,SP,N 78,"Attività di ricerca, selezione, fornitura di personale      ",0,0,0,0,0,2024
LIG,SP,N 79,"Attività dei servizi delle agenzie di viaggio, dei tour o...",0,0,0,0,0,2024
LIG,SP,N 80,Servizi di vigilanza e investigazione                       ,0,0,0,1,1,2024
LIG,SP,N 81,Attività di servizi per edifici e paesaggio                 ,0,0,11,13,24,2024
LIG,SP,N 82,Attività di supporto per le funzioni d'ufficio e altri se...,2,1,2,4,9,2024
LIG,SP,O   ,Amministrazione pubblica e difesa; assicurazione sociale ...,0,0,0,0,0,2024
LIG,SP,O 84,Amministrazione pubblica e difesa; assicurazione sociale ...,0,0,0,0,0,2024
LIG,SP,P   ,Istruzione                                                  ,0,0,0,1,1,2024
LIG,SP,P 85,Istruzione                                                  ,0,0,0,1,1,2024
LIG,SP,Q   ,Sanita' e assistenza sociale                                ,0,0,0,4,4,2024
LIG,SP,Q 86,Assistenza sanitaria                                        ,0,0,0,1,1,2024
LIG,SP,Q 87,Servizi di assistenza sociale residenziale                  ,0,0,0,0,0,2024
LIG,SP,Q 88,Assistenza sociale non residenziale                         ,0,0,0,3,3,2024
LIG,SP,R   ,"Attività artistiche, sportive, di intrattenimento e diver...",1,0,0,1,2,2024
LIG,SP,R 90,"Attività creative, artistiche e di intrattenimento          ",0,0,0,1,1,2024
LIG,SP,R 91,"Attività di biblioteche, archivi, musei ed altre attività...",0,0,0,0,0,2024
LIG,SP,R 92,"Attività riguardanti le lotterie, le scommesse, le case d...",0,0,0,0,0,2024
LIG,SP,R 93,"Attività sportive, di intrattenimento e di divertimento     ",1,0,0,0,1,2024
LIG,SP,S   ,Altre attività di servizi                                   ,2,0,7,5,14,2024
LIG,SP,S 94,Attività di organizzazioni associative                      ,0,0,0,0,0,2024
LIG,SP,S 95,Riparazione di computer e di beni per uso personale e per...,0,0,2,0,2,2024
LIG,SP,S 96,Altre attività di servizi per la persona                    ,2,0,5,5,12,2024
LIG,SP,T   ,Attività di famiglie e convivenze come datori di lavoro p...,0,0,0,0,0,2024
LIG,SP,T 97,Attività di famiglie e convivenze come datori di lavoro p...,0,0,0,0,0,2024
LIG,SP,T 98,Produzione di beni e servizi indifferenziati per uso prop...,0,0,0,0,0,2024
LIG,SP,U   ,Organizzazioni ed organismi extraterritoriali               ,0,0,0,0,0,2024
LIG,SP,U 99,Organizzazioni ed organismi extraterritoriali               ,0,0,0,0,0,2024
LIG,SP,XX  ,Imprese non classificate                                    ,6,0,11,18,35,2024
LIG,SP,TOT ,TOTALE                                                      ,38,8,204,125,375,2024
EMI,  ,A   ,"Agricoltura, silvicoltura pesca                             ",3,18,67,31,119,2024
EMI,  ,A 01,"Coltivazioni agricole e produzione di prodotti animali, c...",3,18,64,23,108,2024
EMI,  ,A 02,Silvicoltura ed utilizzo di aree forestali                  ,0,0,3,7,10,2024
EMI,  ,A 03,Pesca e acquacoltura                                        ,0,0,0,1,1,2024
EMI,  ,B   ,Estrazione di minerali da cave e miniere                    ,0,0,0,1,1,2024
EMI,  ,B 05,Estrazione di carbone (esclusa torba)                       ,0,0,0,0,0,2024
EMI,  ,B 06,Estraz.di petrolio greggio e di gas naturale                ,0,0,0,0,0,2024
EMI,  ,B 07,Estrazione di minerali metalliferi                          ,0,0,0,0,0,2024
EMI,  ,B 08,Altre attività di estrazione di minerali da cave e miniere  ,0,0,0,1,1,2024
EMI,  ,B 09,Attività dei servizi di supporto all'estrazione             ,0,0,0,0,0,2024
EMI,  ,C   ,Attività manifatturiere                                     ,74,88,220,151,533,2024
EMI,  ,C 10,Industrie alimentari                                        ,5,14,10,29,58,2024
EMI,  ,C 11,Industria delle bevande                                     ,0,0,0,0,0,2024
EMI,  ,C 12,Industria del tabacco                                       ,0,0,0,0,0,2024
EMI,  ,C 13,Industrie tessili                                           ,2,1,3,5,11,2024
EMI,  ,C 14,Confezione di articoli di abbigliamento; confezione di ar...,12,21,76,4,113,2024
EMI,  ,C 15,Fabbricazione di articoli in pelle e simili                 ,1,0,7,5,13,2024
EMI,  ,C 16,Industria del legno e dei prodotti in legno e sughero (es...,1,2,7,6,16,2024
EMI,  ,C 17,Fabbricazione di carta e di prodotti di carta               ,1,0,1,0,2,2024
EMI,  ,C 18,Stampa e riproduzione di supporti registrati                ,2,4,7,3,16,2024
EMI,  ,C 19,Fabbricazione di coke e prodotti derivanti dalla raffinaz...,0,0,0,0,0,2024
EMI,  ,C 20,Fabbricazione di prodotti chimici                           ,0,1,0,0,1,2024
EMI,  ,C 21,Fabbricazione di prodotti farmaceutici di base e di prepa...,0,0,0,0,0,2024
EMI,  ,C 22,Fabbricazione di articoli in gomma e materie plastiche      ,1,4,4,1,10,2024
EMI,  ,C 23,Fabbricazione di altri prodotti della lavorazione di miner..,6,4,5,13,28,2024
EMI,  ,C 24,Metallurgia                                                 ,0,1,0,1,2,2024
EMI,  ,C 25,Fabbricazione di prodotti in metallo (esclusi macchinari ...,19,24,44,56,143,2024
EMI,  ,C 26,Fabbricazione di computer e prodotti di elettronica e ott...,0,1,1,2,4,2024
EMI,  ,C 27,Fabbricazione di apparecchiature elettriche ed apparecchi...,2,1,1,1,5,2024
EMI,  ,C 28,Fabbricazione di macchinari ed apparecchiature nca          ,11,4,6,8,29,2024
EMI,  ,C 29,"Fabbricazione di autoveicoli, rimorchi e semirimorchi       ",1,0,0,0,1,2024
EMI,  ,C 30,Fabbricazione di altri mezzi di trasporto                   ,0,1,1,0,2,2024
EMI,  ,C 31,Fabbricazione di mobili                                     ,4,2,4,3,13,2024
EMI,  ,C 32,Altre industrie manifatturiere                              ,4,3,13,2,22,2024
EMI,  ,C 33,"Riparazione, manutenzione ed installazione di macchine ed...",2,0,30,12,44,2024
EMI,  ,D   ,"Fornitura di energia elettrica, gas, vapore e aria condiz...",1,0,2,0,3,2024
EMI,  ,D 35,"Fornitura di energia elettrica, gas, vapore e aria condiz...",1,0,2,0,3,2024
EMI,  ,E   ,"Fornitura di acqua; reti fognarie, attività di gestione d...",0,0,3,1,4,2024
EMI,  ,E 36,"Raccolta, trattamento e fornitura di acqua                  ",0,0,0,0,0,2024
EMI,  ,E 37,Gestione delle reti fognarie                                ,0,0,0,0,0,2024
EMI,  ,E 38,"Attività di raccolta, trattamento e smaltimento dei rifiu...",0,0,3,1,4,2024
EMI,  ,E 39,Attività di risanamento e altri servizi di gestione dei r...,0,0,0,0,0,2024
EMI,  ,F   ,Costruzioni                                                 ,51,64,989,231,1335,2024
EMI,  ,F 41,Costruzione di edifici                                      ,35,23,98,134,290,2024
EMI,  ,F 42,Ingegneria civile                                           ,1,2,2,2,7,2024
EMI,  ,F 43,Lavori di costruzione specializzati                         ,15,39,889,95,1038,2024
EMI,  ,G   ,Commercio all'ingrosso e al dettaglio; riparazione di aut...,66,119,616,43,844,2024
EMI,  ,G 45,Commercio all'ingrosso e al dettaglio e riparazione di au...,7,12,114,3,136,2024
EMI,  ,G 46,Commercio all'ingrosso (escluso quello di autoveicoli e d...,35,40,207,25,307,2024
EMI,  ,G 47,Commercio al dettaglio (escluso quello di autoveicoli e d...,24,67,295,15,401,2024
EMI,  ,H   ,Trasporto e magazzinaggio                                   ,6,18,73,262,359,2024
EMI,  ,H 49,Trasporto terrestre e mediante condotte                     ,2,14,60,45,121,2024
EMI,  ,H 50,Trasporto marittimo e per vie d'acqua                       ,0,0,0,0,0,2024
EMI,  ,H 51,Trasporto aereo                                             ,0,0,0,0,0,2024
EMI,  ,H 52,Magazzinaggio e attività di supporto ai trasporti           ,4,4,10,217,235,2024
EMI,  ,H 53,Servizi postali e attività di corriere                      ,0,0,3,0,3,2024
EMI,  ,I   ,Attività dei servizi alloggio e ristorazione                ,26,156,162,30,374,2024
EMI,  ,I 55,Alloggio                                                    ,1,5,7,4,17,2024
EMI,  ,I 56,Attività dei servizi di ristorazione                        ,25,151,155,26,357,2024
EMI,  ,J   ,Servizi di informazione e comunicazione                     ,13,9,41,15,78,2024
EMI,  ,J 58,Attività editoriali                                         ,1,0,2,3,6,2024
EMI,  ,J 59,"Attività di produzione cinematografica, di video e di pro...",2,1,2,3,8,2024
EMI,  ,J 60,Attività di programmazione e trasmissione                   ,0,0,0,1,1,2024
EMI,  ,J 61,Telecomunicazioni                                           ,1,2,19,0,22,2024
EMI,  ,J 62,"Produzione di software, consulenza informatica e attività...",4,3,7,5,19,2024
EMI,  ,J 63,Attività dei servizi d'informazione e altri servizi infor...,5,3,11,3,22,2024
EMI,  ,K   ,Attività finanziarie e assicurative                         ,5,5,25,0,35,2024
EMI,  ,K 64,Attività di servizi finanziari (escluse le assicurazioni ...,3,3,0,0,6,2024
EMI,  ,K 65,"Assicurazioni, riassicurazioni e fondi pensione (escluse ...",0,0,1,0,1,2024
EMI,  ,K 66,Attività ausiliarie dei servizi finanziari e delle attivi...,2,2,24,0,28,2024
EMI,  ,L   ,Attivita' immobiliari                                       ,23,29,11,16,79,2024
EMI,  ,L 68,Attivita' immobiliari                                       ,23,29,11,16,79,2024
EMI,  ,M   ,"Attività professionali, scientifiche e tecniche             ",31,9,40,42,122,2024
EMI,  ,M 69,Attività legali e contabilità                               ,1,3,1,1,6,2024
EMI,  ,M 70,Attività di direzione aziendale e di consulenza gestional...,17,2,8,12,39,2024
EMI,  ,M 71,Attività degli studi di architettura e d'ingegneria; coll...,2,1,2,2,7,2024
EMI,  ,M 72,Ricerca scientifica e sviluppo                              ,0,0,0,1,1,2024
EMI,  ,M 73,Pubblicità e ricerche di mercato                            ,2,1,18,15,36,2024
EMI,  ,M 74,"Altre attività professionali, scientifiche e tecniche       ",9,2,11,11,33,2024
EMI,  ,M 75,Servizi veterinari                                          ,0,0,0,0,0,2024
EMI,  ,N   ,"Noleggio, agenzie di viaggio, servizi di supporto alle im...",18,15,93,92,218,2024
EMI,  ,N 77,Attività di noleggio e leasing operativo                    ,2,4,2,1,9,2024
EMI,  ,N 78,"Attività di ricerca, selezione, fornitura di personale      ",2,0,0,1,3,2024
EMI,  ,N 79,"Attività dei servizi delle agenzie di viaggio, dei tour o...",1,0,1,4,6,2024
EMI,  ,N 80,Servizi di vigilanza e investigazione                       ,1,0,1,2,4,2024
EMI,  ,N 81,Attività di servizi per edifici e paesaggio                 ,6,8,63,57,134,2024
EMI,  ,N 82,Attività di supporto per le funzioni d'ufficio e altri se...,6,3,26,27,62,2024
EMI,  ,O   ,Amministrazione pubblica e difesa; assicurazione sociale ...,0,0,0,0,0,2024
EMI,  ,O 84,Amministrazione pubblica e difesa; assicurazione sociale ...,0,0,0,0,0,2024
EMI,  ,P   ,Istruzione                                                  ,4,0,1,11,16,2024
EMI,  ,P 85,Istruzione                                                  ,4,0,1,11,16,2024
EMI,  ,Q   ,Sanita' e assistenza sociale                                ,3,1,2,35,41,2024
EMI,  ,Q 86,Assistenza sanitaria                                        ,1,0,1,3,5,2024
EMI,  ,Q 87,Servizi di assistenza sociale residenziale                  ,0,0,1,5,6,2024
EMI,  ,Q 88,Assistenza sociale non residenziale                         ,2,1,0,27,30,2024
EMI,  ,R   ,"Attività artistiche, sportive, di intrattenimento e diver...",8,12,16,42,78,2024
EMI,  ,R 90,"Attività creative, artistiche e di intrattenimento          ",1,2,5,28,36,2024
EMI,  ,R 91,"Attività di biblioteche, archivi, musei ed altre attività...",0,0,0,1,1,2024
EMI,  ,R 92,"Attività riguardanti le lotterie, le scommesse, le case d...",0,0,0,0,0,2024
EMI,  ,R 93,"Attività sportive, di intrattenimento e di divertimento     ",7,10,11,13,41,2024
EMI,  ,S   ,Altre attività di servizi                                   ,9,13,53,15,90,2024
EMI,  ,S 94,Attività di organizzazioni associative                      ,0,0,0,1,1,2024
EMI,  ,S 95,Riparazione di computer e di beni per uso personale e per...,1,4,16,0,21,2024
EMI,  ,S 96,Altre attività di servizi per la persona                    ,8,9,37,14,68,2024
EMI,  ,T   ,Attività di famiglie e convivenze come datori di lavoro p...,0,0,0,0,0,2024
EMI,  ,T 97,Attività di famiglie e convivenze come datori di lavoro p...,0,0,0,0,0,2024
EMI,  ,T 98,Produzione di beni e servizi indifferenziati per uso prop...,0,0,0,0,0,2024
EMI,  ,U   ,Organizzazioni ed organismi extraterritoriali               ,0,0,0,0,0,2024
EMI,  ,U 99,Organizzazioni ed organismi extraterritoriali               ,0,0,0,0,0,2024
EMI,  ,XX  ,Imprese non classificate                                    ,50,34,47,209,340,2024
EMI,  ,TOT ,TOTALE                                                      ,391,590,2461,1227,4669,2024
EMI,PC,A   ,"Agricoltura, silvicoltura pesca                             ",0,1,0,7,8,2024
EMI,PC,A 01,"Coltivazioni agricole e produzione di prodotti animali, c...",0,1,0,5,6,2024
EMI,PC,A 02,Silvicoltura ed utilizzo di aree forestali                  ,0,0,0,2,2,2024
EMI,PC,A 03,Pesca e acquacoltura                                        ,0,0,0,0,0,2024
EMI,PC,B   ,Estrazione di minerali da cave e miniere                    ,0,0,0,0,0,2024
EMI,PC,B 05,Estrazione di carbone (esclusa torba)                       ,0,0,0,0,0,2024
EMI,PC,B 06,Estraz.di petrolio greggio e di gas naturale                ,0,0,0,0,0,2024
EMI,PC,B 07,Estrazione di minerali metalliferi                          ,0,0,0,0,0,2024
EMI,PC,B 08,Altre attività di estrazione di minerali da cave e miniere  ,0,0,0,0,0,2024
EMI,PC,B 09,Attività dei servizi di supporto all'estrazione             ,0,0,0,0,0,2024
EMI,PC,C   ,Attività manifatturiere                                     ,0,0,1,8,9,2024
EMI,PC,C 10,Industrie alimentari                                        ,0,0,0,1,1,2024
EMI,PC,C 11,Industria delle bevande                                     ,0,0,0,0,0,2024
EMI,PC,C 12,Industria del tabacco                                       ,0,0,0,0,0,2024
EMI,PC,C 13,Industrie tessili                                           ,0,0,0,0,0,2024
EMI,PC,C 14,Confezione di articoli di abbigliamento; confezione di ar...,0,0,0,0,0,2024
EMI,PC,C 15,Fabbricazione di articoli in pelle e simili                 ,0,0,0,2,2,2024
EMI,PC,C 16,Industria del legno e dei prodotti in legno e sughero (es...,0,0,0,0,0,2024
EMI,PC,C 17,Fabbricazione di carta e di prodotti di carta               ,0,0,0,0,0,2024
EMI,PC,C 18,Stampa e riproduzione di supporti registrati                ,0,0,0,1,1,2024
EMI,PC,C 19,Fabbricazione di coke e prodotti derivanti dalla raffinaz...,0,0,0,0,0,2024
EMI,PC,C 20,Fabbricazione di prodotti chimici                           ,0,0,0,0,0,2024
EMI,PC,C 21,Fabbricazione di prodotti farmaceutici di base e di prepa...,0,0,0,0,0,2024
EMI,PC,C 22,Fabbricazione di articoli in gomma e materie plastiche      ,0,0,0,0,0,2024
EMI,PC,C 23,Fabbricazione di altri prodotti della lavorazione di miner..,0,0,0,0,0,2024
EMI,PC,C 24,Metallurgia                                                 ,0,0,0,0,0,2024
EMI,PC,C 25,Fabbricazione di prodotti in metallo (esclusi macchinari ...,0,0,1,2,3,2024
EMI,PC,C 26,Fabbricazione di computer e prodotti di elettronica e ott...,0,0,0,0,0,2024
EMI,PC,C 27,Fabbricazione di apparecchiature elettriche ed apparecchi...,0,0,0,0,0,2024
EMI,PC,C 28,Fabbricazione di macchinari ed apparecchiature nca          ,0,0,0,1,1,2024
EMI,PC,C 29,"Fabbricazione di autoveicoli, rimorchi e semirimorchi       ",0,0,0,0,0,2024
EMI,PC,C 30,Fabbricazione di altri mezzi di trasporto                   ,0,0,0,0,0,2024
EMI,PC,C 31,Fabbricazione di mobili                                     ,0,0,0,1,1,2024
EMI,PC,C 32,Altre industrie manifatturiere                              ,0,0,0,0,0,2024
EMI,PC,C 33,"Riparazione, manutenzione ed installazione di macchine ed...",0,0,0,0,0,2024
EMI,PC,D   ,"Fornitura di energia elettrica, gas, vapore e aria condiz...",0,0,0,0,0,2024
EMI,PC,D 35,"Fornitura di energia elettrica, gas, vapore e aria condiz...",0,0,0,0,0,2024
EMI,PC,E   ,"Fornitura di acqua; reti fognarie, attività di gestione d...",0,0,0,0,0,2024
EMI,PC,E 36,"Raccolta, trattamento e fornitura di acqua                  ",0,0,0,0,0,2024
EMI,PC,E 37,Gestione delle reti fognarie                                ,0,0,0,0,0,2024
EMI,PC,E 38,"Attività di raccolta, trattamento e smaltimento dei rifiu...",0,0,0,0,0,2024
EMI,PC,E 39,Attività di risanamento e altri servizi di gestione dei r...,0,0,0,0,0,2024
EMI,PC,F   ,Costruzioni                                                 ,0,0,1,18,19,2024
EMI,PC,F 41,Costruzione di edifici                                      ,0,0,0,13,13,2024
EMI,PC,F 42,Ingegneria civile                                           ,0,0,0,0,0,2024
EMI,PC,F 43,Lavori di costruzione specializzati                         ,0,0,1,5,6,2024
EMI,PC,G   ,Commercio all'ingrosso e al dettaglio; riparazione di aut...,0,0,0,3,3,2024
EMI,PC,G 45,Commercio all'ingrosso e al dettaglio e riparazione di au...,0,0,0,0,0,2024
EMI,PC,G 46,Commercio all'ingrosso (escluso quello di autoveicoli e d...,0,0,0,1,1,2024
EMI,PC,G 47,Commercio al dettaglio (escluso quello di autoveicoli e d...,0,0,0,2,2,2024
EMI,PC,H   ,Trasporto e magazzinaggio                                   ,0,0,0,15,15,2024
EMI,PC,H 49,Trasporto terrestre e mediante condotte                     ,0,0,0,5,5,2024
EMI,PC,H 50,Trasporto marittimo e per vie d'acqua                       ,0,0,0,0,0,2024
EMI,PC,H 51,Trasporto aereo                                             ,0,0,0,0,0,2024
EMI,PC,H 52,Magazzinaggio e attività di supporto ai trasporti           ,0,0,0,10,10,2024
EMI,PC,H 53,Servizi postali e attività di corriere                      ,0,0,0,0,0,2024
EMI,PC,I   ,Attività dei servizi alloggio e ristorazione                ,0,0,0,4,4,2024
EMI,PC,I 55,Alloggio                                                    ,0,0,0,1,1,2024
EMI,PC,I 56,Attività dei servizi di ristorazione                        ,0,0,0,3,3,2024
EMI,PC,J   ,Servizi di informazione e comunicazione                     ,0,0,0,1,1,2024
EMI,PC,J 58,Attività editoriali                                         ,0,0,0,1,1,2024
EMI,PC,J 59,"Attività di produzione cinematografica, di video e di pro...",0,0,0,0,0,2024
EMI,PC,J 60,Attività di programmazione e trasmissione                   ,0,0,0,0,0,2024
EMI,PC,J 61,Telecomunicazioni                                           ,0,0,0,0,0,2024
EMI,PC,J 62,"Produzione di software, consulenza informatica e attività...",0,0,0,0,0,2024
EMI,PC,J 63,Attività dei servizi d'informazione e altri servizi infor...,0,0,0,0,0,2024
EMI,PC,K   ,Attività finanziarie e assicurative                         ,0,1,0,0,1,2024
EMI,PC,K 64,Attività di servizi finanziari (escluse le assicurazioni ...,0,1,0,0,1,2024
EMI,PC,K 65,"Assicurazioni, riassicurazioni e fondi pensione (escluse ...",0,0,0,0,0,2024
EMI,PC,K 66,Attività ausiliarie dei servizi finanziari e delle attivi...,0,0,0,0,0,2024
EMI,PC,L   ,Attivita' immobiliari                                       ,0,0,0,2,2,2024
EMI,PC,L 68,Attivita' immobiliari                                       ,0,0,0,2,2,2024
EMI,PC,M   ,"Attività professionali, scientifiche e tecniche             ",0,0,0,4,4,2024
EMI,PC,M 69,Attività legali e contabilità                               ,0,0,0,0,0,2024
EMI,PC,M 70,Attività di direzione aziendale e di consulenza gestional...,0,0,0,1,1,2024
EMI,PC,M 71,Attività degli studi di architettura e d'ingegneria; coll...,0,0,0,0,0,2024
EMI,PC,M 72,Ricerca scientifica e sviluppo                              ,0,0,0,0,0,2024
EMI,PC,M 73,Pubblicità e ricerche di mercato                            ,0,0,0,3,3,2024
EMI,PC,M 74,"Altre attività professionali, scientifiche e tecniche       ",0,0,0,0,0,2024
EMI,PC,M 75,Servizi veterinari                                          ,0,0,0,0,0,2024
EMI,PC,N   ,"Noleggio, agenzie di viaggio, servizi di supporto alle im...",0,0,0,10,10,2024
EMI,PC,N 77,Attività di noleggio e leasing operativo                    ,0,0,0,0,0,2024
EMI,PC,N 78,"Attività di ricerca, selezione, fornitura di personale      ",0,0,0,0,0,2024
EMI,PC,N 79,"Attività dei servizi delle agenzie di viaggio, dei tour o...",0,0,0,1,1,2024
EMI,PC,N 80,Servizi di vigilanza e investigazione                       ,0,0,0,0,0,2024
EMI,PC,N 81,Attività di servizi per edifici e paesaggio                 ,0,0,0,6,6,2024
EMI,PC,N 82,Attività di supporto per le funzioni d'ufficio e altri se...,0,0,0,3,3,2024
EMI,PC,O   ,Amministrazione pubblica e difesa; assicurazione sociale ...,0,0,0,0,0,2024
EMI,PC,O 84,Amministrazione pubblica e difesa; assicurazione sociale ...,0,0,0,0,0,2024
EMI,PC,P   ,Istruzione                                                  ,0,0,0,2,2,2024
EMI,PC,P 85,Istruzione                                                  ,0,0,0,2,2,2024
EMI,PC,Q   ,Sanita' e assistenza sociale                                ,0,0,0,1,1,2024
EMI,PC,Q 86,Assistenza sanitaria                                        ,0,0,0,0,0,2024
EMI,PC,Q 87,Servizi di assistenza sociale residenziale                  ,0,0,0,0,0,2024
EMI,PC,Q 88,Assistenza sociale non residenziale                         ,0,0,0,1,1,2024
EMI,PC,R   ,"Attività artistiche, sportive, di intrattenimento e diver...",0,0,0,16,16,2024
EMI,PC,R 90,"Attività creative, artistiche e di intrattenimento          ",0,0,0,16,16,2024
EMI,PC,R 91,"Attività di biblioteche, archivi, musei ed altre attività...",0,0,0,0,0,2024
EMI,PC,R 92,"Attività riguardanti le lotterie, le scommesse, le case d...",0,0,0,0,0,2024
EMI,PC,R 93,"Attività sportive, di intrattenimento e di divertimento     ",0,0,0,0,0,2024
EMI,PC,S   ,Altre attività di servizi                                   ,0,0,1,2,3,2024
EMI,PC,S 94,Attività di organizzazioni associative                      ,0,0,0,0,0,2024
EMI,PC,S 95,Riparazione di computer e di beni per uso personale e per...,0,0,0,0,0,2024
EMI,PC,S 96,Altre attività di servizi per la persona                    ,0,0,1,2,3,2024
EMI,PC,T   ,Attività di famiglie e convivenze come datori di lavoro p...,0,0,0,0,0,2024
EMI,PC,T 97,Attività di famiglie e convivenze come datori di lavoro p...,0,0,0,0,0,2024
EMI,PC,T 98,Produzione di beni e servizi indifferenziati per uso prop...,0,0,0,0,0,2024
EMI,PC,U   ,Organizzazioni ed organismi extraterritoriali               ,0,0,0,0,0,2024
EMI,PC,U 99,Organizzazioni ed organismi extraterritoriali               ,0,0,0,0,0,2024
EMI,PC,XX  ,Imprese non classificate                                    ,0,0,0,13,13,2024
EMI,PC,TOT ,TOTALE                                                      ,0,2,3,106,111,2024
EMI,PR,A   ,"Agricoltura, silvicoltura pesca                             ",2,0,0,4,6,2024
EMI,PR,A 01,"Coltivazioni agricole e produzione di prodotti animali, c...",2,0,0,3,5,2024
EMI,PR,A 02,Silvicoltura ed utilizzo di aree forestali                  ,0,0,0,1,1,2024
EMI,PR,A 03,Pesca e acquacoltura                                        ,0,0,0,0,0,2024
EMI,PR,B   ,Estrazione di minerali da cave e miniere                    ,0,0,0,0,0,2024
EMI,PR,B 05,Estrazione di carbone (esclusa torba)                       ,0,0,0,0,0,2024
EMI,PR,B 06,Estraz.di petrolio greggio e di gas naturale                ,0,0,0,0,0,2024
EMI,PR,B 07,Estrazione di minerali metalliferi                          ,0,0,0,0,0,2024
EMI,PR,B 08,Altre attività di estrazione di minerali da cave e miniere  ,0,0,0,0,0,2024
EMI,PR,B 09,Attività dei servizi di supporto all'estrazione             ,0,0,0,0,0,2024
EMI,PR,C   ,Attività manifatturiere                                     ,18,0,0,20,38,2024
EMI,PR,C 10,Industrie alimentari                                        ,3,0,0,8,11,2024
EMI,PR,C 11,Industria delle bevande                                     ,0,0,0,0,0,2024
EMI,PR,C 12,Industria del tabacco                                       ,0,0,0,0,0,2024
EMI,PR,C 13,Industrie tessili                                           ,0,0,0,0,0,2024
EMI,PR,C 14,Confezione di articoli di abbigliamento; confezione di ar...,1,0,0,0,1,2024
EMI,PR,C 15,Fabbricazione di articoli in pelle e simili                 ,0,0,0,0,0,2024
EMI,PR,C 16,Industria del legno e dei prodotti in legno e sughero (es...,0,0,0,0,0,2024
EMI,PR,C 17,Fabbricazione di carta e di prodotti di carta               ,0,0,0,0,0,2024
EMI,PR,C 18,Stampa e riproduzione di supporti registrati                ,0,0,0,0,0,2024
EMI,PR,C 19,Fabbricazione di coke e prodotti derivanti dalla raffinaz...,0,0,0,0,0,2024
EMI,PR,C 20,Fabbricazione di prodotti chimici                           ,0,0,0,0,0,2024
EMI,PR,C 21,Fabbricazione di prodotti farmaceutici di base e di prepa...,0,0,0,0,0,2024
EMI,PR,C 22,Fabbricazione di articoli in gomma e materie plastiche      ,1,0,0,0,1,2024
EMI,PR,C 23,Fabbricazione di altri prodotti della lavorazione di miner..,2,0,0,1,3,2024
EMI,PR,C 24,Metallurgia                                                 ,0,0,0,0,0,2024
EMI,PR,C 25,Fabbricazione di prodotti in metallo (esclusi macchinari ...,6,0,0,6,12,2024
EMI,PR,C 26,Fabbricazione di computer e prodotti di elettronica e ott...,0,0,0,0,0,2024
EMI,PR,C 27,Fabbricazione di apparecchiature elettriche ed apparecchi...,0,0,0,0,0,2024
EMI,PR,C 28,Fabbricazione di macchinari ed apparecchiature nca          ,3,0,0,1,4,2024
EMI,PR,C 29,"Fabbricazione di autoveicoli, rimorchi e semirimorchi       ",0,0,0,0,0,2024
EMI,PR,C 30,Fabbricazione di altri mezzi di trasporto                   ,0,0,0,0,0,2024
EMI,PR,C 31,Fabbricazione di mobili                                     ,1,0,0,0,1,2024
EMI,PR,C 32,Altre industrie manifatturiere                              ,1,0,0,0,1,2024
EMI,PR,C 33,"Riparazione, manutenzione ed installazione di macchine ed...",0,0,0,4,4,2024
EMI,PR,D   ,"Fornitura di energia elettrica, gas, vapore e aria condiz...",0,0,0,0,0,2024
EMI,PR,D 35,"Fornitura di energia elettrica, gas, vapore e aria condiz...",0,0,0,0,0,2024
EMI,PR,E   ,"Fornitura di acqua; reti fognarie, attività di gestione d...",0,0,0,0,0,2024
EMI,PR,E 36,"Raccolta, trattamento e fornitura di acqua                  ",0,0,0,0,0,2024
EMI,PR,E 37,Gestione delle reti fognarie                                ,0,0,0,0,0,2024
EMI,PR,E 38,"Attività di raccolta, trattamento e smaltimento dei rifiu...",0,0,0,0,0,2024
EMI,PR,E 39,Attività di risanamento e altri servizi di gestione dei r...,0,0,0,0,0,2024
EMI,PR,F   ,Costruzioni                                                 ,8,0,0,28,36,2024
EMI,PR,F 41,Costruzione di edifici                                      ,6,0,0,14,20,2024
EMI,PR,F 42,Ingegneria civile                                           ,0,0,0,2,2,2024
EMI,PR,F 43,Lavori di costruzione specializzati                         ,2,0,0,12,14,2024
EMI,PR,G   ,Commercio all'ingrosso e al dettaglio; riparazione di aut...,14,0,0,7,21,2024
EMI,PR,G 45,Commercio all'ingrosso e al dettaglio e riparazione di au...,2,0,0,0,2,2024
EMI,PR,G 46,Commercio all'ingrosso (escluso quello di autoveicoli e d...,5,0,0,5,10,2024
EMI,PR,G 47,Commercio al dettaglio (escluso quello di autoveicoli e d...,7,0,0,2,9,2024
EMI,PR,H   ,Trasporto e magazzinaggio                                   ,1,0,0,18,19,2024
EMI,PR,H 49,Trasporto terrestre e mediante condotte                     ,1,0,0,6,7,2024
EMI,PR,H 50,Trasporto marittimo e per vie d'acqua                       ,0,0,0,0,0,2024
EMI,PR,H 51,Trasporto aereo                                             ,0,0,0,0,0,2024
EMI,PR,H 52,Magazzinaggio e attività di supporto ai trasporti           ,0,0,0,12,12,2024
EMI,PR,H 53,Servizi postali e attività di corriere                      ,0,0,0,0,0,2024
EMI,PR,I   ,Attività dei servizi alloggio e ristorazione                ,7,0,0,6,13,2024
EMI,PR,I 55,Alloggio                                                    ,0,0,0,1,1,2024
EMI,PR,I 56,Attività dei servizi di ristorazione                        ,7,0,0,5,12,2024
EMI,PR,J   ,Servizi di informazione e comunicazione                     ,0,0,0,2,2,2024
EMI,PR,J 58,Attività editoriali                                         ,0,0,0,1,1,2024
EMI,PR,J 59,"Attività di produzione cinematografica, di video e di pro...",0,0,0,1,1,2024
EMI,PR,J 60,Attività di programmazione e trasmissione                   ,0,0,0,0,0,2024
EMI,PR,J 61,Telecomunicazioni                                           ,0,0,0,0,0,2024
EMI,PR,J 62,"Produzione di software, consulenza informatica e attività...",0,0,0,0,0,2024
EMI,PR,J 63,Attività dei servizi d'informazione e altri servizi infor...,0,0,0,0,0,2024
EMI,PR,K   ,Attività finanziarie e assicurative                         ,1,0,0,0,1,2024
EMI,PR,K 64,Attività di servizi finanziari (escluse le assicurazioni ...,0,0,0,0,0,2024
EMI,PR,K 65,"Assicurazioni, riassicurazioni e fondi pensione (escluse ...",0,0,0,0,0,2024
EMI,PR,K 66,Attività ausiliarie dei servizi finanziari e delle attivi...,1,0,0,0,1,2024
EMI,PR,L   ,Attivita' immobiliari                                       ,5,0,0,1,6,2024
EMI,PR,L 68,Attivita' immobiliari                                       ,5,0,0,1,6,2024
EMI,PR,M   ,"Attività professionali, scientifiche e tecniche             ",7,0,0,6,13,2024
EMI,PR,M 69,Attività legali e contabilità                               ,0,0,0,0,0,2024
EMI,PR,M 70,Attività di direzione aziendale e di consulenza gestional...,3,0,0,2,5,2024
EMI,PR,M 71,Attività degli studi di architettura e d'ingegneria; coll...,0,0,0,0,0,2024
EMI,PR,M 72,Ricerca scientifica e sviluppo                              ,0,0,0,0,0,2024
EMI,PR,M 73,Pubblicità e ricerche di mercato                            ,1,0,0,2,3,2024
EMI,PR,M 74,"Altre attività professionali, scientifiche e tecniche       ",3,0,0,2,5,2024
EMI,PR,M 75,Servizi veterinari                                          ,0,0,0,0,0,2024
EMI,PR,N   ,"Noleggio, agenzie di viaggio, servizi di supporto alle im...",5,0,0,16,21,2024
EMI,PR,N 77,Attività di noleggio e leasing operativo                    ,1,0,0,0,1,2024
EMI,PR,N 78,"Attività di ricerca, selezione, fornitura di personale      ",0,0,0,0,0,2024
EMI,PR,N 79,"Attività dei servizi delle agenzie di viaggio, dei tour o...",1,0,0,1,2,2024
EMI,PR,N 80,Servizi di vigilanza e investigazione                       ,0,0,0,0,0,2024
EMI,PR,N 81,Attività di servizi per edifici e paesaggio                 ,1,0,0,8,9,2024
EMI,PR,N 82,Attività di supporto per le funzioni d'ufficio e altri se...,2,0,0,7,9,2024
EMI,PR,O   ,Amministrazione pubblica e difesa; assicurazione sociale ...,0,0,0,0,0,2024
EMI,PR,O 84,Amministrazione pubblica e difesa; assicurazione sociale ...,0,0,0,0,0,2024
EMI,PR,P   ,Istruzione                                                  ,1,0,0,3,4,2024
EMI,PR,P 85,Istruzione                                                  ,1,0,0,3,4,2024
EMI,PR,Q   ,Sanita' e assistenza sociale                                ,1,0,0,7,8,2024
EMI,PR,Q 86,Assistenza sanitaria                                        ,0,0,0,0,0,2024
EMI,PR,Q 87,Servizi di assistenza sociale residenziale                  ,0,0,0,0,0,2024
EMI,PR,Q 88,Assistenza sociale non residenziale                         ,1,0,0,7,8,2024
EMI,PR,R   ,"Attività artistiche, sportive, di intrattenimento e diver...",1,0,0,3,4,2024
EMI,PR,R 90,"Attività creative, artistiche e di intrattenimento          ",0,0,0,2,2,2024
EMI,PR,R 91,"Attività di biblioteche, archivi, musei ed altre attività...",0,0,0,0,0,2024
EMI,PR,R 92,"Attività riguardanti le lotterie, le scommesse, le case d...",0,0,0,0,0,2024
EMI,PR,R 93,"Attività sportive, di intrattenimento e di divertimento     ",1,0,0,1,2,2024
EMI,PR,S   ,Altre attività di servizi                                   ,2,0,0,1,3,2024
EMI,PR,S 94,Attività di organizzazioni associative                      ,0,0,0,0,0,2024
EMI,PR,S 95,Riparazione di computer e di beni per uso personale e per...,0,0,0,0,0,2024
EMI,PR,S 96,Altre attività di servizi per la persona                    ,2,0,0,1,3,2024
EMI,PR,T   ,Attività di famiglie e convivenze come datori di lavoro p...,0,0,0,0,0,2024
EMI,PR,T 97,Attività di famiglie e convivenze come datori di lavoro p...,0,0,0,0,0,2024
EMI,PR,T 98,Produzione di beni e servizi indifferenziati per uso prop...,0,0,0,0,0,2024
EMI,PR,U   ,Organizzazioni ed organismi extraterritoriali               ,0,0,0,0,0,2024
EMI,PR,U 99,Organizzazioni ed organismi extraterritoriali               ,0,0,0,0,0,2024
EMI,PR,XX  ,Imprese non classificate                                    ,15,0,0,35,50,2024
EMI,PR,TOT ,TOTALE                                                      ,88,0,0,157,245,2024
EMI,RE,A   ,"Agricoltura, silvicoltura pesca                             ",0,3,10,3,16,2024
EMI,RE,A 01,"Coltivazioni agricole e produzione di prodotti animali, c...",0,3,10,2,15,2024
EMI,RE,A 02,Silvicoltura ed utilizzo di aree forestali                  ,0,0,0,1,1,2024
EMI,RE,A 03,Pesca e acquacoltura                                        ,0,0,0,0,0,2024
EMI,RE,B   ,Estrazione di minerali da cave e miniere                    ,0,0,0,0,0,2024
EMI,RE,B 05,Estrazione di carbone (esclusa torba)                       ,0,0,0,0,0,2024
EMI,RE,B 06,Estraz.di petrolio greggio e di gas naturale                ,0,0,0,0,0,2024
EMI,RE,B 07,Estrazione di minerali metalliferi                          ,0,0,0,0,0,2024
EMI,RE,B 08,Altre attività di estrazione di minerali da cave e miniere  ,0,0,0,0,0,2024
EMI,RE,B 09,Attività dei servizi di supporto all'estrazione             ,0,0,0,0,0,2024
EMI,RE,C   ,Attività manifatturiere                                     ,0,5,85,28,118,2024
EMI,RE,C 10,Industrie alimentari                                        ,0,1,2,3,6,2024
EMI,RE,C 11,Industria delle bevande                                     ,0,0,0,0,0,2024
EMI,RE,C 12,Industria del tabacco                                       ,0,0,0,0,0,2024
EMI,RE,C 13,Industrie tessili                                           ,0,0,0,0,0,2024
EMI,RE,C 14,Confezione di articoli di abbigliamento; confezione di ar...,0,1,40,0,41,2024
EMI,RE,C 15,Fabbricazione di articoli in pelle e simili                 ,0,0,1,0,1,2024
EMI,RE,C 16,Industria del legno e dei prodotti in legno e sughero (es...,0,1,3,3,7,2024
EMI,RE,C 17,Fabbricazione di carta e di prodotti di carta               ,0,0,0,0,0,2024
EMI,RE,C 18,Stampa e riproduzione di supporti registrati                ,0,0,1,0,1,2024
EMI,RE,C 19,Fabbricazione di coke e prodotti derivanti dalla raffinaz...,0,0,0,0,0,2024
EMI,RE,C 20,Fabbricazione di prodotti chimici                           ,0,0,0,0,0,2024
EMI,RE,C 21,Fabbricazione di prodotti farmaceutici di base e di prepa...,0,0,0,0,0,2024
EMI,RE,C 22,Fabbricazione di articoli in gomma e materie plastiche      ,0,0,2,0,2,2024
EMI,RE,C 23,Fabbricazione di altri prodotti della lavorazione di miner..,0,0,3,1,4,2024
EMI,RE,C 24,Metallurgia                                                 ,0,0,0,0,0,2024
EMI,RE,C 25,Fabbricazione di prodotti in metallo (esclusi macchinari ...,0,1,15,10,26,2024
EMI,RE,C 26,Fabbricazione di computer e prodotti di elettronica e ott...,0,0,0,1,1,2024
EMI,RE,C 27,Fabbricazione di apparecchiature elettriche ed apparecchi...,0,0,0,1,1,2024
EMI,RE,C 28,Fabbricazione di macchinari ed apparecchiature nca          ,0,1,2,3,6,2024
EMI,RE,C 29,"Fabbricazione di autoveicoli, rimorchi e semirimorchi       ",0,0,0,0,0,2024
EMI,RE,C 30,Fabbricazione di altri mezzi di trasporto                   ,0,0,0,0,0,2024
EMI,RE,C 31,Fabbricazione di mobili                                     ,0,0,0,0,0,2024
EMI,RE,C 32,Altre industrie manifatturiere                              ,0,0,4,1,5,2024
EMI,RE,C 33,"Riparazione, manutenzione ed installazione di macchine ed...",0,0,12,5,17,2024
EMI,RE,D   ,"Fornitura di energia elettrica, gas, vapore e aria condiz...",0,0,0,0,0,2024
EMI,RE,D 35,"Fornitura di energia elettrica, gas, vapore e aria condiz...",0,0,0,0,0,2024
EMI,RE,E   ,"Fornitura di acqua; reti fognarie, attività di gestione d...",0,0,3,0,3,2024
EMI,RE,E 36,"Raccolta, trattamento e fornitura di acqua                  ",0,0,0,0,0,2024
EMI,RE,E 37,Gestione delle reti fognarie                                ,0,0,0,0,0,2024
EMI,RE,E 38,"Attività di raccolta, trattamento e smaltimento dei rifiu...",0,0,3,0,3,2024
EMI,RE,E 39,Attività di risanamento e altri servizi di gestione dei r...,0,0,0,0,0,2024
EMI,RE,F   ,Costruzioni                                                 ,0,12,438,77,527,2024
EMI,RE,F 41,Costruzione di edifici                                      ,0,4,15,38,57,2024
EMI,RE,F 42,Ingegneria civile                                           ,0,2,0,0,2,2024
EMI,RE,F 43,Lavori di costruzione specializzati                         ,0,6,423,39,468,2024
EMI,RE,G   ,Commercio all'ingrosso e al dettaglio; riparazione di aut...,0,9,132,11,152,2024
EMI,RE,G 45,Commercio all'ingrosso e al dettaglio e riparazione di au...,0,0,16,0,16,2024
EMI,RE,G 46,Commercio all'ingrosso (escluso quello di autoveicoli e d...,0,2,59,8,69,2024
EMI,RE,G 47,Commercio al dettaglio (escluso quello di autoveicoli e d...,0,7,57,3,67,2024
EMI,RE,H   ,Trasporto e magazzinaggio                                   ,0,1,5,21,27,2024
EMI,RE,H 49,Trasporto terrestre e mediante condotte                     ,0,0,4,11,15,2024
EMI,RE,H 50,Trasporto marittimo e per vie d'acqua                       ,0,0,0,0,0,2024
EMI,RE,H 51,Trasporto aereo                                             ,0,0,0,0,0,2024
EMI,RE,H 52,Magazzinaggio e attività di supporto ai trasporti           ,0,1,1,10,12,2024
EMI,RE,H 53,Servizi postali e attività di corriere                      ,0,0,0,0,0,2024
EMI,RE,I   ,Attività dei servizi alloggio e ristorazione                ,0,21,20,8,49,2024
EMI,RE,I 55,Alloggio                                                    ,0,0,0,0,0,2024
EMI,RE,I 56,Attività dei servizi di ristorazione                        ,0,21,20,8,49,2024
EMI,RE,J   ,Servizi di informazione e comunicazione                     ,0,2,10,3,15,2024
EMI,RE,J 58,Attività editoriali                                         ,0,0,0,0,0,2024
EMI,RE,J 59,"Attività di produzione cinematografica, di video e di pro...",0,0,0,1,1,2024
EMI,RE,J 60,Attività di programmazione e trasmissione                   ,0,0,0,0,0,2024
EMI,RE,J 61,Telecomunicazioni                                           ,0,1,2,0,3,2024
EMI,RE,J 62,"Produzione di software, consulenza informatica e attività...",0,0,1,2,3,2024
EMI,RE,J 63,Attività dei servizi d'informazione e altri servizi infor...,0,1,7,0,8,2024
EMI,RE,K   ,Attività finanziarie e assicurative                         ,0,2,5,0,7,2024
EMI,RE,K 64,Attività di servizi finanziari (escluse le assicurazioni ...,0,1,0,0,1,2024
EMI,RE,K 65,"Assicurazioni, riassicurazioni e fondi pensione (escluse ...",0,0,0,0,0,2024
EMI,RE,K 66,Attività ausiliarie dei servizi finanziari e delle attivi...,0,1,5,0,6,2024
EMI,RE,L   ,Attivita' immobiliari                                       ,0,2,1,2,5,2024
EMI,RE,L 68,Attivita' immobiliari                                       ,0,2,1,2,5,2024
EMI,RE,M   ,"Attività professionali, scientifiche e tecniche             ",0,1,18,7,26,2024
EMI,RE,M 69,Attività legali e contabilità                               ,0,0,0,0,0,2024
EMI,RE,M 70,Attività di direzione aziendale e di consulenza gestional...,0,0,3,0,3,2024
EMI,RE,M 71,Attività degli studi di architettura e d'ingegneria; coll...,0,0,2,1,3,2024
EMI,RE,M 72,Ricerca scientifica e sviluppo                              ,0,0,0,0,0,2024
EMI,RE,M 73,Pubblicità e ricerche di mercato                            ,0,1,10,1,12,2024
EMI,RE,M 74,"Altre attività professionali, scientifiche e tecniche       ",0,0,3,5,8,2024
EMI,RE,M 75,Servizi veterinari                                          ,0,0,0,0,0,2024
EMI,RE,N   ,"Noleggio, agenzie di viaggio, servizi di supporto alle im...",0,1,15,14,30,2024
EMI,RE,N 77,Attività di noleggio e leasing operativo                    ,0,1,0,1,2,2024
EMI,RE,N 78,"Attività di ricerca, selezione, fornitura di personale      ",0,0,0,0,0,2024
EMI,RE,N 79,"Attività dei servizi delle agenzie di viaggio, dei tour o...",0,0,0,0,0,2024
EMI,RE,N 80,Servizi di vigilanza e investigazione                       ,0,0,0,1,1,2024
EMI,RE,N 81,Attività di servizi per edifici e paesaggio                 ,0,0,12,6,18,2024
EMI,RE,N 82,Attività di supporto per le funzioni d'ufficio e altri se...,0,0,3,6,9,2024
EMI,RE,O   ,Amministrazione pubblica e difesa; assicurazione sociale ...,0,0,0,0,0,2024
EMI,RE,O 84,Amministrazione pubblica e difesa; assicurazione sociale ...,0,0,0,0,0,2024
EMI,RE,P   ,Istruzione                                                  ,0,0,0,2,2,2024
EMI,RE,P 85,Istruzione                                                  ,0,0,0,2,2,2024
EMI,RE,Q   ,Sanita' e assistenza sociale                                ,0,0,0,4,4,2024
EMI,RE,Q 86,Assistenza sanitaria                                        ,0,0,0,1,1,2024
EMI,RE,Q 87,Servizi di assistenza sociale residenziale                  ,0,0,0,0,0,2024
EMI,RE,Q 88,Assistenza sociale non residenziale                         ,0,0,0,3,3,2024
EMI,RE,R   ,"Attività artistiche, sportive, di intrattenimento e diver...",0,3,2,2,7,2024
EMI,RE,R 90,"Attività creative, artistiche e di intrattenimento          ",0,1,0,0,1,2024
EMI,RE,R 91,"Attività di biblioteche, archivi, musei ed altre attività...",0,0,0,0,0,2024
EMI,RE,R 92,"Attività riguardanti le lotterie, le scommesse, le case d...",0,0,0,0,0,2024
EMI,RE,R 93,"Attività sportive, di intrattenimento e di divertimento     ",0,2,2,2,6,2024
EMI,RE,S   ,Altre attività di servizi                                   ,0,3,10,3,16,2024
EMI,RE,S 94,Attività di organizzazioni associative                      ,0,0,0,1,1,2024
EMI,RE,S 95,Riparazione di computer e di beni per uso personale e per...,0,0,1,0,1,2024
EMI,RE,S 96,Altre attività di servizi per la persona                    ,0,3,9,2,14,2024
EMI,RE,T   ,Attività di famiglie e convivenze come datori di lavoro p...,0,0,0,0,0,2024
EMI,RE,T 97,Attività di famiglie e convivenze come datori di lavoro p...,0,0,0,0,0,2024
EMI,RE,T 98,Produzione di beni e servizi indifferenziati per uso prop...,0,0,0,0,0,2024
EMI,RE,U   ,Organizzazioni ed organismi extraterritoriali               ,0,0,0,0,0,2024
EMI,RE,U 99,Organizzazioni ed organismi extraterritoriali               ,0,0,0,0,0,2024
EMI,RE,XX  ,Imprese non classificate                                    ,0,0,8,38,46,2024
EMI,RE,TOT ,TOTALE                                                      ,0,65,762,223,1050,2024
EMI,MO,A   ,"Agricoltura, silvicoltura pesca                             ",0,5,4,5,14,2024
EMI,MO,A 01,"Coltivazioni agricole e produzione di prodotti animali, c...",0,5,4,3,12,2024
EMI,MO,A 02,Silvicoltura ed utilizzo di aree forestali                  ,0,0,0,2,2,2024
EMI,MO,A 03,Pesca e acquacoltura                                        ,0,0,0,0,0,2024
EMI,MO,B   ,Estrazione di minerali da cave e miniere                    ,0,0,0,0,0,2024
EMI,MO,B 05,Estrazione di carbone (esclusa torba)                       ,0,0,0,0,0,2024
EMI,MO,B 06,Estraz.di petrolio greggio e di gas naturale                ,0,0,0,0,0,2024
EMI,MO,B 07,Estrazione di minerali metalliferi                          ,0,0,0,0,0,2024
EMI,MO,B 08,Altre attività di estrazione di minerali da cave e miniere  ,0,0,0,0,0,2024
EMI,MO,B 09,Attività dei servizi di supporto all'estrazione             ,0,0,0,0,0,2024
EMI,MO,C   ,Attività manifatturiere                                     ,37,42,12,68,159,2024
EMI,MO,C 10,Industrie alimentari                                        ,0,6,1,11,18,2024
EMI,MO,C 11,Industria delle bevande                                     ,0,0,0,0,0,2024
EMI,MO,C 12,Industria del tabacco                                       ,0,0,0,0,0,2024
EMI,MO,C 13,Industrie tessili                                           ,2,1,0,3,6,2024
EMI,MO,C 14,Confezione di articoli di abbigliamento; confezione di ar...,8,16,5,3,32,2024
EMI,MO,C 15,Fabbricazione di articoli in pelle e simili                 ,1,0,0,2,3,2024
EMI,MO,C 16,Industria del legno e dei prodotti in legno e sughero (es...,1,0,0,2,3,2024
EMI,MO,C 17,Fabbricazione di carta e di prodotti di carta               ,0,0,0,0,0,2024
EMI,MO,C 18,Stampa e riproduzione di supporti registrati                ,0,0,0,0,0,2024
EMI,MO,C 19,Fabbricazione di coke e prodotti derivanti dalla raffinaz...,0,0,0,0,0,2024
EMI,MO,C 20,Fabbricazione di prodotti chimici                           ,0,0,0,0,0,2024
EMI,MO,C 21,Fabbricazione di prodotti farmaceutici di base e di prepa...,0,0,0,0,0,2024
EMI,MO,C 22,Fabbricazione di articoli in gomma e materie plastiche      ,0,2,0,0,2,2024
EMI,MO,C 23,Fabbricazione di altri prodotti della lavorazione di miner..,4,2,1,10,17,2024
EMI,MO,C 24,Metallurgia                                                 ,0,1,0,0,1,2024
EMI,MO,C 25,Fabbricazione di prodotti in metallo (esclusi macchinari ...,7,8,2,29,46,2024
EMI,MO,C 26,Fabbricazione di computer e prodotti di elettronica e ott...,0,1,0,1,2,2024
EMI,MO,C 27,Fabbricazione di apparecchiature elettriche ed apparecchi...,1,1,0,0,2,2024
EMI,MO,C 28,Fabbricazione di macchinari ed apparecchiature nca          ,6,2,1,3,12,2024
EMI,MO,C 29,"Fabbricazione di autoveicoli, rimorchi e semirimorchi       ",1,0,0,0,1,2024
EMI,MO,C 30,Fabbricazione di altri mezzi di trasporto                   ,0,0,0,0,0,2024
EMI,MO,C 31,Fabbricazione di mobili                                     ,2,1,0,0,3,2024
EMI,MO,C 32,Altre industrie manifatturiere                              ,3,1,1,1,6,2024
EMI,MO,C 33,"Riparazione, manutenzione ed installazione di macchine ed...",1,0,1,3,5,2024
EMI,MO,D   ,"Fornitura di energia elettrica, gas, vapore e aria condiz...",1,0,0,0,1,2024
EMI,MO,D 35,"Fornitura di energia elettrica, gas, vapore e aria condiz...",1,0,0,0,1,2024
EMI,MO,E   ,"Fornitura di acqua; reti fognarie, attività di gestione d...",0,0,0,0,0,2024
EMI,MO,E 36,"Raccolta, trattamento e fornitura di acqua                  ",0,0,0,0,0,2024
EMI,MO,E 37,Gestione delle reti fognarie                                ,0,0,0,0,0,2024
EMI,MO,E 38,"Attività di raccolta, trattamento e smaltimento dei rifiu...",0,0,0,0,0,2024
EMI,MO,E 39,Attività di risanamento e altri servizi di gestione dei r...,0,0,0,0,0,2024
EMI,MO,F   ,Costruzioni                                                 ,23,25,25,52,125,2024
EMI,MO,F 41,Costruzione di edifici                                      ,14,11,8,32,65,2024
EMI,MO,F 42,Ingegneria civile                                           ,1,0,0,0,1,2024
EMI,MO,F 43,Lavori di costruzione specializzati                         ,8,14,17,20,59,2024
EMI,MO,G   ,Commercio all'ingrosso e al dettaglio; riparazione di aut...,22,40,22,7,91,2024
EMI,MO,G 45,Commercio all'ingrosso e al dettaglio e riparazione di au...,4,3,2,3,12,2024
EMI,MO,G 46,Commercio all'ingrosso (escluso quello di autoveicoli e d...,12,18,9,2,41,2024
EMI,MO,G 47,Commercio al dettaglio (escluso quello di autoveicoli e d...,6,19,11,2,38,2024
EMI,MO,H   ,Trasporto e magazzinaggio                                   ,1,3,8,126,138,2024
EMI,MO,H 49,Trasporto terrestre e mediante condotte                     ,0,2,7,9,18,2024
EMI,MO,H 50,Trasporto marittimo e per vie d'acqua                       ,0,0,0,0,0,2024
EMI,MO,H 51,Trasporto aereo                                             ,0,0,0,0,0,2024
EMI,MO,H 52,Magazzinaggio e attività di supporto ai trasporti           ,1,1,1,117,120,2024
EMI,MO,H 53,Servizi postali e attività di corriere                      ,0,0,0,0,0,2024
EMI,MO,I   ,Attività dei servizi alloggio e ristorazione                ,8,35,6,4,53,2024
EMI,MO,I 55,Alloggio                                                    ,0,1,0,0,1,2024
EMI,MO,I 56,Attività dei servizi di ristorazione                        ,8,34,6,4,52,2024
EMI,MO,J   ,Servizi di informazione e comunicazione                     ,6,0,2,1,9,2024
EMI,MO,J 58,Attività editoriali                                         ,1,0,0,0,1,2024
EMI,MO,J 59,"Attività di produzione cinematografica, di video e di pro...",0,0,0,0,0,2024
EMI,MO,J 60,Attività di programmazione e trasmissione                   ,0,0,0,0,0,2024
EMI,MO,J 61,Telecomunicazioni                                           ,1,0,1,0,2,2024
EMI,MO,J 62,"Produzione di software, consulenza informatica e attività...",2,0,0,1,3,2024
EMI,MO,J 63,Attività dei servizi d'informazione e altri servizi infor...,2,0,1,0,3,2024
EMI,MO,K   ,Attività finanziarie e assicurative                         ,3,0,1,0,4,2024
EMI,MO,K 64,Attività di servizi finanziari (escluse le assicurazioni ...,3,0,0,0,3,2024
EMI,MO,K 65,"Assicurazioni, riassicurazioni e fondi pensione (escluse ...",0,0,0,0,0,2024
EMI,MO,K 66,Attività ausiliarie dei servizi finanziari e delle attivi...,0,0,1,0,1,2024
EMI,MO,L   ,Attivita' immobiliari                                       ,9,10,2,2,23,2024
EMI,MO,L 68,Attivita' immobiliari                                       ,9,10,2,2,23,2024
EMI,MO,M   ,"Attività professionali, scientifiche e tecniche             ",9,2,0,10,21,2024
EMI,MO,M 69,Attività legali e contabilità                               ,1,0,0,0,1,2024
EMI,MO,M 70,Attività di direzione aziendale e di consulenza gestional...,6,0,0,2,8,2024
EMI,MO,M 71,Attività degli studi di architettura e d'ingegneria; coll...,0,1,0,0,1,2024
EMI,MO,M 72,Ricerca scientifica e sviluppo                              ,0,0,0,1,1,2024
EMI,MO,M 73,Pubblicità e ricerche di mercato                            ,0,0,0,3,3,2024
EMI,MO,M 74,"Altre attività professionali, scientifiche e tecniche       ",2,1,0,4,7,2024
EMI,MO,M 75,Servizi veterinari                                          ,0,0,0,0,0,2024
EMI,MO,N   ,"Noleggio, agenzie di viaggio, servizi di supporto alle im...",2,1,1,19,23,2024
EMI,MO,N 77,Attività di noleggio e leasing operativo                    ,0,1,0,0,1,2024
EMI,MO,N 78,"Attività di ricerca, selezione, fornitura di personale      ",1,0,0,0,1,2024
EMI,MO,N 79,"Attività dei servizi delle agenzie di viaggio, dei tour o...",0,0,0,0,0,2024
EMI,MO,N 80,Servizi di vigilanza e investigazione                       ,0,0,0,0,0,2024
EMI,MO,N 81,Attività di servizi per edifici e paesaggio                 ,0,0,0,16,16,2024
EMI,MO,N 82,Attività di supporto per le funzioni d'ufficio e altri se...,1,0,1,3,5,2024
EMI,MO,O   ,Amministrazione pubblica e difesa; assicurazione sociale ...,0,0,0,0,0,2024
EMI,MO,O 84,Amministrazione pubblica e difesa; assicurazione sociale ...,0,0,0,0,0,2024
EMI,MO,P   ,Istruzione                                                  ,0,0,0,1,1,2024
EMI,MO,P 85,Istruzione                                                  ,0,0,0,1,1,2024
EMI,MO,Q   ,Sanita' e assistenza sociale                                ,0,0,0,4,4,2024
EMI,MO,Q 86,Assistenza sanitaria                                        ,0,0,0,0,0,2024
EMI,MO,Q 87,Servizi di assistenza sociale residenziale                  ,0,0,0,0,0,2024
EMI,MO,Q 88,Assistenza sociale non residenziale                         ,0,0,0,4,4,2024
EMI,MO,R   ,"Attività artistiche, sportive, di intrattenimento e diver...",1,3,5,7,16,2024
EMI,MO,R 90,"Attività creative, artistiche e di intrattenimento          ",0,0,0,4,4,2024
EMI,MO,R 91,"Attività di biblioteche, archivi, musei ed altre attività...",0,0,0,0,0,2024
EMI,MO,R 92,"Attività riguardanti le lotterie, le scommesse, le case d...",0,0,0,0,0,2024
EMI,MO,R 93,"Attività sportive, di intrattenimento e di divertimento     ",1,3,5,3,12,2024
EMI,MO,S   ,Altre attività di servizi                                   ,3,1,2,5,11,2024
EMI,MO,S 94,Attività di organizzazioni associative                      ,0,0,0,0,0,2024
EMI,MO,S 95,Riparazione di computer e di beni per uso personale e per...,1,0,0,0,1,2024
EMI,MO,S 96,Altre attività di servizi per la persona                    ,2,1,2,5,10,2024
EMI,MO,T   ,Attività di famiglie e convivenze come datori di lavoro p...,0,0,0,0,0,2024
EMI,MO,T 97,Attività di famiglie e convivenze come datori di lavoro p...,0,0,0,0,0,2024
EMI,MO,T 98,Produzione di beni e servizi indifferenziati per uso prop...,0,0,0,0,0,2024
EMI,MO,U   ,Organizzazioni ed organismi extraterritoriali               ,0,0,0,0,0,2024
EMI,MO,U 99,Organizzazioni ed organismi extraterritoriali               ,0,0,0,0,0,2024
EMI,MO,XX  ,Imprese non classificate                                    ,19,4,15,65,103,2024
EMI,MO,TOT ,TOTALE                                                      ,144,171,105,376,796,2024
EMI,BO,A   ,"Agricoltura, silvicoltura pesca                             ",0,7,53,2,62,2024
EMI,BO,A 01,"Coltivazioni agricole e produzione di prodotti animali, c...",0,7,50,2,59,2024
EMI,BO,A 02,Silvicoltura ed utilizzo di aree forestali                  ,0,0,3,0,3,2024
EMI,BO,A 03,Pesca e acquacoltura                                        ,0,0,0,0,0,2024
EMI,BO,B   ,Estrazione di minerali da cave e miniere                    ,0,0,0,0,0,2024
EMI,BO,B 05,Estrazione di carbone (esclusa torba)                       ,0,0,0,0,0,2024
EMI,BO,B 06,Estraz.di petrolio greggio e di gas naturale                ,0,0,0,0,0,2024
EMI,BO,B 07,Estrazione di minerali metalliferi                          ,0,0,0,0,0,2024
EMI,BO,B 08,Altre attività di estrazione di minerali da cave e miniere  ,0,0,0,0,0,2024
EMI,BO,B 09,Attività dei servizi di supporto all'estrazione             ,0,0,0,0,0,2024
EMI,BO,C   ,Attività manifatturiere                                     ,15,29,120,12,176,2024
EMI,BO,C 10,Industrie alimentari                                        ,2,6,7,0,15,2024
EMI,BO,C 11,Industria delle bevande                                     ,0,0,0,0,0,2024
EMI,BO,C 12,Industria del tabacco                                       ,0,0,0,0,0,2024
EMI,BO,C 13,Industrie tessili                                           ,0,0,3,1,4,2024
EMI,BO,C 14,Confezione di articoli di abbigliamento; confezione di ar...,2,2,31,1,36,2024
EMI,BO,C 15,Fabbricazione di articoli in pelle e simili                 ,0,0,6,0,6,2024
EMI,BO,C 16,Industria del legno e dei prodotti in legno e sughero (es...,0,1,4,1,6,2024
EMI,BO,C 17,Fabbricazione di carta e di prodotti di carta               ,1,0,1,0,2,2024
EMI,BO,C 18,Stampa e riproduzione di supporti registrati                ,2,2,6,0,10,2024
EMI,BO,C 19,Fabbricazione di coke e prodotti derivanti dalla raffinaz...,0,0,0,0,0,2024
EMI,BO,C 20,Fabbricazione di prodotti chimici                           ,0,0,0,0,0,2024
EMI,BO,C 21,Fabbricazione di prodotti farmaceutici di base e di prepa...,0,0,0,0,0,2024
EMI,BO,C 22,Fabbricazione di articoli in gomma e materie plastiche      ,0,2,2,0,4,2024
EMI,BO,C 23,Fabbricazione di altri prodotti della lavorazione di miner..,0,1,1,0,2,2024
EMI,BO,C 24,Metallurgia                                                 ,0,0,0,1,1,2024
EMI,BO,C 25,Fabbricazione di prodotti in metallo (esclusi macchinari ...,5,11,26,7,49,2024
EMI,BO,C 26,Fabbricazione di computer e prodotti di elettronica e ott...,0,0,1,0,1,2024
EMI,BO,C 27,Fabbricazione di apparecchiature elettriche ed apparecchi...,1,0,1,0,2,2024
EMI,BO,C 28,Fabbricazione di macchinari ed apparecchiature nca          ,0,1,3,0,4,2024
EMI,BO,C 29,"Fabbricazione di autoveicoli, rimorchi e semirimorchi       ",0,0,0,0,0,2024
EMI,BO,C 30,Fabbricazione di altri mezzi di trasporto                   ,0,0,1,0,1,2024
EMI,BO,C 31,Fabbricazione di mobili                                     ,1,1,3,1,6,2024
EMI,BO,C 32,Altre industrie manifatturiere                              ,0,2,8,0,10,2024
EMI,BO,C 33,"Riparazione, manutenzione ed installazione di macchine ed...",1,0,16,0,17,2024
EMI,BO,D   ,"Fornitura di energia elettrica, gas, vapore e aria condiz...",0,0,2,0,2,2024
EMI,BO,D 35,"Fornitura di energia elettrica, gas, vapore e aria condiz...",0,0,2,0,2,2024
EMI,BO,E   ,"Fornitura di acqua; reti fognarie, attività di gestione d...",0,0,0,1,1,2024
EMI,BO,E 36,"Raccolta, trattamento e fornitura di acqua                  ",0,0,0,0,0,2024
EMI,BO,E 37,Gestione delle reti fognarie                                ,0,0,0,0,0,2024
EMI,BO,E 38,"Attività di raccolta, trattamento e smaltimento dei rifiu...",0,0,0,1,1,2024
EMI,BO,E 39,Attività di risanamento e altri servizi di gestione dei r...,0,0,0,0,0,2024
EMI,BO,F   ,Costruzioni                                                 ,19,20,523,30,592,2024
EMI,BO,F 41,Costruzione di edifici                                      ,14,5,74,21,114,2024
EMI,BO,F 42,Ingegneria civile                                           ,0,0,2,0,2,2024
EMI,BO,F 43,Lavori di costruzione specializzati                         ,5,15,447,9,476,2024
EMI,BO,G   ,Commercio all'ingrosso e al dettaglio; riparazione di aut...,28,51,446,4,529,2024
EMI,BO,G 45,Commercio all'ingrosso e al dettaglio e riparazione di au...,0,7,86,0,93,2024
EMI,BO,G 46,Commercio all'ingrosso (escluso quello di autoveicoli e d...,17,11,133,4,165,2024
EMI,BO,G 47,Commercio al dettaglio (escluso quello di autoveicoli e d...,11,33,227,0,271,2024
EMI,BO,H   ,Trasporto e magazzinaggio                                   ,3,8,60,58,129,2024
EMI,BO,H 49,Trasporto terrestre e mediante condotte                     ,1,7,49,11,68,2024
EMI,BO,H 50,Trasporto marittimo e per vie d'acqua                       ,0,0,0,0,0,2024
EMI,BO,H 51,Trasporto aereo                                             ,0,0,0,0,0,2024
EMI,BO,H 52,Magazzinaggio e attività di supporto ai trasporti           ,2,1,8,47,58,2024
EMI,BO,H 53,Servizi postali e attività di corriere                      ,0,0,3,0,3,2024
EMI,BO,I   ,Attività dei servizi alloggio e ristorazione                ,9,76,136,3,224,2024
EMI,BO,I 55,Alloggio                                                    ,1,0,7,1,9,2024
EMI,BO,I 56,Attività dei servizi di ristorazione                        ,8,76,129,2,215,2024
EMI,BO,J   ,Servizi di informazione e comunicazione                     ,7,4,29,3,43,2024
EMI,BO,J 58,Attività editoriali                                         ,0,0,2,0,2,2024
EMI,BO,J 59,"Attività di produzione cinematografica, di video e di pro...",2,1,2,1,6,2024
EMI,BO,J 60,Attività di programmazione e trasmissione                   ,0,0,0,1,1,2024
EMI,BO,J 61,Telecomunicazioni                                           ,0,1,16,0,17,2024
EMI,BO,J 62,"Produzione di software, consulenza informatica e attività...",2,2,6,0,10,2024
EMI,BO,J 63,Attività dei servizi d'informazione e altri servizi infor...,3,0,3,1,7,2024
EMI,BO,K   ,Attività finanziarie e assicurative                         ,1,2,19,0,22,2024
EMI,BO,K 64,Attività di servizi finanziari (escluse le assicurazioni ...,0,1,0,0,1,2024
EMI,BO,K 65,"Assicurazioni, riassicurazioni e fondi pensione (escluse ...",0,0,1,0,1,2024
EMI,BO,K 66,Attività ausiliarie dei servizi finanziari e delle attivi...,1,1,18,0,20,2024
EMI,BO,L   ,Attivita' immobiliari                                       ,9,12,8,4,33,2024
EMI,BO,L 68,Attivita' immobiliari                                       ,9,12,8,4,33,2024
EMI,BO,M   ,"Attività professionali, scientifiche e tecniche             ",14,3,21,6,44,2024
EMI,BO,M 69,Attività legali e contabilità                               ,0,2,1,0,3,2024
EMI,BO,M 70,Attività di direzione aziendale e di consulenza gestional...,8,1,5,2,16,2024
EMI,BO,M 71,Attività degli studi di architettura e d'ingegneria; coll...,1,0,0,0,1,2024
EMI,BO,M 72,Ricerca scientifica e sviluppo                              ,0,0,0,0,0,2024
EMI,BO,M 73,Pubblicità e ricerche di mercato                            ,1,0,8,4,13,2024
EMI,BO,M 74,"Altre attività professionali, scientifiche e tecniche       ",4,0,7,0,11,2024
EMI,BO,M 75,Servizi veterinari                                          ,0,0,0,0,0,2024
EMI,BO,N   ,"Noleggio, agenzie di viaggio, servizi di supporto alle im...",9,11,77,18,115,2024
EMI,BO,N 77,Attività di noleggio e leasing operativo                    ,0,1,2,0,3,2024
EMI,BO,N 78,"Attività di ricerca, selezione, fornitura di personale      ",1,0,0,1,2,2024
EMI,BO,N 79,"Attività dei servizi delle agenzie di viaggio, dei tour o...",0,0,1,0,1,2024
EMI,BO,N 80,Servizi di vigilanza e investigazione                       ,1,0,1,1,3,2024
EMI,BO,N 81,Attività di servizi per edifici e paesaggio                 ,4,8,51,13,76,2024
EMI,BO,N 82,Attività di supporto per le funzioni d'ufficio e altri se...,3,2,22,3,30,2024
EMI,BO,O   ,Amministrazione pubblica e difesa; assicurazione sociale ...,0,0,0,0,0,2024
EMI,BO,O 84,Amministrazione pubblica e difesa; assicurazione sociale ...,0,0,0,0,0,2024
EMI,BO,P   ,Istruzione                                                  ,3,0,1,0,4,2024
EMI,BO,P 85,Istruzione                                                  ,3,0,1,0,4,2024
EMI,BO,Q   ,Sanita' e assistenza sociale                                ,2,1,2,5,10,2024
EMI,BO,Q 86,Assistenza sanitaria                                        ,1,0,1,0,2,2024
EMI,BO,Q 87,Servizi di assistenza sociale residenziale                  ,0,0,1,1,2,2024
EMI,BO,Q 88,Assistenza sociale non residenziale                         ,1,1,0,4,6,2024
EMI,BO,R   ,"Attività artistiche, sportive, di intrattenimento e diver...",4,6,8,3,21,2024
EMI,BO,R 90,"Attività creative, artistiche e di intrattenimento          ",1,1,5,0,7,2024
EMI,BO,R 91,"Attività di biblioteche, archivi, musei ed altre attività...",0,0,0,1,1,2024
EMI,BO,R 92,"Attività riguardanti le lotterie, le scommesse, le case d...",0,0,0,0,0,2024
EMI,BO,R 93,"Attività sportive, di intrattenimento e di divertimento     ",3,5,3,2,13,2024
EMI,BO,S   ,Altre attività di servizi                                   ,4,6,39,1,50,2024
EMI,BO,S 94,Attività di organizzazioni associative                      ,0,0,0,0,0,2024
EMI,BO,S 95,Riparazione di computer e di beni per uso personale e per...,0,1,15,0,16,2024
EMI,BO,S 96,Altre attività di servizi per la persona                    ,4,5,24,1,34,2024
EMI,BO,T   ,Attività di famiglie e convivenze come datori di lavoro p...,0,0,0,0,0,2024
EMI,BO,T 97,Attività di famiglie e convivenze come datori di lavoro p...,0,0,0,0,0,2024
EMI,BO,T 98,Produzione di beni e servizi indifferenziati per uso prop...,0,0,0,0,0,2024
EMI,BO,U   ,Organizzazioni ed organismi extraterritoriali               ,0,0,0,0,0,2024
EMI,BO,U 99,Organizzazioni ed organismi extraterritoriali               ,0,0,0,0,0,2024
EMI,BO,XX  ,Imprese non classificate                                    ,14,20,24,21,79,2024
EMI,BO,TOT ,TOTALE                                                      ,141,256,1568,171,2136,2024
EMI,FE,A   ,"Agricoltura, silvicoltura pesca                             ",0,0,0,2,2,2024
EMI,FE,A 01,"Coltivazioni agricole e produzione di prodotti animali, c...",0,0,0,2,2,2024
EMI,FE,A 02,Silvicoltura ed utilizzo di aree forestali                  ,0,0,0,0,0,2024
EMI,FE,A 03,Pesca e acquacoltura                                        ,0,0,0,0,0,2024
EMI,FE,B   ,Estrazione di minerali da cave e miniere                    ,0,0,0,0,0,2024
EMI,FE,B 05,Estrazione di carbone (esclusa torba)                       ,0,0,0,0,0,2024
EMI,FE,B 06,Estraz.di petrolio greggio e di gas naturale                ,0,0,0,0,0,2024
EMI,FE,B 07,Estrazione di minerali metalliferi                          ,0,0,0,0,0,2024
EMI,FE,B 08,Altre attività di estrazione di minerali da cave e miniere  ,0,0,0,0,0,2024
EMI,FE,B 09,Attività dei servizi di supporto all'estrazione             ,0,0,0,0,0,2024
EMI,FE,C   ,Attività manifatturiere                                     ,0,0,0,2,2,2024
EMI,FE,C 10,Industrie alimentari                                        ,0,0,0,0,0,2024
EMI,FE,C 11,Industria delle bevande                                     ,0,0,0,0,0,2024
EMI,FE,C 12,Industria del tabacco                                       ,0,0,0,0,0,2024
EMI,FE,C 13,Industrie tessili                                           ,0,0,0,0,0,2024
EMI,FE,C 14,Confezione di articoli di abbigliamento; confezione di ar...,0,0,0,0,0,2024
EMI,FE,C 15,Fabbricazione di articoli in pelle e simili                 ,0,0,0,0,0,2024
EMI,FE,C 16,Industria del legno e dei prodotti in legno e sughero (es...,0,0,0,0,0,2024
EMI,FE,C 17,Fabbricazione di carta e di prodotti di carta               ,0,0,0,0,0,2024
EMI,FE,C 18,Stampa e riproduzione di supporti registrati                ,0,0,0,0,0,2024
EMI,FE,C 19,Fabbricazione di coke e prodotti derivanti dalla raffinaz...,0,0,0,0,0,2024
EMI,FE,C 20,Fabbricazione di prodotti chimici                           ,0,0,0,0,0,2024
EMI,FE,C 21,Fabbricazione di prodotti farmaceutici di base e di prepa...,0,0,0,0,0,2024
EMI,FE,C 22,Fabbricazione di articoli in gomma e materie plastiche      ,0,0,0,0,0,2024
EMI,FE,C 23,Fabbricazione di altri prodotti della lavorazione di miner..,0,0,0,0,0,2024
EMI,FE,C 24,Metallurgia                                                 ,0,0,0,0,0,2024
EMI,FE,C 25,Fabbricazione di prodotti in metallo (esclusi macchinari ...,0,0,0,2,2,2024
EMI,FE,C 26,Fabbricazione di computer e prodotti di elettronica e ott...,0,0,0,0,0,2024
EMI,FE,C 27,Fabbricazione di apparecchiature elettriche ed apparecchi...,0,0,0,0,0,2024
EMI,FE,C 28,Fabbricazione di macchinari ed apparecchiature nca          ,0,0,0,0,0,2024
EMI,FE,C 29,"Fabbricazione di autoveicoli, rimorchi e semirimorchi       ",0,0,0,0,0,2024
EMI,FE,C 30,Fabbricazione di altri mezzi di trasporto                   ,0,0,0,0,0,2024
EMI,FE,C 31,Fabbricazione di mobili                                     ,0,0,0,0,0,2024
EMI,FE,C 32,Altre industrie manifatturiere                              ,0,0,0,0,0,2024
EMI,FE,C 33,"Riparazione, manutenzione ed installazione di macchine ed...",0,0,0,0,0,2024
EMI,FE,D   ,"Fornitura di energia elettrica, gas, vapore e aria condiz...",0,0,0,0,0,2024
EMI,FE,D 35,"Fornitura di energia elettrica, gas, vapore e aria condiz...",0,0,0,0,0,2024
EMI,FE,E   ,"Fornitura di acqua; reti fognarie, attività di gestione d...",0,0,0,0,0,2024
EMI,FE,E 36,"Raccolta, trattamento e fornitura di acqua                  ",0,0,0,0,0,2024
EMI,FE,E 37,Gestione delle reti fognarie                                ,0,0,0,0,0,2024
EMI,FE,E 38,"Attività di raccolta, trattamento e smaltimento dei rifiu...",0,0,0,0,0,2024
EMI,FE,E 39,Attività di risanamento e altri servizi di gestione dei r...,0,0,0,0,0,2024
EMI,FE,F   ,Costruzioni                                                 ,0,1,0,4,5,2024
EMI,FE,F 41,Costruzione di edifici                                      ,0,0,0,1,1,2024
EMI,FE,F 42,Ingegneria civile                                           ,0,0,0,0,0,2024
EMI,FE,F 43,Lavori di costruzione specializzati                         ,0,1,0,3,4,2024
EMI,FE,G   ,Commercio all'ingrosso e al dettaglio; riparazione di aut...,0,0,0,3,3,2024
EMI,FE,G 45,Commercio all'ingrosso e al dettaglio e riparazione di au...,0,0,0,0,0,2024
EMI,FE,G 46,Commercio all'ingrosso (escluso quello di autoveicoli e d...,0,0,0,2,2,2024
EMI,FE,G 47,Commercio al dettaglio (escluso quello di autoveicoli e d...,0,0,0,1,1,2024
EMI,FE,H   ,Trasporto e magazzinaggio                                   ,0,0,0,7,7,2024
EMI,FE,H 49,Trasporto terrestre e mediante condotte                     ,0,0,0,0,0,2024
EMI,FE,H 50,Trasporto marittimo e per vie d'acqua                       ,0,0,0,0,0,2024
EMI,FE,H 51,Trasporto aereo                                             ,0,0,0,0,0,2024
EMI,FE,H 52,Magazzinaggio e attività di supporto ai trasporti           ,0,0,0,7,7,2024
EMI,FE,H 53,Servizi postali e attività di corriere                      ,0,0,0,0,0,2024
EMI,FE,I   ,Attività dei servizi alloggio e ristorazione                ,0,2,0,0,2,2024
EMI,FE,I 55,Alloggio                                                    ,0,0,0,0,0,2024
EMI,FE,I 56,Attività dei servizi di ristorazione                        ,0,2,0,0,2,2024
EMI,FE,J   ,Servizi di informazione e comunicazione                     ,0,0,0,1,1,2024
EMI,FE,J 58,Attività editoriali                                         ,0,0,0,0,0,2024
EMI,FE,J 59,"Attività di produzione cinematografica, di video e di pro...",0,0,0,0,0,2024
EMI,FE,J 60,Attività di programmazione e trasmissione                   ,0,0,0,0,0,2024
EMI,FE,J 61,Telecomunicazioni                                           ,0,0,0,0,0,2024
EMI,FE,J 62,"Produzione di software, consulenza informatica e attività...",0,0,0,0,0,2024
EMI,FE,J 63,Attività dei servizi d'informazione e altri servizi infor...,0,0,0,1,1,2024
EMI,FE,K   ,Attività finanziarie e assicurative                         ,0,0,0,0,0,2024
EMI,FE,K 64,Attività di servizi finanziari (escluse le assicurazioni ...,0,0,0,0,0,2024
EMI,FE,K 65,"Assicurazioni, riassicurazioni e fondi pensione (escluse ...",0,0,0,0,0,2024
EMI,FE,K 66,Attività ausiliarie dei servizi finanziari e delle attivi...,0,0,0,0,0,2024
EMI,FE,L   ,Attivita' immobiliari                                       ,0,0,0,1,1,2024
EMI,FE,L 68,Attivita' immobiliari                                       ,0,0,0,1,1,2024
EMI,FE,M   ,"Attività professionali, scientifiche e tecniche             ",0,0,0,2,2,2024
EMI,FE,M 69,Attività legali e contabilità                               ,0,0,0,1,1,2024
EMI,FE,M 70,Attività di direzione aziendale e di consulenza gestional...,0,0,0,1,1,2024
EMI,FE,M 71,Attività degli studi di architettura e d'ingegneria; coll...,0,0,0,0,0,2024
EMI,FE,M 72,Ricerca scientifica e sviluppo                              ,0,0,0,0,0,2024
EMI,FE,M 73,Pubblicità e ricerche di mercato                            ,0,0,0,0,0,2024
EMI,FE,M 74,"Altre attività professionali, scientifiche e tecniche       ",0,0,0,0,0,2024
EMI,FE,M 75,Servizi veterinari                                          ,0,0,0,0,0,2024
EMI,FE,N   ,"Noleggio, agenzie di viaggio, servizi di supporto alle im...",0,0,0,0,0,2024
EMI,FE,N 77,Attività di noleggio e leasing operativo                    ,0,0,0,0,0,2024
EMI,FE,N 78,"Attività di ricerca, selezione, fornitura di personale      ",0,0,0,0,0,2024
EMI,FE,N 79,"Attività dei servizi delle agenzie di viaggio, dei tour o...",0,0,0,0,0,2024
EMI,FE,N 80,Servizi di vigilanza e investigazione                       ,0,0,0,0,0,2024
EMI,FE,N 81,Attività di servizi per edifici e paesaggio                 ,0,0,0,0,0,2024
EMI,FE,N 82,Attività di supporto per le funzioni d'ufficio e altri se...,0,0,0,0,0,2024
EMI,FE,O   ,Amministrazione pubblica e difesa; assicurazione sociale ...,0,0,0,0,0,2024
EMI,FE,O 84,Amministrazione pubblica e difesa; assicurazione sociale ...,0,0,0,0,0,2024
EMI,FE,P   ,Istruzione                                                  ,0,0,0,1,1,2024
EMI,FE,P 85,Istruzione                                                  ,0,0,0,1,1,2024
EMI,FE,Q   ,Sanita' e assistenza sociale                                ,0,0,0,4,4,2024
EMI,FE,Q 86,Assistenza sanitaria                                        ,0,0,0,0,0,2024
EMI,FE,Q 87,Servizi di assistenza sociale residenziale                  ,0,0,0,0,0,2024
EMI,FE,Q 88,Assistenza sociale non residenziale                         ,0,0,0,4,4,2024
EMI,FE,R   ,"Attività artistiche, sportive, di intrattenimento e diver...",0,0,0,0,0,2024
EMI,FE,R 90,"Attività creative, artistiche e di intrattenimento          ",0,0,0,0,0,2024
EMI,FE,R 91,"Attività di biblioteche, archivi, musei ed altre attività...",0,0,0,0,0,2024
EMI,FE,R 92,"Attività riguardanti le lotterie, le scommesse, le case d...",0,0,0,0,0,2024
EMI,FE,R 93,"Attività sportive, di intrattenimento e di divertimento     ",0,0,0,0,0,2024
EMI,FE,S   ,Altre attività di servizi                                   ,0,0,0,1,1,2024
EMI,FE,S 94,Attività di organizzazioni associative                      ,0,0,0,0,0,2024
EMI,FE,S 95,Riparazione di computer e di beni per uso personale e per...,0,0,0,0,0,2024
EMI,FE,S 96,Altre attività di servizi per la persona                    ,0,0,0,1,1,2024
EMI,FE,T   ,Attività di famiglie e convivenze come datori di lavoro p...,0,0,0,0,0,2024
EMI,FE,T 97,Attività di famiglie e convivenze come datori di lavoro p...,0,0,0,0,0,2024
EMI,FE,T 98,Produzione di beni e servizi indifferenziati per uso prop...,0,0,0,0,0,2024
EMI,FE,U   ,Organizzazioni ed organismi extraterritoriali               ,0,0,0,0,0,2024
EMI,FE,U 99,Organizzazioni ed organismi extraterritoriali               ,0,0,0,0,0,2024
EMI,FE,XX  ,Imprese non classificate                                    ,0,2,0,6,8,2024
EMI,FE,TOT ,TOTALE                                                      ,0,5,0,34,39,2024
EMI,RA,A   ,"Agricoltura, silvicoltura pesca                             ",1,2,0,2,5,2024
EMI,RA,A 01,"Coltivazioni agricole e produzione di prodotti animali, c...",1,2,0,2,5,2024
EMI,RA,A 02,Silvicoltura ed utilizzo di aree forestali                  ,0,0,0,0,0,2024
EMI,RA,A 03,Pesca e acquacoltura                                        ,0,0,0,0,0,2024
EMI,RA,B   ,Estrazione di minerali da cave e miniere                    ,0,0,0,1,1,2024
EMI,RA,B 05,Estrazione di carbone (esclusa torba)                       ,0,0,0,0,0,2024
EMI,RA,B 06,Estraz.di petrolio greggio e di gas naturale                ,0,0,0,0,0,2024
EMI,RA,B 07,Estrazione di minerali metalliferi                          ,0,0,0,0,0,2024
EMI,RA,B 08,Altre attività di estrazione di minerali da cave e miniere  ,0,0,0,1,1,2024
EMI,RA,B 09,Attività dei servizi di supporto all'estrazione             ,0,0,0,0,0,2024
EMI,RA,C   ,Attività manifatturiere                                     ,2,9,1,3,15,2024
EMI,RA,C 10,Industrie alimentari                                        ,0,1,0,1,2,2024
EMI,RA,C 11,Industria delle bevande                                     ,0,0,0,0,0,2024
EMI,RA,C 12,Industria del tabacco                                       ,0,0,0,0,0,2024
EMI,RA,C 13,Industrie tessili                                           ,0,0,0,0,0,2024
EMI,RA,C 14,Confezione di articoli di abbigliamento; confezione di ar...,0,1,0,0,1,2024
EMI,RA,C 15,Fabbricazione di articoli in pelle e simili                 ,0,0,0,0,0,2024
EMI,RA,C 16,Industria del legno e dei prodotti in legno e sughero (es...,0,0,0,0,0,2024
EMI,RA,C 17,Fabbricazione di carta e di prodotti di carta               ,0,0,0,0,0,2024
EMI,RA,C 18,Stampa e riproduzione di supporti registrati                ,0,1,0,1,2,2024
EMI,RA,C 19,Fabbricazione di coke e prodotti derivanti dalla raffinaz...,0,0,0,0,0,2024
EMI,RA,C 20,Fabbricazione di prodotti chimici                           ,0,1,0,0,1,2024
EMI,RA,C 21,Fabbricazione di prodotti farmaceutici di base e di prepa...,0,0,0,0,0,2024
EMI,RA,C 22,Fabbricazione di articoli in gomma e materie plastiche      ,0,0,0,0,0,2024
EMI,RA,C 23,Fabbricazione di altri prodotti della lavorazione di miner..,0,0,0,0,0,2024
EMI,RA,C 24,Metallurgia                                                 ,0,0,0,0,0,2024
EMI,RA,C 25,Fabbricazione di prodotti in metallo (esclusi macchinari ...,1,4,0,0,5,2024
EMI,RA,C 26,Fabbricazione di computer e prodotti di elettronica e ott...,0,0,0,0,0,2024
EMI,RA,C 27,Fabbricazione di apparecchiature elettriche ed apparecchi...,0,0,0,0,0,2024
EMI,RA,C 28,Fabbricazione di macchinari ed apparecchiature nca          ,1,0,0,0,1,2024
EMI,RA,C 29,"Fabbricazione di autoveicoli, rimorchi e semirimorchi       ",0,0,0,0,0,2024
EMI,RA,C 30,Fabbricazione di altri mezzi di trasporto                   ,0,1,0,0,1,2024
EMI,RA,C 31,Fabbricazione di mobili                                     ,0,0,0,1,1,2024
EMI,RA,C 32,Altre industrie manifatturiere                              ,0,0,0,0,0,2024
EMI,RA,C 33,"Riparazione, manutenzione ed installazione di macchine ed...",0,0,1,0,1,2024
EMI,RA,D   ,"Fornitura di energia elettrica, gas, vapore e aria condiz...",0,0,0,0,0,2024
EMI,RA,D 35,"Fornitura di energia elettrica, gas, vapore e aria condiz...",0,0,0,0,0,2024
EMI,RA,E   ,"Fornitura di acqua; reti fognarie, attività di gestione d...",0,0,0,0,0,2024
EMI,RA,E 36,"Raccolta, trattamento e fornitura di acqua                  ",0,0,0,0,0,2024
EMI,RA,E 37,Gestione delle reti fognarie                                ,0,0,0,0,0,2024
EMI,RA,E 38,"Attività di raccolta, trattamento e smaltimento dei rifiu...",0,0,0,0,0,2024
EMI,RA,E 39,Attività di risanamento e altri servizi di gestione dei r...,0,0,0,0,0,2024
EMI,RA,F   ,Costruzioni                                                 ,1,4,1,4,10,2024
EMI,RA,F 41,Costruzione di edifici                                      ,1,2,0,2,5,2024
EMI,RA,F 42,Ingegneria civile                                           ,0,0,0,0,0,2024
EMI,RA,F 43,Lavori di costruzione specializzati                         ,0,2,1,2,5,2024
EMI,RA,G   ,Commercio all'ingrosso e al dettaglio; riparazione di aut...,2,17,13,1,33,2024
EMI,RA,G 45,Commercio all'ingrosso e al dettaglio e riparazione di au...,1,2,7,0,10,2024
EMI,RA,G 46,Commercio all'ingrosso (escluso quello di autoveicoli e d...,1,8,6,0,15,2024
EMI,RA,G 47,Commercio al dettaglio (escluso quello di autoveicoli e d...,0,7,0,1,8,2024
EMI,RA,H   ,Trasporto e magazzinaggio                                   ,1,6,0,3,10,2024
EMI,RA,H 49,Trasporto terrestre e mediante condotte                     ,0,5,0,0,5,2024
EMI,RA,H 50,Trasporto marittimo e per vie d'acqua                       ,0,0,0,0,0,2024
EMI,RA,H 51,Trasporto aereo                                             ,0,0,0,0,0,2024
EMI,RA,H 52,Magazzinaggio e attività di supporto ai trasporti           ,1,1,0,3,5,2024
EMI,RA,H 53,Servizi postali e attività di corriere                      ,0,0,0,0,0,2024
EMI,RA,I   ,Attività dei servizi alloggio e ristorazione                ,2,21,0,2,25,2024
EMI,RA,I 55,Alloggio                                                    ,0,4,0,0,4,2024
EMI,RA,I 56,Attività dei servizi di ristorazione                        ,2,17,0,2,21,2024
EMI,RA,J   ,Servizi di informazione e comunicazione                     ,0,3,0,1,4,2024
EMI,RA,J 58,Attività editoriali                                         ,0,0,0,0,0,2024
EMI,RA,J 59,"Attività di produzione cinematografica, di video e di pro...",0,0,0,0,0,2024
EMI,RA,J 60,Attività di programmazione e trasmissione                   ,0,0,0,0,0,2024
EMI,RA,J 61,Telecomunicazioni                                           ,0,0,0,0,0,2024
EMI,RA,J 62,"Produzione di software, consulenza informatica e attività...",0,1,0,1,2,2024
EMI,RA,J 63,Attività dei servizi d'informazione e altri servizi infor...,0,2,0,0,2,2024
EMI,RA,K   ,Attività finanziarie e assicurative                         ,0,0,0,0,0,2024
EMI,RA,K 64,Attività di servizi finanziari (escluse le assicurazioni ...,0,0,0,0,0,2024
EMI,RA,K 65,"Assicurazioni, riassicurazioni e fondi pensione (escluse ...",0,0,0,0,0,2024
EMI,RA,K 66,Attività ausiliarie dei servizi finanziari e delle attivi...,0,0,0,0,0,2024
EMI,RA,L   ,Attivita' immobiliari                                       ,0,3,0,1,4,2024
EMI,RA,L 68,Attivita' immobiliari                                       ,0,3,0,1,4,2024
EMI,RA,M   ,"Attività professionali, scientifiche e tecniche             ",1,3,0,2,6,2024
EMI,RA,M 69,Attività legali e contabilità                               ,0,1,0,0,1,2024
EMI,RA,M 70,Attività di direzione aziendale e di consulenza gestional...,0,1,0,1,2,2024
EMI,RA,M 71,Attività degli studi di architettura e d'ingegneria; coll...,1,0,0,0,1,2024
EMI,RA,M 72,Ricerca scientifica e sviluppo                              ,0,0,0,0,0,2024
EMI,RA,M 73,Pubblicità e ricerche di mercato                            ,0,0,0,1,1,2024
EMI,RA,M 74,"Altre attività professionali, scientifiche e tecniche       ",0,1,0,0,1,2024
EMI,RA,M 75,Servizi veterinari                                          ,0,0,0,0,0,2024
EMI,RA,N   ,"Noleggio, agenzie di viaggio, servizi di supporto alle im...",2,2,0,3,7,2024
EMI,RA,N 77,Attività di noleggio e leasing operativo                    ,1,1,0,0,2,2024
EMI,RA,N 78,"Attività di ricerca, selezione, fornitura di personale      ",0,0,0,0,0,2024
EMI,RA,N 79,"Attività dei servizi delle agenzie di viaggio, dei tour o...",0,0,0,0,0,2024
EMI,RA,N 80,Servizi di vigilanza e investigazione                       ,0,0,0,0,0,2024
EMI,RA,N 81,Attività di servizi per edifici e paesaggio                 ,1,0,0,2,3,2024
EMI,RA,N 82,Attività di supporto per le funzioni d'ufficio e altri se...,0,1,0,1,2,2024
EMI,RA,O   ,Amministrazione pubblica e difesa; assicurazione sociale ...,0,0,0,0,0,2024
EMI,RA,O 84,Amministrazione pubblica e difesa; assicurazione sociale ...,0,0,0,0,0,2024
EMI,RA,P   ,Istruzione                                                  ,0,0,0,0,0,2024
EMI,RA,P 85,Istruzione                                                  ,0,0,0,0,0,2024
EMI,RA,Q   ,Sanita' e assistenza sociale                                ,0,0,0,2,2,2024
EMI,RA,Q 86,Assistenza sanitaria                                        ,0,0,0,0,0,2024
EMI,RA,Q 87,Servizi di assistenza sociale residenziale                  ,0,0,0,1,1,2024
EMI,RA,Q 88,Assistenza sociale non residenziale                         ,0,0,0,1,1,2024
EMI,RA,R   ,"Attività artistiche, sportive, di intrattenimento e diver...",2,0,1,2,5,2024
EMI,RA,R 90,"Attività creative, artistiche e di intrattenimento          ",0,0,0,2,2,2024
EMI,RA,R 91,"Attività di biblioteche, archivi, musei ed altre attività...",0,0,0,0,0,2024
EMI,RA,R 92,"Attività riguardanti le lotterie, le scommesse, le case d...",0,0,0,0,0,2024
EMI,RA,R 93,"Attività sportive, di intrattenimento e di divertimento     ",2,0,1,0,3,2024
EMI,RA,S   ,Altre attività di servizi                                   ,0,3,0,0,3,2024
EMI,RA,S 94,Attività di organizzazioni associative                      ,0,0,0,0,0,2024
EMI,RA,S 95,Riparazione di computer e di beni per uso personale e per...,0,3,0,0,3,2024
EMI,RA,S 96,Altre attività di servizi per la persona                    ,0,0,0,0,0,2024
EMI,RA,T   ,Attività di famiglie e convivenze come datori di lavoro p...,0,0,0,0,0,2024
EMI,RA,T 97,Attività di famiglie e convivenze come datori di lavoro p...,0,0,0,0,0,2024
EMI,RA,T 98,Produzione di beni e servizi indifferenziati per uso prop...,0,0,0,0,0,2024
EMI,RA,U   ,Organizzazioni ed organismi extraterritoriali               ,0,0,0,0,0,2024
EMI,RA,U 99,Organizzazioni ed organismi extraterritoriali               ,0,0,0,0,0,2024
EMI,RA,XX  ,Imprese non classificate                                    ,2,8,0,9,19,2024
EMI,RA,TOT ,TOTALE                                                      ,16,81,16,36,149,2024
EMI,FO,A   ,"Agricoltura, silvicoltura pesca                             ",0,0,0,4,4,2024
EMI,FO,A 01,"Coltivazioni agricole e produzione di prodotti animali, c...",0,0,0,3,3,2024
EMI,FO,A 02,Silvicoltura ed utilizzo di aree forestali                  ,0,0,0,1,1,2024
EMI,FO,A 03,Pesca e acquacoltura                                        ,0,0,0,0,0,2024
EMI,FO,B   ,Estrazione di minerali da cave e miniere                    ,0,0,0,0,0,2024
EMI,FO,B 05,Estrazione di carbone (esclusa torba)                       ,0,0,0,0,0,2024
EMI,FO,B 06,Estraz.di petrolio greggio e di gas naturale                ,0,0,0,0,0,2024
EMI,FO,B 07,Estrazione di minerali metalliferi                          ,0,0,0,0,0,2024
EMI,FO,B 08,Altre attività di estrazione di minerali da cave e miniere  ,0,0,0,0,0,2024
EMI,FO,B 09,Attività dei servizi di supporto all'estrazione             ,0,0,0,0,0,2024
EMI,FO,C   ,Attività manifatturiere                                     ,2,1,1,3,7,2024
EMI,FO,C 10,Industrie alimentari                                        ,0,0,0,0,0,2024
EMI,FO,C 11,Industria delle bevande                                     ,0,0,0,0,0,2024
EMI,FO,C 12,Industria del tabacco                                       ,0,0,0,0,0,2024
EMI,FO,C 13,Industrie tessili                                           ,0,0,0,0,0,2024
EMI,FO,C 14,Confezione di articoli di abbigliamento; confezione di ar...,1,0,0,0,1,2024
EMI,FO,C 15,Fabbricazione di articoli in pelle e simili                 ,0,0,0,1,1,2024
EMI,FO,C 16,Industria del legno e dei prodotti in legno e sughero (es...,0,0,0,0,0,2024
EMI,FO,C 17,Fabbricazione di carta e di prodotti di carta               ,0,0,0,0,0,2024
EMI,FO,C 18,Stampa e riproduzione di supporti registrati                ,0,0,0,1,1,2024
EMI,FO,C 19,Fabbricazione di coke e prodotti derivanti dalla raffinaz...,0,0,0,0,0,2024
EMI,FO,C 20,Fabbricazione di prodotti chimici                           ,0,0,0,0,0,2024
EMI,FO,C 21,Fabbricazione di prodotti farmaceutici di base e di prepa...,0,0,0,0,0,2024
EMI,FO,C 22,Fabbricazione di articoli in gomma e materie plastiche      ,0,0,0,1,1,2024
EMI,FO,C 23,Fabbricazione di altri prodotti della lavorazione di miner..,0,1,0,0,1,2024
EMI,FO,C 24,Metallurgia                                                 ,0,0,0,0,0,2024
EMI,FO,C 25,Fabbricazione di prodotti in metallo (esclusi macchinari ...,0,0,0,0,0,2024
EMI,FO,C 26,Fabbricazione di computer e prodotti di elettronica e ott...,0,0,0,0,0,2024
EMI,FO,C 27,Fabbricazione di apparecchiature elettriche ed apparecchi...,0,0,0,0,0,2024
EMI,FO,C 28,Fabbricazione di macchinari ed apparecchiature nca          ,1,0,0,0,1,2024
EMI,FO,C 29,"Fabbricazione di autoveicoli, rimorchi e semirimorchi       ",0,0,0,0,0,2024
EMI,FO,C 30,Fabbricazione di altri mezzi di trasporto                   ,0,0,0,0,0,2024
EMI,FO,C 31,Fabbricazione di mobili                                     ,0,0,1,0,1,2024
EMI,FO,C 32,Altre industrie manifatturiere                              ,0,0,0,0,0,2024
EMI,FO,C 33,"Riparazione, manutenzione ed installazione di macchine ed...",0,0,0,0,0,2024
EMI,FO,D   ,"Fornitura di energia elettrica, gas, vapore e aria condiz...",0,0,0,0,0,2024
EMI,FO,D 35,"Fornitura di energia elettrica, gas, vapore e aria condiz...",0,0,0,0,0,2024
EMI,FO,E   ,"Fornitura di acqua; reti fognarie, attività di gestione d...",0,0,0,0,0,2024
EMI,FO,E 36,"Raccolta, trattamento e fornitura di acqua                  ",0,0,0,0,0,2024
EMI,FO,E 37,Gestione delle reti fognarie                                ,0,0,0,0,0,2024
EMI,FO,E 38,"Attività di raccolta, trattamento e smaltimento dei rifiu...",0,0,0,0,0,2024
EMI,FO,E 39,Attività di risanamento e altri servizi di gestione dei r...,0,0,0,0,0,2024
EMI,FO,F   ,Costruzioni                                                 ,0,2,1,9,12,2024
EMI,FO,F 41,Costruzione di edifici                                      ,0,1,1,5,7,2024
EMI,FO,F 42,Ingegneria civile                                           ,0,0,0,0,0,2024
EMI,FO,F 43,Lavori di costruzione specializzati                         ,0,1,0,4,5,2024
EMI,FO,G   ,Commercio all'ingrosso e al dettaglio; riparazione di aut...,0,0,1,3,4,2024
EMI,FO,G 45,Commercio all'ingrosso e al dettaglio e riparazione di au...,0,0,1,0,1,2024
EMI,FO,G 46,Commercio all'ingrosso (escluso quello di autoveicoli e d...,0,0,0,0,0,2024
EMI,FO,G 47,Commercio al dettaglio (escluso quello di autoveicoli e d...,0,0,0,3,3,2024
EMI,FO,H   ,Trasporto e magazzinaggio                                   ,0,0,0,8,8,2024
EMI,FO,H 49,Trasporto terrestre e mediante condotte                     ,0,0,0,2,2,2024
EMI,FO,H 50,Trasporto marittimo e per vie d'acqua                       ,0,0,0,0,0,2024
EMI,FO,H 51,Trasporto aereo                                             ,0,0,0,0,0,2024
EMI,FO,H 52,Magazzinaggio e attività di supporto ai trasporti           ,0,0,0,6,6,2024
EMI,FO,H 53,Servizi postali e attività di corriere                      ,0,0,0,0,0,2024
EMI,FO,I   ,Attività dei servizi alloggio e ristorazione                ,0,1,0,0,1,2024
EMI,FO,I 55,Alloggio                                                    ,0,0,0,0,0,2024
EMI,FO,I 56,Attività dei servizi di ristorazione                        ,0,1,0,0,1,2024
EMI,FO,J   ,Servizi di informazione e comunicazione                     ,0,0,0,2,2,2024
EMI,FO,J 58,Attività editoriali                                         ,0,0,0,0,0,2024
EMI,FO,J 59,"Attività di produzione cinematografica, di video e di pro...",0,0,0,0,0,2024
EMI,FO,J 60,Attività di programmazione e trasmissione                   ,0,0,0,0,0,2024
EMI,FO,J 61,Telecomunicazioni                                           ,0,0,0,0,0,2024
EMI,FO,J 62,"Produzione di software, consulenza informatica e attività...",0,0,0,1,1,2024
EMI,FO,J 63,Attività dei servizi d'informazione e altri servizi infor...,0,0,0,1,1,2024
EMI,FO,K   ,Attività finanziarie e assicurative                         ,0,0,0,0,0,2024
EMI,FO,K 64,Attività di servizi finanziari (escluse le assicurazioni ...,0,0,0,0,0,2024
EMI,FO,K 65,"Assicurazioni, riassicurazioni e fondi pensione (escluse ...",0,0,0,0,0,2024
EMI,FO,K 66,Attività ausiliarie dei servizi finanziari e delle attivi...,0,0,0,0,0,2024
EMI,FO,L   ,Attivita' immobiliari                                       ,0,1,0,1,2,2024
EMI,FO,L 68,Attivita' immobiliari                                       ,0,1,0,1,2,2024
EMI,FO,M   ,"Attività professionali, scientifiche e tecniche             ",0,0,0,2,2,2024
EMI,FO,M 69,Attività legali e contabilità                               ,0,0,0,0,0,2024
EMI,FO,M 70,Attività di direzione aziendale e di consulenza gestional...,0,0,0,0,0,2024
EMI,FO,M 71,Attività degli studi di architettura e d'ingegneria; coll...,0,0,0,1,1,2024
EMI,FO,M 72,Ricerca scientifica e sviluppo                              ,0,0,0,0,0,2024
EMI,FO,M 73,Pubblicità e ricerche di mercato                            ,0,0,0,1,1,2024
EMI,FO,M 74,"Altre attività professionali, scientifiche e tecniche       ",0,0,0,0,0,2024
EMI,FO,M 75,Servizi veterinari                                          ,0,0,0,0,0,2024
EMI,FO,N   ,"Noleggio, agenzie di viaggio, servizi di supporto alle im...",0,0,0,3,3,2024
EMI,FO,N 77,Attività di noleggio e leasing operativo                    ,0,0,0,0,0,2024
EMI,FO,N 78,"Attività di ricerca, selezione, fornitura di personale      ",0,0,0,0,0,2024
EMI,FO,N 79,"Attività dei servizi delle agenzie di viaggio, dei tour o...",0,0,0,0,0,2024
EMI,FO,N 80,Servizi di vigilanza e investigazione                       ,0,0,0,0,0,2024
EMI,FO,N 81,Attività di servizi per edifici e paesaggio                 ,0,0,0,2,2,2024
EMI,FO,N 82,Attività di supporto per le funzioni d'ufficio e altri se...,0,0,0,1,1,2024
EMI,FO,O   ,Amministrazione pubblica e difesa; assicurazione sociale ...,0,0,0,0,0,2024
EMI,FO,O 84,Amministrazione pubblica e difesa; assicurazione sociale ...,0,0,0,0,0,2024
EMI,FO,P   ,Istruzione                                                  ,0,0,0,2,2,2024
EMI,FO,P 85,Istruzione                                                  ,0,0,0,2,2,2024
EMI,FO,Q   ,Sanita' e assistenza sociale                                ,0,0,0,3,3,2024
EMI,FO,Q 86,Assistenza sanitaria                                        ,0,0,0,0,0,2024
EMI,FO,Q 87,Servizi di assistenza sociale residenziale                  ,0,0,0,3,3,2024
EMI,FO,Q 88,Assistenza sociale non residenziale                         ,0,0,0,0,0,2024
EMI,FO,R   ,"Attività artistiche, sportive, di intrattenimento e diver...",0,0,0,2,2,2024
EMI,FO,R 90,"Attività creative, artistiche e di intrattenimento          ",0,0,0,1,1,2024
EMI,FO,R 91,"Attività di biblioteche, archivi, musei ed altre attività...",0,0,0,0,0,2024
EMI,FO,R 92,"Attività riguardanti le lotterie, le scommesse, le case d...",0,0,0,0,0,2024
EMI,FO,R 93,"Attività sportive, di intrattenimento e di divertimento     ",0,0,0,1,1,2024
EMI,FO,S   ,Altre attività di servizi                                   ,0,0,0,2,2,2024
EMI,FO,S 94,Attività di organizzazioni associative                      ,0,0,0,0,0,2024
EMI,FO,S 95,Riparazione di computer e di beni per uso personale e per...,0,0,0,0,0,2024
EMI,FO,S 96,Altre attività di servizi per la persona                    ,0,0,0,2,2,2024
EMI,FO,T   ,Attività di famiglie e convivenze come datori di lavoro p...,0,0,0,0,0,2024
EMI,FO,T 97,Attività di famiglie e convivenze come datori di lavoro p...,0,0,0,0,0,2024
EMI,FO,T 98,Produzione di beni e servizi indifferenziati per uso prop...,0,0,0,0,0,2024
EMI,FO,U   ,Organizzazioni ed organismi extraterritoriali               ,0,0,0,0,0,2024
EMI,FO,U 99,Organizzazioni ed organismi extraterritoriali               ,0,0,0,0,0,2024
EMI,FO,XX  ,Imprese non classificate                                    ,0,0,0,11,11,2024
EMI,FO,TOT ,TOTALE                                                      ,2,5,3,55,65,2024
EMI,RN,A   ,"Agricoltura, silvicoltura pesca                             ",0,0,0,2,2,2024
EMI,RN,A 01,"Coltivazioni agricole e produzione di prodotti animali, c...",0,0,0,1,1,2024
EMI,RN,A 02,Silvicoltura ed utilizzo di aree forestali                  ,0,0,0,0,0,2024
EMI,RN,A 03,Pesca e acquacoltura                                        ,0,0,0,1,1,2024
EMI,RN,B   ,Estrazione di minerali da cave e miniere                    ,0,0,0,0,0,2024
EMI,RN,B 05,Estrazione di carbone (esclusa torba)                       ,0,0,0,0,0,2024
EMI,RN,B 06,Estraz.di petrolio greggio e di gas naturale                ,0,0,0,0,0,2024
EMI,RN,B 07,Estrazione di minerali metalliferi                          ,0,0,0,0,0,2024
EMI,RN,B 08,Altre attività di estrazione di minerali da cave e miniere  ,0,0,0,0,0,2024
EMI,RN,B 09,Attività dei servizi di supporto all'estrazione             ,0,0,0,0,0,2024
EMI,RN,C   ,Attività manifatturiere                                     ,0,2,0,7,9,2024
EMI,RN,C 10,Industrie alimentari                                        ,0,0,0,5,5,2024
EMI,RN,C 11,Industria delle bevande                                     ,0,0,0,0,0,2024
EMI,RN,C 12,Industria del tabacco                                       ,0,0,0,0,0,2024
EMI,RN,C 13,Industrie tessili                                           ,0,0,0,1,1,2024
EMI,RN,C 14,Confezione di articoli di abbigliamento; confezione di ar...,0,1,0,0,1,2024
EMI,RN,C 15,Fabbricazione di articoli in pelle e simili                 ,0,0,0,0,0,2024
EMI,RN,C 16,Industria del legno e dei prodotti in legno e sughero (es...,0,0,0,0,0,2024
EMI,RN,C 17,Fabbricazione di carta e di prodotti di carta               ,0,0,0,0,0,2024
EMI,RN,C 18,Stampa e riproduzione di supporti registrati                ,0,1,0,0,1,2024
EMI,RN,C 19,Fabbricazione di coke e prodotti derivanti dalla raffinaz...,0,0,0,0,0,2024
EMI,RN,C 20,Fabbricazione di prodotti chimici                           ,0,0,0,0,0,2024
EMI,RN,C 21,Fabbricazione di prodotti farmaceutici di base e di prepa...,0,0,0,0,0,2024
EMI,RN,C 22,Fabbricazione di articoli in gomma e materie plastiche      ,0,0,0,0,0,2024
EMI,RN,C 23,Fabbricazione di altri prodotti della lavorazione di miner..,0,0,0,1,1,2024
EMI,RN,C 24,Metallurgia                                                 ,0,0,0,0,0,2024
EMI,RN,C 25,Fabbricazione di prodotti in metallo (esclusi macchinari ...,0,0,0,0,0,2024
EMI,RN,C 26,Fabbricazione di computer e prodotti di elettronica e ott...,0,0,0,0,0,2024
EMI,RN,C 27,Fabbricazione di apparecchiature elettriche ed apparecchi...,0,0,0,0,0,2024
EMI,RN,C 28,Fabbricazione di macchinari ed apparecchiature nca          ,0,0,0,0,0,2024
EMI,RN,C 29,"Fabbricazione di autoveicoli, rimorchi e semirimorchi       ",0,0,0,0,0,2024
EMI,RN,C 30,Fabbricazione di altri mezzi di trasporto                   ,0,0,0,0,0,2024
EMI,RN,C 31,Fabbricazione di mobili                                     ,0,0,0,0,0,2024
EMI,RN,C 32,Altre industrie manifatturiere                              ,0,0,0,0,0,2024
EMI,RN,C 33,"Riparazione, manutenzione ed installazione di macchine ed...",0,0,0,0,0,2024
EMI,RN,D   ,"Fornitura di energia elettrica, gas, vapore e aria condiz...",0,0,0,0,0,2024
EMI,RN,D 35,"Fornitura di energia elettrica, gas, vapore e aria condiz...",0,0,0,0,0,2024
EMI,RN,E   ,"Fornitura di acqua; reti fognarie, attività di gestione d...",0,0,0,0,0,2024
EMI,RN,E 36,"Raccolta, trattamento e fornitura di acqua                  ",0,0,0,0,0,2024
EMI,RN,E 37,Gestione delle reti fognarie                                ,0,0,0,0,0,2024
EMI,RN,E 38,"Attività di raccolta, trattamento e smaltimento dei rifiu...",0,0,0,0,0,2024
EMI,RN,E 39,Attività di risanamento e altri servizi di gestione dei r...,0,0,0,0,0,2024
EMI,RN,F   ,Costruzioni                                                 ,0,0,0,9,9,2024
EMI,RN,F 41,Costruzione di edifici                                      ,0,0,0,8,8,2024
EMI,RN,F 42,Ingegneria civile                                           ,0,0,0,0,0,2024
EMI,RN,F 43,Lavori di costruzione specializzati                         ,0,0,0,1,1,2024
EMI,RN,G   ,Commercio all'ingrosso e al dettaglio; riparazione di aut...,0,2,2,4,8,2024
EMI,RN,G 45,Commercio all'ingrosso e al dettaglio e riparazione di au...,0,0,2,0,2,2024
EMI,RN,G 46,Commercio all'ingrosso (escluso quello di autoveicoli e d...,0,1,0,3,4,2024
EMI,RN,G 47,Commercio al dettaglio (escluso quello di autoveicoli e d...,0,1,0,1,2,2024
EMI,RN,H   ,Trasporto e magazzinaggio                                   ,0,0,0,6,6,2024
EMI,RN,H 49,Trasporto terrestre e mediante condotte                     ,0,0,0,1,1,2024
EMI,RN,H 50,Trasporto marittimo e per vie d'acqua                       ,0,0,0,0,0,2024
EMI,RN,H 51,Trasporto aereo                                             ,0,0,0,0,0,2024
EMI,RN,H 52,Magazzinaggio e attività di supporto ai trasporti           ,0,0,0,5,5,2024
EMI,RN,H 53,Servizi postali e attività di corriere                      ,0,0,0,0,0,2024
EMI,RN,I   ,Attività dei servizi alloggio e ristorazione                ,0,0,0,3,3,2024
EMI,RN,I 55,Alloggio                                                    ,0,0,0,1,1,2024
EMI,RN,I 56,Attività dei servizi di ristorazione                        ,0,0,0,2,2,2024
EMI,RN,J   ,Servizi di informazione e comunicazione                     ,0,0,0,1,1,2024
EMI,RN,J 58,Attività editoriali                                         ,0,0,0,1,1,2024
EMI,RN,J 59,"Attività di produzione cinematografica, di video e di pro...",0,0,0,0,0,2024
EMI,RN,J 60,Attività di programmazione e trasmissione                   ,0,0,0,0,0,2024
EMI,RN,J 61,Telecomunicazioni                                           ,0,0,0,0,0,2024
EMI,RN,J 62,"Produzione di software, consulenza informatica e attività...",0,0,0,0,0,2024
EMI,RN,J 63,Attività dei servizi d'informazione e altri servizi infor...,0,0,0,0,0,2024
EMI,RN,K   ,Attività finanziarie e assicurative                         ,0,0,0,0,0,2024
EMI,RN,K 64,Attività di servizi finanziari (escluse le assicurazioni ...,0,0,0,0,0,2024
EMI,RN,K 65,"Assicurazioni, riassicurazioni e fondi pensione (escluse ...",0,0,0,0,0,2024
EMI,RN,K 66,Attività ausiliarie dei servizi finanziari e delle attivi...,0,0,0,0,0,2024
EMI,RN,L   ,Attivita' immobiliari                                       ,0,1,0,2,3,2024
EMI,RN,L 68,Attivita' immobiliari                                       ,0,1,0,2,3,2024
EMI,RN,M   ,"Attività professionali, scientifiche e tecniche             ",0,0,1,3,4,2024
EMI,RN,M 69,Attività legali e contabilità                               ,0,0,0,0,0,2024
EMI,RN,M 70,Attività di direzione aziendale e di consulenza gestional...,0,0,0,3,3,2024
EMI,RN,M 71,Attività degli studi di architettura e d'ingegneria; coll...,0,0,0,0,0,2024
EMI,RN,M 72,Ricerca scientifica e sviluppo                              ,0,0,0,0,0,2024
EMI,RN,M 73,Pubblicità e ricerche di mercato                            ,0,0,0,0,0,2024
EMI,RN,M 74,"Altre attività professionali, scientifiche e tecniche       ",0,0,1,0,1,2024
EMI,RN,M 75,Servizi veterinari                                          ,0,0,0,0,0,2024
EMI,RN,N   ,"Noleggio, agenzie di viaggio, servizi di supporto alle im...",0,0,0,9,9,2024
EMI,RN,N 77,Attività di noleggio e leasing operativo                    ,0,0,0,0,0,2024
EMI,RN,N 78,"Attività di ricerca, selezione, fornitura di personale      ",0,0,0,0,0,2024
EMI,RN,N 79,"Attività dei servizi delle agenzie di viaggio, dei tour o...",0,0,0,2,2,2024
EMI,RN,N 80,Servizi di vigilanza e investigazione                       ,0,0,0,0,0,2024
EMI,RN,N 81,Attività di servizi per edifici e paesaggio                 ,0,0,0,4,4,2024
EMI,RN,N 82,Attività di supporto per le funzioni d'ufficio e altri se...,0,0,0,3,3,2024
EMI,RN,O   ,Amministrazione pubblica e difesa; assicurazione sociale ...,0,0,0,0,0,2024
EMI,RN,O 84,Amministrazione pubblica e difesa; assicurazione sociale ...,0,0,0,0,0,2024
EMI,RN,P   ,Istruzione                                                  ,0,0,0,0,0,2024
EMI,RN,P 85,Istruzione                                                  ,0,0,0,0,0,2024
EMI,RN,Q   ,Sanita' e assistenza sociale                                ,0,0,0,5,5,2024
EMI,RN,Q 86,Assistenza sanitaria                                        ,0,0,0,2,2,2024
EMI,RN,Q 87,Servizi di assistenza sociale residenziale                  ,0,0,0,0,0,2024
EMI,RN,Q 88,Assistenza sociale non residenziale                         ,0,0,0,3,3,2024
EMI,RN,R   ,"Attività artistiche, sportive, di intrattenimento e diver...",0,0,0,7,7,2024
EMI,RN,R 90,"Attività creative, artistiche e di intrattenimento          ",0,0,0,3,3,2024
EMI,RN,R 91,"Attività di biblioteche, archivi, musei ed altre attività...",0,0,0,0,0,2024
EMI,RN,R 92,"Attività riguardanti le lotterie, le scommesse, le case d...",0,0,0,0,0,2024
EMI,RN,R 93,"Attività sportive, di intrattenimento e di divertimento     ",0,0,0,4,4,2024
EMI,RN,S   ,Altre attività di servizi                                   ,0,0,1,0,1,2024
EMI,RN,S 94,Attività di organizzazioni associative                      ,0,0,0,0,0,2024
EMI,RN,S 95,Riparazione di computer e di beni per uso personale e per...,0,0,0,0,0,2024
EMI,RN,S 96,Altre attività di servizi per la persona                    ,0,0,1,0,1,2024
EMI,RN,T   ,Attività di famiglie e convivenze come datori di lavoro p...,0,0,0,0,0,2024
EMI,RN,T 97,Attività di famiglie e convivenze come datori di lavoro p...,0,0,0,0,0,2024
EMI,RN,T 98,Produzione di beni e servizi indifferenziati per uso prop...,0,0,0,0,0,2024
EMI,RN,U   ,Organizzazioni ed organismi extraterritoriali               ,0,0,0,0,0,2024
EMI,RN,U 99,Organizzazioni ed organismi extraterritoriali               ,0,0,0,0,0,2024
EMI,RN,XX  ,Imprese non classificate                                    ,0,0,0,11,11,2024
EMI,RN,TOT ,TOTALE                                                      ,0,5,4,69,78,2024
TOS,  ,A   ,"Agricoltura, silvicoltura pesca                             ",15,35,50,57,157,2024
TOS,  ,A 01,"Coltivazioni agricole e produzione di prodotti animali, c...",14,32,41,37,124,2024
TOS,  ,A 02,Silvicoltura ed utilizzo di aree forestali                  ,0,1,6,14,21,2024
TOS,  ,A 03,Pesca e acquacoltura                                        ,1,2,3,6,12,2024
TOS,  ,B   ,Estrazione di minerali da cave e miniere                    ,13,1,2,7,23,2024
TOS,  ,B 05,Estrazione di carbone (esclusa torba)                       ,0,0,0,0,0,2024
TOS,  ,B 06,Estraz.di petrolio greggio e di gas naturale                ,0,0,0,0,0,2024
TOS,  ,B 07,Estrazione di minerali metalliferi                          ,0,0,0,0,0,2024
TOS,  ,B 08,Altre attività di estrazione di minerali da cave e miniere  ,13,1,1,7,22,2024
TOS,  ,B 09,Attività dei servizi di supporto all'estrazione             ,0,0,1,0,1,2024
TOS,  ,C   ,Attività manifatturiere                                     ,323,43,183,75,624,2024
TOS,  ,C 10,Industrie alimentari                                        ,9,2,6,13,30,2024
TOS,  ,C 11,Industria delle bevande                                     ,1,0,0,0,1,2024
TOS,  ,C 12,Industria del tabacco                                       ,0,0,0,0,0,2024
TOS,  ,C 13,Industrie tessili                                           ,17,7,3,7,34,2024
TOS,  ,C 14,Confezione di articoli di abbigliamento; confezione di ar...,33,6,31,5,75,2024
TOS,  ,C 15,Fabbricazione di articoli in pelle e simili                 ,56,5,26,4,91,2024
TOS,  ,C 16,Industria del legno e dei prodotti in legno e sughero (es...,11,1,20,2,34,2024
TOS,  ,C 17,Fabbricazione di carta e di prodotti di carta               ,5,2,1,0,8,2024
TOS,  ,C 18,Stampa e riproduzione di supporti registrati                ,4,3,3,3,13,2024
TOS,  ,C 19,Fabbricazione di coke e prodotti derivanti dalla raffinaz...,0,0,0,0,0,2024
TOS,  ,C 20,Fabbricazione di prodotti chimici                           ,7,0,0,0,7,2024
TOS,  ,C 21,Fabbricazione di prodotti farmaceutici di base e di prepa...,0,0,1,0,1,2024
TOS,  ,C 22,Fabbricazione di articoli in gomma e materie plastiche      ,9,1,0,1,11,2024
TOS,  ,C 23,Fabbricazione di altri prodotti della lavorazione di miner..,53,1,13,7,74,2024
TOS,  ,C 24,Metallurgia                                                 ,0,0,0,0,0,2024
TOS,  ,C 25,Fabbricazione di prodotti in metallo (esclusi macchinari ...,36,3,21,7,67,2024
TOS,  ,C 26,Fabbricazione di computer e prodotti di elettronica e ott...,6,0,1,1,8,2024
TOS,  ,C 27,Fabbricazione di apparecchiature elettriche ed apparecchi...,6,0,2,1,9,2024
TOS,  ,C 28,Fabbricazione di macchinari ed apparecchiature nca          ,16,1,4,3,24,2024
TOS,  ,C 29,"Fabbricazione di autoveicoli, rimorchi e semirimorchi       ",2,0,0,0,2,2024
TOS,  ,C 30,Fabbricazione di altri mezzi di trasporto                   ,20,0,14,7,41,2024
TOS,  ,C 31,Fabbricazione di mobili                                     ,16,3,6,3,28,2024
TOS,  ,C 32,Altre industrie manifatturiere                              ,6,2,8,4,20,2024
TOS,  ,C 33,"Riparazione, manutenzione ed installazione di macchine ed...",10,6,23,7,46,2024
TOS,  ,D   ,"Fornitura di energia elettrica, gas, vapore e aria condiz...",1,0,1,1,3,2024
TOS,  ,D 35,"Fornitura di energia elettrica, gas, vapore e aria condiz...",1,0,1,1,3,2024
TOS,  ,E   ,"Fornitura di acqua; reti fognarie, attività di gestione d...",3,0,3,7,13,2024
TOS,  ,E 36,"Raccolta, trattamento e fornitura di acqua                  ",0,0,0,0,0,2024
TOS,  ,E 37,Gestione delle reti fognarie                                ,1,0,0,0,1,2024
TOS,  ,E 38,"Attività di raccolta, trattamento e smaltimento dei rifiu...",2,0,3,6,11,2024
TOS,  ,E 39,Attività di risanamento e altri servizi di gestione dei r...,0,0,0,1,1,2024
TOS,  ,F   ,Costruzioni                                                 ,213,38,618,294,1163,2024
TOS,  ,F 41,Costruzione di edifici                                      ,150,18,128,199,495,2024
TOS,  ,F 42,Ingegneria civile                                           ,6,0,0,6,12,2024
TOS,  ,F 43,Lavori di costruzione specializzati                         ,57,20,490,89,656,2024
TOS,  ,G   ,Commercio all'ingrosso e al dettaglio; riparazione di aut...,454,77,506,63,1100,2024
TOS,  ,G 45,Commercio all'ingrosso e al dettaglio e riparazione di au...,41,8,36,2,87,2024
TOS,  ,G 46,Commercio all'ingrosso (escluso quello di autoveicoli e d...,269,23,120,27,439,2024
TOS,  ,G 47,Commercio al dettaglio (escluso quello di autoveicoli e d...,144,46,350,34,574,2024
TOS,  ,H   ,Trasporto e magazzinaggio                                   ,29,5,37,145,216,2024
TOS,  ,H 49,Trasporto terrestre e mediante condotte                     ,17,3,32,47,99,2024
TOS,  ,H 50,Trasporto marittimo e per vie d'acqua                       ,1,0,0,0,1,2024
TOS,  ,H 51,Trasporto aereo                                             ,1,0,0,0,1,2024
TOS,  ,H 52,Magazzinaggio e attività di supporto ai trasporti           ,9,2,5,93,109,2024
TOS,  ,H 53,Servizi postali e attività di corriere                      ,1,0,0,5,6,2024
TOS,  ,I   ,Attività dei servizi alloggio e ristorazione                ,139,102,95,27,363,2024
TOS,  ,I 55,Alloggio                                                    ,17,2,9,7,35,2024
TOS,  ,I 56,Attività dei servizi di ristorazione                        ,122,100,86,20,328,2024
TOS,  ,J   ,Servizi di informazione e comunicazione                     ,56,2,17,19,94,2024
TOS,  ,J 58,Attività editoriali                                         ,8,0,1,3,12,2024
TOS,  ,J 59,"Attività di produzione cinematografica, di video e di pro...",5,0,1,2,8,2024
TOS,  ,J 60,Attività di programmazione e trasmissione                   ,6,0,0,1,7,2024
TOS,  ,J 61,Telecomunicazioni                                           ,1,0,8,0,9,2024
TOS,  ,J 62,"Produzione di software, consulenza informatica e attività...",11,0,2,4,17,2024
TOS,  ,J 63,Attività dei servizi d'informazione e altri servizi infor...,25,2,5,9,41,2024
TOS,  ,K   ,Attività finanziarie e assicurative                         ,14,4,15,4,37,2024
TOS,  ,K 64,Attività di servizi finanziari (escluse le assicurazioni ...,7,0,0,0,7,2024
TOS,  ,K 65,"Assicurazioni, riassicurazioni e fondi pensione (escluse ...",0,0,0,0,0,2024
TOS,  ,K 66,Attività ausiliarie dei servizi finanziari e delle attivi...,7,4,15,4,30,2024
TOS,  ,L   ,Attivita' immobiliari                                       ,129,30,13,35,207,2024
TOS,  ,L 68,Attivita' immobiliari                                       ,129,30,13,35,207,2024
TOS,  ,M   ,"Attività professionali, scientifiche e tecniche             ",88,5,23,53,169,2024
TOS,  ,M 69,Attività legali e contabilità                               ,3,0,1,2,6,2024
TOS,  ,M 70,Attività di direzione aziendale e di consulenza gestional...,15,3,4,26,48,2024
TOS,  ,M 71,Attività degli studi di architettura e d'ingegneria; coll...,9,0,1,10,20,2024
TOS,  ,M 72,Ricerca scientifica e sviluppo                              ,4,0,0,0,4,2024
TOS,  ,M 73,Pubblicità e ricerche di mercato                            ,31,2,7,7,47,2024
TOS,  ,M 74,"Altre attività professionali, scientifiche e tecniche       ",26,0,10,8,44,2024
TOS,  ,M 75,Servizi veterinari                                          ,0,0,0,0,0,2024
TOS,  ,N   ,"Noleggio, agenzie di viaggio, servizi di supporto alle im...",37,8,84,95,224,2024
TOS,  ,N 77,Attività di noleggio e leasing operativo                    ,7,1,8,2,18,2024
TOS,  ,N 78,"Attività di ricerca, selezione, fornitura di personale      ",1,0,0,0,1,2024
TOS,  ,N 79,"Attività dei servizi delle agenzie di viaggio, dei tour o...",7,0,1,4,12,2024
TOS,  ,N 80,Servizi di vigilanza e investigazione                       ,0,1,0,1,2,2024
TOS,  ,N 81,Attività di servizi per edifici e paesaggio                 ,10,4,39,65,118,2024
TOS,  ,N 82,Attività di supporto per le funzioni d'ufficio e altri se...,12,2,36,23,73,2024
TOS,  ,O   ,Amministrazione pubblica e difesa; assicurazione sociale ...,0,0,0,1,1,2024
TOS,  ,O 84,Amministrazione pubblica e difesa; assicurazione sociale ...,0,0,0,1,1,2024
TOS,  ,P   ,Istruzione                                                  ,6,1,2,9,18,2024
TOS,  ,P 85,Istruzione                                                  ,6,1,2,9,18,2024
TOS,  ,Q   ,Sanita' e assistenza sociale                                ,7,0,2,35,44,2024
TOS,  ,Q 86,Assistenza sanitaria                                        ,7,0,0,6,13,2024
TOS,  ,Q 87,Servizi di assistenza sociale residenziale                  ,0,0,1,6,7,2024
TOS,  ,Q 88,Assistenza sociale non residenziale                         ,0,0,1,23,24,2024
TOS,  ,R   ,"Attività artistiche, sportive, di intrattenimento e diver...",41,6,10,35,92,2024
TOS,  ,R 90,"Attività creative, artistiche e di intrattenimento          ",15,1,2,14,32,2024
TOS,  ,R 91,"Attività di biblioteche, archivi, musei ed altre attività...",0,0,0,2,2,2024
TOS,  ,R 92,"Attività riguardanti le lotterie, le scommesse, le case d...",0,1,0,0,1,2024
TOS,  ,R 93,"Attività sportive, di intrattenimento e di divertimento     ",26,4,8,19,57,2024
TOS,  ,S   ,Altre attività di servizi                                   ,23,13,50,18,104,2024
TOS,  ,S 94,Attività di organizzazioni associative                      ,0,0,0,3,3,2024
TOS,  ,S 95,Riparazione di computer e di beni per uso personale e per...,4,0,8,1,13,2024
TOS,  ,S 96,Altre attività di servizi per la persona                    ,19,13,42,14,88,2024
TOS,  ,T   ,Attività di famiglie e convivenze come datori di lavoro p...,0,0,0,0,0,2024
TOS,  ,T 97,Attività di famiglie e convivenze come datori di lavoro p...,0,0,0,0,0,2024
TOS,  ,T 98,Produzione di beni e servizi indifferenziati per uso prop...,0,0,0,0,0,2024
TOS,  ,U   ,Organizzazioni ed organismi extraterritoriali               ,0,0,0,0,0,2024
TOS,  ,U 99,Organizzazioni ed organismi extraterritoriali               ,0,0,0,0,0,2024
TOS,  ,XX  ,Imprese non classificate                                    ,338,34,99,423,894,2024
TOS,  ,TOT ,TOTALE                                                      ,1929,404,1810,1403,5546,2024
TOS,MS,A   ,"Agricoltura, silvicoltura pesca                             ",0,0,11,4,15,2024
TOS,MS,A 01,"Coltivazioni agricole e produzione di prodotti animali, c...",0,0,9,1,10,2024
TOS,MS,A 02,Silvicoltura ed utilizzo di aree forestali                  ,0,0,2,3,5,2024
TOS,MS,A 03,Pesca e acquacoltura                                        ,0,0,0,0,0,2024
TOS,MS,B   ,Estrazione di minerali da cave e miniere                    ,8,0,1,1,10,2024
TOS,MS,B 05,Estrazione di carbone (esclusa torba)                       ,0,0,0,0,0,2024
TOS,MS,B 06,Estraz.di petrolio greggio e di gas naturale                ,0,0,0,0,0,2024
TOS,MS,B 07,Estrazione di minerali metalliferi                          ,0,0,0,0,0,2024
TOS,MS,B 08,Altre attività di estrazione di minerali da cave e miniere  ,8,0,0,1,9,2024
TOS,MS,B 09,Attività dei servizi di supporto all'estrazione             ,0,0,1,0,1,2024
TOS,MS,C   ,Attività manifatturiere                                     ,91,0,29,10,130,2024
TOS,MS,C 10,Industrie alimentari                                        ,2,0,3,0,5,2024
TOS,MS,C 11,Industria delle bevande                                     ,0,0,0,0,0,2024
TOS,MS,C 12,Industria del tabacco                                       ,0,0,0,0,0,2024
TOS,MS,C 13,Industrie tessili                                           ,1,0,0,1,2,2024
TOS,MS,C 14,Confezione di articoli di abbigliamento; confezione di ar...,3,0,1,0,4,2024
TOS,MS,C 15,Fabbricazione di articoli in pelle e simili                 ,0,0,1,0,1,2024
TOS,MS,C 16,Industria del legno e dei prodotti in legno e sughero (es...,3,0,5,0,8,2024
TOS,MS,C 17,Fabbricazione di carta e di prodotti di carta               ,0,0,0,0,0,2024
TOS,MS,C 18,Stampa e riproduzione di supporti registrati                ,2,0,1,0,3,2024
TOS,MS,C 19,Fabbricazione di coke e prodotti derivanti dalla raffinaz...,0,0,0,0,0,2024
TOS,MS,C 20,Fabbricazione di prodotti chimici                           ,1,0,0,0,1,2024
TOS,MS,C 21,Fabbricazione di prodotti farmaceutici di base e di prepa...,0,0,0,0,0,2024
TOS,MS,C 22,Fabbricazione di articoli in gomma e materie plastiche      ,2,0,0,0,2,2024
TOS,MS,C 23,Fabbricazione di altri prodotti della lavorazione di miner..,32,0,3,3,38,2024
TOS,MS,C 24,Metallurgia                                                 ,0,0,0,0,0,2024
TOS,MS,C 25,Fabbricazione di prodotti in metallo (esclusi macchinari ...,21,0,3,2,26,2024
TOS,MS,C 26,Fabbricazione di computer e prodotti di elettronica e ott...,2,0,0,0,2,2024
TOS,MS,C 27,Fabbricazione di apparecchiature elettriche ed apparecchi...,0,0,0,0,0,2024
TOS,MS,C 28,Fabbricazione di macchinari ed apparecchiature nca          ,6,0,2,0,8,2024
TOS,MS,C 29,"Fabbricazione di autoveicoli, rimorchi e semirimorchi       ",1,0,0,0,1,2024
TOS,MS,C 30,Fabbricazione di altri mezzi di trasporto                   ,8,0,4,1,13,2024
TOS,MS,C 31,Fabbricazione di mobili                                     ,1,0,3,0,4,2024
TOS,MS,C 32,Altre industrie manifatturiere                              ,1,0,1,0,2,2024
TOS,MS,C 33,"Riparazione, manutenzione ed installazione di macchine ed...",5,0,2,3,10,2024
TOS,MS,D   ,"Fornitura di energia elettrica, gas, vapore e aria condiz...",0,0,1,1,2,2024
TOS,MS,D 35,"Fornitura di energia elettrica, gas, vapore e aria condiz...",0,0,1,1,2,2024
TOS,MS,E   ,"Fornitura di acqua; reti fognarie, attività di gestione d...",1,0,1,0,2,2024
TOS,MS,E 36,"Raccolta, trattamento e fornitura di acqua                  ",0,0,0,0,0,2024
TOS,MS,E 37,Gestione delle reti fognarie                                ,0,0,0,0,0,2024
TOS,MS,E 38,"Attività di raccolta, trattamento e smaltimento dei rifiu...",1,0,1,0,2,2024
TOS,MS,E 39,Attività di risanamento e altri servizi di gestione dei r...,0,0,0,0,0,2024
TOS,MS,F   ,Costruzioni                                                 ,50,0,116,38,204,2024
TOS,MS,F 41,Costruzione di edifici                                      ,40,0,13,22,75,2024
TOS,MS,F 42,Ingegneria civile                                           ,1,0,0,2,3,2024
TOS,MS,F 43,Lavori di costruzione specializzati                         ,9,0,103,14,126,2024
TOS,MS,G   ,Commercio all'ingrosso e al dettaglio; riparazione di aut...,131,0,140,17,288,2024
TOS,MS,G 45,Commercio all'ingrosso e al dettaglio e riparazione di au...,10,0,6,1,17,2024
TOS,MS,G 46,Commercio all'ingrosso (escluso quello di autoveicoli e d...,92,0,18,5,115,2024
TOS,MS,G 47,Commercio al dettaglio (escluso quello di autoveicoli e d...,29,0,116,11,156,2024
TOS,MS,H   ,Trasporto e magazzinaggio                                   ,15,0,10,9,34,2024
TOS,MS,H 49,Trasporto terrestre e mediante condotte                     ,12,0,9,4,25,2024
TOS,MS,H 50,Trasporto marittimo e per vie d'acqua                       ,0,0,0,0,0,2024
TOS,MS,H 51,Trasporto aereo                                             ,0,0,0,0,0,2024
TOS,MS,H 52,Magazzinaggio e attività di supporto ai trasporti           ,3,0,1,3,7,2024
TOS,MS,H 53,Servizi postali e attività di corriere                      ,0,0,0,2,2,2024
TOS,MS,I   ,Attività dei servizi alloggio e ristorazione                ,22,0,20,6,48,2024
TOS,MS,I 55,Alloggio                                                    ,3,0,3,2,8,2024
TOS,MS,I 56,Attività dei servizi di ristorazione                        ,19,0,17,4,40,2024
TOS,MS,J   ,Servizi di informazione e comunicazione                     ,17,0,2,4,23,2024
TOS,MS,J 58,Attività editoriali                                         ,2,0,1,1,4,2024
TOS,MS,J 59,"Attività di produzione cinematografica, di video e di pro...",3,0,0,0,3,2024
TOS,MS,J 60,Attività di programmazione e trasmissione                   ,4,0,0,1,5,2024
TOS,MS,J 61,Telecomunicazioni                                           ,0,0,0,0,0,2024
TOS,MS,J 62,"Produzione di software, consulenza informatica e attività...",4,0,0,1,5,2024
TOS,MS,J 63,Attività dei servizi d'informazione e altri servizi infor...,4,0,1,1,6,2024
TOS,MS,K   ,Attività finanziarie e assicurative                         ,1,0,2,0,3,2024
TOS,MS,K 64,Attività di servizi finanziari (escluse le assicurazioni ...,1,0,0,0,1,2024
TOS,MS,K 65,"Assicurazioni, riassicurazioni e fondi pensione (escluse ...",0,0,0,0,0,2024
TOS,MS,K 66,Attività ausiliarie dei servizi finanziari e delle attivi...,0,0,2,0,2,2024
TOS,MS,L   ,Attivita' immobiliari                                       ,18,0,4,0,22,2024
TOS,MS,L 68,Attivita' immobiliari                                       ,18,0,4,0,22,2024
TOS,MS,M   ,"Attività professionali, scientifiche e tecniche             ",18,0,2,13,33,2024
TOS,MS,M 69,Attività legali e contabilità                               ,0,0,0,0,0,2024
TOS,MS,M 70,Attività di direzione aziendale e di consulenza gestional...,3,0,0,8,11,2024
TOS,MS,M 71,Attività degli studi di architettura e d'ingegneria; coll...,2,0,0,2,4,2024
TOS,MS,M 72,Ricerca scientifica e sviluppo                              ,1,0,0,0,1,2024
TOS,MS,M 73,Pubblicità e ricerche di mercato                            ,9,0,1,3,13,2024
TOS,MS,M 74,"Altre attività professionali, scientifiche e tecniche       ",3,0,1,0,4,2024
TOS,MS,M 75,Servizi veterinari                                          ,0,0,0,0,0,2024
TOS,MS,N   ,"Noleggio, agenzie di viaggio, servizi di supporto alle im...",8,0,15,11,34,2024
TOS,MS,N 77,Attività di noleggio e leasing operativo                    ,2,0,3,0,5,2024
TOS,MS,N 78,"Attività di ricerca, selezione, fornitura di personale      ",0,0,0,0,0,2024
TOS,MS,N 79,"Attività dei servizi delle agenzie di viaggio, dei tour o...",1,0,0,2,3,2024
TOS,MS,N 80,Servizi di vigilanza e investigazione                       ,0,0,0,0,0,2024
TOS,MS,N 81,Attività di servizi per edifici e paesaggio                 ,3,0,6,9,18,2024
TOS,MS,N 82,Attività di supporto per le funzioni d'ufficio e altri se...,2,0,6,0,8,2024
TOS,MS,O   ,Amministrazione pubblica e difesa; assicurazione sociale ...,0,0,0,0,0,2024
TOS,MS,O 84,Amministrazione pubblica e difesa; assicurazione sociale ...,0,0,0,0,0,2024
TOS,MS,P   ,Istruzione                                                  ,0,0,0,0,0,2024
TOS,MS,P 85,Istruzione                                                  ,0,0,0,0,0,2024
TOS,MS,Q   ,Sanita' e assistenza sociale                                ,2,0,1,4,7,2024
TOS,MS,Q 86,Assistenza sanitaria                                        ,2,0,0,1,3,2024
TOS,MS,Q 87,Servizi di assistenza sociale residenziale                  ,0,0,1,1,2,2024
TOS,MS,Q 88,Assistenza sociale non residenziale                         ,0,0,0,2,2,2024
TOS,MS,R   ,"Attività artistiche, sportive, di intrattenimento e diver...",15,0,3,8,26,2024
TOS,MS,R 90,"Attività creative, artistiche e di intrattenimento          ",4,0,0,2,6,2024
TOS,MS,R 91,"Attività di biblioteche, archivi, musei ed altre attività...",0,0,0,1,1,2024
TOS,MS,R 92,"Attività riguardanti le lotterie, le scommesse, le case d...",0,0,0,0,0,2024
TOS,MS,R 93,"Attività sportive, di intrattenimento e di divertimento     ",11,0,3,5,19,2024
TOS,MS,S   ,Altre attività di servizi                                   ,3,0,15,2,20,2024
TOS,MS,S 94,Attività di organizzazioni associative                      ,0,0,0,0,0,2024
TOS,MS,S 95,Riparazione di computer e di beni per uso personale e per...,1,0,2,0,3,2024
TOS,MS,S 96,Altre attività di servizi per la persona                    ,2,0,13,2,17,2024
TOS,MS,T   ,Attività di famiglie e convivenze come datori di lavoro p...,0,0,0,0,0,2024
TOS,MS,T 97,Attività di famiglie e convivenze come datori di lavoro p...,0,0,0,0,0,2024
TOS,MS,T 98,Produzione di beni e servizi indifferenziati per uso prop...,0,0,0,0,0,2024
TOS,MS,U   ,Organizzazioni ed organismi extraterritoriali               ,0,0,0,0,0,2024
TOS,MS,U 99,Organizzazioni ed organismi extraterritoriali               ,0,0,0,0,0,2024
TOS,MS,XX  ,Imprese non classificate                                    ,92,0,20,22,134,2024
TOS,MS,TOT ,TOTALE                                                      ,492,0,393,150,1035,2024
TOS,LU,A   ,"Agricoltura, silvicoltura pesca                             ",4,0,11,8,23,2024
TOS,LU,A 01,"Coltivazioni agricole e produzione di prodotti animali, c...",3,0,7,4,14,2024
TOS,LU,A 02,Silvicoltura ed utilizzo di aree forestali                  ,0,0,2,3,5,2024
TOS,LU,A 03,Pesca e acquacoltura                                        ,1,0,2,1,4,2024
TOS,LU,B   ,Estrazione di minerali da cave e miniere                    ,3,0,1,6,10,2024
TOS,LU,B 05,Estrazione di carbone (esclusa torba)                       ,0,0,0,0,0,2024
TOS,LU,B 06,Estraz.di petrolio greggio e di gas naturale                ,0,0,0,0,0,2024
TOS,LU,B 07,Estrazione di minerali metalliferi                          ,0,0,0,0,0,2024
TOS,LU,B 08,Altre attività di estrazione di minerali da cave e miniere  ,3,0,1,6,10,2024
TOS,LU,B 09,Attività dei servizi di supporto all'estrazione             ,0,0,0,0,0,2024
TOS,LU,C   ,Attività manifatturiere                                     ,109,0,74,24,207,2024
TOS,LU,C 10,Industrie alimentari                                        ,2,0,0,2,4,2024
TOS,LU,C 11,Industria delle bevande                                     ,0,0,0,0,0,2024
TOS,LU,C 12,Industria del tabacco                                       ,0,0,0,0,0,2024
TOS,LU,C 13,Industrie tessili                                           ,4,0,0,1,5,2024
TOS,LU,C 14,Confezione di articoli di abbigliamento; confezione di ar...,11,0,4,1,16,2024
TOS,LU,C 15,Fabbricazione di articoli in pelle e simili                 ,21,0,7,3,31,2024
TOS,LU,C 16,Industria del legno e dei prodotti in legno e sughero (es...,5,0,8,0,13,2024
TOS,LU,C 17,Fabbricazione di carta e di prodotti di carta               ,3,0,1,0,4,2024
TOS,LU,C 18,Stampa e riproduzione di supporti registrati                ,1,0,1,0,2,2024
TOS,LU,C 19,Fabbricazione di coke e prodotti derivanti dalla raffinaz...,0,0,0,0,0,2024
TOS,LU,C 20,Fabbricazione di prodotti chimici                           ,2,0,0,0,2,2024
TOS,LU,C 21,Fabbricazione di prodotti farmaceutici di base e di prepa...,0,0,0,0,0,2024
TOS,LU,C 22,Fabbricazione di articoli in gomma e materie plastiche      ,5,0,0,1,6,2024
TOS,LU,C 23,Fabbricazione di altri prodotti della lavorazione di miner..,15,0,7,2,24,2024
TOS,LU,C 24,Metallurgia                                                 ,0,0,0,0,0,2024
TOS,LU,C 25,Fabbricazione di prodotti in metallo (esclusi macchinari ...,7,0,13,0,20,2024
TOS,LU,C 26,Fabbricazione di computer e prodotti di elettronica e ott...,3,0,0,0,3,2024
TOS,LU,C 27,Fabbricazione di apparecchiature elettriche ed apparecchi...,4,0,1,1,6,2024
TOS,LU,C 28,Fabbricazione di macchinari ed apparecchiature nca          ,7,0,0,1,8,2024
TOS,LU,C 29,"Fabbricazione di autoveicoli, rimorchi e semirimorchi       ",0,0,0,0,0,2024
TOS,LU,C 30,Fabbricazione di altri mezzi di trasporto                   ,10,0,9,5,24,2024
TOS,LU,C 31,Fabbricazione di mobili                                     ,3,0,2,2,7,2024
TOS,LU,C 32,Altre industrie manifatturiere                              ,3,0,3,2,8,2024
TOS,LU,C 33,"Riparazione, manutenzione ed installazione di macchine ed...",3,0,18,3,24,2024
TOS,LU,D   ,"Fornitura di energia elettrica, gas, vapore e aria condiz...",0,0,0,0,0,2024
TOS,LU,D 35,"Fornitura di energia elettrica, gas, vapore e aria condiz...",0,0,0,0,0,2024
TOS,LU,E   ,"Fornitura di acqua; reti fognarie, attività di gestione d...",1,0,0,1,2,2024
TOS,LU,E 36,"Raccolta, trattamento e fornitura di acqua                  ",0,0,0,0,0,2024
TOS,LU,E 37,Gestione delle reti fognarie                                ,0,0,0,0,0,2024
TOS,LU,E 38,"Attività di raccolta, trattamento e smaltimento dei rifiu...",1,0,0,1,2,2024
TOS,LU,E 39,Attività di risanamento e altri servizi di gestione dei r...,0,0,0,0,0,2024
TOS,LU,F   ,Costruzioni                                                 ,45,0,351,102,498,2024
TOS,LU,F 41,Costruzione di edifici                                      ,33,0,74,75,182,2024
TOS,LU,F 42,Ingegneria civile                                           ,0,0,0,2,2,2024
TOS,LU,F 43,Lavori di costruzione specializzati                         ,12,0,277,25,314,2024
TOS,LU,G   ,Commercio all'ingrosso e al dettaglio; riparazione di aut...,118,0,113,4,235,2024
TOS,LU,G 45,Commercio all'ingrosso e al dettaglio e riparazione di au...,10,0,10,0,20,2024
TOS,LU,G 46,Commercio all'ingrosso (escluso quello di autoveicoli e d...,63,0,24,2,89,2024
TOS,LU,G 47,Commercio al dettaglio (escluso quello di autoveicoli e d...,45,0,79,2,126,2024
TOS,LU,H   ,Trasporto e magazzinaggio                                   ,6,0,14,21,41,2024
TOS,LU,H 49,Trasporto terrestre e mediante condotte                     ,3,0,12,13,28,2024
TOS,LU,H 50,Trasporto marittimo e per vie d'acqua                       ,1,0,0,0,1,2024
TOS,LU,H 51,Trasporto aereo                                             ,0,0,0,0,0,2024
TOS,LU,H 52,Magazzinaggio e attività di supporto ai trasporti           ,1,0,2,8,11,2024
TOS,LU,H 53,Servizi postali e attività di corriere                      ,1,0,0,0,1,2024
TOS,LU,I   ,Attività dei servizi alloggio e ristorazione                ,36,0,31,4,71,2024
TOS,LU,I 55,Alloggio                                                    ,3,0,2,1,6,2024
TOS,LU,I 56,Attività dei servizi di ristorazione                        ,33,0,29,3,65,2024
TOS,LU,J   ,Servizi di informazione e comunicazione                     ,9,0,7,4,20,2024
TOS,LU,J 58,Attività editoriali                                         ,2,0,0,0,2,2024
TOS,LU,J 59,"Attività di produzione cinematografica, di video e di pro...",0,0,1,1,2,2024
TOS,LU,J 60,Attività di programmazione e trasmissione                   ,0,0,0,0,0,2024
TOS,LU,J 61,Telecomunicazioni                                           ,1,0,3,0,4,2024
TOS,LU,J 62,"Produzione di software, consulenza informatica e attività...",3,0,0,0,3,2024
TOS,LU,J 63,Attività dei servizi d'informazione e altri servizi infor...,3,0,3,3,9,2024
TOS,LU,K   ,Attività finanziarie e assicurative                         ,5,0,8,0,13,2024
TOS,LU,K 64,Attività di servizi finanziari (escluse le assicurazioni ...,4,0,0,0,4,2024
TOS,LU,K 65,"Assicurazioni, riassicurazioni e fondi pensione (escluse ...",0,0,0,0,0,2024
TOS,LU,K 66,Attività ausiliarie dei servizi finanziari e delle attivi...,1,0,8,0,9,2024
TOS,LU,L   ,Attivita' immobiliari                                       ,33,0,3,1,37,2024
TOS,LU,L 68,Attivita' immobiliari                                       ,33,0,3,1,37,2024
TOS,LU,M   ,"Attività professionali, scientifiche e tecniche             ",24,0,12,12,48,2024
TOS,LU,M 69,Attività legali e contabilità                               ,0,0,1,1,2,2024
TOS,LU,M 70,Attività di direzione aziendale e di consulenza gestional...,2,0,2,6,10,2024
TOS,LU,M 71,Attività degli studi di architettura e d'ingegneria; coll...,1,0,1,3,5,2024
TOS,LU,M 72,Ricerca scientifica e sviluppo                              ,1,0,0,0,1,2024
TOS,LU,M 73,Pubblicità e ricerche di mercato                            ,6,0,4,0,10,2024
TOS,LU,M 74,"Altre attività professionali, scientifiche e tecniche       ",14,0,4,2,20,2024
TOS,LU,M 75,Servizi veterinari                                          ,0,0,0,0,0,2024
TOS,LU,N   ,"Noleggio, agenzie di viaggio, servizi di supporto alle im...",2,0,31,15,48,2024
TOS,LU,N 77,Attività di noleggio e leasing operativo                    ,1,0,2,0,3,2024
TOS,LU,N 78,"Attività di ricerca, selezione, fornitura di personale      ",0,0,0,0,0,2024
TOS,LU,N 79,"Attività dei servizi delle agenzie di viaggio, dei tour o...",0,0,1,1,2,2024
TOS,LU,N 80,Servizi di vigilanza e investigazione                       ,0,0,0,0,0,2024
TOS,LU,N 81,Attività di servizi per edifici e paesaggio                 ,0,0,20,11,31,2024
TOS,LU,N 82,Attività di supporto per le funzioni d'ufficio e altri se...,1,0,8,3,12,2024
TOS,LU,O   ,Amministrazione pubblica e difesa; assicurazione sociale ...,0,0,0,0,0,2024
TOS,LU,O 84,Amministrazione pubblica e difesa; assicurazione sociale ...,0,0,0,0,0,2024
TOS,LU,P   ,Istruzione                                                  ,2,0,1,0,3,2024
TOS,LU,P 85,Istruzione                                                  ,2,0,1,0,3,2024
TOS,LU,Q   ,Sanita' e assistenza sociale                                ,1,0,1,8,10,2024
TOS,LU,Q 86,Assistenza sanitaria                                        ,1,0,0,1,2,2024
TOS,LU,Q 87,Servizi di assistenza sociale residenziale                  ,0,0,0,1,1,2024
TOS,LU,Q 88,Assistenza sociale non residenziale                         ,0,0,1,6,7,2024
TOS,LU,R   ,"Attività artistiche, sportive, di intrattenimento e diver...",16,0,1,9,26,2024
TOS,LU,R 90,"Attività creative, artistiche e di intrattenimento          ",9,0,1,4,14,2024
TOS,LU,R 91,"Attività di biblioteche, archivi, musei ed altre attività...",0,0,0,0,0,2024
TOS,LU,R 92,"Attività riguardanti le lotterie, le scommesse, le case d...",0,0,0,0,0,2024
TOS,LU,R 93,"Attività sportive, di intrattenimento e di divertimento     ",7,0,0,5,12,2024
TOS,LU,S   ,Altre attività di servizi                                   ,5,0,18,5,28,2024
TOS,LU,S 94,Attività di organizzazioni associative                      ,0,0,0,2,2,2024
TOS,LU,S 95,Riparazione di computer e di beni per uso personale e per...,0,0,5,1,6,2024
TOS,LU,S 96,Altre attività di servizi per la persona                    ,5,0,13,2,20,2024
TOS,LU,T   ,Attività di famiglie e convivenze come datori di lavoro p...,0,0,0,0,0,2024
TOS,LU,T 97,Attività di famiglie e convivenze come datori di lavoro p...,0,0,0,0,0,2024
TOS,LU,T 98,Produzione di beni e servizi indifferenziati per uso prop...,0,0,0,0,0,2024
TOS,LU,U   ,Organizzazioni ed organismi extraterritoriali               ,0,0,0,0,0,2024
TOS,LU,U 99,Organizzazioni ed organismi extraterritoriali               ,0,0,0,0,0,2024
TOS,LU,XX  ,Imprese non classificate                                    ,54,0,16,29,99,2024
TOS,LU,TOT ,TOTALE                                                      ,473,0,693,253,1419,2024
TOS,PT,A   ,"Agricoltura, silvicoltura pesca                             ",1,0,2,2,5,2024
TOS,PT,A 01,"Coltivazioni agricole e produzione di prodotti animali, c...",1,0,2,1,4,2024
TOS,PT,A 02,Silvicoltura ed utilizzo di aree forestali                  ,0,0,0,1,1,2024
TOS,PT,A 03,Pesca e acquacoltura                                        ,0,0,0,0,0,2024
TOS,PT,B   ,Estrazione di minerali da cave e miniere                    ,0,0,0,0,0,2024
TOS,PT,B 05,Estrazione di carbone (esclusa torba)                       ,0,0,0,0,0,2024
TOS,PT,B 06,Estraz.di petrolio greggio e di gas naturale                ,0,0,0,0,0,2024
TOS,PT,B 07,Estrazione di minerali metalliferi                          ,0,0,0,0,0,2024
TOS,PT,B 08,Altre attività di estrazione di minerali da cave e miniere  ,0,0,0,0,0,2024
TOS,PT,B 09,Attività dei servizi di supporto all'estrazione             ,0,0,0,0,0,2024
TOS,PT,C   ,Attività manifatturiere                                     ,10,12,4,4,30,2024
TOS,PT,C 10,Industrie alimentari                                        ,0,2,0,0,2,2024
TOS,PT,C 11,Industria delle bevande                                     ,0,0,0,0,0,2024
TOS,PT,C 12,Industria del tabacco                                       ,0,0,0,0,0,2024
TOS,PT,C 13,Industrie tessili                                           ,2,3,0,1,6,2024
TOS,PT,C 14,Confezione di articoli di abbigliamento; confezione di ar...,2,1,1,1,5,2024
TOS,PT,C 15,Fabbricazione di articoli in pelle e simili                 ,2,0,1,0,3,2024
TOS,PT,C 16,Industria del legno e dei prodotti in legno e sughero (es...,1,0,0,0,1,2024
TOS,PT,C 17,Fabbricazione di carta e di prodotti di carta               ,1,1,0,0,2,2024
TOS,PT,C 18,Stampa e riproduzione di supporti registrati                ,0,2,0,0,2,2024
TOS,PT,C 19,Fabbricazione di coke e prodotti derivanti dalla raffinaz...,0,0,0,0,0,2024
TOS,PT,C 20,Fabbricazione di prodotti chimici                           ,0,0,0,0,0,2024
TOS,PT,C 21,Fabbricazione di prodotti farmaceutici di base e di prepa...,0,0,0,0,0,2024
TOS,PT,C 22,Fabbricazione di articoli in gomma e materie plastiche      ,0,0,0,0,0,2024
TOS,PT,C 23,Fabbricazione di altri prodotti della lavorazione di miner..,0,0,0,1,1,2024
TOS,PT,C 24,Metallurgia                                                 ,0,0,0,0,0,2024
TOS,PT,C 25,Fabbricazione di prodotti in metallo (esclusi macchinari ...,0,1,1,1,3,2024
TOS,PT,C 26,Fabbricazione di computer e prodotti di elettronica e ott...,0,0,0,0,0,2024
TOS,PT,C 27,Fabbricazione di apparecchiature elettriche ed apparecchi...,0,0,0,0,0,2024
TOS,PT,C 28,Fabbricazione di macchinari ed apparecchiature nca          ,1,0,0,0,1,2024
TOS,PT,C 29,"Fabbricazione di autoveicoli, rimorchi e semirimorchi       ",0,0,0,0,0,2024
TOS,PT,C 30,Fabbricazione di altri mezzi di trasporto                   ,0,0,0,0,0,2024
TOS,PT,C 31,Fabbricazione di mobili                                     ,1,0,0,0,1,2024
TOS,PT,C 32,Altre industrie manifatturiere                              ,0,1,1,0,2,2024
TOS,PT,C 33,"Riparazione, manutenzione ed installazione di macchine ed...",0,1,0,0,1,2024
TOS,PT,D   ,"Fornitura di energia elettrica, gas, vapore e aria condiz...",0,0,0,0,0,2024
TOS,PT,D 35,"Fornitura di energia elettrica, gas, vapore e aria condiz...",0,0,0,0,0,2024
TOS,PT,E   ,"Fornitura di acqua; reti fognarie, attività di gestione d...",0,0,0,0,0,2024
TOS,PT,E 36,"Raccolta, trattamento e fornitura di acqua                  ",0,0,0,0,0,2024
TOS,PT,E 37,Gestione delle reti fognarie                                ,0,0,0,0,0,2024
TOS,PT,E 38,"Attività di raccolta, trattamento e smaltimento dei rifiu...",0,0,0,0,0,2024
TOS,PT,E 39,Attività di risanamento e altri servizi di gestione dei r...,0,0,0,0,0,2024
TOS,PT,F   ,Costruzioni                                                 ,9,16,4,15,44,2024
TOS,PT,F 41,Costruzione di edifici                                      ,7,7,0,8,22,2024
TOS,PT,F 42,Ingegneria civile                                           ,0,0,0,0,0,2024
TOS,PT,F 43,Lavori di costruzione specializzati                         ,2,9,4,7,22,2024
TOS,PT,G   ,Commercio all'ingrosso e al dettaglio; riparazione di aut...,17,14,11,4,46,2024
TOS,PT,G 45,Commercio all'ingrosso e al dettaglio e riparazione di au...,3,1,1,0,5,2024
TOS,PT,G 46,Commercio all'ingrosso (escluso quello di autoveicoli e d...,3,9,8,2,22,2024
TOS,PT,G 47,Commercio al dettaglio (escluso quello di autoveicoli e d...,11,4,2,2,19,2024
TOS,PT,H   ,Trasporto e magazzinaggio                                   ,0,0,4,8,12,2024
TOS,PT,H 49,Trasporto terrestre e mediante condotte                     ,0,0,4,2,6,2024
TOS,PT,H 50,Trasporto marittimo e per vie d'acqua                       ,0,0,0,0,0,2024
TOS,PT,H 51,Trasporto aereo                                             ,0,0,0,0,0,2024
TOS,PT,H 52,Magazzinaggio e attività di supporto ai trasporti           ,0,0,0,6,6,2024
TOS,PT,H 53,Servizi postali e attività di corriere                      ,0,0,0,0,0,2024
TOS,PT,I   ,Attività dei servizi alloggio e ristorazione                ,5,40,4,1,50,2024
TOS,PT,I 55,Alloggio                                                    ,1,1,0,1,3,2024
TOS,PT,I 56,Attività dei servizi di ristorazione                        ,4,39,4,0,47,2024
TOS,PT,J   ,Servizi di informazione e comunicazione                     ,2,0,0,0,2,2024
TOS,PT,J 58,Attività editoriali                                         ,0,0,0,0,0,2024
TOS,PT,J 59,"Attività di produzione cinematografica, di video e di pro...",0,0,0,0,0,2024
TOS,PT,J 60,Attività di programmazione e trasmissione                   ,0,0,0,0,0,2024
TOS,PT,J 61,Telecomunicazioni                                           ,0,0,0,0,0,2024
TOS,PT,J 62,"Produzione di software, consulenza informatica e attività...",0,0,0,0,0,2024
TOS,PT,J 63,Attività dei servizi d'informazione e altri servizi infor...,2,0,0,0,2,2024
TOS,PT,K   ,Attività finanziarie e assicurative                         ,0,1,1,1,3,2024
TOS,PT,K 64,Attività di servizi finanziari (escluse le assicurazioni ...,0,0,0,0,0,2024
TOS,PT,K 65,"Assicurazioni, riassicurazioni e fondi pensione (escluse ...",0,0,0,0,0,2024
TOS,PT,K 66,Attività ausiliarie dei servizi finanziari e delle attivi...,0,1,1,1,3,2024
TOS,PT,L   ,Attivita' immobiliari                                       ,6,4,1,1,12,2024
TOS,PT,L 68,Attivita' immobiliari                                       ,6,4,1,1,12,2024
TOS,PT,M   ,"Attività professionali, scientifiche e tecniche             ",6,2,1,4,13,2024
TOS,PT,M 69,Attività legali e contabilità                               ,0,0,0,0,0,2024
TOS,PT,M 70,Attività di direzione aziendale e di consulenza gestional...,2,0,0,2,4,2024
TOS,PT,M 71,Attività degli studi di architettura e d'ingegneria; coll...,2,0,0,0,2,2024
TOS,PT,M 72,Ricerca scientifica e sviluppo                              ,0,0,0,0,0,2024
TOS,PT,M 73,Pubblicità e ricerche di mercato                            ,1,2,0,1,4,2024
TOS,PT,M 74,"Altre attività professionali, scientifiche e tecniche       ",1,0,1,1,3,2024
TOS,PT,M 75,Servizi veterinari                                          ,0,0,0,0,0,2024
TOS,PT,N   ,"Noleggio, agenzie di viaggio, servizi di supporto alle im...",1,0,3,3,7,2024
TOS,PT,N 77,Attività di noleggio e leasing operativo                    ,0,0,0,0,0,2024
TOS,PT,N 78,"Attività di ricerca, selezione, fornitura di personale      ",0,0,0,0,0,2024
TOS,PT,N 79,"Attività dei servizi delle agenzie di viaggio, dei tour o...",0,0,0,0,0,2024
TOS,PT,N 80,Servizi di vigilanza e investigazione                       ,0,0,0,0,0,2024
TOS,PT,N 81,Attività di servizi per edifici e paesaggio                 ,0,0,1,1,2,2024
TOS,PT,N 82,Attività di supporto per le funzioni d'ufficio e altri se...,1,0,2,2,5,2024
TOS,PT,O   ,Amministrazione pubblica e difesa; assicurazione sociale ...,0,0,0,0,0,2024
TOS,PT,O 84,Amministrazione pubblica e difesa; assicurazione sociale ...,0,0,0,0,0,2024
TOS,PT,P   ,Istruzione                                                  ,1,0,0,1,2,2024
TOS,PT,P 85,Istruzione                                                  ,1,0,0,1,2,2024
TOS,PT,Q   ,Sanita' e assistenza sociale                                ,0,0,0,2,2,2024
TOS,PT,Q 86,Assistenza sanitaria                                        ,0,0,0,1,1,2024
TOS,PT,Q 87,Servizi di assistenza sociale residenziale                  ,0,0,0,0,0,2024
TOS,PT,Q 88,Assistenza sociale non residenziale                         ,0,0,0,1,1,2024
TOS,PT,R   ,"Attività artistiche, sportive, di intrattenimento e diver...",0,3,0,4,7,2024
TOS,PT,R 90,"Attività creative, artistiche e di intrattenimento          ",0,0,0,1,1,2024
TOS,PT,R 91,"Attività di biblioteche, archivi, musei ed altre attività...",0,0,0,0,0,2024
TOS,PT,R 92,"Attività riguardanti le lotterie, le scommesse, le case d...",0,0,0,0,0,2024
TOS,PT,R 93,"Attività sportive, di intrattenimento e di divertimento     ",0,3,0,3,6,2024
TOS,PT,S   ,Altre attività di servizi                                   ,2,2,0,2,6,2024
TOS,PT,S 94,Attività di organizzazioni associative                      ,0,0,0,0,0,2024
TOS,PT,S 95,Riparazione di computer e di beni per uso personale e per...,1,0,0,0,1,2024
TOS,PT,S 96,Altre attività di servizi per la persona                    ,1,2,0,2,5,2024
TOS,PT,T   ,Attività di famiglie e convivenze come datori di lavoro p...,0,0,0,0,0,2024
TOS,PT,T 97,Attività di famiglie e convivenze come datori di lavoro p...,0,0,0,0,0,2024
TOS,PT,T 98,Produzione di beni e servizi indifferenziati per uso prop...,0,0,0,0,0,2024
TOS,PT,U   ,Organizzazioni ed organismi extraterritoriali               ,0,0,0,0,0,2024
TOS,PT,U 99,Organizzazioni ed organismi extraterritoriali               ,0,0,0,0,0,2024
TOS,PT,XX  ,Imprese non classificate                                    ,12,17,1,4,34,2024
TOS,PT,TOT ,TOTALE                                                      ,72,111,36,56,275,2024
TOS,FI,A   ,"Agricoltura, silvicoltura pesca                             ",3,0,2,7,12,2024
TOS,FI,A 01,"Coltivazioni agricole e produzione di prodotti animali, c...",3,0,2,7,12,2024
TOS,FI,A 02,Silvicoltura ed utilizzo di aree forestali                  ,0,0,0,0,0,2024
TOS,FI,A 03,Pesca e acquacoltura                                        ,0,0,0,0,0,2024
TOS,FI,B   ,Estrazione di minerali da cave e miniere                    ,1,0,0,0,1,2024
TOS,FI,B 05,Estrazione di carbone (esclusa torba)                       ,0,0,0,0,0,2024
TOS,FI,B 06,Estraz.di petrolio greggio e di gas naturale                ,0,0,0,0,0,2024
TOS,FI,B 07,Estrazione di minerali metalliferi                          ,0,0,0,0,0,2024
TOS,FI,B 08,Altre attività di estrazione di minerali da cave e miniere  ,1,0,0,0,1,2024
TOS,FI,B 09,Attività dei servizi di supporto all'estrazione             ,0,0,0,0,0,2024
TOS,FI,C   ,Attività manifatturiere                                     ,17,2,7,9,35,2024
TOS,FI,C 10,Industrie alimentari                                        ,2,0,0,1,3,2024
TOS,FI,C 11,Industria delle bevande                                     ,0,0,0,0,0,2024
TOS,FI,C 12,Industria del tabacco                                       ,0,0,0,0,0,2024
TOS,FI,C 13,Industrie tessili                                           ,2,0,0,0,2,2024
TOS,FI,C 14,Confezione di articoli di abbigliamento; confezione di ar...,2,0,0,1,3,2024
TOS,FI,C 15,Fabbricazione di articoli in pelle e simili                 ,2,1,3,1,7,2024
TOS,FI,C 16,Industria del legno e dei prodotti in legno e sughero (es...,0,0,0,0,0,2024
TOS,FI,C 17,Fabbricazione di carta e di prodotti di carta               ,0,1,0,0,1,2024
TOS,FI,C 18,Stampa e riproduzione di supporti registrati                ,1,0,0,2,3,2024
TOS,FI,C 19,Fabbricazione di coke e prodotti derivanti dalla raffinaz...,0,0,0,0,0,2024
TOS,FI,C 20,Fabbricazione di prodotti chimici                           ,2,0,0,0,2,2024
TOS,FI,C 21,Fabbricazione di prodotti farmaceutici di base e di prepa...,0,0,1,0,1,2024
TOS,FI,C 22,Fabbricazione di articoli in gomma e materie plastiche      ,0,0,0,0,0,2024
TOS,FI,C 23,Fabbricazione di altri prodotti della lavorazione di miner..,2,0,1,1,4,2024
TOS,FI,C 24,Metallurgia                                                 ,0,0,0,0,0,2024
TOS,FI,C 25,Fabbricazione di prodotti in metallo (esclusi macchinari ...,2,0,1,1,4,2024
TOS,FI,C 26,Fabbricazione di computer e prodotti di elettronica e ott...,0,0,0,1,1,2024
TOS,FI,C 27,Fabbricazione di apparecchiature elettriche ed apparecchi...,1,0,0,0,1,2024
TOS,FI,C 28,Fabbricazione di macchinari ed apparecchiature nca          ,0,0,1,1,2,2024
TOS,FI,C 29,"Fabbricazione di autoveicoli, rimorchi e semirimorchi       ",0,0,0,0,0,2024
TOS,FI,C 30,Fabbricazione di altri mezzi di trasporto                   ,0,0,0,0,0,2024
TOS,FI,C 31,Fabbricazione di mobili                                     ,0,0,0,0,0,2024
TOS,FI,C 32,Altre industrie manifatturiere                              ,1,0,0,0,1,2024
TOS,FI,C 33,"Riparazione, manutenzione ed installazione di macchine ed...",0,0,0,0,0,2024
TOS,FI,D   ,"Fornitura di energia elettrica, gas, vapore e aria condiz...",0,0,0,0,0,2024
TOS,FI,D 35,"Fornitura di energia elettrica, gas, vapore e aria condiz...",0,0,0,0,0,2024
TOS,FI,E   ,"Fornitura di acqua; reti fognarie, attività di gestione d...",0,0,0,0,0,2024
TOS,FI,E 36,"Raccolta, trattamento e fornitura di acqua                  ",0,0,0,0,0,2024
TOS,FI,E 37,Gestione delle reti fognarie                                ,0,0,0,0,0,2024
TOS,FI,E 38,"Attività di raccolta, trattamento e smaltimento dei rifiu...",0,0,0,0,0,2024
TOS,FI,E 39,Attività di risanamento e altri servizi di gestione dei r...,0,0,0,0,0,2024
TOS,FI,F   ,Costruzioni                                                 ,25,0,3,48,76,2024
TOS,FI,F 41,Costruzione di edifici                                      ,15,0,0,31,46,2024
TOS,FI,F 42,Ingegneria civile                                           ,0,0,0,0,0,2024
TOS,FI,F 43,Lavori di costruzione specializzati                         ,10,0,3,17,30,2024
TOS,FI,G   ,Commercio all'ingrosso e al dettaglio; riparazione di aut...,37,5,7,13,62,2024
TOS,FI,G 45,Commercio all'ingrosso e al dettaglio e riparazione di au...,4,0,0,1,5,2024
TOS,FI,G 46,Commercio all'ingrosso (escluso quello di autoveicoli e d...,18,2,1,3,24,2024
TOS,FI,G 47,Commercio al dettaglio (escluso quello di autoveicoli e d...,15,3,6,9,33,2024
TOS,FI,H   ,Trasporto e magazzinaggio                                   ,2,0,0,56,58,2024
TOS,FI,H 49,Trasporto terrestre e mediante condotte                     ,1,0,0,11,12,2024
TOS,FI,H 50,Trasporto marittimo e per vie d'acqua                       ,0,0,0,0,0,2024
TOS,FI,H 51,Trasporto aereo                                             ,0,0,0,0,0,2024
TOS,FI,H 52,Magazzinaggio e attività di supporto ai trasporti           ,1,0,0,44,45,2024
TOS,FI,H 53,Servizi postali e attività di corriere                      ,0,0,0,1,1,2024
TOS,FI,I   ,Attività dei servizi alloggio e ristorazione                ,27,2,0,4,33,2024
TOS,FI,I 55,Alloggio                                                    ,2,0,0,1,3,2024
TOS,FI,I 56,Attività dei servizi di ristorazione                        ,25,2,0,3,30,2024
TOS,FI,J   ,Servizi di informazione e comunicazione                     ,6,0,0,6,12,2024
TOS,FI,J 58,Attività editoriali                                         ,1,0,0,1,2,2024
TOS,FI,J 59,"Attività di produzione cinematografica, di video e di pro...",0,0,0,1,1,2024
TOS,FI,J 60,Attività di programmazione e trasmissione                   ,0,0,0,0,0,2024
TOS,FI,J 61,Telecomunicazioni                                           ,0,0,0,0,0,2024
TOS,FI,J 62,"Produzione di software, consulenza informatica e attività...",1,0,0,2,3,2024
TOS,FI,J 63,Attività dei servizi d'informazione e altri servizi infor...,4,0,0,2,6,2024
TOS,FI,K   ,Attività finanziarie e assicurative                         ,5,0,0,1,6,2024
TOS,FI,K 64,Attività di servizi finanziari (escluse le assicurazioni ...,1,0,0,0,1,2024
TOS,FI,K 65,"Assicurazioni, riassicurazioni e fondi pensione (escluse ...",0,0,0,0,0,2024
TOS,FI,K 66,Attività ausiliarie dei servizi finanziari e delle attivi...,4,0,0,1,5,2024
TOS,FI,L   ,Attivita' immobiliari                                       ,19,1,0,26,46,2024
TOS,FI,L 68,Attivita' immobiliari                                       ,19,1,0,26,46,2024
TOS,FI,M   ,"Attività professionali, scientifiche e tecniche             ",10,1,1,5,17,2024
TOS,FI,M 69,Attività legali e contabilità                               ,2,0,0,0,2,2024
TOS,FI,M 70,Attività di direzione aziendale e di consulenza gestional...,3,1,1,3,8,2024
TOS,FI,M 71,Attività degli studi di architettura e d'ingegneria; coll...,0,0,0,0,0,2024
TOS,FI,M 72,Ricerca scientifica e sviluppo                              ,1,0,0,0,1,2024
TOS,FI,M 73,Pubblicità e ricerche di mercato                            ,3,0,0,1,4,2024
TOS,FI,M 74,"Altre attività professionali, scientifiche e tecniche       ",1,0,0,1,2,2024
TOS,FI,M 75,Servizi veterinari                                          ,0,0,0,0,0,2024
TOS,FI,N   ,"Noleggio, agenzie di viaggio, servizi di supporto alle im...",13,0,1,27,41,2024
TOS,FI,N 77,Attività di noleggio e leasing operativo                    ,1,0,0,0,1,2024
TOS,FI,N 78,"Attività di ricerca, selezione, fornitura di personale      ",0,0,0,0,0,2024
TOS,FI,N 79,"Attività dei servizi delle agenzie di viaggio, dei tour o...",4,0,0,1,5,2024
TOS,FI,N 80,Servizi di vigilanza e investigazione                       ,0,0,0,0,0,2024
TOS,FI,N 81,Attività di servizi per edifici e paesaggio                 ,3,0,0,20,23,2024
TOS,FI,N 82,Attività di supporto per le funzioni d'ufficio e altri se...,5,0,1,6,12,2024
TOS,FI,O   ,Amministrazione pubblica e difesa; assicurazione sociale ...,0,0,0,1,1,2024
TOS,FI,O 84,Amministrazione pubblica e difesa; assicurazione sociale ...,0,0,0,1,1,2024
TOS,FI,P   ,Istruzione                                                  ,2,0,0,2,4,2024
TOS,FI,P 85,Istruzione                                                  ,2,0,0,2,4,2024
TOS,FI,Q   ,Sanita' e assistenza sociale                                ,1,0,0,5,6,2024
TOS,FI,Q 86,Assistenza sanitaria                                        ,1,0,0,2,3,2024
TOS,FI,Q 87,Servizi di assistenza sociale residenziale                  ,0,0,0,1,1,2024
TOS,FI,Q 88,Assistenza sociale non residenziale                         ,0,0,0,2,2,2024
TOS,FI,R   ,"Attività artistiche, sportive, di intrattenimento e diver...",1,0,0,3,4,2024
TOS,FI,R 90,"Attività creative, artistiche e di intrattenimento          ",1,0,0,2,3,2024
TOS,FI,R 91,"Attività di biblioteche, archivi, musei ed altre attività...",0,0,0,0,0,2024
TOS,FI,R 92,"Attività riguardanti le lotterie, le scommesse, le case d...",0,0,0,0,0,2024
TOS,FI,R 93,"Attività sportive, di intrattenimento e di divertimento     ",0,0,0,1,1,2024
TOS,FI,S   ,Altre attività di servizi                                   ,4,0,1,3,8,2024
TOS,FI,S 94,Attività di organizzazioni associative                      ,0,0,0,0,0,2024
TOS,FI,S 95,Riparazione di computer e di beni per uso personale e per...,1,0,0,0,1,2024
TOS,FI,S 96,Altre attività di servizi per la persona                    ,3,0,1,3,7,2024
TOS,FI,T   ,Attività di famiglie e convivenze come datori di lavoro p...,0,0,0,0,0,2024
TOS,FI,T 97,Attività di famiglie e convivenze come datori di lavoro p...,0,0,0,0,0,2024
TOS,FI,T 98,Produzione di beni e servizi indifferenziati per uso prop...,0,0,0,0,0,2024
TOS,FI,U   ,Organizzazioni ed organismi extraterritoriali               ,0,0,0,0,0,2024
TOS,FI,U 99,Organizzazioni ed organismi extraterritoriali               ,0,0,0,0,0,2024
TOS,FI,XX  ,Imprese non classificate                                    ,31,0,0,293,324,2024
TOS,FI,TOT ,TOTALE                                                      ,204,11,22,509,746,2024
TOS,LI,A   ,"Agricoltura, silvicoltura pesca                             ",0,1,1,4,6,2024
TOS,LI,A 01,"Coltivazioni agricole e produzione di prodotti animali, c...",0,1,0,1,2,2024
TOS,LI,A 02,Silvicoltura ed utilizzo di aree forestali                  ,0,0,0,1,1,2024
TOS,LI,A 03,Pesca e acquacoltura                                        ,0,0,1,2,3,2024
TOS,LI,B   ,Estrazione di minerali da cave e miniere                    ,0,0,0,0,0,2024
TOS,LI,B 05,Estrazione di carbone (esclusa torba)                       ,0,0,0,0,0,2024
TOS,LI,B 06,Estraz.di petrolio greggio e di gas naturale                ,0,0,0,0,0,2024
TOS,LI,B 07,Estrazione di minerali metalliferi                          ,0,0,0,0,0,2024
TOS,LI,B 08,Altre attività di estrazione di minerali da cave e miniere  ,0,0,0,0,0,2024
TOS,LI,B 09,Attività dei servizi di supporto all'estrazione             ,0,0,0,0,0,2024
TOS,LI,C   ,Attività manifatturiere                                     ,0,2,7,3,12,2024
TOS,LI,C 10,Industrie alimentari                                        ,0,0,0,1,1,2024
TOS,LI,C 11,Industria delle bevande                                     ,0,0,0,0,0,2024
TOS,LI,C 12,Industria del tabacco                                       ,0,0,0,0,0,2024
TOS,LI,C 13,Industrie tessili                                           ,0,0,0,0,0,2024
TOS,LI,C 14,Confezione di articoli di abbigliamento; confezione di ar...,0,0,0,0,0,2024
TOS,LI,C 15,Fabbricazione di articoli in pelle e simili                 ,0,0,0,0,0,2024
TOS,LI,C 16,Industria del legno e dei prodotti in legno e sughero (es...,0,0,2,0,2,2024
TOS,LI,C 17,Fabbricazione di carta e di prodotti di carta               ,0,0,0,0,0,2024
TOS,LI,C 18,Stampa e riproduzione di supporti registrati                ,0,0,1,0,1,2024
TOS,LI,C 19,Fabbricazione di coke e prodotti derivanti dalla raffinaz...,0,0,0,0,0,2024
TOS,LI,C 20,Fabbricazione di prodotti chimici                           ,0,0,0,0,0,2024
TOS,LI,C 21,Fabbricazione di prodotti farmaceutici di base e di prepa...,0,0,0,0,0,2024
TOS,LI,C 22,Fabbricazione di articoli in gomma e materie plastiche      ,0,1,0,0,1,2024
TOS,LI,C 23,Fabbricazione di altri prodotti della lavorazione di miner..,0,0,0,0,0,2024
TOS,LI,C 24,Metallurgia                                                 ,0,0,0,0,0,2024
TOS,LI,C 25,Fabbricazione di prodotti in metallo (esclusi macchinari ...,0,1,2,1,4,2024
TOS,LI,C 26,Fabbricazione di computer e prodotti di elettronica e ott...,0,0,0,0,0,2024
TOS,LI,C 27,Fabbricazione di apparecchiature elettriche ed apparecchi...,0,0,0,0,0,2024
TOS,LI,C 28,Fabbricazione di macchinari ed apparecchiature nca          ,0,0,0,0,0,2024
TOS,LI,C 29,"Fabbricazione di autoveicoli, rimorchi e semirimorchi       ",0,0,0,0,0,2024
TOS,LI,C 30,Fabbricazione di altri mezzi di trasporto                   ,0,0,0,1,1,2024
TOS,LI,C 31,Fabbricazione di mobili                                     ,0,0,0,0,0,2024
TOS,LI,C 32,Altre industrie manifatturiere                              ,0,0,1,0,1,2024
TOS,LI,C 33,"Riparazione, manutenzione ed installazione di macchine ed...",0,0,1,0,1,2024
TOS,LI,D   ,"Fornitura di energia elettrica, gas, vapore e aria condiz...",0,0,0,0,0,2024
TOS,LI,D 35,"Fornitura di energia elettrica, gas, vapore e aria condiz...",0,0,0,0,0,2024
TOS,LI,E   ,"Fornitura di acqua; reti fognarie, attività di gestione d...",0,0,0,1,1,2024
TOS,LI,E 36,"Raccolta, trattamento e fornitura di acqua                  ",0,0,0,0,0,2024
TOS,LI,E 37,Gestione delle reti fognarie                                ,0,0,0,0,0,2024
TOS,LI,E 38,"Attività di raccolta, trattamento e smaltimento dei rifiu...",0,0,0,0,0,2024
TOS,LI,E 39,Attività di risanamento e altri servizi di gestione dei r...,0,0,0,1,1,2024
TOS,LI,F   ,Costruzioni                                                 ,0,0,5,7,12,2024
TOS,LI,F 41,Costruzione di edifici                                      ,0,0,0,6,6,2024
TOS,LI,F 42,Ingegneria civile                                           ,0,0,0,0,0,2024
TOS,LI,F 43,Lavori di costruzione specializzati                         ,0,0,5,1,6,2024
TOS,LI,G   ,Commercio all'ingrosso e al dettaglio; riparazione di aut...,0,0,13,4,17,2024
TOS,LI,G 45,Commercio all'ingrosso e al dettaglio e riparazione di au...,0,0,2,0,2,2024
TOS,LI,G 46,Commercio all'ingrosso (escluso quello di autoveicoli e d...,0,0,5,2,7,2024
TOS,LI,G 47,Commercio al dettaglio (escluso quello di autoveicoli e d...,0,0,6,2,8,2024
TOS,LI,H   ,Trasporto e magazzinaggio                                   ,0,1,2,17,20,2024
TOS,LI,H 49,Trasporto terrestre e mediante condotte                     ,0,1,1,5,7,2024
TOS,LI,H 50,Trasporto marittimo e per vie d'acqua                       ,0,0,0,0,0,2024
TOS,LI,H 51,Trasporto aereo                                             ,0,0,0,0,0,2024
TOS,LI,H 52,Magazzinaggio e attività di supporto ai trasporti           ,0,0,1,11,12,2024
TOS,LI,H 53,Servizi postali e attività di corriere                      ,0,0,0,1,1,2024
TOS,LI,I   ,Attività dei servizi alloggio e ristorazione                ,0,4,4,1,9,2024
TOS,LI,I 55,Alloggio                                                    ,0,0,2,0,2,2024
TOS,LI,I 56,Attività dei servizi di ristorazione                        ,0,4,2,1,7,2024
TOS,LI,J   ,Servizi di informazione e comunicazione                     ,0,0,1,0,1,2024
TOS,LI,J 58,Attività editoriali                                         ,0,0,0,0,0,2024
TOS,LI,J 59,"Attività di produzione cinematografica, di video e di pro...",0,0,0,0,0,2024
TOS,LI,J 60,Attività di programmazione e trasmissione                   ,0,0,0,0,0,2024
TOS,LI,J 61,Telecomunicazioni                                           ,0,0,1,0,1,2024
TOS,LI,J 62,"Produzione di software, consulenza informatica e attività...",0,0,0,0,0,2024
TOS,LI,J 63,Attività dei servizi d'informazione e altri servizi infor...,0,0,0,0,0,2024
TOS,LI,K   ,Attività finanziarie e assicurative                         ,0,2,0,0,2,2024
TOS,LI,K 64,Attività di servizi finanziari (escluse le assicurazioni ...,0,0,0,0,0,2024
TOS,LI,K 65,"Assicurazioni, riassicurazioni e fondi pensione (escluse ...",0,0,0,0,0,2024
TOS,LI,K 66,Attività ausiliarie dei servizi finanziari e delle attivi...,0,2,0,0,2,2024
TOS,LI,L   ,Attivita' immobiliari                                       ,0,0,0,0,0,2024
TOS,LI,L 68,Attivita' immobiliari                                       ,0,0,0,0,0,2024
TOS,LI,M   ,"Attività professionali, scientifiche e tecniche             ",0,0,0,0,0,2024
TOS,LI,M 69,Attività legali e contabilità                               ,0,0,0,0,0,2024
TOS,LI,M 70,Attività di direzione aziendale e di consulenza gestional...,0,0,0,0,0,2024
TOS,LI,M 71,Attività degli studi di architettura e d'ingegneria; coll...,0,0,0,0,0,2024
TOS,LI,M 72,Ricerca scientifica e sviluppo                              ,0,0,0,0,0,2024
TOS,LI,M 73,Pubblicità e ricerche di mercato                            ,0,0,0,0,0,2024
TOS,LI,M 74,"Altre attività professionali, scientifiche e tecniche       ",0,0,0,0,0,2024
TOS,LI,M 75,Servizi veterinari                                          ,0,0,0,0,0,2024
TOS,LI,N   ,"Noleggio, agenzie di viaggio, servizi di supporto alle im...",0,1,0,11,12,2024
TOS,LI,N 77,Attività di noleggio e leasing operativo                    ,0,0,0,0,0,2024
TOS,LI,N 78,"Attività di ricerca, selezione, fornitura di personale      ",0,0,0,0,0,2024
TOS,LI,N 79,"Attività dei servizi delle agenzie di viaggio, dei tour o...",0,0,0,0,0,2024
TOS,LI,N 80,Servizi di vigilanza e investigazione                       ,0,0,0,1,1,2024
TOS,LI,N 81,Attività di servizi per edifici e paesaggio                 ,0,1,0,10,11,2024
TOS,LI,N 82,Attività di supporto per le funzioni d'ufficio e altri se...,0,0,0,0,0,2024
TOS,LI,O   ,Amministrazione pubblica e difesa; assicurazione sociale ...,0,0,0,0,0,2024
TOS,LI,O 84,Amministrazione pubblica e difesa; assicurazione sociale ...,0,0,0,0,0,2024
TOS,LI,P   ,Istruzione                                                  ,0,0,0,0,0,2024
TOS,LI,P 85,Istruzione                                                  ,0,0,0,0,0,2024
TOS,LI,Q   ,Sanita' e assistenza sociale                                ,0,0,0,6,6,2024
TOS,LI,Q 86,Assistenza sanitaria                                        ,0,0,0,0,0,2024
TOS,LI,Q 87,Servizi di assistenza sociale residenziale                  ,0,0,0,2,2,2024
TOS,LI,Q 88,Assistenza sociale non residenziale                         ,0,0,0,4,4,2024
TOS,LI,R   ,"Attività artistiche, sportive, di intrattenimento e diver...",0,0,0,3,3,2024
TOS,LI,R 90,"Attività creative, artistiche e di intrattenimento          ",0,0,0,2,2,2024
TOS,LI,R 91,"Attività di biblioteche, archivi, musei ed altre attività...",0,0,0,0,0,2024
TOS,LI,R 92,"Attività riguardanti le lotterie, le scommesse, le case d...",0,0,0,0,0,2024
TOS,LI,R 93,"Attività sportive, di intrattenimento e di divertimento     ",0,0,0,1,1,2024
TOS,LI,S   ,Altre attività di servizi                                   ,0,1,2,1,4,2024
TOS,LI,S 94,Attività di organizzazioni associative                      ,0,0,0,0,0,2024
TOS,LI,S 95,Riparazione di computer e di beni per uso personale e per...,0,0,0,0,0,2024
TOS,LI,S 96,Altre attività di servizi per la persona                    ,0,1,2,1,4,2024
TOS,LI,T   ,Attività di famiglie e convivenze come datori di lavoro p...,0,0,0,0,0,2024
TOS,LI,T 97,Attività di famiglie e convivenze come datori di lavoro p...,0,0,0,0,0,2024
TOS,LI,T 98,Produzione di beni e servizi indifferenziati per uso prop...,0,0,0,0,0,2024
TOS,LI,U   ,Organizzazioni ed organismi extraterritoriali               ,0,0,0,0,0,2024
TOS,LI,U 99,Organizzazioni ed organismi extraterritoriali               ,0,0,0,0,0,2024
TOS,LI,XX  ,Imprese non classificate                                    ,0,2,1,11,14,2024
TOS,LI,TOT ,TOTALE                                                      ,0,14,36,69,119,2024
TOS,PI,A   ,"Agricoltura, silvicoltura pesca                             ",3,0,15,7,25,2024
TOS,PI,A 01,"Coltivazioni agricole e produzione di prodotti animali, c...",3,0,13,7,23,2024
TOS,PI,A 02,Silvicoltura ed utilizzo di aree forestali                  ,0,0,2,0,2,2024
TOS,PI,A 03,Pesca e acquacoltura                                        ,0,0,0,0,0,2024
TOS,PI,B   ,Estrazione di minerali da cave e miniere                    ,1,1,0,0,2,2024
TOS,PI,B 05,Estrazione di carbone (esclusa torba)                       ,0,0,0,0,0,2024
TOS,PI,B 06,Estraz.di petrolio greggio e di gas naturale                ,0,0,0,0,0,2024
TOS,PI,B 07,Estrazione di minerali metalliferi                          ,0,0,0,0,0,2024
TOS,PI,B 08,Altre attività di estrazione di minerali da cave e miniere  ,1,1,0,0,2,2024
TOS,PI,B 09,Attività dei servizi di supporto all'estrazione             ,0,0,0,0,0,2024
TOS,PI,C   ,Attività manifatturiere                                     ,62,10,27,4,103,2024
TOS,PI,C 10,Industrie alimentari                                        ,0,0,3,2,5,2024
TOS,PI,C 11,Industria delle bevande                                     ,1,0,0,0,1,2024
TOS,PI,C 12,Industria del tabacco                                       ,0,0,0,0,0,2024
TOS,PI,C 13,Industrie tessili                                           ,1,0,1,0,2,2024
TOS,PI,C 14,Confezione di articoli di abbigliamento; confezione di ar...,7,0,2,0,9,2024
TOS,PI,C 15,Fabbricazione di articoli in pelle e simili                 ,29,4,6,0,39,2024
TOS,PI,C 16,Industria del legno e dei prodotti in legno e sughero (es...,0,1,5,1,7,2024
TOS,PI,C 17,Fabbricazione di carta e di prodotti di carta               ,1,0,0,0,1,2024
TOS,PI,C 18,Stampa e riproduzione di supporti registrati                ,0,0,0,0,0,2024
TOS,PI,C 19,Fabbricazione di coke e prodotti derivanti dalla raffinaz...,0,0,0,0,0,2024
TOS,PI,C 20,Fabbricazione di prodotti chimici                           ,2,0,0,0,2,2024
TOS,PI,C 21,Fabbricazione di prodotti farmaceutici di base e di prepa...,0,0,0,0,0,2024
TOS,PI,C 22,Fabbricazione di articoli in gomma e materie plastiche      ,2,0,0,0,2,2024
TOS,PI,C 23,Fabbricazione di altri prodotti della lavorazione di miner..,2,1,1,0,4,2024
TOS,PI,C 24,Metallurgia                                                 ,0,0,0,0,0,2024
TOS,PI,C 25,Fabbricazione di prodotti in metallo (esclusi macchinari ...,1,0,1,0,2,2024
TOS,PI,C 26,Fabbricazione di computer e prodotti di elettronica e ott...,1,0,1,0,2,2024
TOS,PI,C 27,Fabbricazione di apparecchiature elettriche ed apparecchi...,1,0,1,0,2,2024
TOS,PI,C 28,Fabbricazione di macchinari ed apparecchiature nca          ,2,1,1,0,4,2024
TOS,PI,C 29,"Fabbricazione di autoveicoli, rimorchi e semirimorchi       ",1,0,0,0,1,2024
TOS,PI,C 30,Fabbricazione di altri mezzi di trasporto                   ,1,0,1,0,2,2024
TOS,PI,C 31,Fabbricazione di mobili                                     ,10,2,1,1,14,2024
TOS,PI,C 32,Altre industrie manifatturiere                              ,0,1,1,0,2,2024
TOS,PI,C 33,"Riparazione, manutenzione ed installazione di macchine ed...",0,0,2,0,2,2024
TOS,PI,D   ,"Fornitura di energia elettrica, gas, vapore e aria condiz...",0,0,0,0,0,2024
TOS,PI,D 35,"Fornitura di energia elettrica, gas, vapore e aria condiz...",0,0,0,0,0,2024
TOS,PI,E   ,"Fornitura di acqua; reti fognarie, attività di gestione d...",1,0,2,0,3,2024
TOS,PI,E 36,"Raccolta, trattamento e fornitura di acqua                  ",0,0,0,0,0,2024
TOS,PI,E 37,Gestione delle reti fognarie                                ,1,0,0,0,1,2024
TOS,PI,E 38,"Attività di raccolta, trattamento e smaltimento dei rifiu...",0,0,2,0,2,2024
TOS,PI,E 39,Attività di risanamento e altri servizi di gestione dei r...,0,0,0,0,0,2024
TOS,PI,F   ,Costruzioni                                                 ,42,3,131,24,200,2024
TOS,PI,F 41,Costruzione di edifici                                      ,29,2,38,19,88,2024
TOS,PI,F 42,Ingegneria civile                                           ,3,0,0,0,3,2024
TOS,PI,F 43,Lavori di costruzione specializzati                         ,10,1,93,5,109,2024
TOS,PI,G   ,Commercio all'ingrosso e al dettaglio; riparazione di aut...,96,1,186,15,298,2024
TOS,PI,G 45,Commercio all'ingrosso e al dettaglio e riparazione di au...,8,0,16,0,24,2024
TOS,PI,G 46,Commercio all'ingrosso (escluso quello di autoveicoli e d...,65,1,35,11,112,2024
TOS,PI,G 47,Commercio al dettaglio (escluso quello di autoveicoli e d...,23,0,135,4,162,2024
TOS,PI,H   ,Trasporto e magazzinaggio                                   ,4,1,6,5,16,2024
TOS,PI,H 49,Trasporto terrestre e mediante condotte                     ,0,1,5,2,8,2024
TOS,PI,H 50,Trasporto marittimo e per vie d'acqua                       ,0,0,0,0,0,2024
TOS,PI,H 51,Trasporto aereo                                             ,1,0,0,0,1,2024
TOS,PI,H 52,Magazzinaggio e attività di supporto ai trasporti           ,3,0,1,3,7,2024
TOS,PI,H 53,Servizi postali e attività di corriere                      ,0,0,0,0,0,2024
TOS,PI,I   ,Attività dei servizi alloggio e ristorazione                ,24,2,35,4,65,2024
TOS,PI,I 55,Alloggio                                                    ,2,0,1,1,4,2024
TOS,PI,I 56,Attività dei servizi di ristorazione                        ,22,2,34,3,61,2024
TOS,PI,J   ,Servizi di informazione e comunicazione                     ,8,0,5,3,16,2024
TOS,PI,J 58,Attività editoriali                                         ,0,0,0,0,0,2024
TOS,PI,J 59,"Attività di produzione cinematografica, di video e di pro...",1,0,0,0,1,2024
TOS,PI,J 60,Attività di programmazione e trasmissione                   ,1,0,0,0,1,2024
TOS,PI,J 61,Telecomunicazioni                                           ,0,0,3,0,3,2024
TOS,PI,J 62,"Produzione di software, consulenza informatica e attività...",2,0,2,1,5,2024
TOS,PI,J 63,Attività dei servizi d'informazione e altri servizi infor...,4,0,0,2,6,2024
TOS,PI,K   ,Attività finanziarie e assicurative                         ,2,0,3,1,6,2024
TOS,PI,K 64,Attività di servizi finanziari (escluse le assicurazioni ...,1,0,0,0,1,2024
TOS,PI,K 65,"Assicurazioni, riassicurazioni e fondi pensione (escluse ...",0,0,0,0,0,2024
TOS,PI,K 66,Attività ausiliarie dei servizi finanziari e delle attivi...,1,0,3,1,5,2024
TOS,PI,L   ,Attivita' immobiliari                                       ,28,0,4,1,33,2024
TOS,PI,L 68,Attivita' immobiliari                                       ,28,0,4,1,33,2024
TOS,PI,M   ,"Attività professionali, scientifiche e tecniche             ",20,0,7,8,35,2024
TOS,PI,M 69,Attività legali e contabilità                               ,1,0,0,0,1,2024
TOS,PI,M 70,Attività di direzione aziendale e di consulenza gestional...,3,0,1,3,7,2024
TOS,PI,M 71,Attività degli studi di architettura e d'ingegneria; coll...,1,0,0,4,5,2024
TOS,PI,M 72,Ricerca scientifica e sviluppo                              ,1,0,0,0,1,2024
TOS,PI,M 73,Pubblicità e ricerche di mercato                            ,10,0,2,1,13,2024
TOS,PI,M 74,"Altre attività professionali, scientifiche e tecniche       ",4,0,4,0,8,2024
TOS,PI,M 75,Servizi veterinari                                          ,0,0,0,0,0,2024
TOS,PI,N   ,"Noleggio, agenzie di viaggio, servizi di supporto alle im...",6,0,32,12,50,2024
TOS,PI,N 77,Attività di noleggio e leasing operativo                    ,2,0,3,1,6,2024
TOS,PI,N 78,"Attività di ricerca, selezione, fornitura di personale      ",1,0,0,0,1,2024
TOS,PI,N 79,"Attività dei servizi delle agenzie di viaggio, dei tour o...",2,0,0,0,2,2024
TOS,PI,N 80,Servizi di vigilanza e investigazione                       ,0,0,0,0,0,2024
TOS,PI,N 81,Attività di servizi per edifici e paesaggio                 ,0,0,11,6,17,2024
TOS,PI,N 82,Attività di supporto per le funzioni d'ufficio e altri se...,1,0,18,5,24,2024
TOS,PI,O   ,Amministrazione pubblica e difesa; assicurazione sociale ...,0,0,0,0,0,2024
TOS,PI,O 84,Amministrazione pubblica e difesa; assicurazione sociale ...,0,0,0,0,0,2024
TOS,PI,P   ,Istruzione                                                  ,0,0,1,2,3,2024
TOS,PI,P 85,Istruzione                                                  ,0,0,1,2,3,2024
TOS,PI,Q   ,Sanita' e assistenza sociale                                ,0,0,0,2,2,2024
TOS,PI,Q 86,Assistenza sanitaria                                        ,0,0,0,0,0,2024
TOS,PI,Q 87,Servizi di assistenza sociale residenziale                  ,0,0,0,0,0,2024
TOS,PI,Q 88,Assistenza sociale non residenziale                         ,0,0,0,2,2,2024
TOS,PI,R   ,"Attività artistiche, sportive, di intrattenimento e diver...",6,1,5,2,14,2024
TOS,PI,R 90,"Attività creative, artistiche e di intrattenimento          ",0,1,1,0,2,2024
TOS,PI,R 91,"Attività di biblioteche, archivi, musei ed altre attività...",0,0,0,0,0,2024
TOS,PI,R 92,"Attività riguardanti le lotterie, le scommesse, le case d...",0,0,0,0,0,2024
TOS,PI,R 93,"Attività sportive, di intrattenimento e di divertimento     ",6,0,4,2,12,2024
TOS,PI,S   ,Altre attività di servizi                                   ,5,0,12,1,18,2024
TOS,PI,S 94,Attività di organizzazioni associative                      ,0,0,0,0,0,2024
TOS,PI,S 95,Riparazione di computer e di beni per uso personale e per...,1,0,1,0,2,2024
TOS,PI,S 96,Altre attività di servizi per la persona                    ,4,0,11,1,16,2024
TOS,PI,T   ,Attività di famiglie e convivenze come datori di lavoro p...,0,0,0,0,0,2024
TOS,PI,T 97,Attività di famiglie e convivenze come datori di lavoro p...,0,0,0,0,0,2024
TOS,PI,T 98,Produzione di beni e servizi indifferenziati per uso prop...,0,0,0,0,0,2024
TOS,PI,U   ,Organizzazioni ed organismi extraterritoriali               ,0,0,0,0,0,2024
TOS,PI,U 99,Organizzazioni ed organismi extraterritoriali               ,0,0,0,0,0,2024
TOS,PI,XX  ,Imprese non classificate                                    ,116,0,60,31,207,2024
TOS,PI,TOT ,TOTALE                                                      ,424,19,531,122,1096,2024
TOS,AR,A   ,"Agricoltura, silvicoltura pesca                             ",0,0,8,7,15,2024
TOS,AR,A 01,"Coltivazioni agricole e produzione di prodotti animali, c...",0,0,8,3,11,2024
TOS,AR,A 02,Silvicoltura ed utilizzo di aree forestali                  ,0,0,0,4,4,2024
TOS,AR,A 03,Pesca e acquacoltura                                        ,0,0,0,0,0,2024
TOS,AR,B   ,Estrazione di minerali da cave e miniere                    ,0,0,0,0,0,2024
TOS,AR,B 05,Estrazione di carbone (esclusa torba)                       ,0,0,0,0,0,2024
TOS,AR,B 06,Estraz.di petrolio greggio e di gas naturale                ,0,0,0,0,0,2024
TOS,AR,B 07,Estrazione di minerali metalliferi                          ,0,0,0,0,0,2024
TOS,AR,B 08,Altre attività di estrazione di minerali da cave e miniere  ,0,0,0,0,0,2024
TOS,AR,B 09,Attività dei servizi di supporto all'estrazione             ,0,0,0,0,0,2024
TOS,AR,C   ,Attività manifatturiere                                     ,4,1,1,1,7,2024
TOS,AR,C 10,Industrie alimentari                                        ,0,0,0,1,1,2024
TOS,AR,C 11,Industria delle bevande                                     ,0,0,0,0,0,2024
TOS,AR,C 12,Industria del tabacco                                       ,0,0,0,0,0,2024
TOS,AR,C 13,Industrie tessili                                           ,0,0,0,0,0,2024
TOS,AR,C 14,Confezione di articoli di abbigliamento; confezione di ar...,0,1,0,0,1,2024
TOS,AR,C 15,Fabbricazione di articoli in pelle e simili                 ,1,0,1,0,2,2024
TOS,AR,C 16,Industria del legno e dei prodotti in legno e sughero (es...,1,0,0,0,1,2024
TOS,AR,C 17,Fabbricazione di carta e di prodotti di carta               ,0,0,0,0,0,2024
TOS,AR,C 18,Stampa e riproduzione di supporti registrati                ,0,0,0,0,0,2024
TOS,AR,C 19,Fabbricazione di coke e prodotti derivanti dalla raffinaz...,0,0,0,0,0,2024
TOS,AR,C 20,Fabbricazione di prodotti chimici                           ,0,0,0,0,0,2024
TOS,AR,C 21,Fabbricazione di prodotti farmaceutici di base e di prepa...,0,0,0,0,0,2024
TOS,AR,C 22,Fabbricazione di articoli in gomma e materie plastiche      ,0,0,0,0,0,2024
TOS,AR,C 23,Fabbricazione di altri prodotti della lavorazione di miner..,0,0,0,0,0,2024
TOS,AR,C 24,Metallurgia                                                 ,0,0,0,0,0,2024
TOS,AR,C 25,Fabbricazione di prodotti in metallo (esclusi macchinari ...,2,0,0,0,2,2024
TOS,AR,C 26,Fabbricazione di computer e prodotti di elettronica e ott...,0,0,0,0,0,2024
TOS,AR,C 27,Fabbricazione di apparecchiature elettriche ed apparecchi...,0,0,0,0,0,2024
TOS,AR,C 28,Fabbricazione di macchinari ed apparecchiature nca          ,0,0,0,0,0,2024
TOS,AR,C 29,"Fabbricazione di autoveicoli, rimorchi e semirimorchi       ",0,0,0,0,0,2024
TOS,AR,C 30,Fabbricazione di altri mezzi di trasporto                   ,0,0,0,0,0,2024
TOS,AR,C 31,Fabbricazione di mobili                                     ,0,0,0,0,0,2024
TOS,AR,C 32,Altre industrie manifatturiere                              ,0,0,0,0,0,2024
TOS,AR,C 33,"Riparazione, manutenzione ed installazione di macchine ed...",0,0,0,0,0,2024
TOS,AR,D   ,"Fornitura di energia elettrica, gas, vapore e aria condiz...",0,0,0,0,0,2024
TOS,AR,D 35,"Fornitura di energia elettrica, gas, vapore e aria condiz...",0,0,0,0,0,2024
TOS,AR,E   ,"Fornitura di acqua; reti fognarie, attività di gestione d...",0,0,0,0,0,2024
TOS,AR,E 36,"Raccolta, trattamento e fornitura di acqua                  ",0,0,0,0,0,2024
TOS,AR,E 37,Gestione delle reti fognarie                                ,0,0,0,0,0,2024
TOS,AR,E 38,"Attività di raccolta, trattamento e smaltimento dei rifiu...",0,0,0,0,0,2024
TOS,AR,E 39,Attività di risanamento e altri servizi di gestione dei r...,0,0,0,0,0,2024
TOS,AR,F   ,Costruzioni                                                 ,8,4,3,14,29,2024
TOS,AR,F 41,Costruzione di edifici                                      ,4,3,2,10,19,2024
TOS,AR,F 42,Ingegneria civile                                           ,0,0,0,0,0,2024
TOS,AR,F 43,Lavori di costruzione specializzati                         ,4,1,1,4,10,2024
TOS,AR,G   ,Commercio all'ingrosso e al dettaglio; riparazione di aut...,10,1,6,1,18,2024
TOS,AR,G 45,Commercio all'ingrosso e al dettaglio e riparazione di au...,0,0,0,0,0,2024
TOS,AR,G 46,Commercio all'ingrosso (escluso quello di autoveicoli e d...,4,0,4,1,9,2024
TOS,AR,G 47,Commercio al dettaglio (escluso quello di autoveicoli e d...,6,1,2,0,9,2024
TOS,AR,H   ,Trasporto e magazzinaggio                                   ,0,1,0,4,5,2024
TOS,AR,H 49,Trasporto terrestre e mediante condotte                     ,0,1,0,2,3,2024
TOS,AR,H 50,Trasporto marittimo e per vie d'acqua                       ,0,0,0,0,0,2024
TOS,AR,H 51,Trasporto aereo                                             ,0,0,0,0,0,2024
TOS,AR,H 52,Magazzinaggio e attività di supporto ai trasporti           ,0,0,0,2,2,2024
TOS,AR,H 53,Servizi postali e attività di corriere                      ,0,0,0,0,0,2024
TOS,AR,I   ,Attività dei servizi alloggio e ristorazione                ,3,4,1,4,12,2024
TOS,AR,I 55,Alloggio                                                    ,0,0,1,0,1,2024
TOS,AR,I 56,Attività dei servizi di ristorazione                        ,3,4,0,4,11,2024
TOS,AR,J   ,Servizi di informazione e comunicazione                     ,4,0,0,0,4,2024
TOS,AR,J 58,Attività editoriali                                         ,2,0,0,0,2,2024
TOS,AR,J 59,"Attività di produzione cinematografica, di video e di pro...",0,0,0,0,0,2024
TOS,AR,J 60,Attività di programmazione e trasmissione                   ,0,0,0,0,0,2024
TOS,AR,J 61,Telecomunicazioni                                           ,0,0,0,0,0,2024
TOS,AR,J 62,"Produzione di software, consulenza informatica e attività...",0,0,0,0,0,2024
TOS,AR,J 63,Attività dei servizi d'informazione e altri servizi infor...,2,0,0,0,2,2024
TOS,AR,K   ,Attività finanziarie e assicurative                         ,1,0,0,0,1,2024
TOS,AR,K 64,Attività di servizi finanziari (escluse le assicurazioni ...,0,0,0,0,0,2024
TOS,AR,K 65,"Assicurazioni, riassicurazioni e fondi pensione (escluse ...",0,0,0,0,0,2024
TOS,AR,K 66,Attività ausiliarie dei servizi finanziari e delle attivi...,1,0,0,0,1,2024
TOS,AR,L   ,Attivita' immobiliari                                       ,4,2,0,3,9,2024
TOS,AR,L 68,Attivita' immobiliari                                       ,4,2,0,3,9,2024
TOS,AR,M   ,"Attività professionali, scientifiche e tecniche             ",1,0,0,2,3,2024
TOS,AR,M 69,Attività legali e contabilità                               ,0,0,0,0,0,2024
TOS,AR,M 70,Attività di direzione aziendale e di consulenza gestional...,1,0,0,0,1,2024
TOS,AR,M 71,Attività degli studi di architettura e d'ingegneria; coll...,0,0,0,0,0,2024
TOS,AR,M 72,Ricerca scientifica e sviluppo                              ,0,0,0,0,0,2024
TOS,AR,M 73,Pubblicità e ricerche di mercato                            ,0,0,0,1,1,2024
TOS,AR,M 74,"Altre attività professionali, scientifiche e tecniche       ",0,0,0,1,1,2024
TOS,AR,M 75,Servizi veterinari                                          ,0,0,0,0,0,2024
TOS,AR,N   ,"Noleggio, agenzie di viaggio, servizi di supporto alle im...",1,1,0,2,4,2024
TOS,AR,N 77,Attività di noleggio e leasing operativo                    ,0,0,0,0,0,2024
TOS,AR,N 78,"Attività di ricerca, selezione, fornitura di personale      ",0,0,0,0,0,2024
TOS,AR,N 79,"Attività dei servizi delle agenzie di viaggio, dei tour o...",0,0,0,0,0,2024
TOS,AR,N 80,Servizi di vigilanza e investigazione                       ,0,0,0,0,0,2024
TOS,AR,N 81,Attività di servizi per edifici e paesaggio                 ,0,1,0,2,3,2024
TOS,AR,N 82,Attività di supporto per le funzioni d'ufficio e altri se...,1,0,0,0,1,2024
TOS,AR,O   ,Amministrazione pubblica e difesa; assicurazione sociale ...,0,0,0,0,0,2024
TOS,AR,O 84,Amministrazione pubblica e difesa; assicurazione sociale ...,0,0,0,0,0,2024
TOS,AR,P   ,Istruzione                                                  ,0,0,0,2,2,2024
TOS,AR,P 85,Istruzione                                                  ,0,0,0,2,2,2024
TOS,AR,Q   ,Sanita' e assistenza sociale                                ,0,0,0,0,0,2024
TOS,AR,Q 86,Assistenza sanitaria                                        ,0,0,0,0,0,2024
TOS,AR,Q 87,Servizi di assistenza sociale residenziale                  ,0,0,0,0,0,2024
TOS,AR,Q 88,Assistenza sociale non residenziale                         ,0,0,0,0,0,2024
TOS,AR,R   ,"Attività artistiche, sportive, di intrattenimento e diver...",0,0,1,1,2,2024
TOS,AR,R 90,"Attività creative, artistiche e di intrattenimento          ",0,0,0,1,1,2024
TOS,AR,R 91,"Attività di biblioteche, archivi, musei ed altre attività...",0,0,0,0,0,2024
TOS,AR,R 92,"Attività riguardanti le lotterie, le scommesse, le case d...",0,0,0,0,0,2024
TOS,AR,R 93,"Attività sportive, di intrattenimento e di divertimento     ",0,0,1,0,1,2024
TOS,AR,S   ,Altre attività di servizi                                   ,1,0,2,1,4,2024
TOS,AR,S 94,Attività di organizzazioni associative                      ,0,0,0,1,1,2024
TOS,AR,S 95,Riparazione di computer e di beni per uso personale e per...,0,0,0,0,0,2024
TOS,AR,S 96,Altre attività di servizi per la persona                    ,1,0,2,0,3,2024
TOS,AR,T   ,Attività di famiglie e convivenze come datori di lavoro p...,0,0,0,0,0,2024
TOS,AR,T 97,Attività di famiglie e convivenze come datori di lavoro p...,0,0,0,0,0,2024
TOS,AR,T 98,Produzione di beni e servizi indifferenziati per uso prop...,0,0,0,0,0,2024
TOS,AR,U   ,Organizzazioni ed organismi extraterritoriali               ,0,0,0,0,0,2024
TOS,AR,U 99,Organizzazioni ed organismi extraterritoriali               ,0,0,0,0,0,2024
TOS,AR,XX  ,Imprese non classificate                                    ,3,0,0,3,6,2024
TOS,AR,TOT ,TOTALE                                                      ,40,14,22,45,121,2024
TOS,SI,A   ,"Agricoltura, silvicoltura pesca                             ",1,1,0,6,8,2024
TOS,SI,A 01,"Coltivazioni agricole e produzione di prodotti animali, c...",1,1,0,5,7,2024
TOS,SI,A 02,Silvicoltura ed utilizzo di aree forestali                  ,0,0,0,1,1,2024
TOS,SI,A 03,Pesca e acquacoltura                                        ,0,0,0,0,0,2024
TOS,SI,B   ,Estrazione di minerali da cave e miniere                    ,0,0,0,0,0,2024
TOS,SI,B 05,Estrazione di carbone (esclusa torba)                       ,0,0,0,0,0,2024
TOS,SI,B 06,Estraz.di petrolio greggio e di gas naturale                ,0,0,0,0,0,2024
TOS,SI,B 07,Estrazione di minerali metalliferi                          ,0,0,0,0,0,2024
TOS,SI,B 08,Altre attività di estrazione di minerali da cave e miniere  ,0,0,0,0,0,2024
TOS,SI,B 09,Attività dei servizi di supporto all'estrazione             ,0,0,0,0,0,2024
TOS,SI,C   ,Attività manifatturiere                                     ,5,0,0,5,10,2024
TOS,SI,C 10,Industrie alimentari                                        ,0,0,0,1,1,2024
TOS,SI,C 11,Industria delle bevande                                     ,0,0,0,0,0,2024
TOS,SI,C 12,Industria del tabacco                                       ,0,0,0,0,0,2024
TOS,SI,C 13,Industrie tessili                                           ,0,0,0,0,0,2024
TOS,SI,C 14,Confezione di articoli di abbigliamento; confezione di ar...,1,0,0,0,1,2024
TOS,SI,C 15,Fabbricazione di articoli in pelle e simili                 ,1,0,0,0,1,2024
TOS,SI,C 16,Industria del legno e dei prodotti in legno e sughero (es...,0,0,0,1,1,2024
TOS,SI,C 17,Fabbricazione di carta e di prodotti di carta               ,0,0,0,0,0,2024
TOS,SI,C 18,Stampa e riproduzione di supporti registrati                ,0,0,0,0,0,2024
TOS,SI,C 19,Fabbricazione di coke e prodotti derivanti dalla raffinaz...,0,0,0,0,0,2024
TOS,SI,C 20,Fabbricazione di prodotti chimici                           ,0,0,0,0,0,2024
TOS,SI,C 21,Fabbricazione di prodotti farmaceutici di base e di prepa...,0,0,0,0,0,2024
TOS,SI,C 22,Fabbricazione di articoli in gomma e materie plastiche      ,0,0,0,0,0,2024
TOS,SI,C 23,Fabbricazione di altri prodotti della lavorazione di miner..,1,0,0,0,1,2024
TOS,SI,C 24,Metallurgia                                                 ,0,0,0,0,0,2024
TOS,SI,C 25,Fabbricazione di prodotti in metallo (esclusi macchinari ...,1,0,0,1,2,2024
TOS,SI,C 26,Fabbricazione di computer e prodotti di elettronica e ott...,0,0,0,0,0,2024
TOS,SI,C 27,Fabbricazione di apparecchiature elettriche ed apparecchi...,0,0,0,0,0,2024
TOS,SI,C 28,Fabbricazione di macchinari ed apparecchiature nca          ,0,0,0,1,1,2024
TOS,SI,C 29,"Fabbricazione di autoveicoli, rimorchi e semirimorchi       ",0,0,0,0,0,2024
TOS,SI,C 30,Fabbricazione di altri mezzi di trasporto                   ,0,0,0,0,0,2024
TOS,SI,C 31,Fabbricazione di mobili                                     ,0,0,0,0,0,2024
TOS,SI,C 32,Altre industrie manifatturiere                              ,0,0,0,1,1,2024
TOS,SI,C 33,"Riparazione, manutenzione ed installazione di macchine ed...",1,0,0,0,1,2024
TOS,SI,D   ,"Fornitura di energia elettrica, gas, vapore e aria condiz...",0,0,0,0,0,2024
TOS,SI,D 35,"Fornitura di energia elettrica, gas, vapore e aria condiz...",0,0,0,0,0,2024
TOS,SI,E   ,"Fornitura di acqua; reti fognarie, attività di gestione d...",0,0,0,0,0,2024
TOS,SI,E 36,"Raccolta, trattamento e fornitura di acqua                  ",0,0,0,0,0,2024
TOS,SI,E 37,Gestione delle reti fognarie                                ,0,0,0,0,0,2024
TOS,SI,E 38,"Attività di raccolta, trattamento e smaltimento dei rifiu...",0,0,0,0,0,2024
TOS,SI,E 39,Attività di risanamento e altri servizi di gestione dei r...,0,0,0,0,0,2024
TOS,SI,F   ,Costruzioni                                                 ,11,0,2,5,18,2024
TOS,SI,F 41,Costruzione di edifici                                      ,6,0,0,2,8,2024
TOS,SI,F 42,Ingegneria civile                                           ,1,0,0,0,1,2024
TOS,SI,F 43,Lavori di costruzione specializzati                         ,4,0,2,3,9,2024
TOS,SI,G   ,Commercio all'ingrosso e al dettaglio; riparazione di aut...,17,0,0,2,19,2024
TOS,SI,G 45,Commercio all'ingrosso e al dettaglio e riparazione di au...,2,0,0,0,2,2024
TOS,SI,G 46,Commercio all'ingrosso (escluso quello di autoveicoli e d...,8,0,0,1,9,2024
TOS,SI,G 47,Commercio al dettaglio (escluso quello di autoveicoli e d...,7,0,0,1,8,2024
TOS,SI,H   ,Trasporto e magazzinaggio                                   ,0,0,0,1,1,2024
TOS,SI,H 49,Trasporto terrestre e mediante condotte                     ,0,0,0,1,1,2024
TOS,SI,H 50,Trasporto marittimo e per vie d'acqua                       ,0,0,0,0,0,2024
TOS,SI,H 51,Trasporto aereo                                             ,0,0,0,0,0,2024
TOS,SI,H 52,Magazzinaggio e attività di supporto ai trasporti           ,0,0,0,0,0,2024
TOS,SI,H 53,Servizi postali e attività di corriere                      ,0,0,0,0,0,2024
TOS,SI,I   ,Attività dei servizi alloggio e ristorazione                ,7,0,0,0,7,2024
TOS,SI,I 55,Alloggio                                                    ,1,0,0,0,1,2024
TOS,SI,I 56,Attività dei servizi di ristorazione                        ,6,0,0,0,6,2024
TOS,SI,J   ,Servizi di informazione e comunicazione                     ,1,0,0,1,2,2024
TOS,SI,J 58,Attività editoriali                                         ,1,0,0,1,2,2024
TOS,SI,J 59,"Attività di produzione cinematografica, di video e di pro...",0,0,0,0,0,2024
TOS,SI,J 60,Attività di programmazione e trasmissione                   ,0,0,0,0,0,2024
TOS,SI,J 61,Telecomunicazioni                                           ,0,0,0,0,0,2024
TOS,SI,J 62,"Produzione di software, consulenza informatica e attività...",0,0,0,0,0,2024
TOS,SI,J 63,Attività dei servizi d'informazione e altri servizi infor...,0,0,0,0,0,2024
TOS,SI,K   ,Attività finanziarie e assicurative                         ,0,0,0,0,0,2024
TOS,SI,K 64,Attività di servizi finanziari (escluse le assicurazioni ...,0,0,0,0,0,2024
TOS,SI,K 65,"Assicurazioni, riassicurazioni e fondi pensione (escluse ...",0,0,0,0,0,2024
TOS,SI,K 66,Attività ausiliarie dei servizi finanziari e delle attivi...,0,0,0,0,0,2024
TOS,SI,L   ,Attivita' immobiliari                                       ,4,0,1,0,5,2024
TOS,SI,L 68,Attivita' immobiliari                                       ,4,0,1,0,5,2024
TOS,SI,M   ,"Attività professionali, scientifiche e tecniche             ",1,0,0,1,2,2024
TOS,SI,M 69,Attività legali e contabilità                               ,0,0,0,0,0,2024
TOS,SI,M 70,Attività di direzione aziendale e di consulenza gestional...,0,0,0,1,1,2024
TOS,SI,M 71,Attività degli studi di architettura e d'ingegneria; coll...,0,0,0,0,0,2024
TOS,SI,M 72,Ricerca scientifica e sviluppo                              ,0,0,0,0,0,2024
TOS,SI,M 73,Pubblicità e ricerche di mercato                            ,1,0,0,0,1,2024
TOS,SI,M 74,"Altre attività professionali, scientifiche e tecniche       ",0,0,0,0,0,2024
TOS,SI,M 75,Servizi veterinari                                          ,0,0,0,0,0,2024
TOS,SI,N   ,"Noleggio, agenzie di viaggio, servizi di supporto alle im...",2,0,0,4,6,2024
TOS,SI,N 77,Attività di noleggio e leasing operativo                    ,1,0,0,0,1,2024
TOS,SI,N 78,"Attività di ricerca, selezione, fornitura di personale      ",0,0,0,0,0,2024
TOS,SI,N 79,"Attività dei servizi delle agenzie di viaggio, dei tour o...",0,0,0,0,0,2024
TOS,SI,N 80,Servizi di vigilanza e investigazione                       ,0,0,0,0,0,2024
TOS,SI,N 81,Attività di servizi per edifici e paesaggio                 ,1,0,0,1,2,2024
TOS,SI,N 82,Attività di supporto per le funzioni d'ufficio e altri se...,0,0,0,3,3,2024
TOS,SI,O   ,Amministrazione pubblica e difesa; assicurazione sociale ...,0,0,0,0,0,2024
TOS,SI,O 84,Amministrazione pubblica e difesa; assicurazione sociale ...,0,0,0,0,0,2024
TOS,SI,P   ,Istruzione                                                  ,0,0,0,0,0,2024
TOS,SI,P 85,Istruzione                                                  ,0,0,0,0,0,2024
TOS,SI,Q   ,Sanita' e assistenza sociale                                ,0,0,0,1,1,2024
TOS,SI,Q 86,Assistenza sanitaria                                        ,0,0,0,1,1,2024
TOS,SI,Q 87,Servizi di assistenza sociale residenziale                  ,0,0,0,0,0,2024
TOS,SI,Q 88,Assistenza sociale non residenziale                         ,0,0,0,0,0,2024
TOS,SI,R   ,"Attività artistiche, sportive, di intrattenimento e diver...",0,0,0,0,0,2024
TOS,SI,R 90,"Attività creative, artistiche e di intrattenimento          ",0,0,0,0,0,2024
TOS,SI,R 91,"Attività di biblioteche, archivi, musei ed altre attività...",0,0,0,0,0,2024
TOS,SI,R 92,"Attività riguardanti le lotterie, le scommesse, le case d...",0,0,0,0,0,2024
TOS,SI,R 93,"Attività sportive, di intrattenimento e di divertimento     ",0,0,0,0,0,2024
TOS,SI,S   ,Altre attività di servizi                                   ,1,0,0,1,2,2024
TOS,SI,S 94,Attività di organizzazioni associative                      ,0,0,0,0,0,2024
TOS,SI,S 95,Riparazione di computer e di beni per uso personale e per...,0,0,0,0,0,2024
TOS,SI,S 96,Altre attività di servizi per la persona                    ,1,0,0,1,2,2024
TOS,SI,T   ,Attività di famiglie e convivenze come datori di lavoro p...,0,0,0,0,0,2024
TOS,SI,T 97,Attività di famiglie e convivenze come datori di lavoro p...,0,0,0,0,0,2024
TOS,SI,T 98,Produzione di beni e servizi indifferenziati per uso prop...,0,0,0,0,0,2024
TOS,SI,U   ,Organizzazioni ed organismi extraterritoriali               ,0,0,0,0,0,2024
TOS,SI,U 99,Organizzazioni ed organismi extraterritoriali               ,0,0,0,0,0,2024
TOS,SI,XX  ,Imprese non classificate                                    ,8,0,0,9,17,2024
TOS,SI,TOT ,TOTALE                                                      ,58,1,3,36,98,2024
TOS,GR,A   ,"Agricoltura, silvicoltura pesca                             ",3,32,0,11,46,2024
TOS,GR,A 01,"Coltivazioni agricole e produzione di prodotti animali, c...",3,30,0,7,40,2024
TOS,GR,A 02,Silvicoltura ed utilizzo di aree forestali                  ,0,0,0,1,1,2024
TOS,GR,A 03,Pesca e acquacoltura                                        ,0,2,0,3,5,2024
TOS,GR,B   ,Estrazione di minerali da cave e miniere                    ,0,0,0,0,0,2024
TOS,GR,B 05,Estrazione di carbone (esclusa torba)                       ,0,0,0,0,0,2024
TOS,GR,B 06,Estraz.di petrolio greggio e di gas naturale                ,0,0,0,0,0,2024
TOS,GR,B 07,Estrazione di minerali metalliferi                          ,0,0,0,0,0,2024
TOS,GR,B 08,Altre attività di estrazione di minerali da cave e miniere  ,0,0,0,0,0,2024
TOS,GR,B 09,Attività dei servizi di supporto all'estrazione             ,0,0,0,0,0,2024
TOS,GR,C   ,Attività manifatturiere                                     ,6,9,0,6,21,2024
TOS,GR,C 10,Industrie alimentari                                        ,2,0,0,3,5,2024
TOS,GR,C 11,Industria delle bevande                                     ,0,0,0,0,0,2024
TOS,GR,C 12,Industria del tabacco                                       ,0,0,0,0,0,2024
TOS,GR,C 13,Industrie tessili                                           ,0,0,0,0,0,2024
TOS,GR,C 14,Confezione di articoli di abbigliamento; confezione di ar...,0,1,0,1,2,2024
TOS,GR,C 15,Fabbricazione di articoli in pelle e simili                 ,0,0,0,0,0,2024
TOS,GR,C 16,Industria del legno e dei prodotti in legno e sughero (es...,0,0,0,0,0,2024
TOS,GR,C 17,Fabbricazione di carta e di prodotti di carta               ,0,0,0,0,0,2024
TOS,GR,C 18,Stampa e riproduzione di supporti registrati                ,0,1,0,1,2,2024
TOS,GR,C 19,Fabbricazione di coke e prodotti derivanti dalla raffinaz...,0,0,0,0,0,2024
TOS,GR,C 20,Fabbricazione di prodotti chimici                           ,0,0,0,0,0,2024
TOS,GR,C 21,Fabbricazione di prodotti farmaceutici di base e di prepa...,0,0,0,0,0,2024
TOS,GR,C 22,Fabbricazione di articoli in gomma e materie plastiche      ,0,0,0,0,0,2024
TOS,GR,C 23,Fabbricazione di altri prodotti della lavorazione di miner..,1,0,0,0,1,2024
TOS,GR,C 24,Metallurgia                                                 ,0,0,0,0,0,2024
TOS,GR,C 25,Fabbricazione di prodotti in metallo (esclusi macchinari ...,2,1,0,1,4,2024
TOS,GR,C 26,Fabbricazione di computer e prodotti di elettronica e ott...,0,0,0,0,0,2024
TOS,GR,C 27,Fabbricazione di apparecchiature elettriche ed apparecchi...,0,0,0,0,0,2024
TOS,GR,C 28,Fabbricazione di macchinari ed apparecchiature nca          ,0,0,0,0,0,2024
TOS,GR,C 29,"Fabbricazione di autoveicoli, rimorchi e semirimorchi       ",0,0,0,0,0,2024
TOS,GR,C 30,Fabbricazione di altri mezzi di trasporto                   ,1,0,0,0,1,2024
TOS,GR,C 31,Fabbricazione di mobili                                     ,0,1,0,0,1,2024
TOS,GR,C 32,Altre industrie manifatturiere                              ,0,0,0,0,0,2024
TOS,GR,C 33,"Riparazione, manutenzione ed installazione di macchine ed...",0,5,0,0,5,2024
TOS,GR,D   ,"Fornitura di energia elettrica, gas, vapore e aria condiz...",1,0,0,0,1,2024
TOS,GR,D 35,"Fornitura di energia elettrica, gas, vapore e aria condiz...",1,0,0,0,1,2024
TOS,GR,E   ,"Fornitura di acqua; reti fognarie, attività di gestione d...",0,0,0,0,0,2024
TOS,GR,E 36,"Raccolta, trattamento e fornitura di acqua                  ",0,0,0,0,0,2024
TOS,GR,E 37,Gestione delle reti fognarie                                ,0,0,0,0,0,2024
TOS,GR,E 38,"Attività di raccolta, trattamento e smaltimento dei rifiu...",0,0,0,0,0,2024
TOS,GR,E 39,Attività di risanamento e altri servizi di gestione dei r...,0,0,0,0,0,2024
TOS,GR,F   ,Costruzioni                                                 ,19,12,1,16,48,2024
TOS,GR,F 41,Costruzione di edifici                                      ,14,5,0,13,32,2024
TOS,GR,F 42,Ingegneria civile                                           ,1,0,0,1,2,2024
TOS,GR,F 43,Lavori di costruzione specializzati                         ,4,7,1,2,14,2024
TOS,GR,G   ,Commercio all'ingrosso e al dettaglio; riparazione di aut...,13,39,0,3,55,2024
TOS,GR,G 45,Commercio all'ingrosso e al dettaglio e riparazione di au...,3,6,0,0,9,2024
TOS,GR,G 46,Commercio all'ingrosso (escluso quello di autoveicoli e d...,4,7,0,0,11,2024
TOS,GR,G 47,Commercio al dettaglio (escluso quello di autoveicoli e d...,6,26,0,3,35,2024
TOS,GR,H   ,Trasporto e magazzinaggio                                   ,2,1,0,5,8,2024
TOS,GR,H 49,Trasporto terrestre e mediante condotte                     ,1,0,0,0,1,2024
TOS,GR,H 50,Trasporto marittimo e per vie d'acqua                       ,0,0,0,0,0,2024
TOS,GR,H 51,Trasporto aereo                                             ,0,0,0,0,0,2024
TOS,GR,H 52,Magazzinaggio e attività di supporto ai trasporti           ,1,1,0,4,6,2024
TOS,GR,H 53,Servizi postali e attività di corriere                      ,0,0,0,1,1,2024
TOS,GR,I   ,Attività dei servizi alloggio e ristorazione                ,11,37,0,3,51,2024
TOS,GR,I 55,Alloggio                                                    ,4,1,0,1,6,2024
TOS,GR,I 56,Attività dei servizi di ristorazione                        ,7,36,0,2,45,2024
TOS,GR,J   ,Servizi di informazione e comunicazione                     ,6,1,0,0,7,2024
TOS,GR,J 58,Attività editoriali                                         ,0,0,0,0,0,2024
TOS,GR,J 59,"Attività di produzione cinematografica, di video e di pro...",1,0,0,0,1,2024
TOS,GR,J 60,Attività di programmazione e trasmissione                   ,1,0,0,0,1,2024
TOS,GR,J 61,Telecomunicazioni                                           ,0,0,0,0,0,2024
TOS,GR,J 62,"Produzione di software, consulenza informatica e attività...",1,0,0,0,1,2024
TOS,GR,J 63,Attività dei servizi d'informazione e altri servizi infor...,3,1,0,0,4,2024
TOS,GR,K   ,Attività finanziarie e assicurative                         ,0,1,1,1,3,2024
TOS,GR,K 64,Attività di servizi finanziari (escluse le assicurazioni ...,0,0,0,0,0,2024
TOS,GR,K 65,"Assicurazioni, riassicurazioni e fondi pensione (escluse ...",0,0,0,0,0,2024
TOS,GR,K 66,Attività ausiliarie dei servizi finanziari e delle attivi...,0,1,1,1,3,2024
TOS,GR,L   ,Attivita' immobiliari                                       ,15,18,0,1,34,2024
TOS,GR,L 68,Attivita' immobiliari                                       ,15,18,0,1,34,2024
TOS,GR,M   ,"Attività professionali, scientifiche e tecniche             ",4,1,0,3,8,2024
TOS,GR,M 69,Attività legali e contabilità                               ,0,0,0,1,1,2024
TOS,GR,M 70,Attività di direzione aziendale e di consulenza gestional...,1,1,0,1,3,2024
TOS,GR,M 71,Attività degli studi di architettura e d'ingegneria; coll...,1,0,0,0,1,2024
TOS,GR,M 72,Ricerca scientifica e sviluppo                              ,0,0,0,0,0,2024
TOS,GR,M 73,Pubblicità e ricerche di mercato                            ,1,0,0,0,1,2024
TOS,GR,M 74,"Altre attività professionali, scientifiche e tecniche       ",1,0,0,1,2,2024
TOS,GR,M 75,Servizi veterinari                                          ,0,0,0,0,0,2024
TOS,GR,N   ,"Noleggio, agenzie di viaggio, servizi di supporto alle im...",4,4,0,7,15,2024
TOS,GR,N 77,Attività di noleggio e leasing operativo                    ,0,1,0,1,2,2024
TOS,GR,N 78,"Attività di ricerca, selezione, fornitura di personale      ",0,0,0,0,0,2024
TOS,GR,N 79,"Attività dei servizi delle agenzie di viaggio, dei tour o...",0,0,0,0,0,2024
TOS,GR,N 80,Servizi di vigilanza e investigazione                       ,0,1,0,0,1,2024
TOS,GR,N 81,Attività di servizi per edifici e paesaggio                 ,3,0,0,4,7,2024
TOS,GR,N 82,Attività di supporto per le funzioni d'ufficio e altri se...,1,2,0,2,5,2024
TOS,GR,O   ,Amministrazione pubblica e difesa; assicurazione sociale ...,0,0,0,0,0,2024
TOS,GR,O 84,Amministrazione pubblica e difesa; assicurazione sociale ...,0,0,0,0,0,2024
TOS,GR,P   ,Istruzione                                                  ,1,1,0,1,3,2024
TOS,GR,P 85,Istruzione                                                  ,1,1,0,1,3,2024
TOS,GR,Q   ,Sanita' e assistenza sociale                                ,3,0,0,6,9,2024
TOS,GR,Q 86,Assistenza sanitaria                                        ,3,0,0,0,3,2024
TOS,GR,Q 87,Servizi di assistenza sociale residenziale                  ,0,0,0,1,1,2024
TOS,GR,Q 88,Assistenza sociale non residenziale                         ,0,0,0,5,5,2024
TOS,GR,R   ,"Attività artistiche, sportive, di intrattenimento e diver...",1,1,0,4,6,2024
TOS,GR,R 90,"Attività creative, artistiche e di intrattenimento          ",0,0,0,2,2,2024
TOS,GR,R 91,"Attività di biblioteche, archivi, musei ed altre attività...",0,0,0,1,1,2024
TOS,GR,R 92,"Attività riguardanti le lotterie, le scommesse, le case d...",0,0,0,0,0,2024
TOS,GR,R 93,"Attività sportive, di intrattenimento e di divertimento     ",1,1,0,1,3,2024
TOS,GR,S   ,Altre attività di servizi                                   ,2,6,0,1,9,2024
TOS,GR,S 94,Attività di organizzazioni associative                      ,0,0,0,0,0,2024
TOS,GR,S 95,Riparazione di computer e di beni per uso personale e per...,0,0,0,0,0,2024
TOS,GR,S 96,Altre attività di servizi per la persona                    ,2,6,0,1,9,2024
TOS,GR,T   ,Attività di famiglie e convivenze come datori di lavoro p...,0,0,0,0,0,2024
TOS,GR,T 97,Attività di famiglie e convivenze come datori di lavoro p...,0,0,0,0,0,2024
TOS,GR,T 98,Produzione di beni e servizi indifferenziati per uso prop...,0,0,0,0,0,2024
TOS,GR,U   ,Organizzazioni ed organismi extraterritoriali               ,0,0,0,0,0,2024
TOS,GR,U 99,Organizzazioni ed organismi extraterritoriali               ,0,0,0,0,0,2024
TOS,GR,XX  ,Imprese non classificate                                    ,12,12,0,15,39,2024
TOS,GR,TOT ,TOTALE                                                      ,103,175,2,83,363,2024
TOS,PO,A   ,"Agricoltura, silvicoltura pesca                             ",0,1,0,1,2,2024
TOS,PO,A 01,"Coltivazioni agricole e produzione di prodotti animali, c...",0,0,0,1,1,2024
TOS,PO,A 02,Silvicoltura ed utilizzo di aree forestali                  ,0,1,0,0,1,2024
TOS,PO,A 03,Pesca e acquacoltura                                        ,0,0,0,0,0,2024
TOS,PO,B   ,Estrazione di minerali da cave e miniere                    ,0,0,0,0,0,2024
TOS,PO,B 05,Estrazione di carbone (esclusa torba)                       ,0,0,0,0,0,2024
TOS,PO,B 06,Estraz.di petrolio greggio e di gas naturale                ,0,0,0,0,0,2024
TOS,PO,B 07,Estrazione di minerali metalliferi                          ,0,0,0,0,0,2024
TOS,PO,B 08,Altre attività di estrazione di minerali da cave e miniere  ,0,0,0,0,0,2024
TOS,PO,B 09,Attività dei servizi di supporto all'estrazione             ,0,0,0,0,0,2024
TOS,PO,C   ,Attività manifatturiere                                     ,19,7,34,9,69,2024
TOS,PO,C 10,Industrie alimentari                                        ,1,0,0,2,3,2024
TOS,PO,C 11,Industria delle bevande                                     ,0,0,0,0,0,2024
TOS,PO,C 12,Industria del tabacco                                       ,0,0,0,0,0,2024
TOS,PO,C 13,Industrie tessili                                           ,7,4,2,4,17,2024
TOS,PO,C 14,Confezione di articoli di abbigliamento; confezione di ar...,7,3,23,1,34,2024
TOS,PO,C 15,Fabbricazione di articoli in pelle e simili                 ,0,0,7,0,7,2024
TOS,PO,C 16,Industria del legno e dei prodotti in legno e sughero (es...,1,0,0,0,1,2024
TOS,PO,C 17,Fabbricazione di carta e di prodotti di carta               ,0,0,0,0,0,2024
TOS,PO,C 18,Stampa e riproduzione di supporti registrati                ,0,0,0,0,0,2024
TOS,PO,C 19,Fabbricazione di coke e prodotti derivanti dalla raffinaz...,0,0,0,0,0,2024
TOS,PO,C 20,Fabbricazione di prodotti chimici                           ,0,0,0,0,0,2024
TOS,PO,C 21,Fabbricazione di prodotti farmaceutici di base e di prepa...,0,0,0,0,0,2024
TOS,PO,C 22,Fabbricazione di articoli in gomma e materie plastiche      ,0,0,0,0,0,2024
TOS,PO,C 23,Fabbricazione di altri prodotti della lavorazione di miner..,0,0,1,0,1,2024
TOS,PO,C 24,Metallurgia                                                 ,0,0,0,0,0,2024
TOS,PO,C 25,Fabbricazione di prodotti in metallo (esclusi macchinari ...,0,0,0,0,0,2024
TOS,PO,C 26,Fabbricazione di computer e prodotti di elettronica e ott...,0,0,0,0,0,2024
TOS,PO,C 27,Fabbricazione di apparecchiature elettriche ed apparecchi...,0,0,0,0,0,2024
TOS,PO,C 28,Fabbricazione di macchinari ed apparecchiature nca          ,0,0,0,0,0,2024
TOS,PO,C 29,"Fabbricazione di autoveicoli, rimorchi e semirimorchi       ",0,0,0,0,0,2024
TOS,PO,C 30,Fabbricazione di altri mezzi di trasporto                   ,0,0,0,0,0,2024
TOS,PO,C 31,Fabbricazione di mobili                                     ,1,0,0,0,1,2024
TOS,PO,C 32,Altre industrie manifatturiere                              ,1,0,1,1,3,2024
TOS,PO,C 33,"Riparazione, manutenzione ed installazione di macchine ed...",1,0,0,1,2,2024
TOS,PO,D   ,"Fornitura di energia elettrica, gas, vapore e aria condiz...",0,0,0,0,0,2024
TOS,PO,D 35,"Fornitura di energia elettrica, gas, vapore e aria condiz...",0,0,0,0,0,2024
TOS,PO,E   ,"Fornitura di acqua; reti fognarie, attività di gestione d...",0,0,0,5,5,2024
TOS,PO,E 36,"Raccolta, trattamento e fornitura di acqua                  ",0,0,0,0,0,2024
TOS,PO,E 37,Gestione delle reti fognarie                                ,0,0,0,0,0,2024
TOS,PO,E 38,"Attività di raccolta, trattamento e smaltimento dei rifiu...",0,0,0,5,5,2024
TOS,PO,E 39,Attività di risanamento e altri servizi di gestione dei r...,0,0,0,0,0,2024
TOS,PO,F   ,Costruzioni                                                 ,4,3,2,25,34,2024
TOS,PO,F 41,Costruzione di edifici                                      ,2,1,1,13,17,2024
TOS,PO,F 42,Ingegneria civile                                           ,0,0,0,1,1,2024
TOS,PO,F 43,Lavori di costruzione specializzati                         ,2,2,1,11,16,2024
TOS,PO,G   ,Commercio all'ingrosso e al dettaglio; riparazione di aut...,15,17,30,0,62,2024
TOS,PO,G 45,Commercio all'ingrosso e al dettaglio e riparazione di au...,1,1,1,0,3,2024
TOS,PO,G 46,Commercio all'ingrosso (escluso quello di autoveicoli e d...,12,4,25,0,41,2024
TOS,PO,G 47,Commercio al dettaglio (escluso quello di autoveicoli e d...,2,12,4,0,18,2024
TOS,PO,H   ,Trasporto e magazzinaggio                                   ,0,1,1,19,21,2024
TOS,PO,H 49,Trasporto terrestre e mediante condotte                     ,0,0,1,7,8,2024
TOS,PO,H 50,Trasporto marittimo e per vie d'acqua                       ,0,0,0,0,0,2024
TOS,PO,H 51,Trasporto aereo                                             ,0,0,0,0,0,2024
TOS,PO,H 52,Magazzinaggio e attività di supporto ai trasporti           ,0,1,0,12,13,2024
TOS,PO,H 53,Servizi postali e attività di corriere                      ,0,0,0,0,0,2024
TOS,PO,I   ,Attività dei servizi alloggio e ristorazione                ,4,13,0,0,17,2024
TOS,PO,I 55,Alloggio                                                    ,1,0,0,0,1,2024
TOS,PO,I 56,Attività dei servizi di ristorazione                        ,3,13,0,0,16,2024
TOS,PO,J   ,Servizi di informazione e comunicazione                     ,3,1,2,1,7,2024
TOS,PO,J 58,Attività editoriali                                         ,0,0,0,0,0,2024
TOS,PO,J 59,"Attività di produzione cinematografica, di video e di pro...",0,0,0,0,0,2024
TOS,PO,J 60,Attività di programmazione e trasmissione                   ,0,0,0,0,0,2024
TOS,PO,J 61,Telecomunicazioni                                           ,0,0,1,0,1,2024
TOS,PO,J 62,"Produzione di software, consulenza informatica e attività...",0,0,0,0,0,2024
TOS,PO,J 63,Attività dei servizi d'informazione e altri servizi infor...,3,1,1,1,6,2024
TOS,PO,K   ,Attività finanziarie e assicurative                         ,0,0,0,0,0,2024
TOS,PO,K 64,Attività di servizi finanziari (escluse le assicurazioni ...,0,0,0,0,0,2024
TOS,PO,K 65,"Assicurazioni, riassicurazioni e fondi pensione (escluse ...",0,0,0,0,0,2024
TOS,PO,K 66,Attività ausiliarie dei servizi finanziari e delle attivi...,0,0,0,0,0,2024
TOS,PO,L   ,Attivita' immobiliari                                       ,2,5,0,2,9,2024
TOS,PO,L 68,Attivita' immobiliari                                       ,2,5,0,2,9,2024
TOS,PO,M   ,"Attività professionali, scientifiche e tecniche             ",4,1,0,5,10,2024
TOS,PO,M 69,Attività legali e contabilità                               ,0,0,0,0,0,2024
TOS,PO,M 70,Attività di direzione aziendale e di consulenza gestional...,0,1,0,2,3,2024
TOS,PO,M 71,Attività degli studi di architettura e d'ingegneria; coll...,2,0,0,1,3,2024
TOS,PO,M 72,Ricerca scientifica e sviluppo                              ,0,0,0,0,0,2024
TOS,PO,M 73,Pubblicità e ricerche di mercato                            ,0,0,0,0,0,2024
TOS,PO,M 74,"Altre attività professionali, scientifiche e tecniche       ",2,0,0,2,4,2024
TOS,PO,M 75,Servizi veterinari                                          ,0,0,0,0,0,2024
TOS,PO,N   ,"Noleggio, agenzie di viaggio, servizi di supporto alle im...",0,2,2,3,7,2024
TOS,PO,N 77,Attività di noleggio e leasing operativo                    ,0,0,0,0,0,2024
TOS,PO,N 78,"Attività di ricerca, selezione, fornitura di personale      ",0,0,0,0,0,2024
TOS,PO,N 79,"Attività dei servizi delle agenzie di viaggio, dei tour o...",0,0,0,0,0,2024
TOS,PO,N 80,Servizi di vigilanza e investigazione                       ,0,0,0,0,0,2024
TOS,PO,N 81,Attività di servizi per edifici e paesaggio                 ,0,2,1,1,4,2024
TOS,PO,N 82,Attività di supporto per le funzioni d'ufficio e altri se...,0,0,1,2,3,2024
TOS,PO,O   ,Amministrazione pubblica e difesa; assicurazione sociale ...,0,0,0,0,0,2024
TOS,PO,O 84,Amministrazione pubblica e difesa; assicurazione sociale ...,0,0,0,0,0,2024
TOS,PO,P   ,Istruzione                                                  ,0,0,0,1,1,2024
TOS,PO,P 85,Istruzione                                                  ,0,0,0,1,1,2024
TOS,PO,Q   ,Sanita' e assistenza sociale                                ,0,0,0,1,1,2024
TOS,PO,Q 86,Assistenza sanitaria                                        ,0,0,0,0,0,2024
TOS,PO,Q 87,Servizi di assistenza sociale residenziale                  ,0,0,0,0,0,2024
TOS,PO,Q 88,Assistenza sociale non residenziale                         ,0,0,0,1,1,2024
TOS,PO,R   ,"Attività artistiche, sportive, di intrattenimento e diver...",2,1,0,1,4,2024
TOS,PO,R 90,"Attività creative, artistiche e di intrattenimento          ",1,0,0,0,1,2024
TOS,PO,R 91,"Attività di biblioteche, archivi, musei ed altre attività...",0,0,0,0,0,2024
TOS,PO,R 92,"Attività riguardanti le lotterie, le scommesse, le case d...",0,1,0,0,1,2024
TOS,PO,R 93,"Attività sportive, di intrattenimento e di divertimento     ",1,0,0,1,2,2024
TOS,PO,S   ,Altre attività di servizi                                   ,0,4,0,1,5,2024
TOS,PO,S 94,Attività di organizzazioni associative                      ,0,0,0,0,0,2024
TOS,PO,S 95,Riparazione di computer e di beni per uso personale e per...,0,0,0,0,0,2024
TOS,PO,S 96,Altre attività di servizi per la persona                    ,0,4,0,1,5,2024
TOS,PO,T   ,Attività di famiglie e convivenze come datori di lavoro p...,0,0,0,0,0,2024
TOS,PO,T 97,Attività di famiglie e convivenze come datori di lavoro p...,0,0,0,0,0,2024
TOS,PO,T 98,Produzione di beni e servizi indifferenziati per uso prop...,0,0,0,0,0,2024
TOS,PO,U   ,Organizzazioni ed organismi extraterritoriali               ,0,0,0,0,0,2024
TOS,PO,U 99,Organizzazioni ed organismi extraterritoriali               ,0,0,0,0,0,2024
TOS,PO,XX  ,Imprese non classificate                                    ,10,3,1,6,20,2024
TOS,PO,TOT ,TOTALE                                                      ,63,59,72,80,274,2024
UMB,  ,A   ,"Agricoltura, silvicoltura pesca                             ",0,0,114,21,135,2024
UMB,  ,A 01,"Coltivazioni agricole e produzione di prodotti animali, c...",0,0,109,18,127,2024
UMB,  ,A 02,Silvicoltura ed utilizzo di aree forestali                  ,0,0,5,1,6,2024
UMB,  ,A 03,Pesca e acquacoltura                                        ,0,0,0,2,2,2024
UMB,  ,B   ,Estrazione di minerali da cave e miniere                    ,0,0,0,0,0,2024
UMB,  ,B 05,Estrazione di carbone (esclusa torba)                       ,0,0,0,0,0,2024
UMB,  ,B 06,Estraz.di petrolio greggio e di gas naturale                ,0,0,0,0,0,2024
UMB,  ,B 07,Estrazione di minerali metalliferi                          ,0,0,0,0,0,2024
UMB,  ,B 08,Altre attività di estrazione di minerali da cave e miniere  ,0,0,0,0,0,2024
UMB,  ,B 09,Attività dei servizi di supporto all'estrazione             ,0,0,0,0,0,2024
UMB,  ,C   ,Attività manifatturiere                                     ,0,1,110,16,127,2024
UMB,  ,C 10,Industrie alimentari                                        ,0,1,6,2,9,2024
UMB,  ,C 11,Industria delle bevande                                     ,0,0,0,0,0,2024
UMB,  ,C 12,Industria del tabacco                                       ,0,0,0,0,0,2024
UMB,  ,C 13,Industrie tessili                                           ,0,0,2,1,3,2024
UMB,  ,C 14,Confezione di articoli di abbigliamento; confezione di ar...,0,0,27,0,27,2024
UMB,  ,C 15,Fabbricazione di articoli in pelle e simili                 ,0,0,3,2,5,2024
UMB,  ,C 16,Industria del legno e dei prodotti in legno e sughero (es...,0,0,8,0,8,2024
UMB,  ,C 17,Fabbricazione di carta e di prodotti di carta               ,0,0,0,0,0,2024
UMB,  ,C 18,Stampa e riproduzione di supporti registrati                ,0,0,2,1,3,2024
UMB,  ,C 19,Fabbricazione di coke e prodotti derivanti dalla raffinaz...,0,0,0,0,0,2024
UMB,  ,C 20,Fabbricazione di prodotti chimici                           ,0,0,0,0,0,2024
UMB,  ,C 21,Fabbricazione di prodotti farmaceutici di base e di prepa...,0,0,0,0,0,2024
UMB,  ,C 22,Fabbricazione di articoli in gomma e materie plastiche      ,0,0,1,1,2,2024
UMB,  ,C 23,Fabbricazione di altri prodotti della lavorazione di miner..,0,0,5,2,7,2024
UMB,  ,C 24,Metallurgia                                                 ,0,0,1,0,1,2024
UMB,  ,C 25,Fabbricazione di prodotti in metallo (esclusi macchinari ...,0,0,29,4,33,2024
UMB,  ,C 26,Fabbricazione di computer e prodotti di elettronica e ott...,0,0,0,1,1,2024
UMB,  ,C 27,Fabbricazione di apparecchiature elettriche ed apparecchi...,0,0,3,0,3,2024
UMB,  ,C 28,Fabbricazione di macchinari ed apparecchiature nca          ,0,0,5,0,5,2024
UMB,  ,C 29,"Fabbricazione di autoveicoli, rimorchi e semirimorchi       ",0,0,0,0,0,2024
UMB,  ,C 30,Fabbricazione di altri mezzi di trasporto                   ,0,0,0,0,0,2024
UMB,  ,C 31,Fabbricazione di mobili                                     ,0,0,4,0,4,2024
UMB,  ,C 32,Altre industrie manifatturiere                              ,0,0,8,1,9,2024
UMB,  ,C 33,"Riparazione, manutenzione ed installazione di macchine ed...",0,0,6,1,7,2024
UMB,  ,D   ,"Fornitura di energia elettrica, gas, vapore e aria condiz...",0,0,0,0,0,2024
UMB,  ,D 35,"Fornitura di energia elettrica, gas, vapore e aria condiz...",0,0,0,0,0,2024
UMB,  ,E   ,"Fornitura di acqua; reti fognarie, attività di gestione d...",0,0,0,0,0,2024
UMB,  ,E 36,"Raccolta, trattamento e fornitura di acqua                  ",0,0,0,0,0,2024
UMB,  ,E 37,Gestione delle reti fognarie                                ,0,0,0,0,0,2024
UMB,  ,E 38,"Attività di raccolta, trattamento e smaltimento dei rifiu...",0,0,0,0,0,2024
UMB,  ,E 39,Attività di risanamento e altri servizi di gestione dei r...,0,0,0,0,0,2024
UMB,  ,F   ,Costruzioni                                                 ,0,0,451,40,491,2024
UMB,  ,F 41,Costruzione di edifici                                      ,0,0,73,23,96,2024
UMB,  ,F 42,Ingegneria civile                                           ,0,0,2,1,3,2024
UMB,  ,F 43,Lavori di costruzione specializzati                         ,0,0,376,16,392,2024
UMB,  ,G   ,Commercio all'ingrosso e al dettaglio; riparazione di aut...,0,0,372,11,383,2024
UMB,  ,G 45,Commercio all'ingrosso e al dettaglio e riparazione di au...,0,0,21,1,22,2024
UMB,  ,G 46,Commercio all'ingrosso (escluso quello di autoveicoli e d...,0,0,66,1,67,2024
UMB,  ,G 47,Commercio al dettaglio (escluso quello di autoveicoli e d...,0,0,285,9,294,2024
UMB,  ,H   ,Trasporto e magazzinaggio                                   ,0,0,43,9,52,2024
UMB,  ,H 49,Trasporto terrestre e mediante condotte                     ,0,0,43,4,47,2024
UMB,  ,H 50,Trasporto marittimo e per vie d'acqua                       ,0,0,0,0,0,2024
UMB,  ,H 51,Trasporto aereo                                             ,0,0,0,0,0,2024
UMB,  ,H 52,Magazzinaggio e attività di supporto ai trasporti           ,0,0,0,5,5,2024
UMB,  ,H 53,Servizi postali e attività di corriere                      ,0,0,0,0,0,2024
UMB,  ,I   ,Attività dei servizi alloggio e ristorazione                ,0,0,72,9,81,2024
UMB,  ,I 55,Alloggio                                                    ,0,0,5,2,7,2024
UMB,  ,I 56,Attività dei servizi di ristorazione                        ,0,0,67,7,74,2024
UMB,  ,J   ,Servizi di informazione e comunicazione                     ,0,0,18,4,22,2024
UMB,  ,J 58,Attività editoriali                                         ,0,0,2,0,2,2024
UMB,  ,J 59,"Attività di produzione cinematografica, di video e di pro...",0,0,3,0,3,2024
UMB,  ,J 60,Attività di programmazione e trasmissione                   ,0,0,0,0,0,2024
UMB,  ,J 61,Telecomunicazioni                                           ,0,0,4,0,4,2024
UMB,  ,J 62,"Produzione di software, consulenza informatica e attività...",0,0,7,3,10,2024
UMB,  ,J 63,Attività dei servizi d'informazione e altri servizi infor...,0,0,2,1,3,2024
UMB,  ,K   ,Attività finanziarie e assicurative                         ,0,0,7,2,9,2024
UMB,  ,K 64,Attività di servizi finanziari (escluse le assicurazioni ...,0,0,0,0,0,2024
UMB,  ,K 65,"Assicurazioni, riassicurazioni e fondi pensione (escluse ...",0,0,0,0,0,2024
UMB,  ,K 66,Attività ausiliarie dei servizi finanziari e delle attivi...,0,0,7,2,9,2024
UMB,  ,L   ,Attivita' immobiliari                                       ,0,0,8,0,8,2024
UMB,  ,L 68,Attivita' immobiliari                                       ,0,0,8,0,8,2024
UMB,  ,M   ,"Attività professionali, scientifiche e tecniche             ",0,0,17,11,28,2024
UMB,  ,M 69,Attività legali e contabilità                               ,0,0,0,1,1,2024
UMB,  ,M 70,Attività di direzione aziendale e di consulenza gestional...,0,0,2,6,8,2024
UMB,  ,M 71,Attività degli studi di architettura e d'ingegneria; coll...,0,0,3,1,4,2024
UMB,  ,M 72,Ricerca scientifica e sviluppo                              ,0,0,0,0,0,2024
UMB,  ,M 73,Pubblicità e ricerche di mercato                            ,0,0,5,0,5,2024
UMB,  ,M 74,"Altre attività professionali, scientifiche e tecniche       ",0,0,7,3,10,2024
UMB,  ,M 75,Servizi veterinari                                          ,0,0,0,0,0,2024
UMB,  ,N   ,"Noleggio, agenzie di viaggio, servizi di supporto alle im...",0,0,37,16,53,2024
UMB,  ,N 77,Attività di noleggio e leasing operativo                    ,0,0,4,1,5,2024
UMB,  ,N 78,"Attività di ricerca, selezione, fornitura di personale      ",0,0,0,0,0,2024
UMB,  ,N 79,"Attività dei servizi delle agenzie di viaggio, dei tour o...",0,0,2,1,3,2024
UMB,  ,N 80,Servizi di vigilanza e investigazione                       ,0,0,0,0,0,2024
UMB,  ,N 81,Attività di servizi per edifici e paesaggio                 ,0,0,13,7,20,2024
UMB,  ,N 82,Attività di supporto per le funzioni d'ufficio e altri se...,0,0,18,7,25,2024
UMB,  ,O   ,Amministrazione pubblica e difesa; assicurazione sociale ...,0,0,0,0,0,2024
UMB,  ,O 84,Amministrazione pubblica e difesa; assicurazione sociale ...,0,0,0,0,0,2024
UMB,  ,P   ,Istruzione                                                  ,0,0,2,3,5,2024
UMB,  ,P 85,Istruzione                                                  ,0,0,2,3,5,2024
UMB,  ,Q   ,Sanita' e assistenza sociale                                ,0,0,1,8,9,2024
UMB,  ,Q 86,Assistenza sanitaria                                        ,0,0,0,0,0,2024
UMB,  ,Q 87,Servizi di assistenza sociale residenziale                  ,0,0,0,0,0,2024
UMB,  ,Q 88,Assistenza sociale non residenziale                         ,0,0,1,8,9,2024
UMB,  ,R   ,"Attività artistiche, sportive, di intrattenimento e diver...",0,0,6,6,12,2024
UMB,  ,R 90,"Attività creative, artistiche e di intrattenimento          ",0,0,4,5,9,2024
UMB,  ,R 91,"Attività di biblioteche, archivi, musei ed altre attività...",0,0,0,1,1,2024
UMB,  ,R 92,"Attività riguardanti le lotterie, le scommesse, le case d...",0,0,0,0,0,2024
UMB,  ,R 93,"Attività sportive, di intrattenimento e di divertimento     ",0,0,2,0,2,2024
UMB,  ,S   ,Altre attività di servizi                                   ,0,0,33,4,37,2024
UMB,  ,S 94,Attività di organizzazioni associative                      ,0,0,0,0,0,2024
UMB,  ,S 95,Riparazione di computer e di beni per uso personale e per...,0,0,11,1,12,2024
UMB,  ,S 96,Altre attività di servizi per la persona                    ,0,0,22,3,25,2024
UMB,  ,T   ,Attività di famiglie e convivenze come datori di lavoro p...,0,0,0,0,0,2024
UMB,  ,T 97,Attività di famiglie e convivenze come datori di lavoro p...,0,0,0,0,0,2024
UMB,  ,T 98,Produzione di beni e servizi indifferenziati per uso prop...,0,0,0,0,0,2024
UMB,  ,U   ,Organizzazioni ed organismi extraterritoriali               ,0,0,0,0,0,2024
UMB,  ,U 99,Organizzazioni ed organismi extraterritoriali               ,0,0,0,0,0,2024
UMB,  ,XX  ,Imprese non classificate                                    ,0,0,64,47,111,2024
UMB,  ,TOT ,TOTALE                                                      ,0,1,1355,207,1563,2024
UMB,PG,A   ,"Agricoltura, silvicoltura pesca                             ",0,0,87,17,104,2024
UMB,PG,A 01,"Coltivazioni agricole e produzione di prodotti animali, c...",0,0,82,15,97,2024
UMB,PG,A 02,Silvicoltura ed utilizzo di aree forestali                  ,0,0,5,0,5,2024
UMB,PG,A 03,Pesca e acquacoltura                                        ,0,0,0,2,2,2024
UMB,PG,B   ,Estrazione di minerali da cave e miniere                    ,0,0,0,0,0,2024
UMB,PG,B 05,Estrazione di carbone (esclusa torba)                       ,0,0,0,0,0,2024
UMB,PG,B 06,Estraz.di petrolio greggio e di gas naturale                ,0,0,0,0,0,2024
UMB,PG,B 07,Estrazione di minerali metalliferi                          ,0,0,0,0,0,2024
UMB,PG,B 08,Altre attività di estrazione di minerali da cave e miniere  ,0,0,0,0,0,2024
UMB,PG,B 09,Attività dei servizi di supporto all'estrazione             ,0,0,0,0,0,2024
UMB,PG,C   ,Attività manifatturiere                                     ,0,1,92,10,103,2024
UMB,PG,C 10,Industrie alimentari                                        ,0,1,5,2,8,2024
UMB,PG,C 11,Industria delle bevande                                     ,0,0,0,0,0,2024
UMB,PG,C 12,Industria del tabacco                                       ,0,0,0,0,0,2024
UMB,PG,C 13,Industrie tessili                                           ,0,0,2,1,3,2024
UMB,PG,C 14,Confezione di articoli di abbigliamento; confezione di ar...,0,0,22,0,22,2024
UMB,PG,C 15,Fabbricazione di articoli in pelle e simili                 ,0,0,3,2,5,2024
UMB,PG,C 16,Industria del legno e dei prodotti in legno e sughero (es...,0,0,7,0,7,2024
UMB,PG,C 17,Fabbricazione di carta e di prodotti di carta               ,0,0,0,0,0,2024
UMB,PG,C 18,Stampa e riproduzione di supporti registrati                ,0,0,2,0,2,2024
UMB,PG,C 19,Fabbricazione di coke e prodotti derivanti dalla raffinaz...,0,0,0,0,0,2024
UMB,PG,C 20,Fabbricazione di prodotti chimici                           ,0,0,0,0,0,2024
UMB,PG,C 21,Fabbricazione di prodotti farmaceutici di base e di prepa...,0,0,0,0,0,2024
UMB,PG,C 22,Fabbricazione di articoli in gomma e materie plastiche      ,0,0,1,1,2,2024
UMB,PG,C 23,Fabbricazione di altri prodotti della lavorazione di miner..,0,0,5,0,5,2024
UMB,PG,C 24,Metallurgia                                                 ,0,0,1,0,1,2024
UMB,PG,C 25,Fabbricazione di prodotti in metallo (esclusi macchinari ...,0,0,24,2,26,2024
UMB,PG,C 26,Fabbricazione di computer e prodotti di elettronica e ott...,0,0,0,1,1,2024
UMB,PG,C 27,Fabbricazione di apparecchiature elettriche ed apparecchi...,0,0,3,0,3,2024
UMB,PG,C 28,Fabbricazione di macchinari ed apparecchiature nca          ,0,0,5,0,5,2024
UMB,PG,C 29,"Fabbricazione di autoveicoli, rimorchi e semirimorchi       ",0,0,0,0,0,2024
UMB,PG,C 30,Fabbricazione di altri mezzi di trasporto                   ,0,0,0,0,0,2024
UMB,PG,C 31,Fabbricazione di mobili                                     ,0,0,4,0,4,2024
UMB,PG,C 32,Altre industrie manifatturiere                              ,0,0,3,1,4,2024
UMB,PG,C 33,"Riparazione, manutenzione ed installazione di macchine ed...",0,0,5,0,5,2024
UMB,PG,D   ,"Fornitura di energia elettrica, gas, vapore e aria condiz...",0,0,0,0,0,2024
UMB,PG,D 35,"Fornitura di energia elettrica, gas, vapore e aria condiz...",0,0,0,0,0,2024
UMB,PG,E   ,"Fornitura di acqua; reti fognarie, attività di gestione d...",0,0,0,0,0,2024
UMB,PG,E 36,"Raccolta, trattamento e fornitura di acqua                  ",0,0,0,0,0,2024
UMB,PG,E 37,Gestione delle reti fognarie                                ,0,0,0,0,0,2024
UMB,PG,E 38,"Attività di raccolta, trattamento e smaltimento dei rifiu...",0,0,0,0,0,2024
UMB,PG,E 39,Attività di risanamento e altri servizi di gestione dei r...,0,0,0,0,0,2024
UMB,PG,F   ,Costruzioni                                                 ,0,0,429,18,447,2024
UMB,PG,F 41,Costruzione di edifici                                      ,0,0,69,11,80,2024
UMB,PG,F 42,Ingegneria civile                                           ,0,0,2,0,2,2024
UMB,PG,F 43,Lavori di costruzione specializzati                         ,0,0,358,7,365,2024
UMB,PG,G   ,Commercio all'ingrosso e al dettaglio; riparazione di aut...,0,0,306,6,312,2024
UMB,PG,G 45,Commercio all'ingrosso e al dettaglio e riparazione di au...,0,0,19,1,20,2024
UMB,PG,G 46,Commercio all'ingrosso (escluso quello di autoveicoli e d...,0,0,54,1,55,2024
UMB,PG,G 47,Commercio al dettaglio (escluso quello di autoveicoli e d...,0,0,233,4,237,2024
UMB,PG,H   ,Trasporto e magazzinaggio                                   ,0,0,36,6,42,2024
UMB,PG,H 49,Trasporto terrestre e mediante condotte                     ,0,0,36,4,40,2024
UMB,PG,H 50,Trasporto marittimo e per vie d'acqua                       ,0,0,0,0,0,2024
UMB,PG,H 51,Trasporto aereo                                             ,0,0,0,0,0,2024
UMB,PG,H 52,Magazzinaggio e attività di supporto ai trasporti           ,0,0,0,2,2,2024
UMB,PG,H 53,Servizi postali e attività di corriere                      ,0,0,0,0,0,2024
UMB,PG,I   ,Attività dei servizi alloggio e ristorazione                ,0,0,57,4,61,2024
UMB,PG,I 55,Alloggio                                                    ,0,0,3,2,5,2024
UMB,PG,I 56,Attività dei servizi di ristorazione                        ,0,0,54,2,56,2024
UMB,PG,J   ,Servizi di informazione e comunicazione                     ,0,0,13,4,17,2024
UMB,PG,J 58,Attività editoriali                                         ,0,0,1,0,1,2024
UMB,PG,J 59,"Attività di produzione cinematografica, di video e di pro...",0,0,1,0,1,2024
UMB,PG,J 60,Attività di programmazione e trasmissione                   ,0,0,0,0,0,2024
UMB,PG,J 61,Telecomunicazioni                                           ,0,0,4,0,4,2024
UMB,PG,J 62,"Produzione di software, consulenza informatica e attività...",0,0,5,3,8,2024
UMB,PG,J 63,Attività dei servizi d'informazione e altri servizi infor...,0,0,2,1,3,2024
UMB,PG,K   ,Attività finanziarie e assicurative                         ,0,0,7,1,8,2024
UMB,PG,K 64,Attività di servizi finanziari (escluse le assicurazioni ...,0,0,0,0,0,2024
UMB,PG,K 65,"Assicurazioni, riassicurazioni e fondi pensione (escluse ...",0,0,0,0,0,2024
UMB,PG,K 66,Attività ausiliarie dei servizi finanziari e delle attivi...,0,0,7,1,8,2024
UMB,PG,L   ,Attivita' immobiliari                                       ,0,0,6,0,6,2024
UMB,PG,L 68,Attivita' immobiliari                                       ,0,0,6,0,6,2024
UMB,PG,M   ,"Attività professionali, scientifiche e tecniche             ",0,0,14,7,21,2024
UMB,PG,M 69,Attività legali e contabilità                               ,0,0,0,1,1,2024
UMB,PG,M 70,Attività di direzione aziendale e di consulenza gestional...,0,0,2,5,7,2024
UMB,PG,M 71,Attività degli studi di architettura e d'ingegneria; coll...,0,0,2,1,3,2024
UMB,PG,M 72,Ricerca scientifica e sviluppo                              ,0,0,0,0,0,2024
UMB,PG,M 73,Pubblicità e ricerche di mercato                            ,0,0,5,0,5,2024
UMB,PG,M 74,"Altre attività professionali, scientifiche e tecniche       ",0,0,5,0,5,2024
UMB,PG,M 75,Servizi veterinari                                          ,0,0,0,0,0,2024
UMB,PG,N   ,"Noleggio, agenzie di viaggio, servizi di supporto alle im...",0,0,29,9,38,2024
UMB,PG,N 77,Attività di noleggio e leasing operativo                    ,0,0,4,0,4,2024
UMB,PG,N 78,"Attività di ricerca, selezione, fornitura di personale      ",0,0,0,0,0,2024
UMB,PG,N 79,"Attività dei servizi delle agenzie di viaggio, dei tour o...",0,0,2,1,3,2024
UMB,PG,N 80,Servizi di vigilanza e investigazione                       ,0,0,0,0,0,2024
UMB,PG,N 81,Attività di servizi per edifici e paesaggio                 ,0,0,13,2,15,2024
UMB,PG,N 82,Attività di supporto per le funzioni d'ufficio e altri se...,0,0,10,6,16,2024
UMB,PG,O   ,Amministrazione pubblica e difesa; assicurazione sociale ...,0,0,0,0,0,2024
UMB,PG,O 84,Amministrazione pubblica e difesa; assicurazione sociale ...,0,0,0,0,0,2024
UMB,PG,P   ,Istruzione                                                  ,0,0,2,2,4,2024
UMB,PG,P 85,Istruzione                                                  ,0,0,2,2,4,2024
UMB,PG,Q   ,Sanita' e assistenza sociale                                ,0,0,1,1,2,2024
UMB,PG,Q 86,Assistenza sanitaria                                        ,0,0,0,0,0,2024
UMB,PG,Q 87,Servizi di assistenza sociale residenziale                  ,0,0,0,0,0,2024
UMB,PG,Q 88,Assistenza sociale non residenziale                         ,0,0,1,1,2,2024
UMB,PG,R   ,"Attività artistiche, sportive, di intrattenimento e diver...",0,0,4,5,9,2024
UMB,PG,R 90,"Attività creative, artistiche e di intrattenimento          ",0,0,2,4,6,2024
UMB,PG,R 91,"Attività di biblioteche, archivi, musei ed altre attività...",0,0,0,1,1,2024
UMB,PG,R 92,"Attività riguardanti le lotterie, le scommesse, le case d...",0,0,0,0,0,2024
UMB,PG,R 93,"Attività sportive, di intrattenimento e di divertimento     ",0,0,2,0,2,2024
UMB,PG,S   ,Altre attività di servizi                                   ,0,0,28,2,30,2024
UMB,PG,S 94,Attività di organizzazioni associative                      ,0,0,0,0,0,2024
UMB,PG,S 95,Riparazione di computer e di beni per uso personale e per...,0,0,10,0,10,2024
UMB,PG,S 96,Altre attività di servizi per la persona                    ,0,0,18,2,20,2024
UMB,PG,T   ,Attività di famiglie e convivenze come datori di lavoro p...,0,0,0,0,0,2024
UMB,PG,T 97,Attività di famiglie e convivenze come datori di lavoro p...,0,0,0,0,0,2024
UMB,PG,T 98,Produzione di beni e servizi indifferenziati per uso prop...,0,0,0,0,0,2024
UMB,PG,U   ,Organizzazioni ed organismi extraterritoriali               ,0,0,0,0,0,2024
UMB,PG,U 99,Organizzazioni ed organismi extraterritoriali               ,0,0,0,0,0,2024
UMB,PG,XX  ,Imprese non classificate                                    ,0,0,61,26,87,2024
UMB,PG,TOT ,TOTALE                                                      ,0,1,1172,118,1291,2024
UMB,TR,A   ,"Agricoltura, silvicoltura pesca                             ",0,0,27,4,31,2024
UMB,TR,A 01,"Coltivazioni agricole e produzione di prodotti animali, c...",0,0,27,3,30,2024
UMB,TR,A 02,Silvicoltura ed utilizzo di aree forestali                  ,0,0,0,1,1,2024
UMB,TR,A 03,Pesca e acquacoltura                                        ,0,0,0,0,0,2024
UMB,TR,B   ,Estrazione di minerali da cave e miniere                    ,0,0,0,0,0,2024
UMB,TR,B 05,Estrazione di carbone (esclusa torba)                       ,0,0,0,0,0,2024
UMB,TR,B 06,Estraz.di petrolio greggio e di gas naturale                ,0,0,0,0,0,2024
UMB,TR,B 07,Estrazione di minerali metalliferi                          ,0,0,0,0,0,2024
UMB,TR,B 08,Altre attività di estrazione di minerali da cave e miniere  ,0,0,0,0,0,2024
UMB,TR,B 09,Attività dei servizi di supporto all'estrazione             ,0,0,0,0,0,2024
UMB,TR,C   ,Attività manifatturiere                                     ,0,0,18,6,24,2024
UMB,TR,C 10,Industrie alimentari                                        ,0,0,1,0,1,2024
UMB,TR,C 11,Industria delle bevande                                     ,0,0,0,0,0,2024
UMB,TR,C 12,Industria del tabacco                                       ,0,0,0,0,0,2024
UMB,TR,C 13,Industrie tessili                                           ,0,0,0,0,0,2024
UMB,TR,C 14,Confezione di articoli di abbigliamento; confezione di ar...,0,0,5,0,5,2024
UMB,TR,C 15,Fabbricazione di articoli in pelle e simili                 ,0,0,0,0,0,2024
UMB,TR,C 16,Industria del legno e dei prodotti in legno e sughero (es...,0,0,1,0,1,2024
UMB,TR,C 17,Fabbricazione di carta e di prodotti di carta               ,0,0,0,0,0,2024
UMB,TR,C 18,Stampa e riproduzione di supporti registrati                ,0,0,0,1,1,2024
UMB,TR,C 19,Fabbricazione di coke e prodotti derivanti dalla raffinaz...,0,0,0,0,0,2024
UMB,TR,C 20,Fabbricazione di prodotti chimici                           ,0,0,0,0,0,2024
UMB,TR,C 21,Fabbricazione di prodotti farmaceutici di base e di prepa...,0,0,0,0,0,2024
UMB,TR,C 22,Fabbricazione di articoli in gomma e materie plastiche      ,0,0,0,0,0,2024
UMB,TR,C 23,Fabbricazione di altri prodotti della lavorazione di miner..,0,0,0,2,2,2024
UMB,TR,C 24,Metallurgia                                                 ,0,0,0,0,0,2024
UMB,TR,C 25,Fabbricazione di prodotti in metallo (esclusi macchinari ...,0,0,5,2,7,2024
UMB,TR,C 26,Fabbricazione di computer e prodotti di elettronica e ott...,0,0,0,0,0,2024
UMB,TR,C 27,Fabbricazione di apparecchiature elettriche ed apparecchi...,0,0,0,0,0,2024
UMB,TR,C 28,Fabbricazione di macchinari ed apparecchiature nca          ,0,0,0,0,0,2024
UMB,TR,C 29,"Fabbricazione di autoveicoli, rimorchi e semirimorchi       ",0,0,0,0,0,2024
UMB,TR,C 30,Fabbricazione di altri mezzi di trasporto                   ,0,0,0,0,0,2024
UMB,TR,C 31,Fabbricazione di mobili                                     ,0,0,0,0,0,2024
UMB,TR,C 32,Altre industrie manifatturiere                              ,0,0,5,0,5,2024
UMB,TR,C 33,"Riparazione, manutenzione ed installazione di macchine ed...",0,0,1,1,2,2024
UMB,TR,D   ,"Fornitura di energia elettrica, gas, vapore e aria condiz...",0,0,0,0,0,2024
UMB,TR,D 35,"Fornitura di energia elettrica, gas, vapore e aria condiz...",0,0,0,0,0,2024
UMB,TR,E   ,"Fornitura di acqua; reti fognarie, attività di gestione d...",0,0,0,0,0,2024
UMB,TR,E 36,"Raccolta, trattamento e fornitura di acqua                  ",0,0,0,0,0,2024
UMB,TR,E 37,Gestione delle reti fognarie                                ,0,0,0,0,0,2024
UMB,TR,E 38,"Attività di raccolta, trattamento e smaltimento dei rifiu...",0,0,0,0,0,2024
UMB,TR,E 39,Attività di risanamento e altri servizi di gestione dei r...,0,0,0,0,0,2024
UMB,TR,F   ,Costruzioni                                                 ,0,0,22,22,44,2024
UMB,TR,F 41,Costruzione di edifici                                      ,0,0,4,12,16,2024
UMB,TR,F 42,Ingegneria civile                                           ,0,0,0,1,1,2024
UMB,TR,F 43,Lavori di costruzione specializzati                         ,0,0,18,9,27,2024
UMB,TR,G   ,Commercio all'ingrosso e al dettaglio; riparazione di aut...,0,0,66,5,71,2024
UMB,TR,G 45,Commercio all'ingrosso e al dettaglio e riparazione di au...,0,0,2,0,2,2024
UMB,TR,G 46,Commercio all'ingrosso (escluso quello di autoveicoli e d...,0,0,12,0,12,2024
UMB,TR,G 47,Commercio al dettaglio (escluso quello di autoveicoli e d...,0,0,52,5,57,2024
UMB,TR,H   ,Trasporto e magazzinaggio                                   ,0,0,7,3,10,2024
UMB,TR,H 49,Trasporto terrestre e mediante condotte                     ,0,0,7,0,7,2024
UMB,TR,H 50,Trasporto marittimo e per vie d'acqua                       ,0,0,0,0,0,2024
UMB,TR,H 51,Trasporto aereo                                             ,0,0,0,0,0,2024
UMB,TR,H 52,Magazzinaggio e attività di supporto ai trasporti           ,0,0,0,3,3,2024
UMB,TR,H 53,Servizi postali e attività di corriere                      ,0,0,0,0,0,2024
UMB,TR,I   ,Attività dei servizi alloggio e ristorazione                ,0,0,15,5,20,2024
UMB,TR,I 55,Alloggio                                                    ,0,0,2,0,2,2024
UMB,TR,I 56,Attività dei servizi di ristorazione                        ,0,0,13,5,18,2024
UMB,TR,J   ,Servizi di informazione e comunicazione                     ,0,0,5,0,5,2024
UMB,TR,J 58,Attività editoriali                                         ,0,0,1,0,1,2024
UMB,TR,J 59,"Attività di produzione cinematografica, di video e di pro...",0,0,2,0,2,2024
UMB,TR,J 60,Attività di programmazione e trasmissione                   ,0,0,0,0,0,2024
UMB,TR,J 61,Telecomunicazioni                                           ,0,0,0,0,0,2024
UMB,TR,J 62,"Produzione di software, consulenza informatica e attività...",0,0,2,0,2,2024
UMB,TR,J 63,Attività dei servizi d'informazione e altri servizi infor...,0,0,0,0,0,2024
UMB,TR,K   ,Attività finanziarie e assicurative                         ,0,0,0,1,1,2024
UMB,TR,K 64,Attività di servizi finanziari (escluse le assicurazioni ...,0,0,0,0,0,2024
UMB,TR,K 65,"Assicurazioni, riassicurazioni e fondi pensione (escluse ...",0,0,0,0,0,2024
UMB,TR,K 66,Attività ausiliarie dei servizi finanziari e delle attivi...,0,0,0,1,1,2024
UMB,TR,L   ,Attivita' immobiliari                                       ,0,0,2,0,2,2024
UMB,TR,L 68,Attivita' immobiliari                                       ,0,0,2,0,2,2024
UMB,TR,M   ,"Attività professionali, scientifiche e tecniche             ",0,0,3,4,7,2024
UMB,TR,M 69,Attività legali e contabilità                               ,0,0,0,0,0,2024
UMB,TR,M 70,Attività di direzione aziendale e di consulenza gestional...,0,0,0,1,1,2024
UMB,TR,M 71,Attività degli studi di architettura e d'ingegneria; coll...,0,0,1,0,1,2024
UMB,TR,M 72,Ricerca scientifica e sviluppo                              ,0,0,0,0,0,2024
UMB,TR,M 73,Pubblicità e ricerche di mercato                            ,0,0,0,0,0,2024
UMB,TR,M 74,"Altre attività professionali, scientifiche e tecniche       ",0,0,2,3,5,2024
UMB,TR,M 75,Servizi veterinari                                          ,0,0,0,0,0,2024
UMB,TR,N   ,"Noleggio, agenzie di viaggio, servizi di supporto alle im...",0,0,8,7,15,2024
UMB,TR,N 77,Attività di noleggio e leasing operativo                    ,0,0,0,1,1,2024
UMB,TR,N 78,"Attività di ricerca, selezione, fornitura di personale      ",0,0,0,0,0,2024
UMB,TR,N 79,"Attività dei servizi delle agenzie di viaggio, dei tour o...",0,0,0,0,0,2024
UMB,TR,N 80,Servizi di vigilanza e investigazione                       ,0,0,0,0,0,2024
UMB,TR,N 81,Attività di servizi per edifici e paesaggio                 ,0,0,0,5,5,2024
UMB,TR,N 82,Attività di supporto per le funzioni d'ufficio e altri se...,0,0,8,1,9,2024
UMB,TR,O   ,Amministrazione pubblica e difesa; assicurazione sociale ...,0,0,0,0,0,2024
UMB,TR,O 84,Amministrazione pubblica e difesa; assicurazione sociale ...,0,0,0,0,0,2024
UMB,TR,P   ,Istruzione                                                  ,0,0,0,1,1,2024
UMB,TR,P 85,Istruzione                                                  ,0,0,0,1,1,2024
UMB,TR,Q   ,Sanita' e assistenza sociale                                ,0,0,0,7,7,2024
UMB,TR,Q 86,Assistenza sanitaria                                        ,0,0,0,0,0,2024
UMB,TR,Q 87,Servizi di assistenza sociale residenziale                  ,0,0,0,0,0,2024
UMB,TR,Q 88,Assistenza sociale non residenziale                         ,0,0,0,7,7,2024
UMB,TR,R   ,"Attività artistiche, sportive, di intrattenimento e diver...",0,0,2,1,3,2024
UMB,TR,R 90,"Attività creative, artistiche e di intrattenimento          ",0,0,2,1,3,2024
UMB,TR,R 91,"Attività di biblioteche, archivi, musei ed altre attività...",0,0,0,0,0,2024
UMB,TR,R 92,"Attività riguardanti le lotterie, le scommesse, le case d...",0,0,0,0,0,2024
UMB,TR,R 93,"Attività sportive, di intrattenimento e di divertimento     ",0,0,0,0,0,2024
UMB,TR,S   ,Altre attività di servizi                                   ,0,0,5,2,7,2024
UMB,TR,S 94,Attività di organizzazioni associative                      ,0,0,0,0,0,2024
UMB,TR,S 95,Riparazione di computer e di beni per uso personale e per...,0,0,1,1,2,2024
UMB,TR,S 96,Altre attività di servizi per la persona                    ,0,0,4,1,5,2024
UMB,TR,T   ,Attività di famiglie e convivenze come datori di lavoro p...,0,0,0,0,0,2024
UMB,TR,T 97,Attività di famiglie e convivenze come datori di lavoro p...,0,0,0,0,0,2024
UMB,TR,T 98,Produzione di beni e servizi indifferenziati per uso prop...,0,0,0,0,0,2024
UMB,TR,U   ,Organizzazioni ed organismi extraterritoriali               ,0,0,0,0,0,2024
UMB,TR,U 99,Organizzazioni ed organismi extraterritoriali               ,0,0,0,0,0,2024
UMB,TR,XX  ,Imprese non classificate                                    ,0,0,3,21,24,2024
UMB,TR,TOT ,TOTALE                                                      ,0,0,183,89,272,2024
MAR,  ,A   ,"Agricoltura, silvicoltura pesca                             ",16,103,411,19,549,2024
MAR,  ,A 01,"Coltivazioni agricole e produzione di prodotti animali, c...",16,83,389,15,503,2024
MAR,  ,A 02,Silvicoltura ed utilizzo di aree forestali                  ,0,9,12,2,23,2024
MAR,  ,A 03,Pesca e acquacoltura                                        ,0,11,10,2,23,2024
MAR,  ,B   ,Estrazione di minerali da cave e miniere                    ,1,2,0,0,3,2024
MAR,  ,B 05,Estrazione di carbone (esclusa torba)                       ,0,0,0,0,0,2024
MAR,  ,B 06,Estraz.di petrolio greggio e di gas naturale                ,0,0,0,0,0,2024
MAR,  ,B 07,Estrazione di minerali metalliferi                          ,0,0,0,0,0,2024
MAR,  ,B 08,Altre attività di estrazione di minerali da cave e miniere  ,1,2,0,0,3,2024
MAR,  ,B 09,Attività dei servizi di supporto all'estrazione             ,0,0,0,0,0,2024
MAR,  ,C   ,Attività manifatturiere                                     ,308,365,291,42,1006,2024
MAR,  ,C 10,Industrie alimentari                                        ,12,42,13,10,77,2024
MAR,  ,C 11,Industria delle bevande                                     ,2,1,0,0,3,2024
MAR,  ,C 12,Industria del tabacco                                       ,0,0,0,0,0,2024
MAR,  ,C 13,Industrie tessili                                           ,6,6,11,2,25,2024
MAR,  ,C 14,Confezione di articoli di abbigliamento; confezione di ar...,51,52,89,2,194,2024
MAR,  ,C 15,Fabbricazione di articoli in pelle e simili                 ,52,21,55,2,130,2024
MAR,  ,C 16,Industria del legno e dei prodotti in legno e sughero (es...,17,25,8,2,52,2024
MAR,  ,C 17,Fabbricazione di carta e di prodotti di carta               ,1,4,0,0,5,2024
MAR,  ,C 18,Stampa e riproduzione di supporti registrati                ,3,14,2,2,21,2024
MAR,  ,C 19,Fabbricazione di coke e prodotti derivanti dalla raffinaz...,1,0,0,0,1,2024
MAR,  ,C 20,Fabbricazione di prodotti chimici                           ,1,5,1,0,7,2024
MAR,  ,C 21,Fabbricazione di prodotti farmaceutici di base e di prepa...,0,0,0,0,0,2024
MAR,  ,C 22,Fabbricazione di articoli in gomma e materie plastiche      ,7,10,5,4,26,2024
MAR,  ,C 23,Fabbricazione di altri prodotti della lavorazione di miner..,4,9,3,1,17,2024
MAR,  ,C 24,Metallurgia                                                 ,2,1,1,0,4,2024
MAR,  ,C 25,Fabbricazione di prodotti in metallo (esclusi macchinari ...,34,37,27,5,103,2024
MAR,  ,C 26,Fabbricazione di computer e prodotti di elettronica e ott...,3,7,2,1,13,2024
MAR,  ,C 27,Fabbricazione di apparecchiature elettriche ed apparecchi...,12,11,2,3,28,2024
MAR,  ,C 28,Fabbricazione di macchinari ed apparecchiature nca          ,10,8,1,1,20,2024
MAR,  ,C 29,"Fabbricazione di autoveicoli, rimorchi e semirimorchi       ",3,1,0,0,4,2024
MAR,  ,C 30,Fabbricazione di altri mezzi di trasporto                   ,19,21,16,1,57,2024
MAR,  ,C 31,Fabbricazione di mobili                                     ,53,67,33,4,157,2024
MAR,  ,C 32,Altre industrie manifatturiere                              ,10,9,6,1,26,2024
MAR,  ,C 33,"Riparazione, manutenzione ed installazione di macchine ed...",5,14,16,1,36,2024
MAR,  ,D   ,"Fornitura di energia elettrica, gas, vapore e aria condiz...",0,0,0,0,0,2024
MAR,  ,D 35,"Fornitura di energia elettrica, gas, vapore e aria condiz...",0,0,0,0,0,2024
MAR,  ,E   ,"Fornitura di acqua; reti fognarie, attività di gestione d...",6,1,4,2,13,2024
MAR,  ,E 36,"Raccolta, trattamento e fornitura di acqua                  ",0,0,0,0,0,2024
MAR,  ,E 37,Gestione delle reti fognarie                                ,1,0,1,0,2,2024
MAR,  ,E 38,"Attività di raccolta, trattamento e smaltimento dei rifiu...",5,1,3,1,10,2024
MAR,  ,E 39,Attività di risanamento e altri servizi di gestione dei r...,0,0,0,1,1,2024
MAR,  ,F   ,Costruzioni                                                 ,221,282,418,54,975,2024
MAR,  ,F 41,Costruzione di edifici                                      ,164,154,81,36,435,2024
MAR,  ,F 42,Ingegneria civile                                           ,2,6,1,2,11,2024
MAR,  ,F 43,Lavori di costruzione specializzati                         ,55,122,336,16,529,2024
MAR,  ,G   ,Commercio all'ingrosso e al dettaglio; riparazione di aut...,320,559,793,32,1704,2024
MAR,  ,G 45,Commercio all'ingrosso e al dettaglio e riparazione di au...,50,55,60,4,169,2024
MAR,  ,G 46,Commercio all'ingrosso (escluso quello di autoveicoli e d...,180,185,198,10,573,2024
MAR,  ,G 47,Commercio al dettaglio (escluso quello di autoveicoli e d...,90,319,535,18,962,2024
MAR,  ,H   ,Trasporto e magazzinaggio                                   ,23,53,55,31,162,2024
MAR,  ,H 49,Trasporto terrestre e mediante condotte                     ,19,45,49,8,121,2024
MAR,  ,H 50,Trasporto marittimo e per vie d'acqua                       ,0,0,1,0,1,2024
MAR,  ,H 51,Trasporto aereo                                             ,1,0,0,0,1,2024
MAR,  ,H 52,Magazzinaggio e attività di supporto ai trasporti           ,3,8,4,22,37,2024
MAR,  ,H 53,Servizi postali e attività di corriere                      ,0,0,1,1,2,2024
MAR,  ,I   ,Attività dei servizi alloggio e ristorazione                ,89,620,158,26,893,2024
MAR,  ,I 55,Alloggio                                                    ,12,28,2,1,43,2024
MAR,  ,I 56,Attività dei servizi di ristorazione                        ,77,592,156,25,850,2024
MAR,  ,J   ,Servizi di informazione e comunicazione                     ,36,40,22,15,113,2024
MAR,  ,J 58,Attività editoriali                                         ,4,4,0,3,11,2024
MAR,  ,J 59,"Attività di produzione cinematografica, di video e di pro...",4,5,2,0,11,2024
MAR,  ,J 60,Attività di programmazione e trasmissione                   ,4,3,0,1,8,2024
MAR,  ,J 61,Telecomunicazioni                                           ,2,4,5,0,11,2024
MAR,  ,J 62,"Produzione di software, consulenza informatica e attività...",12,4,7,1,24,2024
MAR,  ,J 63,Attività dei servizi d'informazione e altri servizi infor...,10,20,8,10,48,2024
MAR,  ,K   ,Attività finanziarie e assicurative                         ,8,34,36,1,79,2024
MAR,  ,K 64,Attività di servizi finanziari (escluse le assicurazioni ...,4,4,0,1,9,2024
MAR,  ,K 65,"Assicurazioni, riassicurazioni e fondi pensione (escluse ...",0,1,0,0,1,2024
MAR,  ,K 66,Attività ausiliarie dei servizi finanziari e delle attivi...,4,29,36,0,69,2024
MAR,  ,L   ,Attivita' immobiliari                                       ,75,83,15,0,173,2024
MAR,  ,L 68,Attivita' immobiliari                                       ,75,83,15,0,173,2024
MAR,  ,M   ,"Attività professionali, scientifiche e tecniche             ",76,68,46,17,207,2024
MAR,  ,M 69,Attività legali e contabilità                               ,3,7,1,1,12,2024
MAR,  ,M 70,Attività di direzione aziendale e di consulenza gestional...,22,11,7,9,49,2024
MAR,  ,M 71,Attività degli studi di architettura e d'ingegneria; coll...,7,6,3,1,17,2024
MAR,  ,M 72,Ricerca scientifica e sviluppo                              ,1,0,0,0,1,2024
MAR,  ,M 73,Pubblicità e ricerche di mercato                            ,21,12,6,3,42,2024
MAR,  ,M 74,"Altre attività professionali, scientifiche e tecniche       ",22,32,29,3,86,2024
MAR,  ,M 75,Servizi veterinari                                          ,0,0,0,0,0,2024
MAR,  ,N   ,"Noleggio, agenzie di viaggio, servizi di supporto alle im...",28,42,84,33,187,2024
MAR,  ,N 77,Attività di noleggio e leasing operativo                    ,6,6,7,1,20,2024
MAR,  ,N 78,"Attività di ricerca, selezione, fornitura di personale      ",0,1,1,0,2,2024
MAR,  ,N 79,"Attività dei servizi delle agenzie di viaggio, dei tour o...",6,7,6,1,20,2024
MAR,  ,N 80,Servizi di vigilanza e investigazione                       ,0,1,0,0,1,2024
MAR,  ,N 81,Attività di servizi per edifici e paesaggio                 ,3,15,36,17,71,2024
MAR,  ,N 82,Attività di supporto per le funzioni d'ufficio e altri se...,13,12,34,14,73,2024
MAR,  ,O   ,Amministrazione pubblica e difesa; assicurazione sociale ...,0,0,0,1,1,2024
MAR,  ,O 84,Amministrazione pubblica e difesa; assicurazione sociale ...,0,0,0,1,1,2024
MAR,  ,P   ,Istruzione                                                  ,8,3,2,2,15,2024
MAR,  ,P 85,Istruzione                                                  ,8,3,2,2,15,2024
MAR,  ,Q   ,Sanita' e assistenza sociale                                ,3,6,2,21,32,2024
MAR,  ,Q 86,Assistenza sanitaria                                        ,2,5,0,2,9,2024
MAR,  ,Q 87,Servizi di assistenza sociale residenziale                  ,0,0,0,5,5,2024
MAR,  ,Q 88,Assistenza sociale non residenziale                         ,1,1,2,14,18,2024
MAR,  ,R   ,"Attività artistiche, sportive, di intrattenimento e diver...",39,47,23,12,121,2024
MAR,  ,R 90,"Attività creative, artistiche e di intrattenimento          ",1,11,6,5,23,2024
MAR,  ,R 91,"Attività di biblioteche, archivi, musei ed altre attività...",0,0,0,0,0,2024
MAR,  ,R 92,"Attività riguardanti le lotterie, le scommesse, le case d...",1,3,2,0,6,2024
MAR,  ,R 93,"Attività sportive, di intrattenimento e di divertimento     ",37,33,15,7,92,2024
MAR,  ,S   ,Altre attività di servizi                                   ,12,50,50,12,124,2024
MAR,  ,S 94,Attività di organizzazioni associative                      ,0,0,0,1,1,2024
MAR,  ,S 95,Riparazione di computer e di beni per uso personale e per...,4,8,18,1,31,2024
MAR,  ,S 96,Altre attività di servizi per la persona                    ,8,42,32,10,92,2024
MAR,  ,T   ,Attività di famiglie e convivenze come datori di lavoro p...,0,0,0,0,0,2024
MAR,  ,T 97,Attività di famiglie e convivenze come datori di lavoro p...,0,0,0,0,0,2024
MAR,  ,T 98,Produzione di beni e servizi indifferenziati per uso prop...,0,0,0,0,0,2024
MAR,  ,U   ,Organizzazioni ed organismi extraterritoriali               ,0,0,0,0,0,2024
MAR,  ,U 99,Organizzazioni ed organismi extraterritoriali               ,0,0,0,0,0,2024
MAR,  ,XX  ,Imprese non classificate                                    ,338,619,145,67,1169,2024
MAR,  ,TOT ,TOTALE                                                      ,1607,2977,2555,387,7526,2024
MAR,PS,A   ,"Agricoltura, silvicoltura pesca                             ",4,33,179,1,217,2024
MAR,PS,A 01,"Coltivazioni agricole e produzione di prodotti animali, c...",4,25,162,0,191,2024
MAR,PS,A 02,Silvicoltura ed utilizzo di aree forestali                  ,0,7,10,1,18,2024
MAR,PS,A 03,Pesca e acquacoltura                                        ,0,1,7,0,8,2024
MAR,PS,B   ,Estrazione di minerali da cave e miniere                    ,0,0,0,0,0,2024
MAR,PS,B 05,Estrazione di carbone (esclusa torba)                       ,0,0,0,0,0,2024
MAR,PS,B 06,Estraz.di petrolio greggio e di gas naturale                ,0,0,0,0,0,2024
MAR,PS,B 07,Estrazione di minerali metalliferi                          ,0,0,0,0,0,2024
MAR,PS,B 08,Altre attività di estrazione di minerali da cave e miniere  ,0,0,0,0,0,2024
MAR,PS,B 09,Attività dei servizi di supporto all'estrazione             ,0,0,0,0,0,2024
MAR,PS,C   ,Attività manifatturiere                                     ,115,209,188,6,518,2024
MAR,PS,C 10,Industrie alimentari                                        ,2,16,9,0,27,2024
MAR,PS,C 11,Industria delle bevande                                     ,0,0,0,0,0,2024
MAR,PS,C 12,Industria del tabacco                                       ,0,0,0,0,0,2024
MAR,PS,C 13,Industrie tessili                                           ,1,3,10,1,15,2024
MAR,PS,C 14,Confezione di articoli di abbigliamento; confezione di ar...,14,34,69,0,117,2024
MAR,PS,C 15,Fabbricazione di articoli in pelle e simili                 ,4,2,2,0,8,2024
MAR,PS,C 16,Industria del legno e dei prodotti in legno e sughero (es...,7,16,8,0,31,2024
MAR,PS,C 17,Fabbricazione di carta e di prodotti di carta               ,0,1,0,0,1,2024
MAR,PS,C 18,Stampa e riproduzione di supporti registrati                ,0,6,1,0,7,2024
MAR,PS,C 19,Fabbricazione di coke e prodotti derivanti dalla raffinaz...,0,0,0,0,0,2024
MAR,PS,C 20,Fabbricazione di prodotti chimici                           ,0,5,1,0,6,2024
MAR,PS,C 21,Fabbricazione di prodotti farmaceutici di base e di prepa...,0,0,0,0,0,2024
MAR,PS,C 22,Fabbricazione di articoli in gomma e materie plastiche      ,2,3,3,1,9,2024
MAR,PS,C 23,Fabbricazione di altri prodotti della lavorazione di miner..,2,7,3,0,12,2024
MAR,PS,C 24,Metallurgia                                                 ,0,1,0,0,1,2024
MAR,PS,C 25,Fabbricazione di prodotti in metallo (esclusi macchinari ...,14,19,14,0,47,2024
MAR,PS,C 26,Fabbricazione di computer e prodotti di elettronica e ott...,2,1,2,0,5,2024
MAR,PS,C 27,Fabbricazione di apparecchiature elettriche ed apparecchi...,5,5,1,0,11,2024
MAR,PS,C 28,Fabbricazione di macchinari ed apparecchiature nca          ,2,4,0,1,7,2024
MAR,PS,C 29,"Fabbricazione di autoveicoli, rimorchi e semirimorchi       ",1,1,0,0,2,2024
MAR,PS,C 30,Fabbricazione di altri mezzi di trasporto                   ,14,14,16,1,45,2024
MAR,PS,C 31,Fabbricazione di mobili                                     ,42,62,32,2,138,2024
MAR,PS,C 32,Altre industrie manifatturiere                              ,2,4,4,0,10,2024
MAR,PS,C 33,"Riparazione, manutenzione ed installazione di macchine ed...",1,5,13,0,19,2024
MAR,PS,D   ,"Fornitura di energia elettrica, gas, vapore e aria condiz...",0,0,0,0,0,2024
MAR,PS,D 35,"Fornitura di energia elettrica, gas, vapore e aria condiz...",0,0,0,0,0,2024
MAR,PS,E   ,"Fornitura di acqua; reti fognarie, attività di gestione d...",2,0,4,0,6,2024
MAR,PS,E 36,"Raccolta, trattamento e fornitura di acqua                  ",0,0,0,0,0,2024
MAR,PS,E 37,Gestione delle reti fognarie                                ,0,0,1,0,1,2024
MAR,PS,E 38,"Attività di raccolta, trattamento e smaltimento dei rifiu...",2,0,3,0,5,2024
MAR,PS,E 39,Attività di risanamento e altri servizi di gestione dei r...,0,0,0,0,0,2024
MAR,PS,F   ,Costruzioni                                                 ,75,97,312,13,497,2024
MAR,PS,F 41,Costruzione di edifici                                      ,55,58,59,9,181,2024
MAR,PS,F 42,Ingegneria civile                                           ,1,3,1,0,5,2024
MAR,PS,F 43,Lavori di costruzione specializzati                         ,19,36,252,4,311,2024
MAR,PS,G   ,Commercio all'ingrosso e al dettaglio; riparazione di aut...,77,211,522,5,815,2024
MAR,PS,G 45,Commercio all'ingrosso e al dettaglio e riparazione di au...,12,14,34,1,61,2024
MAR,PS,G 46,Commercio all'ingrosso (escluso quello di autoveicoli e d...,41,91,133,2,267,2024
MAR,PS,G 47,Commercio al dettaglio (escluso quello di autoveicoli e d...,24,106,355,2,487,2024
MAR,PS,H   ,Trasporto e magazzinaggio                                   ,6,18,37,3,64,2024
MAR,PS,H 49,Trasporto terrestre e mediante condotte                     ,4,16,34,1,55,2024
MAR,PS,H 50,Trasporto marittimo e per vie d'acqua                       ,0,0,0,0,0,2024
MAR,PS,H 51,Trasporto aereo                                             ,1,0,0,0,1,2024
MAR,PS,H 52,Magazzinaggio e attività di supporto ai trasporti           ,1,2,3,2,8,2024
MAR,PS,H 53,Servizi postali e attività di corriere                      ,0,0,0,0,0,2024
MAR,PS,I   ,Attività dei servizi alloggio e ristorazione                ,26,238,109,1,374,2024
MAR,PS,I 55,Alloggio                                                    ,5,18,1,0,24,2024
MAR,PS,I 56,Attività dei servizi di ristorazione                        ,21,220,108,1,350,2024
MAR,PS,J   ,Servizi di informazione e comunicazione                     ,9,12,17,2,40,2024
MAR,PS,J 58,Attività editoriali                                         ,0,1,0,0,1,2024
MAR,PS,J 59,"Attività di produzione cinematografica, di video e di pro...",2,1,2,0,5,2024
MAR,PS,J 60,Attività di programmazione e trasmissione                   ,0,0,0,0,0,2024
MAR,PS,J 61,Telecomunicazioni                                           ,2,1,5,0,8,2024
MAR,PS,J 62,"Produzione di software, consulenza informatica e attività...",1,2,5,1,9,2024
MAR,PS,J 63,Attività dei servizi d'informazione e altri servizi infor...,4,7,5,1,17,2024
MAR,PS,K   ,Attività finanziarie e assicurative                         ,1,14,27,0,42,2024
MAR,PS,K 64,Attività di servizi finanziari (escluse le assicurazioni ...,0,1,0,0,1,2024
MAR,PS,K 65,"Assicurazioni, riassicurazioni e fondi pensione (escluse ...",0,0,0,0,0,2024
MAR,PS,K 66,Attività ausiliarie dei servizi finanziari e delle attivi...,1,13,27,0,41,2024
MAR,PS,L   ,Attivita' immobiliari                                       ,24,44,9,0,77,2024
MAR,PS,L 68,Attivita' immobiliari                                       ,24,44,9,0,77,2024
MAR,PS,M   ,"Attività professionali, scientifiche e tecniche             ",23,22,33,3,81,2024
MAR,PS,M 69,Attività legali e contabilità                               ,1,1,1,1,4,2024
MAR,PS,M 70,Attività di direzione aziendale e di consulenza gestional...,6,4,7,1,18,2024
MAR,PS,M 71,Attività degli studi di architettura e d'ingegneria; coll...,4,2,1,0,7,2024
MAR,PS,M 72,Ricerca scientifica e sviluppo                              ,0,0,0,0,0,2024
MAR,PS,M 73,Pubblicità e ricerche di mercato                            ,5,4,4,1,14,2024
MAR,PS,M 74,"Altre attività professionali, scientifiche e tecniche       ",7,11,20,0,38,2024
MAR,PS,M 75,Servizi veterinari                                          ,0,0,0,0,0,2024
MAR,PS,N   ,"Noleggio, agenzie di viaggio, servizi di supporto alle im...",6,12,57,4,79,2024
MAR,PS,N 77,Attività di noleggio e leasing operativo                    ,1,3,6,0,10,2024
MAR,PS,N 78,"Attività di ricerca, selezione, fornitura di personale      ",0,0,1,0,1,2024
MAR,PS,N 79,"Attività dei servizi delle agenzie di viaggio, dei tour o...",1,1,5,0,7,2024
MAR,PS,N 80,Servizi di vigilanza e investigazione                       ,0,1,0,0,1,2024
MAR,PS,N 81,Attività di servizi per edifici e paesaggio                 ,0,3,25,2,30,2024
MAR,PS,N 82,Attività di supporto per le funzioni d'ufficio e altri se...,4,4,20,2,30,2024
MAR,PS,O   ,Amministrazione pubblica e difesa; assicurazione sociale ...,0,0,0,0,0,2024
MAR,PS,O 84,Amministrazione pubblica e difesa; assicurazione sociale ...,0,0,0,0,0,2024
MAR,PS,P   ,Istruzione                                                  ,2,2,1,0,5,2024
MAR,PS,P 85,Istruzione                                                  ,2,2,1,0,5,2024
MAR,PS,Q   ,Sanita' e assistenza sociale                                ,1,3,1,5,10,2024
MAR,PS,Q 86,Assistenza sanitaria                                        ,1,2,0,1,4,2024
MAR,PS,Q 87,Servizi di assistenza sociale residenziale                  ,0,0,0,2,2,2024
MAR,PS,Q 88,Assistenza sociale non residenziale                         ,0,1,1,2,4,2024
MAR,PS,R   ,"Attività artistiche, sportive, di intrattenimento e diver...",16,22,12,2,52,2024
MAR,PS,R 90,"Attività creative, artistiche e di intrattenimento          ",0,6,5,1,12,2024
MAR,PS,R 91,"Attività di biblioteche, archivi, musei ed altre attività...",0,0,0,0,0,2024
MAR,PS,R 92,"Attività riguardanti le lotterie, le scommesse, le case d...",0,1,0,0,1,2024
MAR,PS,R 93,"Attività sportive, di intrattenimento e di divertimento     ",16,15,7,1,39,2024
MAR,PS,S   ,Altre attività di servizi                                   ,5,13,31,1,50,2024
MAR,PS,S 94,Attività di organizzazioni associative                      ,0,0,0,0,0,2024
MAR,PS,S 95,Riparazione di computer e di beni per uso personale e per...,2,3,12,1,18,2024
MAR,PS,S 96,Altre attività di servizi per la persona                    ,3,10,19,0,32,2024
MAR,PS,T   ,Attività di famiglie e convivenze come datori di lavoro p...,0,0,0,0,0,2024
MAR,PS,T 97,Attività di famiglie e convivenze come datori di lavoro p...,0,0,0,0,0,2024
MAR,PS,T 98,Produzione di beni e servizi indifferenziati per uso prop...,0,0,0,0,0,2024
MAR,PS,U   ,Organizzazioni ed organismi extraterritoriali               ,0,0,0,0,0,2024
MAR,PS,U 99,Organizzazioni ed organismi extraterritoriali               ,0,0,0,0,0,2024
MAR,PS,XX  ,Imprese non classificate                                    ,91,228,75,15,409,2024
MAR,PS,TOT ,TOTALE                                                      ,483,1178,1614,61,3336,2024
MAR,AN,A   ,"Agricoltura, silvicoltura pesca                             ",2,24,98,4,128,2024
MAR,AN,A 01,"Coltivazioni agricole e produzione di prodotti animali, c...",2,21,98,2,123,2024
MAR,AN,A 02,Silvicoltura ed utilizzo di aree forestali                  ,0,0,0,1,1,2024
MAR,AN,A 03,Pesca e acquacoltura                                        ,0,3,0,1,4,2024
MAR,AN,B   ,Estrazione di minerali da cave e miniere                    ,0,0,0,0,0,2024
MAR,AN,B 05,Estrazione di carbone (esclusa torba)                       ,0,0,0,0,0,2024
MAR,AN,B 06,Estraz.di petrolio greggio e di gas naturale                ,0,0,0,0,0,2024
MAR,AN,B 07,Estrazione di minerali metalliferi                          ,0,0,0,0,0,2024
MAR,AN,B 08,Altre attività di estrazione di minerali da cave e miniere  ,0,0,0,0,0,2024
MAR,AN,B 09,Attività dei servizi di supporto all'estrazione             ,0,0,0,0,0,2024
MAR,AN,C   ,Attività manifatturiere                                     ,68,87,22,17,194,2024
MAR,AN,C 10,Industrie alimentari                                        ,0,13,2,3,18,2024
MAR,AN,C 11,Industria delle bevande                                     ,2,0,0,0,2,2024
MAR,AN,C 12,Industria del tabacco                                       ,0,0,0,0,0,2024
MAR,AN,C 13,Industrie tessili                                           ,2,2,0,0,4,2024
MAR,AN,C 14,Confezione di articoli di abbigliamento; confezione di ar...,12,8,7,1,28,2024
MAR,AN,C 15,Fabbricazione di articoli in pelle e simili                 ,4,3,0,0,7,2024
MAR,AN,C 16,Industria del legno e dei prodotti in legno e sughero (es...,4,6,0,2,12,2024
MAR,AN,C 17,Fabbricazione di carta e di prodotti di carta               ,0,2,0,0,2,2024
MAR,AN,C 18,Stampa e riproduzione di supporti registrati                ,2,3,1,1,7,2024
MAR,AN,C 19,Fabbricazione di coke e prodotti derivanti dalla raffinaz...,0,0,0,0,0,2024
MAR,AN,C 20,Fabbricazione di prodotti chimici                           ,1,0,0,0,1,2024
MAR,AN,C 21,Fabbricazione di prodotti farmaceutici di base e di prepa...,0,0,0,0,0,2024
MAR,AN,C 22,Fabbricazione di articoli in gomma e materie plastiche      ,3,6,0,1,10,2024
MAR,AN,C 23,Fabbricazione di altri prodotti della lavorazione di miner..,1,1,0,0,2,2024
MAR,AN,C 24,Metallurgia                                                 ,0,0,0,0,0,2024
MAR,AN,C 25,Fabbricazione di prodotti in metallo (esclusi macchinari ...,10,10,8,3,31,2024
MAR,AN,C 26,Fabbricazione di computer e prodotti di elettronica e ott...,1,4,0,1,6,2024
MAR,AN,C 27,Fabbricazione di apparecchiature elettriche ed apparecchi...,5,6,0,3,14,2024
MAR,AN,C 28,Fabbricazione di macchinari ed apparecchiature nca          ,5,3,1,0,9,2024
MAR,AN,C 29,"Fabbricazione di autoveicoli, rimorchi e semirimorchi       ",1,0,0,0,1,2024
MAR,AN,C 30,Fabbricazione di altri mezzi di trasporto                   ,4,6,0,0,10,2024
MAR,AN,C 31,Fabbricazione di mobili                                     ,4,4,0,2,10,2024
MAR,AN,C 32,Altre industrie manifatturiere                              ,4,4,2,0,10,2024
MAR,AN,C 33,"Riparazione, manutenzione ed installazione di macchine ed...",3,6,1,0,10,2024
MAR,AN,D   ,"Fornitura di energia elettrica, gas, vapore e aria condiz...",0,0,0,0,0,2024
MAR,AN,D 35,"Fornitura di energia elettrica, gas, vapore e aria condiz...",0,0,0,0,0,2024
MAR,AN,E   ,"Fornitura di acqua; reti fognarie, attività di gestione d...",0,0,0,0,0,2024
MAR,AN,E 36,"Raccolta, trattamento e fornitura di acqua                  ",0,0,0,0,0,2024
MAR,AN,E 37,Gestione delle reti fognarie                                ,0,0,0,0,0,2024
MAR,AN,E 38,"Attività di raccolta, trattamento e smaltimento dei rifiu...",0,0,0,0,0,2024
MAR,AN,E 39,Attività di risanamento e altri servizi di gestione dei r...,0,0,0,0,0,2024
MAR,AN,F   ,Costruzioni                                                 ,75,114,34,24,247,2024
MAR,AN,F 41,Costruzione di edifici                                      ,64,63,2,17,146,2024
MAR,AN,F 42,Ingegneria civile                                           ,0,0,0,1,1,2024
MAR,AN,F 43,Lavori di costruzione specializzati                         ,11,51,32,6,100,2024
MAR,AN,G   ,Commercio all'ingrosso e al dettaglio; riparazione di aut...,87,185,77,13,362,2024
MAR,AN,G 45,Commercio all'ingrosso e al dettaglio e riparazione di au...,12,20,9,1,42,2024
MAR,AN,G 46,Commercio all'ingrosso (escluso quello di autoveicoli e d...,52,37,28,2,119,2024
MAR,AN,G 47,Commercio al dettaglio (escluso quello di autoveicoli e d...,23,128,40,10,201,2024
MAR,AN,H   ,Trasporto e magazzinaggio                                   ,6,16,9,10,41,2024
MAR,AN,H 49,Trasporto terrestre e mediante condotte                     ,6,13,8,1,28,2024
MAR,AN,H 50,Trasporto marittimo e per vie d'acqua                       ,0,0,0,0,0,2024
MAR,AN,H 51,Trasporto aereo                                             ,0,0,0,0,0,2024
MAR,AN,H 52,Magazzinaggio e attività di supporto ai trasporti           ,0,3,1,9,13,2024
MAR,AN,H 53,Servizi postali e attività di corriere                      ,0,0,0,0,0,2024
MAR,AN,I   ,Attività dei servizi alloggio e ristorazione                ,26,217,10,12,265,2024
MAR,AN,I 55,Alloggio                                                    ,1,5,0,0,6,2024
MAR,AN,I 56,Attività dei servizi di ristorazione                        ,25,212,10,12,259,2024
MAR,AN,J   ,Servizi di informazione e comunicazione                     ,12,13,0,2,27,2024
MAR,AN,J 58,Attività editoriali                                         ,3,3,0,0,6,2024
MAR,AN,J 59,"Attività di produzione cinematografica, di video e di pro...",2,3,0,0,5,2024
MAR,AN,J 60,Attività di programmazione e trasmissione                   ,0,0,0,0,0,2024
MAR,AN,J 61,Telecomunicazioni                                           ,0,1,0,0,1,2024
MAR,AN,J 62,"Produzione di software, consulenza informatica e attività...",5,1,0,0,6,2024
MAR,AN,J 63,Attività dei servizi d'informazione e altri servizi infor...,2,5,0,2,9,2024
MAR,AN,K   ,Attività finanziarie e assicurative                         ,2,12,3,1,18,2024
MAR,AN,K 64,Attività di servizi finanziari (escluse le assicurazioni ...,1,2,0,1,4,2024
MAR,AN,K 65,"Assicurazioni, riassicurazioni e fondi pensione (escluse ...",0,0,0,0,0,2024
MAR,AN,K 66,Attività ausiliarie dei servizi finanziari e delle attivi...,1,10,3,0,14,2024
MAR,AN,L   ,Attivita' immobiliari                                       ,26,29,1,0,56,2024
MAR,AN,L 68,Attivita' immobiliari                                       ,26,29,1,0,56,2024
MAR,AN,M   ,"Attività professionali, scientifiche e tecniche             ",33,27,3,2,65,2024
MAR,AN,M 69,Attività legali e contabilità                               ,2,4,0,0,6,2024
MAR,AN,M 70,Attività di direzione aziendale e di consulenza gestional...,12,4,0,1,17,2024
MAR,AN,M 71,Attività degli studi di architettura e d'ingegneria; coll...,3,2,2,0,7,2024
MAR,AN,M 72,Ricerca scientifica e sviluppo                              ,1,0,0,0,1,2024
MAR,AN,M 73,Pubblicità e ricerche di mercato                            ,8,4,0,1,13,2024
MAR,AN,M 74,"Altre attività professionali, scientifiche e tecniche       ",7,13,1,0,21,2024
MAR,AN,M 75,Servizi veterinari                                          ,0,0,0,0,0,2024
MAR,AN,N   ,"Noleggio, agenzie di viaggio, servizi di supporto alle im...",10,14,6,9,39,2024
MAR,AN,N 77,Attività di noleggio e leasing operativo                    ,1,3,1,0,5,2024
MAR,AN,N 78,"Attività di ricerca, selezione, fornitura di personale      ",0,1,0,0,1,2024
MAR,AN,N 79,"Attività dei servizi delle agenzie di viaggio, dei tour o...",2,4,0,0,6,2024
MAR,AN,N 80,Servizi di vigilanza e investigazione                       ,0,0,0,0,0,2024
MAR,AN,N 81,Attività di servizi per edifici e paesaggio                 ,2,5,2,4,13,2024
MAR,AN,N 82,Attività di supporto per le funzioni d'ufficio e altri se...,5,1,3,5,14,2024
MAR,AN,O   ,Amministrazione pubblica e difesa; assicurazione sociale ...,0,0,0,1,1,2024
MAR,AN,O 84,Amministrazione pubblica e difesa; assicurazione sociale ...,0,0,0,1,1,2024
MAR,AN,P   ,Istruzione                                                  ,4,1,0,1,6,2024
MAR,AN,P 85,Istruzione                                                  ,4,1,0,1,6,2024
MAR,AN,Q   ,Sanita' e assistenza sociale                                ,1,1,0,6,8,2024
MAR,AN,Q 86,Assistenza sanitaria                                        ,0,1,0,0,1,2024
MAR,AN,Q 87,Servizi di assistenza sociale residenziale                  ,0,0,0,2,2,2024
MAR,AN,Q 88,Assistenza sociale non residenziale                         ,1,0,0,4,5,2024
MAR,AN,R   ,"Attività artistiche, sportive, di intrattenimento e diver...",10,14,5,6,35,2024
MAR,AN,R 90,"Attività creative, artistiche e di intrattenimento          ",1,4,1,3,9,2024
MAR,AN,R 91,"Attività di biblioteche, archivi, musei ed altre attività...",0,0,0,0,0,2024
MAR,AN,R 92,"Attività riguardanti le lotterie, le scommesse, le case d...",0,1,0,0,1,2024
MAR,AN,R 93,"Attività sportive, di intrattenimento e di divertimento     ",9,9,4,3,25,2024
MAR,AN,S   ,Altre attività di servizi                                   ,4,19,4,2,29,2024
MAR,AN,S 94,Attività di organizzazioni associative                      ,0,0,0,0,0,2024
MAR,AN,S 95,Riparazione di computer e di beni per uso personale e per...,1,1,0,0,2,2024
MAR,AN,S 96,Altre attività di servizi per la persona                    ,3,18,4,2,27,2024
MAR,AN,T   ,Attività di famiglie e convivenze come datori di lavoro p...,0,0,0,0,0,2024
MAR,AN,T 97,Attività di famiglie e convivenze come datori di lavoro p...,0,0,0,0,0,2024
MAR,AN,T 98,Produzione di beni e servizi indifferenziati per uso prop...,0,0,0,0,0,2024
MAR,AN,U   ,Organizzazioni ed organismi extraterritoriali               ,0,0,0,0,0,2024
MAR,AN,U 99,Organizzazioni ed organismi extraterritoriali               ,0,0,0,0,0,2024
MAR,AN,XX  ,Imprese non classificate                                    ,120,228,12,17,377,2024
MAR,AN,TOT ,TOTALE                                                      ,486,1001,284,127,1898,2024
MAR,MC,A   ,"Agricoltura, silvicoltura pesca                             ",7,7,63,7,84,2024
MAR,MC,A 01,"Coltivazioni agricole e produzione di prodotti animali, c...",7,6,62,6,81,2024
MAR,MC,A 02,Silvicoltura ed utilizzo di aree forestali                  ,0,0,0,0,0,2024
MAR,MC,A 03,Pesca e acquacoltura                                        ,0,1,1,1,3,2024
MAR,MC,B   ,Estrazione di minerali da cave e miniere                    ,0,1,0,0,1,2024
MAR,MC,B 05,Estrazione di carbone (esclusa torba)                       ,0,0,0,0,0,2024
MAR,MC,B 06,Estraz.di petrolio greggio e di gas naturale                ,0,0,0,0,0,2024
MAR,MC,B 07,Estrazione di minerali metalliferi                          ,0,0,0,0,0,2024
MAR,MC,B 08,Altre attività di estrazione di minerali da cave e miniere  ,0,1,0,0,1,2024
MAR,MC,B 09,Attività dei servizi di supporto all'estrazione             ,0,0,0,0,0,2024
MAR,MC,C   ,Attività manifatturiere                                     ,56,7,25,11,99,2024
MAR,MC,C 10,Industrie alimentari                                        ,5,0,0,4,9,2024
MAR,MC,C 11,Industria delle bevande                                     ,0,0,0,0,0,2024
MAR,MC,C 12,Industria del tabacco                                       ,0,0,0,0,0,2024
MAR,MC,C 13,Industrie tessili                                           ,1,0,1,0,2,2024
MAR,MC,C 14,Confezione di articoli di abbigliamento; confezione di ar...,7,3,5,1,16,2024
MAR,MC,C 15,Fabbricazione di articoli in pelle e simili                 ,21,1,13,2,37,2024
MAR,MC,C 16,Industria del legno e dei prodotti in legno e sughero (es...,2,0,0,0,2,2024
MAR,MC,C 17,Fabbricazione di carta e di prodotti di carta               ,0,0,0,0,0,2024
MAR,MC,C 18,Stampa e riproduzione di supporti registrati                ,0,0,0,0,0,2024
MAR,MC,C 19,Fabbricazione di coke e prodotti derivanti dalla raffinaz...,1,0,0,0,1,2024
MAR,MC,C 20,Fabbricazione di prodotti chimici                           ,0,0,0,0,0,2024
MAR,MC,C 21,Fabbricazione di prodotti farmaceutici di base e di prepa...,0,0,0,0,0,2024
MAR,MC,C 22,Fabbricazione di articoli in gomma e materie plastiche      ,1,0,1,2,4,2024
MAR,MC,C 23,Fabbricazione di altri prodotti della lavorazione di miner..,1,0,0,1,2,2024
MAR,MC,C 24,Metallurgia                                                 ,1,0,0,0,1,2024
MAR,MC,C 25,Fabbricazione di prodotti in metallo (esclusi macchinari ...,5,1,2,1,9,2024
MAR,MC,C 26,Fabbricazione di computer e prodotti di elettronica e ott...,0,0,0,0,0,2024
MAR,MC,C 27,Fabbricazione di apparecchiature elettriche ed apparecchi...,1,0,0,0,1,2024
MAR,MC,C 28,Fabbricazione di macchinari ed apparecchiature nca          ,1,0,0,0,1,2024
MAR,MC,C 29,"Fabbricazione di autoveicoli, rimorchi e semirimorchi       ",1,0,0,0,1,2024
MAR,MC,C 30,Fabbricazione di altri mezzi di trasporto                   ,1,1,0,0,2,2024
MAR,MC,C 31,Fabbricazione di mobili                                     ,4,0,1,0,5,2024
MAR,MC,C 32,Altre industrie manifatturiere                              ,3,1,0,0,4,2024
MAR,MC,C 33,"Riparazione, manutenzione ed installazione di macchine ed...",0,0,2,0,2,2024
MAR,MC,D   ,"Fornitura di energia elettrica, gas, vapore e aria condiz...",0,0,0,0,0,2024
MAR,MC,D 35,"Fornitura di energia elettrica, gas, vapore e aria condiz...",0,0,0,0,0,2024
MAR,MC,E   ,"Fornitura di acqua; reti fognarie, attività di gestione d...",3,0,0,1,4,2024
MAR,MC,E 36,"Raccolta, trattamento e fornitura di acqua                  ",0,0,0,0,0,2024
MAR,MC,E 37,Gestione delle reti fognarie                                ,1,0,0,0,1,2024
MAR,MC,E 38,"Attività di raccolta, trattamento e smaltimento dei rifiu...",2,0,0,1,3,2024
MAR,MC,E 39,Attività di risanamento e altri servizi di gestione dei r...,0,0,0,0,0,2024
MAR,MC,F   ,Costruzioni                                                 ,44,5,28,8,85,2024
MAR,MC,F 41,Costruzione di edifici                                      ,26,2,7,4,39,2024
MAR,MC,F 42,Ingegneria civile                                           ,1,0,0,1,2,2024
MAR,MC,F 43,Lavori di costruzione specializzati                         ,17,3,21,3,44,2024
MAR,MC,G   ,Commercio all'ingrosso e al dettaglio; riparazione di aut...,76,8,112,8,204,2024
MAR,MC,G 45,Commercio all'ingrosso e al dettaglio e riparazione di au...,14,1,11,1,27,2024
MAR,MC,G 46,Commercio all'ingrosso (escluso quello di autoveicoli e d...,42,2,18,2,64,2024
MAR,MC,G 47,Commercio al dettaglio (escluso quello di autoveicoli e d...,20,5,83,5,113,2024
MAR,MC,H   ,Trasporto e magazzinaggio                                   ,2,1,5,10,18,2024
MAR,MC,H 49,Trasporto terrestre e mediante condotte                     ,1,1,4,4,10,2024
MAR,MC,H 50,Trasporto marittimo e per vie d'acqua                       ,0,0,0,0,0,2024
MAR,MC,H 51,Trasporto aereo                                             ,0,0,0,0,0,2024
MAR,MC,H 52,Magazzinaggio e attività di supporto ai trasporti           ,1,0,0,6,7,2024
MAR,MC,H 53,Servizi postali e attività di corriere                      ,0,0,1,0,1,2024
MAR,MC,I   ,Attività dei servizi alloggio e ristorazione                ,15,12,18,5,50,2024
MAR,MC,I 55,Alloggio                                                    ,2,0,1,0,3,2024
MAR,MC,I 56,Attività dei servizi di ristorazione                        ,13,12,17,5,47,2024
MAR,MC,J   ,Servizi di informazione e comunicazione                     ,8,0,4,5,17,2024
MAR,MC,J 58,Attività editoriali                                         ,0,0,0,2,2,2024
MAR,MC,J 59,"Attività di produzione cinematografica, di video e di pro...",0,0,0,0,0,2024
MAR,MC,J 60,Attività di programmazione e trasmissione                   ,3,0,0,0,3,2024
MAR,MC,J 61,Telecomunicazioni                                           ,0,0,0,0,0,2024
MAR,MC,J 62,"Produzione di software, consulenza informatica e attività...",3,0,2,0,5,2024
MAR,MC,J 63,Attività dei servizi d'informazione e altri servizi infor...,2,0,2,3,7,2024
MAR,MC,K   ,Attività finanziarie e assicurative                         ,3,1,1,0,5,2024
MAR,MC,K 64,Attività di servizi finanziari (escluse le assicurazioni ...,2,1,0,0,3,2024
MAR,MC,K 65,"Assicurazioni, riassicurazioni e fondi pensione (escluse ...",0,0,0,0,0,2024
MAR,MC,K 66,Attività ausiliarie dei servizi finanziari e delle attivi...,1,0,1,0,2,2024
MAR,MC,L   ,Attivita' immobiliari                                       ,21,1,3,0,25,2024
MAR,MC,L 68,Attivita' immobiliari                                       ,21,1,3,0,25,2024
MAR,MC,M   ,"Attività professionali, scientifiche e tecniche             ",15,1,4,5,25,2024
MAR,MC,M 69,Attività legali e contabilità                               ,0,0,0,0,0,2024
MAR,MC,M 70,Attività di direzione aziendale e di consulenza gestional...,3,0,0,3,6,2024
MAR,MC,M 71,Attività degli studi di architettura e d'ingegneria; coll...,0,1,0,0,1,2024
MAR,MC,M 72,Ricerca scientifica e sviluppo                              ,0,0,0,0,0,2024
MAR,MC,M 73,Pubblicità e ricerche di mercato                            ,5,0,0,0,5,2024
MAR,MC,M 74,"Altre attività professionali, scientifiche e tecniche       ",7,0,4,2,13,2024
MAR,MC,M 75,Servizi veterinari                                          ,0,0,0,0,0,2024
MAR,MC,N   ,"Noleggio, agenzie di viaggio, servizi di supporto alle im...",7,1,10,12,30,2024
MAR,MC,N 77,Attività di noleggio e leasing operativo                    ,4,0,0,1,5,2024
MAR,MC,N 78,"Attività di ricerca, selezione, fornitura di personale      ",0,0,0,0,0,2024
MAR,MC,N 79,"Attività dei servizi delle agenzie di viaggio, dei tour o...",1,0,1,1,3,2024
MAR,MC,N 80,Servizi di vigilanza e investigazione                       ,0,0,0,0,0,2024
MAR,MC,N 81,Attività di servizi per edifici e paesaggio                 ,1,1,4,6,12,2024
MAR,MC,N 82,Attività di supporto per le funzioni d'ufficio e altri se...,1,0,5,4,10,2024
MAR,MC,O   ,Amministrazione pubblica e difesa; assicurazione sociale ...,0,0,0,0,0,2024
MAR,MC,O 84,Amministrazione pubblica e difesa; assicurazione sociale ...,0,0,0,0,0,2024
MAR,MC,P   ,Istruzione                                                  ,2,0,1,0,3,2024
MAR,MC,P 85,Istruzione                                                  ,2,0,1,0,3,2024
MAR,MC,Q   ,Sanita' e assistenza sociale                                ,1,0,1,6,8,2024
MAR,MC,Q 86,Assistenza sanitaria                                        ,1,0,0,1,2,2024
MAR,MC,Q 87,Servizi di assistenza sociale residenziale                  ,0,0,0,0,0,2024
MAR,MC,Q 88,Assistenza sociale non residenziale                         ,0,0,1,5,6,2024
MAR,MC,R   ,"Attività artistiche, sportive, di intrattenimento e diver...",6,0,4,0,10,2024
MAR,MC,R 90,"Attività creative, artistiche e di intrattenimento          ",0,0,0,0,0,2024
MAR,MC,R 91,"Attività di biblioteche, archivi, musei ed altre attività...",0,0,0,0,0,2024
MAR,MC,R 92,"Attività riguardanti le lotterie, le scommesse, le case d...",1,0,1,0,2,2024
MAR,MC,R 93,"Attività sportive, di intrattenimento e di divertimento     ",5,0,3,0,8,2024
MAR,MC,S   ,Altre attività di servizi                                   ,2,2,9,3,16,2024
MAR,MC,S 94,Attività di organizzazioni associative                      ,0,0,0,0,0,2024
MAR,MC,S 95,Riparazione di computer e di beni per uso personale e per...,0,0,3,0,3,2024
MAR,MC,S 96,Altre attività di servizi per la persona                    ,2,2,6,3,13,2024
MAR,MC,T   ,Attività di famiglie e convivenze come datori di lavoro p...,0,0,0,0,0,2024
MAR,MC,T 97,Attività di famiglie e convivenze come datori di lavoro p...,0,0,0,0,0,2024
MAR,MC,T 98,Produzione di beni e servizi indifferenziati per uso prop...,0,0,0,0,0,2024
MAR,MC,U   ,Organizzazioni ed organismi extraterritoriali               ,0,0,0,0,0,2024
MAR,MC,U 99,Organizzazioni ed organismi extraterritoriali               ,0,0,0,0,0,2024
MAR,MC,XX  ,Imprese non classificate                                    ,65,4,45,17,131,2024
MAR,MC,TOT ,TOTALE                                                      ,333,51,333,98,815,2024
MAR,AP,A   ,"Agricoltura, silvicoltura pesca                             ",3,35,33,2,73,2024
MAR,AP,A 01,"Coltivazioni agricole e produzione di prodotti animali, c...",3,27,32,2,64,2024
MAR,AP,A 02,Silvicoltura ed utilizzo di aree forestali                  ,0,2,1,0,3,2024
MAR,AP,A 03,Pesca e acquacoltura                                        ,0,6,0,0,6,2024
MAR,AP,B   ,Estrazione di minerali da cave e miniere                    ,1,1,0,0,2,2024
MAR,AP,B 05,Estrazione di carbone (esclusa torba)                       ,0,0,0,0,0,2024
MAR,AP,B 06,Estraz.di petrolio greggio e di gas naturale                ,0,0,0,0,0,2024
MAR,AP,B 07,Estrazione di minerali metalliferi                          ,0,0,0,0,0,2024
MAR,AP,B 08,Altre attività di estrazione di minerali da cave e miniere  ,1,1,0,0,2,2024
MAR,AP,B 09,Attività dei servizi di supporto all'estrazione             ,0,0,0,0,0,2024
MAR,AP,C   ,Attività manifatturiere                                     ,46,57,15,4,122,2024
MAR,AP,C 10,Industrie alimentari                                        ,4,12,1,2,19,2024
MAR,AP,C 11,Industria delle bevande                                     ,0,1,0,0,1,2024
MAR,AP,C 12,Industria del tabacco                                       ,0,0,0,0,0,2024
MAR,AP,C 13,Industrie tessili                                           ,2,1,0,1,4,2024
MAR,AP,C 14,Confezione di articoli di abbigliamento; confezione di ar...,17,7,5,0,29,2024
MAR,AP,C 15,Fabbricazione di articoli in pelle e simili                 ,6,11,6,0,23,2024
MAR,AP,C 16,Industria del legno e dei prodotti in legno e sughero (es...,4,3,0,0,7,2024
MAR,AP,C 17,Fabbricazione di carta e di prodotti di carta               ,1,1,0,0,2,2024
MAR,AP,C 18,Stampa e riproduzione di supporti registrati                ,1,5,0,0,6,2024
MAR,AP,C 19,Fabbricazione di coke e prodotti derivanti dalla raffinaz...,0,0,0,0,0,2024
MAR,AP,C 20,Fabbricazione di prodotti chimici                           ,0,0,0,0,0,2024
MAR,AP,C 21,Fabbricazione di prodotti farmaceutici di base e di prepa...,0,0,0,0,0,2024
MAR,AP,C 22,Fabbricazione di articoli in gomma e materie plastiche      ,0,1,0,0,1,2024
MAR,AP,C 23,Fabbricazione di altri prodotti della lavorazione di miner..,0,1,0,0,1,2024
MAR,AP,C 24,Metallurgia                                                 ,0,0,0,0,0,2024
MAR,AP,C 25,Fabbricazione di prodotti in metallo (esclusi macchinari ...,4,7,2,1,14,2024
MAR,AP,C 26,Fabbricazione di computer e prodotti di elettronica e ott...,0,2,0,0,2,2024
MAR,AP,C 27,Fabbricazione di apparecchiature elettriche ed apparecchi...,1,0,1,0,2,2024
MAR,AP,C 28,Fabbricazione di macchinari ed apparecchiature nca          ,2,1,0,0,3,2024
MAR,AP,C 29,"Fabbricazione di autoveicoli, rimorchi e semirimorchi       ",0,0,0,0,0,2024
MAR,AP,C 30,Fabbricazione di altri mezzi di trasporto                   ,0,0,0,0,0,2024
MAR,AP,C 31,Fabbricazione di mobili                                     ,2,1,0,0,3,2024
MAR,AP,C 32,Altre industrie manifatturiere                              ,1,0,0,0,1,2024
MAR,AP,C 33,"Riparazione, manutenzione ed installazione di macchine ed...",1,3,0,0,4,2024
MAR,AP,D   ,"Fornitura di energia elettrica, gas, vapore e aria condiz...",0,0,0,0,0,2024
MAR,AP,D 35,"Fornitura di energia elettrica, gas, vapore e aria condiz...",0,0,0,0,0,2024
MAR,AP,E   ,"Fornitura di acqua; reti fognarie, attività di gestione d...",1,1,0,0,2,2024
MAR,AP,E 36,"Raccolta, trattamento e fornitura di acqua                  ",0,0,0,0,0,2024
MAR,AP,E 37,Gestione delle reti fognarie                                ,0,0,0,0,0,2024
MAR,AP,E 38,"Attività di raccolta, trattamento e smaltimento dei rifiu...",1,1,0,0,2,2024
MAR,AP,E 39,Attività di risanamento e altri servizi di gestione dei r...,0,0,0,0,0,2024
MAR,AP,F   ,Costruzioni                                                 ,19,64,16,2,101,2024
MAR,AP,F 41,Costruzione di edifici                                      ,13,30,8,1,52,2024
MAR,AP,F 42,Ingegneria civile                                           ,0,3,0,0,3,2024
MAR,AP,F 43,Lavori di costruzione specializzati                         ,6,31,8,1,46,2024
MAR,AP,G   ,Commercio all'ingrosso e al dettaglio; riparazione di aut...,60,152,35,3,250,2024
MAR,AP,G 45,Commercio all'ingrosso e al dettaglio e riparazione di au...,10,19,1,1,31,2024
MAR,AP,G 46,Commercio all'ingrosso (escluso quello di autoveicoli e d...,30,54,10,2,96,2024
MAR,AP,G 47,Commercio al dettaglio (escluso quello di autoveicoli e d...,20,79,24,0,123,2024
MAR,AP,H   ,Trasporto e magazzinaggio                                   ,6,18,2,5,31,2024
MAR,AP,H 49,Trasporto terrestre e mediante condotte                     ,6,15,1,1,23,2024
MAR,AP,H 50,Trasporto marittimo e per vie d'acqua                       ,0,0,1,0,1,2024
MAR,AP,H 51,Trasporto aereo                                             ,0,0,0,0,0,2024
MAR,AP,H 52,Magazzinaggio e attività di supporto ai trasporti           ,0,3,0,3,6,2024
MAR,AP,H 53,Servizi postali e attività di corriere                      ,0,0,0,1,1,2024
MAR,AP,I   ,Attività dei servizi alloggio e ristorazione                ,17,143,9,5,174,2024
MAR,AP,I 55,Alloggio                                                    ,4,4,0,0,8,2024
MAR,AP,I 56,Attività dei servizi di ristorazione                        ,13,139,9,5,166,2024
MAR,AP,J   ,Servizi di informazione e comunicazione                     ,6,15,0,2,23,2024
MAR,AP,J 58,Attività editoriali                                         ,1,0,0,0,1,2024
MAR,AP,J 59,"Attività di produzione cinematografica, di video e di pro...",0,1,0,0,1,2024
MAR,AP,J 60,Attività di programmazione e trasmissione                   ,1,3,0,1,5,2024
MAR,AP,J 61,Telecomunicazioni                                           ,0,2,0,0,2,2024
MAR,AP,J 62,"Produzione di software, consulenza informatica e attività...",3,1,0,0,4,2024
MAR,AP,J 63,Attività dei servizi d'informazione e altri servizi infor...,1,8,0,1,10,2024
MAR,AP,K   ,Attività finanziarie e assicurative                         ,2,6,2,0,10,2024
MAR,AP,K 64,Attività di servizi finanziari (escluse le assicurazioni ...,1,0,0,0,1,2024
MAR,AP,K 65,"Assicurazioni, riassicurazioni e fondi pensione (escluse ...",0,1,0,0,1,2024
MAR,AP,K 66,Attività ausiliarie dei servizi finanziari e delle attivi...,1,5,2,0,8,2024
MAR,AP,L   ,Attivita' immobiliari                                       ,3,9,1,0,13,2024
MAR,AP,L 68,Attivita' immobiliari                                       ,3,9,1,0,13,2024
MAR,AP,M   ,"Attività professionali, scientifiche e tecniche             ",2,18,1,3,24,2024
MAR,AP,M 69,Attività legali e contabilità                               ,0,2,0,0,2,2024
MAR,AP,M 70,Attività di direzione aziendale e di consulenza gestional...,0,3,0,2,5,2024
MAR,AP,M 71,Attività degli studi di architettura e d'ingegneria; coll...,0,1,0,0,1,2024
MAR,AP,M 72,Ricerca scientifica e sviluppo                              ,0,0,0,0,0,2024
MAR,AP,M 73,Pubblicità e ricerche di mercato                            ,2,4,1,0,7,2024
MAR,AP,M 74,"Altre attività professionali, scientifiche e tecniche       ",0,8,0,1,9,2024
MAR,AP,M 75,Servizi veterinari                                          ,0,0,0,0,0,2024
MAR,AP,N   ,"Noleggio, agenzie di viaggio, servizi di supporto alle im...",5,15,4,6,30,2024
MAR,AP,N 77,Attività di noleggio e leasing operativo                    ,0,0,0,0,0,2024
MAR,AP,N 78,"Attività di ricerca, selezione, fornitura di personale      ",0,0,0,0,0,2024
MAR,AP,N 79,"Attività dei servizi delle agenzie di viaggio, dei tour o...",2,2,0,0,4,2024
MAR,AP,N 80,Servizi di vigilanza e investigazione                       ,0,0,0,0,0,2024
MAR,AP,N 81,Attività di servizi per edifici e paesaggio                 ,0,6,1,3,10,2024
MAR,AP,N 82,Attività di supporto per le funzioni d'ufficio e altri se...,3,7,3,3,16,2024
MAR,AP,O   ,Amministrazione pubblica e difesa; assicurazione sociale ...,0,0,0,0,0,2024
MAR,AP,O 84,Amministrazione pubblica e difesa; assicurazione sociale ...,0,0,0,0,0,2024
MAR,AP,P   ,Istruzione                                                  ,0,0,0,0,0,2024
MAR,AP,P 85,Istruzione                                                  ,0,0,0,0,0,2024
MAR,AP,Q   ,Sanita' e assistenza sociale                                ,0,2,0,3,5,2024
MAR,AP,Q 86,Assistenza sanitaria                                        ,0,2,0,0,2,2024
MAR,AP,Q 87,Servizi di assistenza sociale residenziale                  ,0,0,0,0,0,2024
MAR,AP,Q 88,Assistenza sociale non residenziale                         ,0,0,0,3,3,2024
MAR,AP,R   ,"Attività artistiche, sportive, di intrattenimento e diver...",5,10,1,2,18,2024
MAR,AP,R 90,"Attività creative, artistiche e di intrattenimento          ",0,1,0,0,1,2024
MAR,AP,R 91,"Attività di biblioteche, archivi, musei ed altre attività...",0,0,0,0,0,2024
MAR,AP,R 92,"Attività riguardanti le lotterie, le scommesse, le case d...",0,1,0,0,1,2024
MAR,AP,R 93,"Attività sportive, di intrattenimento e di divertimento     ",5,8,1,2,16,2024
MAR,AP,S   ,Altre attività di servizi                                   ,1,16,5,2,24,2024
MAR,AP,S 94,Attività di organizzazioni associative                      ,0,0,0,0,0,2024
MAR,AP,S 95,Riparazione di computer e di beni per uso personale e per...,1,4,2,0,7,2024
MAR,AP,S 96,Altre attività di servizi per la persona                    ,0,12,3,2,17,2024
MAR,AP,T   ,Attività di famiglie e convivenze come datori di lavoro p...,0,0,0,0,0,2024
MAR,AP,T 97,Attività di famiglie e convivenze come datori di lavoro p...,0,0,0,0,0,2024
MAR,AP,T 98,Produzione di beni e servizi indifferenziati per uso prop...,0,0,0,0,0,2024
MAR,AP,U   ,Organizzazioni ed organismi extraterritoriali               ,0,0,0,0,0,2024
MAR,AP,U 99,Organizzazioni ed organismi extraterritoriali               ,0,0,0,0,0,2024
MAR,AP,XX  ,Imprese non classificate                                    ,39,157,5,10,211,2024
MAR,AP,TOT ,TOTALE                                                      ,216,719,129,49,1113,2024
MAR,FM,A   ,"Agricoltura, silvicoltura pesca                             ",0,4,38,5,47,2024
MAR,FM,A 01,"Coltivazioni agricole e produzione di prodotti animali, c...",0,4,35,5,44,2024
MAR,FM,A 02,Silvicoltura ed utilizzo di aree forestali                  ,0,0,1,0,1,2024
MAR,FM,A 03,Pesca e acquacoltura                                        ,0,0,2,0,2,2024
MAR,FM,B   ,Estrazione di minerali da cave e miniere                    ,0,0,0,0,0,2024
MAR,FM,B 05,Estrazione di carbone (esclusa torba)                       ,0,0,0,0,0,2024
MAR,FM,B 06,Estraz.di petrolio greggio e di gas naturale                ,0,0,0,0,0,2024
MAR,FM,B 07,Estrazione di minerali metalliferi                          ,0,0,0,0,0,2024
MAR,FM,B 08,Altre attività di estrazione di minerali da cave e miniere  ,0,0,0,0,0,2024
MAR,FM,B 09,Attività dei servizi di supporto all'estrazione             ,0,0,0,0,0,2024
MAR,FM,C   ,Attività manifatturiere                                     ,23,5,41,4,73,2024
MAR,FM,C 10,Industrie alimentari                                        ,1,1,1,1,4,2024
MAR,FM,C 11,Industria delle bevande                                     ,0,0,0,0,0,2024
MAR,FM,C 12,Industria del tabacco                                       ,0,0,0,0,0,2024
MAR,FM,C 13,Industrie tessili                                           ,0,0,0,0,0,2024
MAR,FM,C 14,Confezione di articoli di abbigliamento; confezione di ar...,1,0,3,0,4,2024
MAR,FM,C 15,Fabbricazione di articoli in pelle e simili                 ,17,4,34,0,55,2024
MAR,FM,C 16,Industria del legno e dei prodotti in legno e sughero (es...,0,0,0,0,0,2024
MAR,FM,C 17,Fabbricazione di carta e di prodotti di carta               ,0,0,0,0,0,2024
MAR,FM,C 18,Stampa e riproduzione di supporti registrati                ,0,0,0,1,1,2024
MAR,FM,C 19,Fabbricazione di coke e prodotti derivanti dalla raffinaz...,0,0,0,0,0,2024
MAR,FM,C 20,Fabbricazione di prodotti chimici                           ,0,0,0,0,0,2024
MAR,FM,C 21,Fabbricazione di prodotti farmaceutici di base e di prepa...,0,0,0,0,0,2024
MAR,FM,C 22,Fabbricazione di articoli in gomma e materie plastiche      ,1,0,1,0,2,2024
MAR,FM,C 23,Fabbricazione di altri prodotti della lavorazione di miner..,0,0,0,0,0,2024
MAR,FM,C 24,Metallurgia                                                 ,1,0,1,0,2,2024
MAR,FM,C 25,Fabbricazione di prodotti in metallo (esclusi macchinari ...,1,0,1,0,2,2024
MAR,FM,C 26,Fabbricazione di computer e prodotti di elettronica e ott...,0,0,0,0,0,2024
MAR,FM,C 27,Fabbricazione di apparecchiature elettriche ed apparecchi...,0,0,0,0,0,2024
MAR,FM,C 28,Fabbricazione di macchinari ed apparecchiature nca          ,0,0,0,0,0,2024
MAR,FM,C 29,"Fabbricazione di autoveicoli, rimorchi e semirimorchi       ",0,0,0,0,0,2024
MAR,FM,C 30,Fabbricazione di altri mezzi di trasporto                   ,0,0,0,0,0,2024
MAR,FM,C 31,Fabbricazione di mobili                                     ,1,0,0,0,1,2024
MAR,FM,C 32,Altre industrie manifatturiere                              ,0,0,0,1,1,2024
MAR,FM,C 33,"Riparazione, manutenzione ed installazione di macchine ed...",0,0,0,1,1,2024
MAR,FM,D   ,"Fornitura di energia elettrica, gas, vapore e aria condiz...",0,0,0,0,0,2024
MAR,FM,D 35,"Fornitura di energia elettrica, gas, vapore e aria condiz...",0,0,0,0,0,2024
MAR,FM,E   ,"Fornitura di acqua; reti fognarie, attività di gestione d...",0,0,0,1,1,2024
MAR,FM,E 36,"Raccolta, trattamento e fornitura di acqua                  ",0,0,0,0,0,2024
MAR,FM,E 37,Gestione delle reti fognarie                                ,0,0,0,0,0,2024
MAR,FM,E 38,"Attività di raccolta, trattamento e smaltimento dei rifiu...",0,0,0,0,0,2024
MAR,FM,E 39,Attività di risanamento e altri servizi di gestione dei r...,0,0,0,1,1,2024
MAR,FM,F   ,Costruzioni                                                 ,8,2,28,7,45,2024
MAR,FM,F 41,Costruzione di edifici                                      ,6,1,5,5,17,2024
MAR,FM,F 42,Ingegneria civile                                           ,0,0,0,0,0,2024
MAR,FM,F 43,Lavori di costruzione specializzati                         ,2,1,23,2,28,2024
MAR,FM,G   ,Commercio all'ingrosso e al dettaglio; riparazione di aut...,20,3,47,3,73,2024
MAR,FM,G 45,Commercio all'ingrosso e al dettaglio e riparazione di au...,2,1,5,0,8,2024
MAR,FM,G 46,Commercio all'ingrosso (escluso quello di autoveicoli e d...,15,1,9,2,27,2024
MAR,FM,G 47,Commercio al dettaglio (escluso quello di autoveicoli e d...,3,1,33,1,38,2024
MAR,FM,H   ,Trasporto e magazzinaggio                                   ,3,0,2,3,8,2024
MAR,FM,H 49,Trasporto terrestre e mediante condotte                     ,2,0,2,1,5,2024
MAR,FM,H 50,Trasporto marittimo e per vie d'acqua                       ,0,0,0,0,0,2024
MAR,FM,H 51,Trasporto aereo                                             ,0,0,0,0,0,2024
MAR,FM,H 52,Magazzinaggio e attività di supporto ai trasporti           ,1,0,0,2,3,2024
MAR,FM,H 53,Servizi postali e attività di corriere                      ,0,0,0,0,0,2024
MAR,FM,I   ,Attività dei servizi alloggio e ristorazione                ,5,10,12,3,30,2024
MAR,FM,I 55,Alloggio                                                    ,0,1,0,1,2,2024
MAR,FM,I 56,Attività dei servizi di ristorazione                        ,5,9,12,2,28,2024
MAR,FM,J   ,Servizi di informazione e comunicazione                     ,1,0,1,4,6,2024
MAR,FM,J 58,Attività editoriali                                         ,0,0,0,1,1,2024
MAR,FM,J 59,"Attività di produzione cinematografica, di video e di pro...",0,0,0,0,0,2024
MAR,FM,J 60,Attività di programmazione e trasmissione                   ,0,0,0,0,0,2024
MAR,FM,J 61,Telecomunicazioni                                           ,0,0,0,0,0,2024
MAR,FM,J 62,"Produzione di software, consulenza informatica e attività...",0,0,0,0,0,2024
MAR,FM,J 63,Attività dei servizi d'informazione e altri servizi infor...,1,0,1,3,5,2024
MAR,FM,K   ,Attività finanziarie e assicurative                         ,0,1,3,0,4,2024
MAR,FM,K 64,Attività di servizi finanziari (escluse le assicurazioni ...,0,0,0,0,0,2024
MAR,FM,K 65,"Assicurazioni, riassicurazioni e fondi pensione (escluse ...",0,0,0,0,0,2024
MAR,FM,K 66,Attività ausiliarie dei servizi finanziari e delle attivi...,0,1,3,0,4,2024
MAR,FM,L   ,Attivita' immobiliari                                       ,1,0,1,0,2,2024
MAR,FM,L 68,Attivita' immobiliari                                       ,1,0,1,0,2,2024
MAR,FM,M   ,"Attività professionali, scientifiche e tecniche             ",3,0,5,4,12,2024
MAR,FM,M 69,Attività legali e contabilità                               ,0,0,0,0,0,2024
MAR,FM,M 70,Attività di direzione aziendale e di consulenza gestional...,1,0,0,2,3,2024
MAR,FM,M 71,Attività degli studi di architettura e d'ingegneria; coll...,0,0,0,1,1,2024
MAR,FM,M 72,Ricerca scientifica e sviluppo                              ,0,0,0,0,0,2024
MAR,FM,M 73,Pubblicità e ricerche di mercato                            ,1,0,1,1,3,2024
MAR,FM,M 74,"Altre attività professionali, scientifiche e tecniche       ",1,0,4,0,5,2024
MAR,FM,M 75,Servizi veterinari                                          ,0,0,0,0,0,2024
MAR,FM,N   ,"Noleggio, agenzie di viaggio, servizi di supporto alle im...",0,0,7,2,9,2024
MAR,FM,N 77,Attività di noleggio e leasing operativo                    ,0,0,0,0,0,2024
MAR,FM,N 78,"Attività di ricerca, selezione, fornitura di personale      ",0,0,0,0,0,2024
MAR,FM,N 79,"Attività dei servizi delle agenzie di viaggio, dei tour o...",0,0,0,0,0,2024
MAR,FM,N 80,Servizi di vigilanza e investigazione                       ,0,0,0,0,0,2024
MAR,FM,N 81,Attività di servizi per edifici e paesaggio                 ,0,0,4,2,6,2024
MAR,FM,N 82,Attività di supporto per le funzioni d'ufficio e altri se...,0,0,3,0,3,2024
MAR,FM,O   ,Amministrazione pubblica e difesa; assicurazione sociale ...,0,0,0,0,0,2024
MAR,FM,O 84,Amministrazione pubblica e difesa; assicurazione sociale ...,0,0,0,0,0,2024
MAR,FM,P   ,Istruzione                                                  ,0,0,0,1,1,2024
MAR,FM,P 85,Istruzione                                                  ,0,0,0,1,1,2024
MAR,FM,Q   ,Sanita' e assistenza sociale                                ,0,0,0,1,1,2024
MAR,FM,Q 86,Assistenza sanitaria                                        ,0,0,0,0,0,2024
MAR,FM,Q 87,Servizi di assistenza sociale residenziale                  ,0,0,0,1,1,2024
MAR,FM,Q 88,Assistenza sociale non residenziale                         ,0,0,0,0,0,2024
MAR,FM,R   ,"Attività artistiche, sportive, di intrattenimento e diver...",2,1,1,2,6,2024
MAR,FM,R 90,"Attività creative, artistiche e di intrattenimento          ",0,0,0,1,1,2024
MAR,FM,R 91,"Attività di biblioteche, archivi, musei ed altre attività...",0,0,0,0,0,2024
MAR,FM,R 92,"Attività riguardanti le lotterie, le scommesse, le case d...",0,0,1,0,1,2024
MAR,FM,R 93,"Attività sportive, di intrattenimento e di divertimento     ",2,1,0,1,4,2024
MAR,FM,S   ,Altre attività di servizi                                   ,0,0,1,4,5,2024
MAR,FM,S 94,Attività di organizzazioni associative                      ,0,0,0,1,1,2024
MAR,FM,S 95,Riparazione di computer e di beni per uso personale e per...,0,0,1,0,1,2024
MAR,FM,S 96,Altre attività di servizi per la persona                    ,0,0,0,3,3,2024
MAR,FM,T   ,Attività di famiglie e convivenze come datori di lavoro p...,0,0,0,0,0,2024
MAR,FM,T 97,Attività di famiglie e convivenze come datori di lavoro p...,0,0,0,0,0,2024
MAR,FM,T 98,Produzione di beni e servizi indifferenziati per uso prop...,0,0,0,0,0,2024
MAR,FM,U   ,Organizzazioni ed organismi extraterritoriali               ,0,0,0,0,0,2024
MAR,FM,U 99,Organizzazioni ed organismi extraterritoriali               ,0,0,0,0,0,2024
MAR,FM,XX  ,Imprese non classificate                                    ,23,2,8,8,41,2024
MAR,FM,TOT ,TOTALE                                                      ,89,28,195,52,364,2024
LAZ,  ,A   ,"Agricoltura, silvicoltura pesca                             ",12,53,326,166,557,2024
LAZ,  ,A 01,"Coltivazioni agricole e produzione di prodotti animali, c...",11,50,309,143,513,2024
LAZ,  ,A 02,Silvicoltura ed utilizzo di aree forestali                  ,1,1,11,9,22,2024
LAZ,  ,A 03,Pesca e acquacoltura                                        ,0,2,6,14,22,2024
LAZ,  ,B   ,Estrazione di minerali da cave e miniere                    ,0,6,0,0,6,2024
LAZ,  ,B 05,Estrazione di carbone (esclusa torba)                       ,0,0,0,0,0,2024
LAZ,  ,B 06,Estraz.di petrolio greggio e di gas naturale                ,0,1,0,0,1,2024
LAZ,  ,B 07,Estrazione di minerali metalliferi                          ,0,1,0,0,1,2024
LAZ,  ,B 08,Altre attività di estrazione di minerali da cave e miniere  ,0,4,0,0,4,2024
LAZ,  ,B 09,Attività dei servizi di supporto all'estrazione             ,0,0,0,0,0,2024
LAZ,  ,C   ,Attività manifatturiere                                     ,72,331,279,159,841,2024
LAZ,  ,C 10,Industrie alimentari                                        ,5,50,20,29,104,2024
LAZ,  ,C 11,Industria delle bevande                                     ,0,1,0,0,1,2024
LAZ,  ,C 12,Industria del tabacco                                       ,0,0,0,1,1,2024
LAZ,  ,C 13,Industrie tessili                                           ,1,5,7,3,16,2024
LAZ,  ,C 14,Confezione di articoli di abbigliamento; confezione di ar...,6,43,42,8,99,2024
LAZ,  ,C 15,Fabbricazione di articoli in pelle e simili                 ,0,11,4,0,15,2024
LAZ,  ,C 16,Industria del legno e dei prodotti in legno e sughero (es...,7,11,27,11,56,2024
LAZ,  ,C 17,Fabbricazione di carta e di prodotti di carta               ,1,1,2,1,5,2024
LAZ,  ,C 18,Stampa e riproduzione di supporti registrati                ,5,35,9,12,61,2024
LAZ,  ,C 19,Fabbricazione di coke e prodotti derivanti dalla raffinaz...,0,0,0,0,0,2024
LAZ,  ,C 20,Fabbricazione di prodotti chimici                           ,3,8,0,2,13,2024
LAZ,  ,C 21,Fabbricazione di prodotti farmaceutici di base e di prepa...,1,4,0,0,5,2024
LAZ,  ,C 22,Fabbricazione di articoli in gomma e materie plastiche      ,2,6,0,2,10,2024
LAZ,  ,C 23,Fabbricazione di altri prodotti della lavorazione di miner..,7,8,13,10,38,2024
LAZ,  ,C 24,Metallurgia                                                 ,1,2,3,1,7,2024
LAZ,  ,C 25,Fabbricazione di prodotti in metallo (esclusi macchinari ...,12,56,64,33,165,2024
LAZ,  ,C 26,Fabbricazione di computer e prodotti di elettronica e ott...,4,29,3,5,41,2024
LAZ,  ,C 27,Fabbricazione di apparecchiature elettriche ed apparecchi...,2,6,8,3,19,2024
LAZ,  ,C 28,Fabbricazione di macchinari ed apparecchiature nca          ,2,14,4,6,26,2024
LAZ,  ,C 29,"Fabbricazione di autoveicoli, rimorchi e semirimorchi       ",0,2,1,1,4,2024
LAZ,  ,C 30,Fabbricazione di altri mezzi di trasporto                   ,0,3,2,5,10,2024
LAZ,  ,C 31,Fabbricazione di mobili                                     ,0,15,7,11,33,2024
LAZ,  ,C 32,Altre industrie manifatturiere                              ,6,16,40,7,69,2024
LAZ,  ,C 33,"Riparazione, manutenzione ed installazione di macchine ed...",7,5,23,8,43,2024
LAZ,  ,D   ,"Fornitura di energia elettrica, gas, vapore e aria condiz...",0,0,0,0,0,2024
LAZ,  ,D 35,"Fornitura di energia elettrica, gas, vapore e aria condiz...",0,0,0,0,0,2024
LAZ,  ,E   ,"Fornitura di acqua; reti fognarie, attività di gestione d...",6,4,2,21,33,2024
LAZ,  ,E 36,"Raccolta, trattamento e fornitura di acqua                  ",0,0,0,1,1,2024
LAZ,  ,E 37,Gestione delle reti fognarie                                ,0,1,0,1,2,2024
LAZ,  ,E 38,"Attività di raccolta, trattamento e smaltimento dei rifiu...",6,2,1,10,19,2024
LAZ,  ,E 39,Attività di risanamento e altri servizi di gestione dei r...,0,1,1,9,11,2024
LAZ,  ,F   ,Costruzioni                                                 ,219,392,1221,631,2463,2024
LAZ,  ,F 41,Costruzione di edifici                                      ,133,222,147,426,928,2024
LAZ,  ,F 42,Ingegneria civile                                           ,4,5,4,7,20,2024
LAZ,  ,F 43,Lavori di costruzione specializzati                         ,82,165,1070,198,1515,2024
LAZ,  ,G   ,Commercio all'ingrosso e al dettaglio; riparazione di aut...,297,1416,2902,156,4771,2024
LAZ,  ,G 45,Commercio all'ingrosso e al dettaglio e riparazione di au...,39,130,224,25,418,2024
LAZ,  ,G 46,Commercio all'ingrosso (escluso quello di autoveicoli e d...,104,545,682,41,1372,2024
LAZ,  ,G 47,Commercio al dettaglio (escluso quello di autoveicoli e d...,154,741,1996,90,2981,2024
LAZ,  ,H   ,Trasporto e magazzinaggio                                   ,32,111,186,414,743,2024
LAZ,  ,H 49,Trasporto terrestre e mediante condotte                     ,16,79,156,209,460,2024
LAZ,  ,H 50,Trasporto marittimo e per vie d'acqua                       ,0,1,0,1,2,2024
LAZ,  ,H 51,Trasporto aereo                                             ,0,0,0,0,0,2024
LAZ,  ,H 52,Magazzinaggio e attività di supporto ai trasporti           ,12,28,24,197,261,2024
LAZ,  ,H 53,Servizi postali e attività di corriere                      ,4,3,6,7,20,2024
LAZ,  ,I   ,Attività dei servizi alloggio e ristorazione                ,149,706,557,149,1561,2024
LAZ,  ,I 55,Alloggio                                                    ,17,30,33,7,87,2024
LAZ,  ,I 56,Attività dei servizi di ristorazione                        ,132,676,524,142,1474,2024
LAZ,  ,J   ,Servizi di informazione e comunicazione                     ,96,178,198,107,579,2024
LAZ,  ,J 58,Attività editoriali                                         ,14,35,10,20,79,2024
LAZ,  ,J 59,"Attività di produzione cinematografica, di video e di pro...",11,26,16,7,60,2024
LAZ,  ,J 60,Attività di programmazione e trasmissione                   ,3,2,3,4,12,2024
LAZ,  ,J 61,Telecomunicazioni                                           ,6,17,76,3,102,2024
LAZ,  ,J 62,"Produzione di software, consulenza informatica e attività...",35,39,48,17,139,2024
LAZ,  ,J 63,Attività dei servizi d'informazione e altri servizi infor...,27,59,45,56,187,2024
LAZ,  ,K   ,Attività finanziarie e assicurative                         ,16,113,125,10,264,2024
LAZ,  ,K 64,Attività di servizi finanziari (escluse le assicurazioni ...,7,26,1,3,37,2024
LAZ,  ,K 65,"Assicurazioni, riassicurazioni e fondi pensione (escluse ...",0,12,0,1,13,2024
LAZ,  ,K 66,Attività ausiliarie dei servizi finanziari e delle attivi...,9,75,124,6,214,2024
LAZ,  ,L   ,Attivita' immobiliari                                       ,78,130,47,31,286,2024
LAZ,  ,L 68,Attivita' immobiliari                                       ,78,130,47,31,286,2024
LAZ,  ,M   ,"Attività professionali, scientifiche e tecniche             ",84,157,245,154,640,2024
LAZ,  ,M 69,Attività legali e contabilità                               ,4,25,1,11,41,2024
LAZ,  ,M 70,Attività di direzione aziendale e di consulenza gestional...,26,26,37,49,138,2024
LAZ,  ,M 71,Attività degli studi di architettura e d'ingegneria; coll...,10,9,4,8,31,2024
LAZ,  ,M 72,Ricerca scientifica e sviluppo                              ,2,5,0,1,8,2024
LAZ,  ,M 73,Pubblicità e ricerche di mercato                            ,22,35,82,21,160,2024
LAZ,  ,M 74,"Altre attività professionali, scientifiche e tecniche       ",20,57,121,64,262,2024
LAZ,  ,M 75,Servizi veterinari                                          ,0,0,0,0,0,2024
LAZ,  ,N   ,"Noleggio, agenzie di viaggio, servizi di supporto alle im...",111,145,697,434,1387,2024
LAZ,  ,N 77,Attività di noleggio e leasing operativo                    ,8,27,22,11,68,2024
LAZ,  ,N 78,"Attività di ricerca, selezione, fornitura di personale      ",1,0,0,3,4,2024
LAZ,  ,N 79,"Attività dei servizi delle agenzie di viaggio, dei tour o...",11,18,14,1,44,2024
LAZ,  ,N 80,Servizi di vigilanza e investigazione                       ,3,5,3,7,18,2024
LAZ,  ,N 81,Attività di servizi per edifici e paesaggio                 ,20,39,100,269,428,2024
LAZ,  ,N 82,Attività di supporto per le funzioni d'ufficio e altri se...,68,56,558,143,825,2024
LAZ,  ,O   ,Amministrazione pubblica e difesa; assicurazione sociale ...,0,0,0,4,4,2024
LAZ,  ,O 84,Amministrazione pubblica e difesa; assicurazione sociale ...,0,0,0,4,4,2024
LAZ,  ,P   ,Istruzione                                                  ,15,15,21,19,70,2024
LAZ,  ,P 85,Istruzione                                                  ,15,15,21,19,70,2024
LAZ,  ,Q   ,Sanita' e assistenza sociale                                ,22,38,16,127,203,2024
LAZ,  ,Q 86,Assistenza sanitaria                                        ,16,34,5,19,74,2024
LAZ,  ,Q 87,Servizi di assistenza sociale residenziale                  ,3,2,9,17,31,2024
LAZ,  ,Q 88,Assistenza sociale non residenziale                         ,3,2,2,91,98,2024
LAZ,  ,R   ,"Attività artistiche, sportive, di intrattenimento e diver...",36,78,118,54,286,2024
LAZ,  ,R 90,"Attività creative, artistiche e di intrattenimento          ",6,28,28,23,85,2024
LAZ,  ,R 91,"Attività di biblioteche, archivi, musei ed altre attività...",0,0,0,4,4,2024
LAZ,  ,R 92,"Attività riguardanti le lotterie, le scommesse, le case d...",9,3,9,1,22,2024
LAZ,  ,R 93,"Attività sportive, di intrattenimento e di divertimento     ",21,47,81,26,175,2024
LAZ,  ,S   ,Altre attività di servizi                                   ,36,209,261,94,600,2024
LAZ,  ,S 94,Attività di organizzazioni associative                      ,0,0,0,19,19,2024
LAZ,  ,S 95,Riparazione di computer e di beni per uso personale e per...,9,19,41,7,76,2024
LAZ,  ,S 96,Altre attività di servizi per la persona                    ,27,190,220,68,505,2024
LAZ,  ,T   ,Attività di famiglie e convivenze come datori di lavoro p...,0,0,0,0,0,2024
LAZ,  ,T 97,Attività di famiglie e convivenze come datori di lavoro p...,0,0,0,0,0,2024
LAZ,  ,T 98,Produzione di beni e servizi indifferenziati per uso prop...,0,0,0,0,0,2024
LAZ,  ,U   ,Organizzazioni ed organismi extraterritoriali               ,0,0,0,0,0,2024
LAZ,  ,U 99,Organizzazioni ed organismi extraterritoriali               ,0,0,0,0,0,2024
LAZ,  ,XX  ,Imprese non classificate                                    ,426,896,522,1103,2947,2024
LAZ,  ,TOT ,TOTALE                                                      ,1707,4978,7723,3833,18241,2024
LAZ,VT,A   ,"Agricoltura, silvicoltura pesca                             ",0,1,30,9,40,2024
LAZ,VT,A 01,"Coltivazioni agricole e produzione di prodotti animali, c...",0,1,30,8,39,2024
LAZ,VT,A 02,Silvicoltura ed utilizzo di aree forestali                  ,0,0,0,0,0,2024
LAZ,VT,A 03,Pesca e acquacoltura                                        ,0,0,0,1,1,2024
LAZ,VT,B   ,Estrazione di minerali da cave e miniere                    ,0,0,0,0,0,2024
LAZ,VT,B 05,Estrazione di carbone (esclusa torba)                       ,0,0,0,0,0,2024
LAZ,VT,B 06,Estraz.di petrolio greggio e di gas naturale                ,0,0,0,0,0,2024
LAZ,VT,B 07,Estrazione di minerali metalliferi                          ,0,0,0,0,0,2024
LAZ,VT,B 08,Altre attività di estrazione di minerali da cave e miniere  ,0,0,0,0,0,2024
LAZ,VT,B 09,Attività dei servizi di supporto all'estrazione             ,0,0,0,0,0,2024
LAZ,VT,C   ,Attività manifatturiere                                     ,1,0,5,14,20,2024
LAZ,VT,C 10,Industrie alimentari                                        ,0,0,0,4,4,2024
LAZ,VT,C 11,Industria delle bevande                                     ,0,0,0,0,0,2024
LAZ,VT,C 12,Industria del tabacco                                       ,0,0,0,0,0,2024
LAZ,VT,C 13,Industrie tessili                                           ,0,0,0,0,0,2024
LAZ,VT,C 14,Confezione di articoli di abbigliamento; confezione di ar...,0,0,0,1,1,2024
LAZ,VT,C 15,Fabbricazione di articoli in pelle e simili                 ,0,0,0,0,0,2024
LAZ,VT,C 16,Industria del legno e dei prodotti in legno e sughero (es...,0,0,0,1,1,2024
LAZ,VT,C 17,Fabbricazione di carta e di prodotti di carta               ,0,0,0,0,0,2024
LAZ,VT,C 18,Stampa e riproduzione di supporti registrati                ,0,0,0,0,0,2024
LAZ,VT,C 19,Fabbricazione di coke e prodotti derivanti dalla raffinaz...,0,0,0,0,0,2024
LAZ,VT,C 20,Fabbricazione di prodotti chimici                           ,0,0,0,0,0,2024
LAZ,VT,C 21,Fabbricazione di prodotti farmaceutici di base e di prepa...,0,0,0,0,0,2024
LAZ,VT,C 22,Fabbricazione di articoli in gomma e materie plastiche      ,0,0,0,0,0,2024
LAZ,VT,C 23,Fabbricazione di altri prodotti della lavorazione di miner..,1,0,0,0,1,2024
LAZ,VT,C 24,Metallurgia                                                 ,0,0,0,0,0,2024
LAZ,VT,C 25,Fabbricazione di prodotti in metallo (esclusi macchinari ...,0,0,2,3,5,2024
LAZ,VT,C 26,Fabbricazione di computer e prodotti di elettronica e ott...,0,0,0,0,0,2024
LAZ,VT,C 27,Fabbricazione di apparecchiature elettriche ed apparecchi...,0,0,0,0,0,2024
LAZ,VT,C 28,Fabbricazione di macchinari ed apparecchiature nca          ,0,0,0,0,0,2024
LAZ,VT,C 29,"Fabbricazione di autoveicoli, rimorchi e semirimorchi       ",0,0,0,0,0,2024
LAZ,VT,C 30,Fabbricazione di altri mezzi di trasporto                   ,0,0,0,0,0,2024
LAZ,VT,C 31,Fabbricazione di mobili                                     ,0,0,0,1,1,2024
LAZ,VT,C 32,Altre industrie manifatturiere                              ,0,0,1,2,3,2024
LAZ,VT,C 33,"Riparazione, manutenzione ed installazione di macchine ed...",0,0,2,2,4,2024
LAZ,VT,D   ,"Fornitura di energia elettrica, gas, vapore e aria condiz...",0,0,0,0,0,2024
LAZ,VT,D 35,"Fornitura di energia elettrica, gas, vapore e aria condiz...",0,0,0,0,0,2024
LAZ,VT,E   ,"Fornitura di acqua; reti fognarie, attività di gestione d...",0,0,0,3,3,2024
LAZ,VT,E 36,"Raccolta, trattamento e fornitura di acqua                  ",0,0,0,0,0,2024
LAZ,VT,E 37,Gestione delle reti fognarie                                ,0,0,0,0,0,2024
LAZ,VT,E 38,"Attività di raccolta, trattamento e smaltimento dei rifiu...",0,0,0,2,2,2024
LAZ,VT,E 39,Attività di risanamento e altri servizi di gestione dei r...,0,0,0,1,1,2024
LAZ,VT,F   ,Costruzioni                                                 ,8,0,15,40,63,2024
LAZ,VT,F 41,Costruzione di edifici                                      ,5,0,1,29,35,2024
LAZ,VT,F 42,Ingegneria civile                                           ,0,0,0,0,0,2024
LAZ,VT,F 43,Lavori di costruzione specializzati                         ,3,0,14,11,28,2024
LAZ,VT,G   ,Commercio all'ingrosso e al dettaglio; riparazione di aut...,6,3,25,12,46,2024
LAZ,VT,G 45,Commercio all'ingrosso e al dettaglio e riparazione di au...,0,0,3,2,5,2024
LAZ,VT,G 46,Commercio all'ingrosso (escluso quello di autoveicoli e d...,3,0,6,5,14,2024
LAZ,VT,G 47,Commercio al dettaglio (escluso quello di autoveicoli e d...,3,3,16,5,27,2024
LAZ,VT,H   ,Trasporto e magazzinaggio                                   ,2,0,2,14,18,2024
LAZ,VT,H 49,Trasporto terrestre e mediante condotte                     ,0,0,2,3,5,2024
LAZ,VT,H 50,Trasporto marittimo e per vie d'acqua                       ,0,0,0,0,0,2024
LAZ,VT,H 51,Trasporto aereo                                             ,0,0,0,0,0,2024
LAZ,VT,H 52,Magazzinaggio e attività di supporto ai trasporti           ,2,0,0,10,12,2024
LAZ,VT,H 53,Servizi postali e attività di corriere                      ,0,0,0,1,1,2024
LAZ,VT,I   ,Attività dei servizi alloggio e ristorazione                ,1,3,7,6,17,2024
LAZ,VT,I 55,Alloggio                                                    ,0,0,0,0,0,2024
LAZ,VT,I 56,Attività dei servizi di ristorazione                        ,1,3,7,6,17,2024
LAZ,VT,J   ,Servizi di informazione e comunicazione                     ,3,1,2,5,11,2024
LAZ,VT,J 58,Attività editoriali                                         ,1,0,0,1,2,2024
LAZ,VT,J 59,"Attività di produzione cinematografica, di video e di pro...",0,0,0,0,0,2024
LAZ,VT,J 60,Attività di programmazione e trasmissione                   ,0,0,0,1,1,2024
LAZ,VT,J 61,Telecomunicazioni                                           ,0,0,0,0,0,2024
LAZ,VT,J 62,"Produzione di software, consulenza informatica e attività...",0,0,1,0,1,2024
LAZ,VT,J 63,Attività dei servizi d'informazione e altri servizi infor...,2,1,1,3,7,2024
LAZ,VT,K   ,Attività finanziarie e assicurative                         ,1,0,1,3,5,2024
LAZ,VT,K 64,Attività di servizi finanziari (escluse le assicurazioni ...,1,0,0,0,1,2024
LAZ,VT,K 65,"Assicurazioni, riassicurazioni e fondi pensione (escluse ...",0,0,0,0,0,2024
LAZ,VT,K 66,Attività ausiliarie dei servizi finanziari e delle attivi...,0,0,1,3,4,2024
LAZ,VT,L   ,Attivita' immobiliari                                       ,4,0,0,0,4,2024
LAZ,VT,L 68,Attivita' immobiliari                                       ,4,0,0,0,4,2024
LAZ,VT,M   ,"Attività professionali, scientifiche e tecniche             ",4,0,4,2,10,2024
LAZ,VT,M 69,Attività legali e contabilità                               ,0,0,0,1,1,2024
LAZ,VT,M 70,Attività di direzione aziendale e di consulenza gestional...,0,0,2,0,2,2024
LAZ,VT,M 71,Attività degli studi di architettura e d'ingegneria; coll...,0,0,1,0,1,2024
LAZ,VT,M 72,Ricerca scientifica e sviluppo                              ,1,0,0,0,1,2024
LAZ,VT,M 73,Pubblicità e ricerche di mercato                            ,1,0,0,1,2,2024
LAZ,VT,M 74,"Altre attività professionali, scientifiche e tecniche       ",2,0,1,0,3,2024
LAZ,VT,M 75,Servizi veterinari                                          ,0,0,0,0,0,2024
LAZ,VT,N   ,"Noleggio, agenzie di viaggio, servizi di supporto alle im...",1,0,1,18,20,2024
LAZ,VT,N 77,Attività di noleggio e leasing operativo                    ,0,0,0,0,0,2024
LAZ,VT,N 78,"Attività di ricerca, selezione, fornitura di personale      ",0,0,0,0,0,2024
LAZ,VT,N 79,"Attività dei servizi delle agenzie di viaggio, dei tour o...",0,0,0,0,0,2024
LAZ,VT,N 80,Servizi di vigilanza e investigazione                       ,0,0,0,0,0,2024
LAZ,VT,N 81,Attività di servizi per edifici e paesaggio                 ,1,0,0,13,14,2024
LAZ,VT,N 82,Attività di supporto per le funzioni d'ufficio e altri se...,0,0,1,5,6,2024
LAZ,VT,O   ,Amministrazione pubblica e difesa; assicurazione sociale ...,0,0,0,0,0,2024
LAZ,VT,O 84,Amministrazione pubblica e difesa; assicurazione sociale ...,0,0,0,0,0,2024
LAZ,VT,P   ,Istruzione                                                  ,0,0,0,0,0,2024
LAZ,VT,P 85,Istruzione                                                  ,0,0,0,0,0,2024
LAZ,VT,Q   ,Sanita' e assistenza sociale                                ,0,0,0,9,9,2024
LAZ,VT,Q 86,Assistenza sanitaria                                        ,0,0,0,1,1,2024
LAZ,VT,Q 87,Servizi di assistenza sociale residenziale                  ,0,0,0,1,1,2024
LAZ,VT,Q 88,Assistenza sociale non residenziale                         ,0,0,0,7,7,2024
LAZ,VT,R   ,"Attività artistiche, sportive, di intrattenimento e diver...",1,0,1,4,6,2024
LAZ,VT,R 90,"Attività creative, artistiche e di intrattenimento          ",0,0,0,3,3,2024
LAZ,VT,R 91,"Attività di biblioteche, archivi, musei ed altre attività...",0,0,0,0,0,2024
LAZ,VT,R 92,"Attività riguardanti le lotterie, le scommesse, le case d...",0,0,0,0,0,2024
LAZ,VT,R 93,"Attività sportive, di intrattenimento e di divertimento     ",1,0,1,1,3,2024
LAZ,VT,S   ,Altre attività di servizi                                   ,0,0,2,3,5,2024
LAZ,VT,S 94,Attività di organizzazioni associative                      ,0,0,0,0,0,2024
LAZ,VT,S 95,Riparazione di computer e di beni per uso personale e per...,0,0,0,0,0,2024
LAZ,VT,S 96,Altre attività di servizi per la persona                    ,0,0,2,3,5,2024
LAZ,VT,T   ,Attività di famiglie e convivenze come datori di lavoro p...,0,0,0,0,0,2024
LAZ,VT,T 97,Attività di famiglie e convivenze come datori di lavoro p...,0,0,0,0,0,2024
LAZ,VT,T 98,Produzione di beni e servizi indifferenziati per uso prop...,0,0,0,0,0,2024
LAZ,VT,U   ,Organizzazioni ed organismi extraterritoriali               ,0,0,0,0,0,2024
LAZ,VT,U 99,Organizzazioni ed organismi extraterritoriali               ,0,0,0,0,0,2024
LAZ,VT,XX  ,Imprese non classificate                                    ,15,4,4,48,71,2024
LAZ,VT,TOT ,TOTALE                                                      ,47,12,99,190,348,2024
LAZ,RI,A   ,"Agricoltura, silvicoltura pesca                             ",0,0,12,31,43,2024
LAZ,RI,A 01,"Coltivazioni agricole e produzione di prodotti animali, c...",0,0,12,28,40,2024
LAZ,RI,A 02,Silvicoltura ed utilizzo di aree forestali                  ,0,0,0,3,3,2024
LAZ,RI,A 03,Pesca e acquacoltura                                        ,0,0,0,0,0,2024
LAZ,RI,B   ,Estrazione di minerali da cave e miniere                    ,0,0,0,0,0,2024
LAZ,RI,B 05,Estrazione di carbone (esclusa torba)                       ,0,0,0,0,0,2024
LAZ,RI,B 06,Estraz.di petrolio greggio e di gas naturale                ,0,0,0,0,0,2024
LAZ,RI,B 07,Estrazione di minerali metalliferi                          ,0,0,0,0,0,2024
LAZ,RI,B 08,Altre attività di estrazione di minerali da cave e miniere  ,0,0,0,0,0,2024
LAZ,RI,B 09,Attività dei servizi di supporto all'estrazione             ,0,0,0,0,0,2024
LAZ,RI,C   ,Attività manifatturiere                                     ,2,0,0,16,18,2024
LAZ,RI,C 10,Industrie alimentari                                        ,0,0,0,7,7,2024
LAZ,RI,C 11,Industria delle bevande                                     ,0,0,0,0,0,2024
LAZ,RI,C 12,Industria del tabacco                                       ,0,0,0,0,0,2024
LAZ,RI,C 13,Industrie tessili                                           ,0,0,0,1,1,2024
LAZ,RI,C 14,Confezione di articoli di abbigliamento; confezione di ar...,0,0,0,0,0,2024
LAZ,RI,C 15,Fabbricazione di articoli in pelle e simili                 ,0,0,0,0,0,2024
LAZ,RI,C 16,Industria del legno e dei prodotti in legno e sughero (es...,0,0,0,2,2,2024
LAZ,RI,C 17,Fabbricazione di carta e di prodotti di carta               ,0,0,0,0,0,2024
LAZ,RI,C 18,Stampa e riproduzione di supporti registrati                ,0,0,0,0,0,2024
LAZ,RI,C 19,Fabbricazione di coke e prodotti derivanti dalla raffinaz...,0,0,0,0,0,2024
LAZ,RI,C 20,Fabbricazione di prodotti chimici                           ,0,0,0,0,0,2024
LAZ,RI,C 21,Fabbricazione di prodotti farmaceutici di base e di prepa...,0,0,0,0,0,2024
LAZ,RI,C 22,Fabbricazione di articoli in gomma e materie plastiche      ,0,0,0,0,0,2024
LAZ,RI,C 23,Fabbricazione di altri prodotti della lavorazione di miner..,1,0,0,1,2,2024
LAZ,RI,C 24,Metallurgia                                                 ,0,0,0,0,0,2024
LAZ,RI,C 25,Fabbricazione di prodotti in metallo (esclusi macchinari ...,0,0,0,0,0,2024
LAZ,RI,C 26,Fabbricazione di computer e prodotti di elettronica e ott...,0,0,0,2,2,2024
LAZ,RI,C 27,Fabbricazione di apparecchiature elettriche ed apparecchi...,0,0,0,1,1,2024
LAZ,RI,C 28,Fabbricazione di macchinari ed apparecchiature nca          ,0,0,0,0,0,2024
LAZ,RI,C 29,"Fabbricazione di autoveicoli, rimorchi e semirimorchi       ",0,0,0,0,0,2024
LAZ,RI,C 30,Fabbricazione di altri mezzi di trasporto                   ,0,0,0,0,0,2024
LAZ,RI,C 31,Fabbricazione di mobili                                     ,0,0,0,2,2,2024
LAZ,RI,C 32,Altre industrie manifatturiere                              ,1,0,0,0,1,2024
LAZ,RI,C 33,"Riparazione, manutenzione ed installazione di macchine ed...",0,0,0,0,0,2024
LAZ,RI,D   ,"Fornitura di energia elettrica, gas, vapore e aria condiz...",0,0,0,0,0,2024
LAZ,RI,D 35,"Fornitura di energia elettrica, gas, vapore e aria condiz...",0,0,0,0,0,2024
LAZ,RI,E   ,"Fornitura di acqua; reti fognarie, attività di gestione d...",0,0,0,0,0,2024
LAZ,RI,E 36,"Raccolta, trattamento e fornitura di acqua                  ",0,0,0,0,0,2024
LAZ,RI,E 37,Gestione delle reti fognarie                                ,0,0,0,0,0,2024
LAZ,RI,E 38,"Attività di raccolta, trattamento e smaltimento dei rifiu...",0,0,0,0,0,2024
LAZ,RI,E 39,Attività di risanamento e altri servizi di gestione dei r...,0,0,0,0,0,2024
LAZ,RI,F   ,Costruzioni                                                 ,5,2,8,54,69,2024
LAZ,RI,F 41,Costruzione di edifici                                      ,2,1,0,30,33,2024
LAZ,RI,F 42,Ingegneria civile                                           ,0,0,0,0,0,2024
LAZ,RI,F 43,Lavori di costruzione specializzati                         ,3,1,8,24,36,2024
LAZ,RI,G   ,Commercio all'ingrosso e al dettaglio; riparazione di aut...,9,0,14,28,51,2024
LAZ,RI,G 45,Commercio all'ingrosso e al dettaglio e riparazione di au...,4,0,2,9,15,2024
LAZ,RI,G 46,Commercio all'ingrosso (escluso quello di autoveicoli e d...,0,0,0,3,3,2024
LAZ,RI,G 47,Commercio al dettaglio (escluso quello di autoveicoli e d...,5,0,12,16,33,2024
LAZ,RI,H   ,Trasporto e magazzinaggio                                   ,0,0,1,15,16,2024
LAZ,RI,H 49,Trasporto terrestre e mediante condotte                     ,0,0,1,9,10,2024
LAZ,RI,H 50,Trasporto marittimo e per vie d'acqua                       ,0,0,0,0,0,2024
LAZ,RI,H 51,Trasporto aereo                                             ,0,0,0,0,0,2024
LAZ,RI,H 52,Magazzinaggio e attività di supporto ai trasporti           ,0,0,0,5,5,2024
LAZ,RI,H 53,Servizi postali e attività di corriere                      ,0,0,0,1,1,2024
LAZ,RI,I   ,Attività dei servizi alloggio e ristorazione                ,5,1,5,34,45,2024
LAZ,RI,I 55,Alloggio                                                    ,0,0,1,0,1,2024
LAZ,RI,I 56,Attività dei servizi di ristorazione                        ,5,1,4,34,44,2024
LAZ,RI,J   ,Servizi di informazione e comunicazione                     ,1,0,1,8,10,2024
LAZ,RI,J 58,Attività editoriali                                         ,0,0,0,0,0,2024
LAZ,RI,J 59,"Attività di produzione cinematografica, di video e di pro...",0,0,0,0,0,2024
LAZ,RI,J 60,Attività di programmazione e trasmissione                   ,0,0,0,0,0,2024
LAZ,RI,J 61,Telecomunicazioni                                           ,0,0,1,0,1,2024
LAZ,RI,J 62,"Produzione di software, consulenza informatica e attività...",1,0,0,1,2,2024
LAZ,RI,J 63,Attività dei servizi d'informazione e altri servizi infor...,0,0,0,7,7,2024
LAZ,RI,K   ,Attività finanziarie e assicurative                         ,0,0,2,0,2,2024
LAZ,RI,K 64,Attività di servizi finanziari (escluse le assicurazioni ...,0,0,0,0,0,2024
LAZ,RI,K 65,"Assicurazioni, riassicurazioni e fondi pensione (escluse ...",0,0,0,0,0,2024
LAZ,RI,K 66,Attività ausiliarie dei servizi finanziari e delle attivi...,0,0,2,0,2,2024
LAZ,RI,L   ,Attivita' immobiliari                                       ,1,0,1,1,3,2024
LAZ,RI,L 68,Attivita' immobiliari                                       ,1,0,1,1,3,2024
LAZ,RI,M   ,"Attività professionali, scientifiche e tecniche             ",1,0,1,5,7,2024
LAZ,RI,M 69,Attività legali e contabilità                               ,0,0,0,0,0,2024
LAZ,RI,M 70,Attività di direzione aziendale e di consulenza gestional...,0,0,0,2,2,2024
LAZ,RI,M 71,Attività degli studi di architettura e d'ingegneria; coll...,0,0,0,1,1,2024
LAZ,RI,M 72,Ricerca scientifica e sviluppo                              ,0,0,0,0,0,2024
LAZ,RI,M 73,Pubblicità e ricerche di mercato                            ,0,0,0,1,1,2024
LAZ,RI,M 74,"Altre attività professionali, scientifiche e tecniche       ",1,0,1,1,3,2024
LAZ,RI,M 75,Servizi veterinari                                          ,0,0,0,0,0,2024
LAZ,RI,N   ,"Noleggio, agenzie di viaggio, servizi di supporto alle im...",1,0,3,22,26,2024
LAZ,RI,N 77,Attività di noleggio e leasing operativo                    ,0,0,0,1,1,2024
LAZ,RI,N 78,"Attività di ricerca, selezione, fornitura di personale      ",0,0,0,0,0,2024
LAZ,RI,N 79,"Attività dei servizi delle agenzie di viaggio, dei tour o...",1,0,0,0,1,2024
LAZ,RI,N 80,Servizi di vigilanza e investigazione                       ,0,0,0,0,0,2024
LAZ,RI,N 81,Attività di servizi per edifici e paesaggio                 ,0,0,1,16,17,2024
LAZ,RI,N 82,Attività di supporto per le funzioni d'ufficio e altri se...,0,0,2,5,7,2024
LAZ,RI,O   ,Amministrazione pubblica e difesa; assicurazione sociale ...,0,0,0,0,0,2024
LAZ,RI,O 84,Amministrazione pubblica e difesa; assicurazione sociale ...,0,0,0,0,0,2024
LAZ,RI,P   ,Istruzione                                                  ,0,0,0,3,3,2024
LAZ,RI,P 85,Istruzione                                                  ,0,0,0,3,3,2024
LAZ,RI,Q   ,Sanita' e assistenza sociale                                ,0,0,2,16,18,2024
LAZ,RI,Q 86,Assistenza sanitaria                                        ,0,0,2,1,3,2024
LAZ,RI,Q 87,Servizi di assistenza sociale residenziale                  ,0,0,0,2,2,2024
LAZ,RI,Q 88,Assistenza sociale non residenziale                         ,0,0,0,13,13,2024
LAZ,RI,R   ,"Attività artistiche, sportive, di intrattenimento e diver...",1,0,2,1,4,2024
LAZ,RI,R 90,"Attività creative, artistiche e di intrattenimento          ",0,0,1,0,1,2024
LAZ,RI,R 91,"Attività di biblioteche, archivi, musei ed altre attività...",0,0,0,0,0,2024
LAZ,RI,R 92,"Attività riguardanti le lotterie, le scommesse, le case d...",0,0,0,1,1,2024
LAZ,RI,R 93,"Attività sportive, di intrattenimento e di divertimento     ",1,0,1,0,2,2024
LAZ,RI,S   ,Altre attività di servizi                                   ,0,1,0,11,12,2024
LAZ,RI,S 94,Attività di organizzazioni associative                      ,0,0,0,0,0,2024
LAZ,RI,S 95,Riparazione di computer e di beni per uso personale e per...,0,0,0,3,3,2024
LAZ,RI,S 96,Altre attività di servizi per la persona                    ,0,1,0,8,9,2024
LAZ,RI,T   ,Attività di famiglie e convivenze come datori di lavoro p...,0,0,0,0,0,2024
LAZ,RI,T 97,Attività di famiglie e convivenze come datori di lavoro p...,0,0,0,0,0,2024
LAZ,RI,T 98,Produzione di beni e servizi indifferenziati per uso prop...,0,0,0,0,0,2024
LAZ,RI,U   ,Organizzazioni ed organismi extraterritoriali               ,0,0,0,0,0,2024
LAZ,RI,U 99,Organizzazioni ed organismi extraterritoriali               ,0,0,0,0,0,2024
LAZ,RI,XX  ,Imprese non classificate                                    ,6,0,6,89,101,2024
LAZ,RI,TOT ,TOTALE                                                      ,32,4,58,334,428,2024
LAZ,RM,A   ,"Agricoltura, silvicoltura pesca                             ",12,52,249,29,342,2024
LAZ,RM,A 01,"Coltivazioni agricole e produzione di prodotti animali, c...",11,49,236,24,320,2024
LAZ,RM,A 02,Silvicoltura ed utilizzo di aree forestali                  ,1,1,8,2,12,2024
LAZ,RM,A 03,Pesca e acquacoltura                                        ,0,2,5,3,10,2024
LAZ,RM,B   ,Estrazione di minerali da cave e miniere                    ,0,6,0,0,6,2024
LAZ,RM,B 05,Estrazione di carbone (esclusa torba)                       ,0,0,0,0,0,2024
LAZ,RM,B 06,Estraz.di petrolio greggio e di gas naturale                ,0,1,0,0,1,2024
LAZ,RM,B 07,Estrazione di minerali metalliferi                          ,0,1,0,0,1,2024
LAZ,RM,B 08,Altre attività di estrazione di minerali da cave e miniere  ,0,4,0,0,4,2024
LAZ,RM,B 09,Attività dei servizi di supporto all'estrazione             ,0,0,0,0,0,2024
LAZ,RM,C   ,Attività manifatturiere                                     ,55,318,205,40,618,2024
LAZ,RM,C 10,Industrie alimentari                                        ,5,50,16,5,76,2024
LAZ,RM,C 11,Industria delle bevande                                     ,0,1,0,0,1,2024
LAZ,RM,C 12,Industria del tabacco                                       ,0,0,0,0,0,2024
LAZ,RM,C 13,Industrie tessili                                           ,1,4,5,0,10,2024
LAZ,RM,C 14,Confezione di articoli di abbigliamento; confezione di ar...,4,43,35,2,84,2024
LAZ,RM,C 15,Fabbricazione di articoli in pelle e simili                 ,0,10,4,0,14,2024
LAZ,RM,C 16,Industria del legno e dei prodotti in legno e sughero (es...,5,10,17,1,33,2024
LAZ,RM,C 17,Fabbricazione di carta e di prodotti di carta               ,0,1,2,0,3,2024
LAZ,RM,C 18,Stampa e riproduzione di supporti registrati                ,3,35,6,6,50,2024
LAZ,RM,C 19,Fabbricazione di coke e prodotti derivanti dalla raffinaz...,0,0,0,0,0,2024
LAZ,RM,C 20,Fabbricazione di prodotti chimici                           ,3,8,0,0,11,2024
LAZ,RM,C 21,Fabbricazione di prodotti farmaceutici di base e di prepa...,1,4,0,0,5,2024
LAZ,RM,C 22,Fabbricazione di articoli in gomma e materie plastiche      ,2,5,0,1,8,2024
LAZ,RM,C 23,Fabbricazione di altri prodotti della lavorazione di miner..,4,7,11,3,25,2024
LAZ,RM,C 24,Metallurgia                                                 ,1,1,3,0,5,2024
LAZ,RM,C 25,Fabbricazione di prodotti in metallo (esclusi macchinari ...,8,51,38,8,105,2024
LAZ,RM,C 26,Fabbricazione di computer e prodotti di elettronica e ott...,4,29,1,2,36,2024
LAZ,RM,C 27,Fabbricazione di apparecchiature elettriche ed apparecchi...,2,5,6,0,13,2024
LAZ,RM,C 28,Fabbricazione di macchinari ed apparecchiature nca          ,2,14,3,3,22,2024
LAZ,RM,C 29,"Fabbricazione di autoveicoli, rimorchi e semirimorchi       ",0,1,1,0,2,2024
LAZ,RM,C 30,Fabbricazione di altri mezzi di trasporto                   ,0,3,1,0,4,2024
LAZ,RM,C 31,Fabbricazione di mobili                                     ,0,15,4,3,22,2024
LAZ,RM,C 32,Altre industrie manifatturiere                              ,5,16,35,3,59,2024
LAZ,RM,C 33,"Riparazione, manutenzione ed installazione di macchine ed...",5,5,17,3,30,2024
LAZ,RM,D   ,"Fornitura di energia elettrica, gas, vapore e aria condiz...",0,0,0,0,0,2024
LAZ,RM,D 35,"Fornitura di energia elettrica, gas, vapore e aria condiz...",0,0,0,0,0,2024
LAZ,RM,E   ,"Fornitura di acqua; reti fognarie, attività di gestione d...",2,4,2,8,16,2024
LAZ,RM,E 36,"Raccolta, trattamento e fornitura di acqua                  ",0,0,0,1,1,2024
LAZ,RM,E 37,Gestione delle reti fognarie                                ,0,1,0,1,2,2024
LAZ,RM,E 38,"Attività di raccolta, trattamento e smaltimento dei rifiu...",2,2,1,2,7,2024
LAZ,RM,E 39,Attività di risanamento e altri servizi di gestione dei r...,0,1,1,4,6,2024
LAZ,RM,F   ,Costruzioni                                                 ,177,379,1043,308,1907,2024
LAZ,RM,F 41,Costruzione di edifici                                      ,108,213,107,218,646,2024
LAZ,RM,F 42,Ingegneria civile                                           ,3,5,4,6,18,2024
LAZ,RM,F 43,Lavori di costruzione specializzati                         ,66,161,932,84,1243,2024
LAZ,RM,G   ,Commercio all'ingrosso e al dettaglio; riparazione di aut...,249,1390,2571,42,4252,2024
LAZ,RM,G 45,Commercio all'ingrosso e al dettaglio e riparazione di au...,28,126,197,4,355,2024
LAZ,RM,G 46,Commercio all'ingrosso (escluso quello di autoveicoli e d...,91,542,627,14,1274,2024
LAZ,RM,G 47,Commercio al dettaglio (escluso quello di autoveicoli e d...,130,722,1747,24,2623,2024
LAZ,RM,H   ,Trasporto e magazzinaggio                                   ,28,99,152,286,565,2024
LAZ,RM,H 49,Trasporto terrestre e mediante condotte                     ,14,67,124,146,351,2024
LAZ,RM,H 50,Trasporto marittimo e per vie d'acqua                       ,0,1,0,1,2,2024
LAZ,RM,H 51,Trasporto aereo                                             ,0,0,0,0,0,2024
LAZ,RM,H 52,Magazzinaggio e attività di supporto ai trasporti           ,10,28,22,137,197,2024
LAZ,RM,H 53,Servizi postali e attività di corriere                      ,4,3,6,2,15,2024
LAZ,RM,I   ,Attività dei servizi alloggio e ristorazione                ,137,694,489,42,1362,2024
LAZ,RM,I 55,Alloggio                                                    ,17,29,32,4,82,2024
LAZ,RM,I 56,Attività dei servizi di ristorazione                        ,120,665,457,38,1280,2024
LAZ,RM,J   ,Servizi di informazione e comunicazione                     ,89,176,181,60,506,2024
LAZ,RM,J 58,Attività editoriali                                         ,13,35,10,16,74,2024
LAZ,RM,J 59,"Attività di produzione cinematografica, di video e di pro...",11,26,14,7,58,2024
LAZ,RM,J 60,Attività di programmazione e trasmissione                   ,3,2,3,0,8,2024
LAZ,RM,J 61,Telecomunicazioni                                           ,6,17,70,2,95,2024
LAZ,RM,J 62,"Produzione di software, consulenza informatica e attività...",31,39,45,12,127,2024
LAZ,RM,J 63,Attività dei servizi d'informazione e altri servizi infor...,25,57,39,23,144,2024
LAZ,RM,K   ,Attività finanziarie e assicurative                         ,13,113,112,4,242,2024
LAZ,RM,K 64,Attività di servizi finanziari (escluse le assicurazioni ...,5,26,1,2,34,2024
LAZ,RM,K 65,"Assicurazioni, riassicurazioni e fondi pensione (escluse ...",0,12,0,0,12,2024
LAZ,RM,K 66,Attività ausiliarie dei servizi finanziari e delle attivi...,8,75,111,2,196,2024
LAZ,RM,L   ,Attivita' immobiliari                                       ,69,128,42,18,257,2024
LAZ,RM,L 68,Attivita' immobiliari                                       ,69,128,42,18,257,2024
LAZ,RM,M   ,"Attività professionali, scientifiche e tecniche             ",73,157,229,105,564,2024
LAZ,RM,M 69,Attività legali e contabilità                               ,3,25,1,7,36,2024
LAZ,RM,M 70,Attività di direzione aziendale e di consulenza gestional...,26,26,34,37,123,2024
LAZ,RM,M 71,Attività degli studi di architettura e d'ingegneria; coll...,9,9,3,4,25,2024
LAZ,RM,M 72,Ricerca scientifica e sviluppo                              ,1,5,0,0,6,2024
LAZ,RM,M 73,Pubblicità e ricerche di mercato                            ,17,35,79,8,139,2024
LAZ,RM,M 74,"Altre attività professionali, scientifiche e tecniche       ",17,57,112,49,235,2024
LAZ,RM,M 75,Servizi veterinari                                          ,0,0,0,0,0,2024
LAZ,RM,N   ,"Noleggio, agenzie di viaggio, servizi di supporto alle im...",107,142,673,274,1196,2024
LAZ,RM,N 77,Attività di noleggio e leasing operativo                    ,8,27,19,8,62,2024
LAZ,RM,N 78,"Attività di ricerca, selezione, fornitura di personale      ",1,0,0,2,3,2024
LAZ,RM,N 79,"Attività dei servizi delle agenzie di viaggio, dei tour o...",9,16,13,1,39,2024
LAZ,RM,N 80,Servizi di vigilanza e investigazione                       ,3,5,3,6,17,2024
LAZ,RM,N 81,Attività di servizi per edifici e paesaggio                 ,19,38,90,163,310,2024
LAZ,RM,N 82,Attività di supporto per le funzioni d'ufficio e altri se...,67,56,548,94,765,2024
LAZ,RM,O   ,Amministrazione pubblica e difesa; assicurazione sociale ...,0,0,0,3,3,2024
LAZ,RM,O 84,Amministrazione pubblica e difesa; assicurazione sociale ...,0,0,0,3,3,2024
LAZ,RM,P   ,Istruzione                                                  ,14,14,19,7,54,2024
LAZ,RM,P 85,Istruzione                                                  ,14,14,19,7,54,2024
LAZ,RM,Q   ,Sanita' e assistenza sociale                                ,19,37,13,58,127,2024
LAZ,RM,Q 86,Assistenza sanitaria                                        ,15,33,3,15,66,2024
LAZ,RM,Q 87,Servizi di assistenza sociale residenziale                  ,2,2,8,3,15,2024
LAZ,RM,Q 88,Assistenza sociale non residenziale                         ,2,2,2,40,46,2024
LAZ,RM,R   ,"Attività artistiche, sportive, di intrattenimento e diver...",32,77,99,27,235,2024
LAZ,RM,R 90,"Attività creative, artistiche e di intrattenimento          ",6,27,22,10,65,2024
LAZ,RM,R 91,"Attività di biblioteche, archivi, musei ed altre attività...",0,0,0,3,3,2024
LAZ,RM,R 92,"Attività riguardanti le lotterie, le scommesse, le case d...",9,3,9,0,21,2024
LAZ,RM,R 93,"Attività sportive, di intrattenimento e di divertimento     ",17,47,68,14,146,2024
LAZ,RM,S   ,Altre attività di servizi                                   ,36,205,238,59,538,2024
LAZ,RM,S 94,Attività di organizzazioni associative                      ,0,0,0,18,18,2024
LAZ,RM,S 95,Riparazione di computer e di beni per uso personale e per...,9,18,36,2,65,2024
LAZ,RM,S 96,Altre attività di servizi per la persona                    ,27,187,202,39,455,2024
LAZ,RM,T   ,Attività di famiglie e convivenze come datori di lavoro p...,0,0,0,0,0,2024
LAZ,RM,T 97,Attività di famiglie e convivenze come datori di lavoro p...,0,0,0,0,0,2024
LAZ,RM,T 98,Produzione di beni e servizi indifferenziati per uso prop...,0,0,0,0,0,2024
LAZ,RM,U   ,Organizzazioni ed organismi extraterritoriali               ,0,0,0,0,0,2024
LAZ,RM,U 99,Organizzazioni ed organismi extraterritoriali               ,0,0,0,0,0,2024
LAZ,RM,XX  ,Imprese non classificate                                    ,387,880,502,779,2548,2024
LAZ,RM,TOT ,TOTALE                                                      ,1499,4871,6819,2149,15338,2024
LAZ,LT,A   ,"Agricoltura, silvicoltura pesca                             ",0,0,18,79,97,2024
LAZ,LT,A 01,"Coltivazioni agricole e produzione di prodotti animali, c...",0,0,17,65,82,2024
LAZ,LT,A 02,Silvicoltura ed utilizzo di aree forestali                  ,0,0,0,4,4,2024
LAZ,LT,A 03,Pesca e acquacoltura                                        ,0,0,1,10,11,2024
LAZ,LT,B   ,Estrazione di minerali da cave e miniere                    ,0,0,0,0,0,2024
LAZ,LT,B 05,Estrazione di carbone (esclusa torba)                       ,0,0,0,0,0,2024
LAZ,LT,B 06,Estraz.di petrolio greggio e di gas naturale                ,0,0,0,0,0,2024
LAZ,LT,B 07,Estrazione di minerali metalliferi                          ,0,0,0,0,0,2024
LAZ,LT,B 08,Altre attività di estrazione di minerali da cave e miniere  ,0,0,0,0,0,2024
LAZ,LT,B 09,Attività dei servizi di supporto all'estrazione             ,0,0,0,0,0,2024
LAZ,LT,C   ,Attività manifatturiere                                     ,4,0,11,57,72,2024
LAZ,LT,C 10,Industrie alimentari                                        ,0,0,1,7,8,2024
LAZ,LT,C 11,Industria delle bevande                                     ,0,0,0,0,0,2024
LAZ,LT,C 12,Industria del tabacco                                       ,0,0,0,1,1,2024
LAZ,LT,C 13,Industrie tessili                                           ,0,0,0,1,1,2024
LAZ,LT,C 14,Confezione di articoli di abbigliamento; confezione di ar...,0,0,0,5,5,2024
LAZ,LT,C 15,Fabbricazione di articoli in pelle e simili                 ,0,0,0,0,0,2024
LAZ,LT,C 16,Industria del legno e dei prodotti in legno e sughero (es...,1,0,0,5,6,2024
LAZ,LT,C 17,Fabbricazione di carta e di prodotti di carta               ,0,0,0,1,1,2024
LAZ,LT,C 18,Stampa e riproduzione di supporti registrati                ,1,0,1,4,6,2024
LAZ,LT,C 19,Fabbricazione di coke e prodotti derivanti dalla raffinaz...,0,0,0,0,0,2024
LAZ,LT,C 20,Fabbricazione di prodotti chimici                           ,0,0,0,1,1,2024
LAZ,LT,C 21,Fabbricazione di prodotti farmaceutici di base e di prepa...,0,0,0,0,0,2024
LAZ,LT,C 22,Fabbricazione di articoli in gomma e materie plastiche      ,0,0,0,0,0,2024
LAZ,LT,C 23,Fabbricazione di altri prodotti della lavorazione di miner..,0,0,0,1,1,2024
LAZ,LT,C 24,Metallurgia                                                 ,0,0,0,1,1,2024
LAZ,LT,C 25,Fabbricazione di prodotti in metallo (esclusi macchinari ...,0,0,5,15,20,2024
LAZ,LT,C 26,Fabbricazione di computer e prodotti di elettronica e ott...,0,0,0,0,0,2024
LAZ,LT,C 27,Fabbricazione di apparecchiature elettriche ed apparecchi...,0,0,0,2,2,2024
LAZ,LT,C 28,Fabbricazione di macchinari ed apparecchiature nca          ,0,0,0,2,2,2024
LAZ,LT,C 29,"Fabbricazione di autoveicoli, rimorchi e semirimorchi       ",0,0,0,1,1,2024
LAZ,LT,C 30,Fabbricazione di altri mezzi di trasporto                   ,0,0,1,5,6,2024
LAZ,LT,C 31,Fabbricazione di mobili                                     ,0,0,2,2,4,2024
LAZ,LT,C 32,Altre industrie manifatturiere                              ,0,0,0,1,1,2024
LAZ,LT,C 33,"Riparazione, manutenzione ed installazione di macchine ed...",2,0,1,2,5,2024
LAZ,LT,D   ,"Fornitura di energia elettrica, gas, vapore e aria condiz...",0,0,0,0,0,2024
LAZ,LT,D 35,"Fornitura di energia elettrica, gas, vapore e aria condiz...",0,0,0,0,0,2024
LAZ,LT,E   ,"Fornitura di acqua; reti fognarie, attività di gestione d...",2,0,0,6,8,2024
LAZ,LT,E 36,"Raccolta, trattamento e fornitura di acqua                  ",0,0,0,0,0,2024
LAZ,LT,E 37,Gestione delle reti fognarie                                ,0,0,0,0,0,2024
LAZ,LT,E 38,"Attività di raccolta, trattamento e smaltimento dei rifiu...",2,0,0,5,7,2024
LAZ,LT,E 39,Attività di risanamento e altri servizi di gestione dei r...,0,0,0,1,1,2024
LAZ,LT,F   ,Costruzioni                                                 ,6,0,13,123,142,2024
LAZ,LT,F 41,Costruzione di edifici                                      ,3,0,5,89,97,2024
LAZ,LT,F 42,Ingegneria civile                                           ,1,0,0,0,1,2024
LAZ,LT,F 43,Lavori di costruzione specializzati                         ,2,0,8,34,44,2024
LAZ,LT,G   ,Commercio all'ingrosso e al dettaglio; riparazione di aut...,14,0,49,39,102,2024
LAZ,LT,G 45,Commercio all'ingrosso e al dettaglio e riparazione di au...,1,0,9,8,18,2024
LAZ,LT,G 46,Commercio all'ingrosso (escluso quello di autoveicoli e d...,5,0,5,9,19,2024
LAZ,LT,G 47,Commercio al dettaglio (escluso quello di autoveicoli e d...,8,0,35,22,65,2024
LAZ,LT,H   ,Trasporto e magazzinaggio                                   ,0,0,3,64,67,2024
LAZ,LT,H 49,Trasporto terrestre e mediante condotte                     ,0,0,1,27,28,2024
LAZ,LT,H 50,Trasporto marittimo e per vie d'acqua                       ,0,0,0,0,0,2024
LAZ,LT,H 51,Trasporto aereo                                             ,0,0,0,0,0,2024
LAZ,LT,H 52,Magazzinaggio e attività di supporto ai trasporti           ,0,0,2,35,37,2024
LAZ,LT,H 53,Servizi postali e attività di corriere                      ,0,0,0,2,2,2024
LAZ,LT,I   ,Attività dei servizi alloggio e ristorazione                ,4,0,14,29,47,2024
LAZ,LT,I 55,Alloggio                                                    ,0,0,0,1,1,2024
LAZ,LT,I 56,Attività dei servizi di ristorazione                        ,4,0,14,28,46,2024
LAZ,LT,J   ,Servizi di informazione e comunicazione                     ,1,0,3,21,25,2024
LAZ,LT,J 58,Attività editoriali                                         ,0,0,0,2,2,2024
LAZ,LT,J 59,"Attività di produzione cinematografica, di video e di pro...",0,0,0,0,0,2024
LAZ,LT,J 60,Attività di programmazione e trasmissione                   ,0,0,0,3,3,2024
LAZ,LT,J 61,Telecomunicazioni                                           ,0,0,0,1,1,2024
LAZ,LT,J 62,"Produzione di software, consulenza informatica e attività...",1,0,1,4,6,2024
LAZ,LT,J 63,Attività dei servizi d'informazione e altri servizi infor...,0,0,2,11,13,2024
LAZ,LT,K   ,Attività finanziarie e assicurative                         ,0,0,3,1,4,2024
LAZ,LT,K 64,Attività di servizi finanziari (escluse le assicurazioni ...,0,0,0,0,0,2024
LAZ,LT,K 65,"Assicurazioni, riassicurazioni e fondi pensione (escluse ...",0,0,0,0,0,2024
LAZ,LT,K 66,Attività ausiliarie dei servizi finanziari e delle attivi...,0,0,3,1,4,2024
LAZ,LT,L   ,Attivita' immobiliari                                       ,2,0,0,8,10,2024
LAZ,LT,L 68,Attivita' immobiliari                                       ,2,0,0,8,10,2024
LAZ,LT,M   ,"Attività professionali, scientifiche e tecniche             ",4,0,6,25,35,2024
LAZ,LT,M 69,Attività legali e contabilità                               ,1,0,0,3,4,2024
LAZ,LT,M 70,Attività di direzione aziendale e di consulenza gestional...,0,0,1,4,5,2024
LAZ,LT,M 71,Attività degli studi di architettura e d'ingegneria; coll...,1,0,0,2,3,2024
LAZ,LT,M 72,Ricerca scientifica e sviluppo                              ,0,0,0,1,1,2024
LAZ,LT,M 73,Pubblicità e ricerche di mercato                            ,2,0,0,6,8,2024
LAZ,LT,M 74,"Altre attività professionali, scientifiche e tecniche       ",0,0,5,9,14,2024
LAZ,LT,M 75,Servizi veterinari                                          ,0,0,0,0,0,2024
LAZ,LT,N   ,"Noleggio, agenzie di viaggio, servizi di supporto alle im...",1,0,8,80,89,2024
LAZ,LT,N 77,Attività di noleggio e leasing operativo                    ,0,0,1,1,2,2024
LAZ,LT,N 78,"Attività di ricerca, selezione, fornitura di personale      ",0,0,0,1,1,2024
LAZ,LT,N 79,"Attività dei servizi delle agenzie di viaggio, dei tour o...",1,0,0,0,1,2024
LAZ,LT,N 80,Servizi di vigilanza e investigazione                       ,0,0,0,1,1,2024
LAZ,LT,N 81,Attività di servizi per edifici e paesaggio                 ,0,0,4,52,56,2024
LAZ,LT,N 82,Attività di supporto per le funzioni d'ufficio e altri se...,0,0,3,25,28,2024
LAZ,LT,O   ,Amministrazione pubblica e difesa; assicurazione sociale ...,0,0,0,1,1,2024
LAZ,LT,O 84,Amministrazione pubblica e difesa; assicurazione sociale ...,0,0,0,1,1,2024
LAZ,LT,P   ,Istruzione                                                  ,1,0,0,7,8,2024
LAZ,LT,P 85,Istruzione                                                  ,1,0,0,7,8,2024
LAZ,LT,Q   ,Sanita' e assistenza sociale                                ,1,0,1,25,27,2024
LAZ,LT,Q 86,Assistenza sanitaria                                        ,0,0,0,2,2,2024
LAZ,LT,Q 87,Servizi di assistenza sociale residenziale                  ,0,0,1,4,5,2024
LAZ,LT,Q 88,Assistenza sociale non residenziale                         ,1,0,0,19,20,2024
LAZ,LT,R   ,"Attività artistiche, sportive, di intrattenimento e diver...",2,0,4,19,25,2024
LAZ,LT,R 90,"Attività creative, artistiche e di intrattenimento          ",0,0,1,8,9,2024
LAZ,LT,R 91,"Attività di biblioteche, archivi, musei ed altre attività...",0,0,0,1,1,2024
LAZ,LT,R 92,"Attività riguardanti le lotterie, le scommesse, le case d...",0,0,0,0,0,2024
LAZ,LT,R 93,"Attività sportive, di intrattenimento e di divertimento     ",2,0,3,10,15,2024
LAZ,LT,S   ,Altre attività di servizi                                   ,0,0,3,15,18,2024
LAZ,LT,S 94,Attività di organizzazioni associative                      ,0,0,0,1,1,2024
LAZ,LT,S 95,Riparazione di computer e di beni per uso personale e per...,0,0,0,1,1,2024
LAZ,LT,S 96,Altre attività di servizi per la persona                    ,0,0,3,13,16,2024
LAZ,LT,T   ,Attività di famiglie e convivenze come datori di lavoro p...,0,0,0,0,0,2024
LAZ,LT,T 97,Attività di famiglie e convivenze come datori di lavoro p...,0,0,0,0,0,2024
LAZ,LT,T 98,Produzione di beni e servizi indifferenziati per uso prop...,0,0,0,0,0,2024
LAZ,LT,U   ,Organizzazioni ed organismi extraterritoriali               ,0,0,0,0,0,2024
LAZ,LT,U 99,Organizzazioni ed organismi extraterritoriali               ,0,0,0,0,0,2024
LAZ,LT,XX  ,Imprese non classificate                                    ,5,0,10,41,56,2024
LAZ,LT,TOT ,TOTALE                                                      ,47,0,146,640,833,2024
LAZ,FR,A   ,"Agricoltura, silvicoltura pesca                             ",0,0,17,18,35,2024
LAZ,FR,A 01,"Coltivazioni agricole e produzione di prodotti animali, c...",0,0,14,18,32,2024
LAZ,FR,A 02,Silvicoltura ed utilizzo di aree forestali                  ,0,0,3,0,3,2024
LAZ,FR,A 03,Pesca e acquacoltura                                        ,0,0,0,0,0,2024
LAZ,FR,B   ,Estrazione di minerali da cave e miniere                    ,0,0,0,0,0,2024
LAZ,FR,B 05,Estrazione di carbone (esclusa torba)                       ,0,0,0,0,0,2024
LAZ,FR,B 06,Estraz.di petrolio greggio e di gas naturale                ,0,0,0,0,0,2024
LAZ,FR,B 07,Estrazione di minerali metalliferi                          ,0,0,0,0,0,2024
LAZ,FR,B 08,Altre attività di estrazione di minerali da cave e miniere  ,0,0,0,0,0,2024
LAZ,FR,B 09,Attività dei servizi di supporto all'estrazione             ,0,0,0,0,0,2024
LAZ,FR,C   ,Attività manifatturiere                                     ,10,13,58,32,113,2024
LAZ,FR,C 10,Industrie alimentari                                        ,0,0,3,6,9,2024
LAZ,FR,C 11,Industria delle bevande                                     ,0,0,0,0,0,2024
LAZ,FR,C 12,Industria del tabacco                                       ,0,0,0,0,0,2024
LAZ,FR,C 13,Industrie tessili                                           ,0,1,2,1,4,2024
LAZ,FR,C 14,Confezione di articoli di abbigliamento; confezione di ar...,2,0,7,0,9,2024
LAZ,FR,C 15,Fabbricazione di articoli in pelle e simili                 ,0,1,0,0,1,2024
LAZ,FR,C 16,Industria del legno e dei prodotti in legno e sughero (es...,1,1,10,2,14,2024
LAZ,FR,C 17,Fabbricazione di carta e di prodotti di carta               ,1,0,0,0,1,2024
LAZ,FR,C 18,Stampa e riproduzione di supporti registrati                ,1,0,2,2,5,2024
LAZ,FR,C 19,Fabbricazione di coke e prodotti derivanti dalla raffinaz...,0,0,0,0,0,2024
LAZ,FR,C 20,Fabbricazione di prodotti chimici                           ,0,0,0,1,1,2024
LAZ,FR,C 21,Fabbricazione di prodotti farmaceutici di base e di prepa...,0,0,0,0,0,2024
LAZ,FR,C 22,Fabbricazione di articoli in gomma e materie plastiche      ,0,1,0,1,2,2024
LAZ,FR,C 23,Fabbricazione di altri prodotti della lavorazione di miner..,1,1,2,5,9,2024
LAZ,FR,C 24,Metallurgia                                                 ,0,1,0,0,1,2024
LAZ,FR,C 25,Fabbricazione di prodotti in metallo (esclusi macchinari ...,4,5,19,7,35,2024
LAZ,FR,C 26,Fabbricazione di computer e prodotti di elettronica e ott...,0,0,2,1,3,2024
LAZ,FR,C 27,Fabbricazione di apparecchiature elettriche ed apparecchi...,0,1,2,0,3,2024
LAZ,FR,C 28,Fabbricazione di macchinari ed apparecchiature nca          ,0,0,1,1,2,2024
LAZ,FR,C 29,"Fabbricazione di autoveicoli, rimorchi e semirimorchi       ",0,1,0,0,1,2024
LAZ,FR,C 30,Fabbricazione di altri mezzi di trasporto                   ,0,0,0,0,0,2024
LAZ,FR,C 31,Fabbricazione di mobili                                     ,0,0,1,3,4,2024
LAZ,FR,C 32,Altre industrie manifatturiere                              ,0,0,4,1,5,2024
LAZ,FR,C 33,"Riparazione, manutenzione ed installazione di macchine ed...",0,0,3,1,4,2024
LAZ,FR,D   ,"Fornitura di energia elettrica, gas, vapore e aria condiz...",0,0,0,0,0,2024
LAZ,FR,D 35,"Fornitura di energia elettrica, gas, vapore e aria condiz...",0,0,0,0,0,2024
LAZ,FR,E   ,"Fornitura di acqua; reti fognarie, attività di gestione d...",2,0,0,4,6,2024
LAZ,FR,E 36,"Raccolta, trattamento e fornitura di acqua                  ",0,0,0,0,0,2024
LAZ,FR,E 37,Gestione delle reti fognarie                                ,0,0,0,0,0,2024
LAZ,FR,E 38,"Attività di raccolta, trattamento e smaltimento dei rifiu...",2,0,0,1,3,2024
LAZ,FR,E 39,Attività di risanamento e altri servizi di gestione dei r...,0,0,0,3,3,2024
LAZ,FR,F   ,Costruzioni                                                 ,23,11,142,106,282,2024
LAZ,FR,F 41,Costruzione di edifici                                      ,15,8,34,60,117,2024
LAZ,FR,F 42,Ingegneria civile                                           ,0,0,0,1,1,2024
LAZ,FR,F 43,Lavori di costruzione specializzati                         ,8,3,108,45,164,2024
LAZ,FR,G   ,Commercio all'ingrosso e al dettaglio; riparazione di aut...,19,23,243,35,320,2024
LAZ,FR,G 45,Commercio all'ingrosso e al dettaglio e riparazione di au...,6,4,13,2,25,2024
LAZ,FR,G 46,Commercio all'ingrosso (escluso quello di autoveicoli e d...,5,3,44,10,62,2024
LAZ,FR,G 47,Commercio al dettaglio (escluso quello di autoveicoli e d...,8,16,186,23,233,2024
LAZ,FR,H   ,Trasporto e magazzinaggio                                   ,2,12,28,35,77,2024
LAZ,FR,H 49,Trasporto terrestre e mediante condotte                     ,2,12,28,24,66,2024
LAZ,FR,H 50,Trasporto marittimo e per vie d'acqua                       ,0,0,0,0,0,2024
LAZ,FR,H 51,Trasporto aereo                                             ,0,0,0,0,0,2024
LAZ,FR,H 52,Magazzinaggio e attività di supporto ai trasporti           ,0,0,0,10,10,2024
LAZ,FR,H 53,Servizi postali e attività di corriere                      ,0,0,0,1,1,2024
LAZ,FR,I   ,Attività dei servizi alloggio e ristorazione                ,2,8,42,38,90,2024
LAZ,FR,I 55,Alloggio                                                    ,0,1,0,2,3,2024
LAZ,FR,I 56,Attività dei servizi di ristorazione                        ,2,7,42,36,87,2024
LAZ,FR,J   ,Servizi di informazione e comunicazione                     ,2,1,11,13,27,2024
LAZ,FR,J 58,Attività editoriali                                         ,0,0,0,1,1,2024
LAZ,FR,J 59,"Attività di produzione cinematografica, di video e di pro...",0,0,2,0,2,2024
LAZ,FR,J 60,Attività di programmazione e trasmissione                   ,0,0,0,0,0,2024
LAZ,FR,J 61,Telecomunicazioni                                           ,0,0,5,0,5,2024
LAZ,FR,J 62,"Produzione di software, consulenza informatica e attività...",2,0,1,0,3,2024
LAZ,FR,J 63,Attività dei servizi d'informazione e altri servizi infor...,0,1,3,12,16,2024
LAZ,FR,K   ,Attività finanziarie e assicurative                         ,2,0,7,2,11,2024
LAZ,FR,K 64,Attività di servizi finanziari (escluse le assicurazioni ...,1,0,0,1,2,2024
LAZ,FR,K 65,"Assicurazioni, riassicurazioni e fondi pensione (escluse ...",0,0,0,1,1,2024
LAZ,FR,K 66,Attività ausiliarie dei servizi finanziari e delle attivi...,1,0,7,0,8,2024
LAZ,FR,L   ,Attivita' immobiliari                                       ,2,2,4,4,12,2024
LAZ,FR,L 68,Attivita' immobiliari                                       ,2,2,4,4,12,2024
LAZ,FR,M   ,"Attività professionali, scientifiche e tecniche             ",2,0,5,17,24,2024
LAZ,FR,M 69,Attività legali e contabilità                               ,0,0,0,0,0,2024
LAZ,FR,M 70,Attività di direzione aziendale e di consulenza gestional...,0,0,0,6,6,2024
LAZ,FR,M 71,Attività degli studi di architettura e d'ingegneria; coll...,0,0,0,1,1,2024
LAZ,FR,M 72,Ricerca scientifica e sviluppo                              ,0,0,0,0,0,2024
LAZ,FR,M 73,Pubblicità e ricerche di mercato                            ,2,0,3,5,10,2024
LAZ,FR,M 74,"Altre attività professionali, scientifiche e tecniche       ",0,0,2,5,7,2024
LAZ,FR,M 75,Servizi veterinari                                          ,0,0,0,0,0,2024
LAZ,FR,N   ,"Noleggio, agenzie di viaggio, servizi di supporto alle im...",1,3,12,40,56,2024
LAZ,FR,N 77,Attività di noleggio e leasing operativo                    ,0,0,2,1,3,2024
LAZ,FR,N 78,"Attività di ricerca, selezione, fornitura di personale      ",0,0,0,0,0,2024
LAZ,FR,N 79,"Attività dei servizi delle agenzie di viaggio, dei tour o...",0,2,1,0,3,2024
LAZ,FR,N 80,Servizi di vigilanza e investigazione                       ,0,0,0,0,0,2024
LAZ,FR,N 81,Attività di servizi per edifici e paesaggio                 ,0,1,5,25,31,2024
LAZ,FR,N 82,Attività di supporto per le funzioni d'ufficio e altri se...,1,0,4,14,19,2024
LAZ,FR,O   ,Amministrazione pubblica e difesa; assicurazione sociale ...,0,0,0,0,0,2024
LAZ,FR,O 84,Amministrazione pubblica e difesa; assicurazione sociale ...,0,0,0,0,0,2024
LAZ,FR,P   ,Istruzione                                                  ,0,1,2,2,5,2024
LAZ,FR,P 85,Istruzione                                                  ,0,1,2,2,5,2024
LAZ,FR,Q   ,Sanita' e assistenza sociale                                ,2,1,0,19,22,2024
LAZ,FR,Q 86,Assistenza sanitaria                                        ,1,1,0,0,2,2024
LAZ,FR,Q 87,Servizi di assistenza sociale residenziale                  ,1,0,0,7,8,2024
LAZ,FR,Q 88,Assistenza sociale non residenziale                         ,0,0,0,12,12,2024
LAZ,FR,R   ,"Attività artistiche, sportive, di intrattenimento e diver...",0,1,12,3,16,2024
LAZ,FR,R 90,"Attività creative, artistiche e di intrattenimento          ",0,1,4,2,7,2024
LAZ,FR,R 91,"Attività di biblioteche, archivi, musei ed altre attività...",0,0,0,0,0,2024
LAZ,FR,R 92,"Attività riguardanti le lotterie, le scommesse, le case d...",0,0,0,0,0,2024
LAZ,FR,R 93,"Attività sportive, di intrattenimento e di divertimento     ",0,0,8,1,9,2024
LAZ,FR,S   ,Altre attività di servizi                                   ,0,3,18,6,27,2024
LAZ,FR,S 94,Attività di organizzazioni associative                      ,0,0,0,0,0,2024
LAZ,FR,S 95,Riparazione di computer e di beni per uso personale e per...,0,1,5,1,7,2024
LAZ,FR,S 96,Altre attività di servizi per la persona                    ,0,2,13,5,20,2024
LAZ,FR,T   ,Attività di famiglie e convivenze come datori di lavoro p...,0,0,0,0,0,2024
LAZ,FR,T 97,Attività di famiglie e convivenze come datori di lavoro p...,0,0,0,0,0,2024
LAZ,FR,T 98,Produzione di beni e servizi indifferenziati per uso prop...,0,0,0,0,0,2024
LAZ,FR,U   ,Organizzazioni ed organismi extraterritoriali               ,0,0,0,0,0,2024
LAZ,FR,U 99,Organizzazioni ed organismi extraterritoriali               ,0,0,0,0,0,2024
LAZ,FR,XX  ,Imprese non classificate                                    ,13,12,0,146,171,2024
LAZ,FR,TOT ,TOTALE                                                      ,82,91,601,520,1294,2024
ABR,  ,A   ,"Agricoltura, silvicoltura pesca                             ",0,1,0,45,46,2024
ABR,  ,A 01,"Coltivazioni agricole e produzione di prodotti animali, c...",0,0,0,35,35,2024
ABR,  ,A 02,Silvicoltura ed utilizzo di aree forestali                  ,0,0,0,10,10,2024
ABR,  ,A 03,Pesca e acquacoltura                                        ,0,1,0,0,1,2024
ABR,  ,B   ,Estrazione di minerali da cave e miniere                    ,0,0,0,0,0,2024
ABR,  ,B 05,Estrazione di carbone (esclusa torba)                       ,0,0,0,0,0,2024
ABR,  ,B 06,Estraz.di petrolio greggio e di gas naturale                ,0,0,0,0,0,2024
ABR,  ,B 07,Estrazione di minerali metalliferi                          ,0,0,0,0,0,2024
ABR,  ,B 08,Altre attività di estrazione di minerali da cave e miniere  ,0,0,0,0,0,2024
ABR,  ,B 09,Attività dei servizi di supporto all'estrazione             ,0,0,0,0,0,2024
ABR,  ,C   ,Attività manifatturiere                                     ,42,19,1,30,92,2024
ABR,  ,C 10,Industrie alimentari                                        ,3,2,1,8,14,2024
ABR,  ,C 11,Industria delle bevande                                     ,1,0,0,0,1,2024
ABR,  ,C 12,Industria del tabacco                                       ,0,0,0,0,0,2024
ABR,  ,C 13,Industrie tessili                                           ,1,0,0,0,1,2024
ABR,  ,C 14,Confezione di articoli di abbigliamento; confezione di ar...,7,1,0,3,11,2024
ABR,  ,C 15,Fabbricazione di articoli in pelle e simili                 ,0,1,0,3,4,2024
ABR,  ,C 16,Industria del legno e dei prodotti in legno e sughero (es...,4,3,0,0,7,2024
ABR,  ,C 17,Fabbricazione di carta e di prodotti di carta               ,2,0,0,0,2,2024
ABR,  ,C 18,Stampa e riproduzione di supporti registrati                ,1,3,0,5,9,2024
ABR,  ,C 19,Fabbricazione di coke e prodotti derivanti dalla raffinaz...,0,0,0,0,0,2024
ABR,  ,C 20,Fabbricazione di prodotti chimici                           ,0,0,0,0,0,2024
ABR,  ,C 21,Fabbricazione di prodotti farmaceutici di base e di prepa...,0,0,0,0,0,2024
ABR,  ,C 22,Fabbricazione di articoli in gomma e materie plastiche      ,3,0,0,0,3,2024
ABR,  ,C 23,Fabbricazione di altri prodotti della lavorazione di miner..,3,0,0,1,4,2024
ABR,  ,C 24,Metallurgia                                                 ,0,0,0,0,0,2024
ABR,  ,C 25,Fabbricazione di prodotti in metallo (esclusi macchinari ...,10,6,0,7,23,2024
ABR,  ,C 26,Fabbricazione di computer e prodotti di elettronica e ott...,1,0,0,0,1,2024
ABR,  ,C 27,Fabbricazione di apparecchiature elettriche ed apparecchi...,0,0,0,0,0,2024
ABR,  ,C 28,Fabbricazione di macchinari ed apparecchiature nca          ,3,0,0,1,4,2024
ABR,  ,C 29,"Fabbricazione di autoveicoli, rimorchi e semirimorchi       ",0,1,0,1,2,2024
ABR,  ,C 30,Fabbricazione di altri mezzi di trasporto                   ,0,0,0,0,0,2024
ABR,  ,C 31,Fabbricazione di mobili                                     ,2,2,0,0,4,2024
ABR,  ,C 32,Altre industrie manifatturiere                              ,0,0,0,0,0,2024
ABR,  ,C 33,"Riparazione, manutenzione ed installazione di macchine ed...",1,0,0,1,2,2024
ABR,  ,D   ,"Fornitura di energia elettrica, gas, vapore e aria condiz...",0,0,0,0,0,2024
ABR,  ,D 35,"Fornitura di energia elettrica, gas, vapore e aria condiz...",0,0,0,0,0,2024
ABR,  ,E   ,"Fornitura di acqua; reti fognarie, attività di gestione d...",0,2,0,3,5,2024
ABR,  ,E 36,"Raccolta, trattamento e fornitura di acqua                  ",0,0,0,1,1,2024
ABR,  ,E 37,Gestione delle reti fognarie                                ,0,1,0,1,2,2024
ABR,  ,E 38,"Attività di raccolta, trattamento e smaltimento dei rifiu...",0,1,0,1,2,2024
ABR,  ,E 39,Attività di risanamento e altri servizi di gestione dei r...,0,0,0,0,0,2024
ABR,  ,F   ,Costruzioni                                                 ,31,17,2,72,122,2024
ABR,  ,F 41,Costruzione di edifici                                      ,16,11,0,44,71,2024
ABR,  ,F 42,Ingegneria civile                                           ,1,0,0,0,1,2024
ABR,  ,F 43,Lavori di costruzione specializzati                         ,14,6,2,28,50,2024
ABR,  ,G   ,Commercio all'ingrosso e al dettaglio; riparazione di aut...,37,63,13,25,138,2024
ABR,  ,G 45,Commercio all'ingrosso e al dettaglio e riparazione di au...,4,9,9,4,26,2024
ABR,  ,G 46,Commercio all'ingrosso (escluso quello di autoveicoli e d...,14,14,2,6,36,2024
ABR,  ,G 47,Commercio al dettaglio (escluso quello di autoveicoli e d...,19,40,2,15,76,2024
ABR,  ,H   ,Trasporto e magazzinaggio                                   ,7,10,0,28,45,2024
ABR,  ,H 49,Trasporto terrestre e mediante condotte                     ,3,8,0,13,24,2024
ABR,  ,H 50,Trasporto marittimo e per vie d'acqua                       ,1,0,0,0,1,2024
ABR,  ,H 51,Trasporto aereo                                             ,0,0,0,0,0,2024
ABR,  ,H 52,Magazzinaggio e attività di supporto ai trasporti           ,3,0,0,14,17,2024
ABR,  ,H 53,Servizi postali e attività di corriere                      ,0,2,0,1,3,2024
ABR,  ,I   ,Attività dei servizi alloggio e ristorazione                ,16,58,2,15,91,2024
ABR,  ,I 55,Alloggio                                                    ,2,2,0,2,6,2024
ABR,  ,I 56,Attività dei servizi di ristorazione                        ,14,56,2,13,85,2024
ABR,  ,J   ,Servizi di informazione e comunicazione                     ,8,6,1,23,38,2024
ABR,  ,J 58,Attività editoriali                                         ,0,1,0,2,3,2024
ABR,  ,J 59,"Attività di produzione cinematografica, di video e di pro...",0,0,0,2,2,2024
ABR,  ,J 60,Attività di programmazione e trasmissione                   ,0,1,0,0,1,2024
ABR,  ,J 61,Telecomunicazioni                                           ,1,1,0,0,2,2024
ABR,  ,J 62,"Produzione di software, consulenza informatica e attività...",2,2,0,4,8,2024
ABR,  ,J 63,Attività dei servizi d'informazione e altri servizi infor...,5,1,1,15,22,2024
ABR,  ,K   ,Attività finanziarie e assicurative                         ,6,1,0,3,10,2024
ABR,  ,K 64,Attività di servizi finanziari (escluse le assicurazioni ...,1,0,0,1,2,2024
ABR,  ,K 65,"Assicurazioni, riassicurazioni e fondi pensione (escluse ...",0,1,0,0,1,2024
ABR,  ,K 66,Attività ausiliarie dei servizi finanziari e delle attivi...,5,0,0,2,7,2024
ABR,  ,L   ,Attivita' immobiliari                                       ,3,2,0,1,6,2024
ABR,  ,L 68,Attivita' immobiliari                                       ,3,2,0,1,6,2024
ABR,  ,M   ,"Attività professionali, scientifiche e tecniche             ",12,11,1,18,42,2024
ABR,  ,M 69,Attività legali e contabilità                               ,1,0,0,2,3,2024
ABR,  ,M 70,Attività di direzione aziendale e di consulenza gestional...,2,1,0,6,9,2024
ABR,  ,M 71,Attività degli studi di architettura e d'ingegneria; coll...,3,1,0,2,6,2024
ABR,  ,M 72,Ricerca scientifica e sviluppo                              ,0,0,0,0,0,2024
ABR,  ,M 73,Pubblicità e ricerche di mercato                            ,3,3,0,2,8,2024
ABR,  ,M 74,"Altre attività professionali, scientifiche e tecniche       ",3,6,1,5,15,2024
ABR,  ,M 75,Servizi veterinari                                          ,0,0,0,1,1,2024
ABR,  ,N   ,"Noleggio, agenzie di viaggio, servizi di supporto alle im...",7,13,1,40,61,2024
ABR,  ,N 77,Attività di noleggio e leasing operativo                    ,1,2,0,1,4,2024
ABR,  ,N 78,"Attività di ricerca, selezione, fornitura di personale      ",0,0,0,0,0,2024
ABR,  ,N 79,"Attività dei servizi delle agenzie di viaggio, dei tour o...",1,1,0,0,2,2024
ABR,  ,N 80,Servizi di vigilanza e investigazione                       ,2,0,0,2,4,2024
ABR,  ,N 81,Attività di servizi per edifici e paesaggio                 ,1,6,1,26,34,2024
ABR,  ,N 82,Attività di supporto per le funzioni d'ufficio e altri se...,2,4,0,11,17,2024
ABR,  ,O   ,Amministrazione pubblica e difesa; assicurazione sociale ...,0,0,0,1,1,2024
ABR,  ,O 84,Amministrazione pubblica e difesa; assicurazione sociale ...,0,0,0,1,1,2024
ABR,  ,P   ,Istruzione                                                  ,1,0,0,3,4,2024
ABR,  ,P 85,Istruzione                                                  ,1,0,0,3,4,2024
ABR,  ,Q   ,Sanita' e assistenza sociale                                ,3,3,0,19,25,2024
ABR,  ,Q 86,Assistenza sanitaria                                        ,2,1,0,4,7,2024
ABR,  ,Q 87,Servizi di assistenza sociale residenziale                  ,1,0,0,3,4,2024
ABR,  ,Q 88,Assistenza sociale non residenziale                         ,0,2,0,12,14,2024
ABR,  ,R   ,"Attività artistiche, sportive, di intrattenimento e diver...",4,8,0,17,29,2024
ABR,  ,R 90,"Attività creative, artistiche e di intrattenimento          ",0,0,0,3,3,2024
ABR,  ,R 91,"Attività di biblioteche, archivi, musei ed altre attività...",0,0,0,4,4,2024
ABR,  ,R 92,"Attività riguardanti le lotterie, le scommesse, le case d...",0,0,0,0,0,2024
ABR,  ,R 93,"Attività sportive, di intrattenimento e di divertimento     ",4,8,0,10,22,2024
ABR,  ,S   ,Altre attività di servizi                                   ,7,13,0,21,41,2024
ABR,  ,S 94,Attività di organizzazioni associative                      ,0,0,0,0,0,2024
ABR,  ,S 95,Riparazione di computer e di beni per uso personale e per...,1,2,0,1,4,2024
ABR,  ,S 96,Altre attività di servizi per la persona                    ,6,11,0,20,37,2024
ABR,  ,T   ,Attività di famiglie e convivenze come datori di lavoro p...,0,0,0,0,0,2024
ABR,  ,T 97,Attività di famiglie e convivenze come datori di lavoro p...,0,0,0,0,0,2024
ABR,  ,T 98,Produzione di beni e servizi indifferenziati per uso prop...,0,0,0,0,0,2024
ABR,  ,U   ,Organizzazioni ed organismi extraterritoriali               ,0,0,0,0,0,2024
ABR,  ,U 99,Organizzazioni ed organismi extraterritoriali               ,0,0,0,0,0,2024
ABR,  ,XX  ,Imprese non classificate                                    ,70,45,3,86,204,2024
ABR,  ,TOT ,TOTALE                                                      ,254,272,24,450,1000,2024
ABR,AQ,A   ,"Agricoltura, silvicoltura pesca                             ",0,0,0,27,27,2024
ABR,AQ,A 01,"Coltivazioni agricole e produzione di prodotti animali, c...",0,0,0,23,23,2024
ABR,AQ,A 02,Silvicoltura ed utilizzo di aree forestali                  ,0,0,0,4,4,2024
ABR,AQ,A 03,Pesca e acquacoltura                                        ,0,0,0,0,0,2024
ABR,AQ,B   ,Estrazione di minerali da cave e miniere                    ,0,0,0,0,0,2024
ABR,AQ,B 05,Estrazione di carbone (esclusa torba)                       ,0,0,0,0,0,2024
ABR,AQ,B 06,Estraz.di petrolio greggio e di gas naturale                ,0,0,0,0,0,2024
ABR,AQ,B 07,Estrazione di minerali metalliferi                          ,0,0,0,0,0,2024
ABR,AQ,B 08,Altre attività di estrazione di minerali da cave e miniere  ,0,0,0,0,0,2024
ABR,AQ,B 09,Attività dei servizi di supporto all'estrazione             ,0,0,0,0,0,2024
ABR,AQ,C   ,Attività manifatturiere                                     ,0,0,0,5,5,2024
ABR,AQ,C 10,Industrie alimentari                                        ,0,0,0,3,3,2024
ABR,AQ,C 11,Industria delle bevande                                     ,0,0,0,0,0,2024
ABR,AQ,C 12,Industria del tabacco                                       ,0,0,0,0,0,2024
ABR,AQ,C 13,Industrie tessili                                           ,0,0,0,0,0,2024
ABR,AQ,C 14,Confezione di articoli di abbigliamento; confezione di ar...,0,0,0,0,0,2024
ABR,AQ,C 15,Fabbricazione di articoli in pelle e simili                 ,0,0,0,0,0,2024
ABR,AQ,C 16,Industria del legno e dei prodotti in legno e sughero (es...,0,0,0,0,0,2024
ABR,AQ,C 17,Fabbricazione di carta e di prodotti di carta               ,0,0,0,0,0,2024
ABR,AQ,C 18,Stampa e riproduzione di supporti registrati                ,0,0,0,2,2,2024
ABR,AQ,C 19,Fabbricazione di coke e prodotti derivanti dalla raffinaz...,0,0,0,0,0,2024
ABR,AQ,C 20,Fabbricazione di prodotti chimici                           ,0,0,0,0,0,2024
ABR,AQ,C 21,Fabbricazione di prodotti farmaceutici di base e di prepa...,0,0,0,0,0,2024
ABR,AQ,C 22,Fabbricazione di articoli in gomma e materie plastiche      ,0,0,0,0,0,2024
ABR,AQ,C 23,Fabbricazione di altri prodotti della lavorazione di miner..,0,0,0,0,0,2024
ABR,AQ,C 24,Metallurgia                                                 ,0,0,0,0,0,2024
ABR,AQ,C 25,Fabbricazione di prodotti in metallo (esclusi macchinari ...,0,0,0,0,0,2024
ABR,AQ,C 26,Fabbricazione di computer e prodotti di elettronica e ott...,0,0,0,0,0,2024
ABR,AQ,C 27,Fabbricazione di apparecchiature elettriche ed apparecchi...,0,0,0,0,0,2024
ABR,AQ,C 28,Fabbricazione di macchinari ed apparecchiature nca          ,0,0,0,0,0,2024
ABR,AQ,C 29,"Fabbricazione di autoveicoli, rimorchi e semirimorchi       ",0,0,0,0,0,2024
ABR,AQ,C 30,Fabbricazione di altri mezzi di trasporto                   ,0,0,0,0,0,2024
ABR,AQ,C 31,Fabbricazione di mobili                                     ,0,0,0,0,0,2024
ABR,AQ,C 32,Altre industrie manifatturiere                              ,0,0,0,0,0,2024
ABR,AQ,C 33,"Riparazione, manutenzione ed installazione di macchine ed...",0,0,0,0,0,2024
ABR,AQ,D   ,"Fornitura di energia elettrica, gas, vapore e aria condiz...",0,0,0,0,0,2024
ABR,AQ,D 35,"Fornitura di energia elettrica, gas, vapore e aria condiz...",0,0,0,0,0,2024
ABR,AQ,E   ,"Fornitura di acqua; reti fognarie, attività di gestione d...",0,0,0,0,0,2024
ABR,AQ,E 36,"Raccolta, trattamento e fornitura di acqua                  ",0,0,0,0,0,2024
ABR,AQ,E 37,Gestione delle reti fognarie                                ,0,0,0,0,0,2024
ABR,AQ,E 38,"Attività di raccolta, trattamento e smaltimento dei rifiu...",0,0,0,0,0,2024
ABR,AQ,E 39,Attività di risanamento e altri servizi di gestione dei r...,0,0,0,0,0,2024
ABR,AQ,F   ,Costruzioni                                                 ,0,0,0,38,38,2024
ABR,AQ,F 41,Costruzione di edifici                                      ,0,0,0,25,25,2024
ABR,AQ,F 42,Ingegneria civile                                           ,0,0,0,0,0,2024
ABR,AQ,F 43,Lavori di costruzione specializzati                         ,0,0,0,13,13,2024
ABR,AQ,G   ,Commercio all'ingrosso e al dettaglio; riparazione di aut...,0,0,0,9,9,2024
ABR,AQ,G 45,Commercio all'ingrosso e al dettaglio e riparazione di au...,0,0,0,0,0,2024
ABR,AQ,G 46,Commercio all'ingrosso (escluso quello di autoveicoli e d...,0,0,0,4,4,2024
ABR,AQ,G 47,Commercio al dettaglio (escluso quello di autoveicoli e d...,0,0,0,5,5,2024
ABR,AQ,H   ,Trasporto e magazzinaggio                                   ,0,0,0,9,9,2024
ABR,AQ,H 49,Trasporto terrestre e mediante condotte                     ,0,0,0,5,5,2024
ABR,AQ,H 50,Trasporto marittimo e per vie d'acqua                       ,0,0,0,0,0,2024
ABR,AQ,H 51,Trasporto aereo                                             ,0,0,0,0,0,2024
ABR,AQ,H 52,Magazzinaggio e attività di supporto ai trasporti           ,0,0,0,4,4,2024
ABR,AQ,H 53,Servizi postali e attività di corriere                      ,0,0,0,0,0,2024
ABR,AQ,I   ,Attività dei servizi alloggio e ristorazione                ,0,0,0,4,4,2024
ABR,AQ,I 55,Alloggio                                                    ,0,0,0,1,1,2024
ABR,AQ,I 56,Attività dei servizi di ristorazione                        ,0,0,0,3,3,2024
ABR,AQ,J   ,Servizi di informazione e comunicazione                     ,0,0,0,11,11,2024
ABR,AQ,J 58,Attività editoriali                                         ,0,0,0,0,0,2024
ABR,AQ,J 59,"Attività di produzione cinematografica, di video e di pro...",0,0,0,2,2,2024
ABR,AQ,J 60,Attività di programmazione e trasmissione                   ,0,0,0,0,0,2024
ABR,AQ,J 61,Telecomunicazioni                                           ,0,0,0,0,0,2024
ABR,AQ,J 62,"Produzione di software, consulenza informatica e attività...",0,0,0,3,3,2024
ABR,AQ,J 63,Attività dei servizi d'informazione e altri servizi infor...,0,0,0,6,6,2024
ABR,AQ,K   ,Attività finanziarie e assicurative                         ,0,0,0,2,2,2024
ABR,AQ,K 64,Attività di servizi finanziari (escluse le assicurazioni ...,0,0,0,0,0,2024
ABR,AQ,K 65,"Assicurazioni, riassicurazioni e fondi pensione (escluse ...",0,0,0,0,0,2024
ABR,AQ,K 66,Attività ausiliarie dei servizi finanziari e delle attivi...,0,0,0,2,2,2024
ABR,AQ,L   ,Attivita' immobiliari                                       ,0,0,0,1,1,2024
ABR,AQ,L 68,Attivita' immobiliari                                       ,0,0,0,1,1,2024
ABR,AQ,M   ,"Attività professionali, scientifiche e tecniche             ",0,0,0,11,11,2024
ABR,AQ,M 69,Attività legali e contabilità                               ,0,0,0,1,1,2024
ABR,AQ,M 70,Attività di direzione aziendale e di consulenza gestional...,0,0,0,3,3,2024
ABR,AQ,M 71,Attività degli studi di architettura e d'ingegneria; coll...,0,0,0,2,2,2024
ABR,AQ,M 72,Ricerca scientifica e sviluppo                              ,0,0,0,0,0,2024
ABR,AQ,M 73,Pubblicità e ricerche di mercato                            ,0,0,0,0,0,2024
ABR,AQ,M 74,"Altre attività professionali, scientifiche e tecniche       ",0,0,0,4,4,2024
ABR,AQ,M 75,Servizi veterinari                                          ,0,0,0,1,1,2024
ABR,AQ,N   ,"Noleggio, agenzie di viaggio, servizi di supporto alle im...",0,0,0,9,9,2024
ABR,AQ,N 77,Attività di noleggio e leasing operativo                    ,0,0,0,1,1,2024
ABR,AQ,N 78,"Attività di ricerca, selezione, fornitura di personale      ",0,0,0,0,0,2024
ABR,AQ,N 79,"Attività dei servizi delle agenzie di viaggio, dei tour o...",0,0,0,0,0,2024
ABR,AQ,N 80,Servizi di vigilanza e investigazione                       ,0,0,0,0,0,2024
ABR,AQ,N 81,Attività di servizi per edifici e paesaggio                 ,0,0,0,5,5,2024
ABR,AQ,N 82,Attività di supporto per le funzioni d'ufficio e altri se...,0,0,0,3,3,2024
ABR,AQ,O   ,Amministrazione pubblica e difesa; assicurazione sociale ...,0,0,0,1,1,2024
ABR,AQ,O 84,Amministrazione pubblica e difesa; assicurazione sociale ...,0,0,0,1,1,2024
ABR,AQ,P   ,Istruzione                                                  ,0,0,0,3,3,2024
ABR,AQ,P 85,Istruzione                                                  ,0,0,0,3,3,2024
ABR,AQ,Q   ,Sanita' e assistenza sociale                                ,0,0,0,7,7,2024
ABR,AQ,Q 86,Assistenza sanitaria                                        ,0,0,0,1,1,2024
ABR,AQ,Q 87,Servizi di assistenza sociale residenziale                  ,0,0,0,3,3,2024
ABR,AQ,Q 88,Assistenza sociale non residenziale                         ,0,0,0,3,3,2024
ABR,AQ,R   ,"Attività artistiche, sportive, di intrattenimento e diver...",0,0,0,6,6,2024
ABR,AQ,R 90,"Attività creative, artistiche e di intrattenimento          ",0,0,0,1,1,2024
ABR,AQ,R 91,"Attività di biblioteche, archivi, musei ed altre attività...",0,0,0,0,0,2024
ABR,AQ,R 92,"Attività riguardanti le lotterie, le scommesse, le case d...",0,0,0,0,0,2024
ABR,AQ,R 93,"Attività sportive, di intrattenimento e di divertimento     ",0,0,0,5,5,2024
ABR,AQ,S   ,Altre attività di servizi                                   ,0,0,0,12,12,2024
ABR,AQ,S 94,Attività di organizzazioni associative                      ,0,0,0,0,0,2024
ABR,AQ,S 95,Riparazione di computer e di beni per uso personale e per...,0,0,0,1,1,2024
ABR,AQ,S 96,Altre attività di servizi per la persona                    ,0,0,0,11,11,2024
ABR,AQ,T   ,Attività di famiglie e convivenze come datori di lavoro p...,0,0,0,0,0,2024
ABR,AQ,T 97,Attività di famiglie e convivenze come datori di lavoro p...,0,0,0,0,0,2024
ABR,AQ,T 98,Produzione di beni e servizi indifferenziati per uso prop...,0,0,0,0,0,2024
ABR,AQ,U   ,Organizzazioni ed organismi extraterritoriali               ,0,0,0,0,0,2024
ABR,AQ,U 99,Organizzazioni ed organismi extraterritoriali               ,0,0,0,0,0,2024
ABR,AQ,XX  ,Imprese non classificate                                    ,0,0,0,31,31,2024
ABR,AQ,TOT ,TOTALE                                                      ,0,0,0,186,186,2024
ABR,TE,A   ,"Agricoltura, silvicoltura pesca                             ",0,0,0,6,6,2024
ABR,TE,A 01,"Coltivazioni agricole e produzione di prodotti animali, c...",0,0,0,4,4,2024
ABR,TE,A 02,Silvicoltura ed utilizzo di aree forestali                  ,0,0,0,2,2,2024
ABR,TE,A 03,Pesca e acquacoltura                                        ,0,0,0,0,0,2024
ABR,TE,B   ,Estrazione di minerali da cave e miniere                    ,0,0,0,0,0,2024
ABR,TE,B 05,Estrazione di carbone (esclusa torba)                       ,0,0,0,0,0,2024
ABR,TE,B 06,Estraz.di petrolio greggio e di gas naturale                ,0,0,0,0,0,2024
ABR,TE,B 07,Estrazione di minerali metalliferi                          ,0,0,0,0,0,2024
ABR,TE,B 08,Altre attività di estrazione di minerali da cave e miniere  ,0,0,0,0,0,2024
ABR,TE,B 09,Attività dei servizi di supporto all'estrazione             ,0,0,0,0,0,2024
ABR,TE,C   ,Attività manifatturiere                                     ,0,0,0,10,10,2024
ABR,TE,C 10,Industrie alimentari                                        ,0,0,0,2,2,2024
ABR,TE,C 11,Industria delle bevande                                     ,0,0,0,0,0,2024
ABR,TE,C 12,Industria del tabacco                                       ,0,0,0,0,0,2024
ABR,TE,C 13,Industrie tessili                                           ,0,0,0,0,0,2024
ABR,TE,C 14,Confezione di articoli di abbigliamento; confezione di ar...,0,0,0,0,0,2024
ABR,TE,C 15,Fabbricazione di articoli in pelle e simili                 ,0,0,0,2,2,2024
ABR,TE,C 16,Industria del legno e dei prodotti in legno e sughero (es...,0,0,0,0,0,2024
ABR,TE,C 17,Fabbricazione di carta e di prodotti di carta               ,0,0,0,0,0,2024
ABR,TE,C 18,Stampa e riproduzione di supporti registrati                ,0,0,0,2,2,2024
ABR,TE,C 19,Fabbricazione di coke e prodotti derivanti dalla raffinaz...,0,0,0,0,0,2024
ABR,TE,C 20,Fabbricazione di prodotti chimici                           ,0,0,0,0,0,2024
ABR,TE,C 21,Fabbricazione di prodotti farmaceutici di base e di prepa...,0,0,0,0,0,2024
ABR,TE,C 22,Fabbricazione di articoli in gomma e materie plastiche      ,0,0,0,0,0,2024
ABR,TE,C 23,Fabbricazione di altri prodotti della lavorazione di miner..,0,0,0,0,0,2024
ABR,TE,C 24,Metallurgia                                                 ,0,0,0,0,0,2024
ABR,TE,C 25,Fabbricazione di prodotti in metallo (esclusi macchinari ...,0,0,0,3,3,2024
ABR,TE,C 26,Fabbricazione di computer e prodotti di elettronica e ott...,0,0,0,0,0,2024
ABR,TE,C 27,Fabbricazione di apparecchiature elettriche ed apparecchi...,0,0,0,0,0,2024
ABR,TE,C 28,Fabbricazione di macchinari ed apparecchiature nca          ,0,0,0,0,0,2024
ABR,TE,C 29,"Fabbricazione di autoveicoli, rimorchi e semirimorchi       ",0,0,0,0,0,2024
ABR,TE,C 30,Fabbricazione di altri mezzi di trasporto                   ,0,0,0,0,0,2024
ABR,TE,C 31,Fabbricazione di mobili                                     ,0,0,0,0,0,2024
ABR,TE,C 32,Altre industrie manifatturiere                              ,0,0,0,0,0,2024
ABR,TE,C 33,"Riparazione, manutenzione ed installazione di macchine ed...",0,0,0,1,1,2024
ABR,TE,D   ,"Fornitura di energia elettrica, gas, vapore e aria condiz...",0,0,0,0,0,2024
ABR,TE,D 35,"Fornitura di energia elettrica, gas, vapore e aria condiz...",0,0,0,0,0,2024
ABR,TE,E   ,"Fornitura di acqua; reti fognarie, attività di gestione d...",0,0,0,1,1,2024
ABR,TE,E 36,"Raccolta, trattamento e fornitura di acqua                  ",0,0,0,0,0,2024
ABR,TE,E 37,Gestione delle reti fognarie                                ,0,0,0,0,0,2024
ABR,TE,E 38,"Attività di raccolta, trattamento e smaltimento dei rifiu...",0,0,0,1,1,2024
ABR,TE,E 39,Attività di risanamento e altri servizi di gestione dei r...,0,0,0,0,0,2024
ABR,TE,F   ,Costruzioni                                                 ,0,1,0,6,7,2024
ABR,TE,F 41,Costruzione di edifici                                      ,0,1,0,5,6,2024
ABR,TE,F 42,Ingegneria civile                                           ,0,0,0,0,0,2024
ABR,TE,F 43,Lavori di costruzione specializzati                         ,0,0,0,1,1,2024
ABR,TE,G   ,Commercio all'ingrosso e al dettaglio; riparazione di aut...,0,2,1,3,6,2024
ABR,TE,G 45,Commercio all'ingrosso e al dettaglio e riparazione di au...,0,2,1,2,5,2024
ABR,TE,G 46,Commercio all'ingrosso (escluso quello di autoveicoli e d...,0,0,0,0,0,2024
ABR,TE,G 47,Commercio al dettaglio (escluso quello di autoveicoli e d...,0,0,0,1,1,2024
ABR,TE,H   ,Trasporto e magazzinaggio                                   ,0,0,0,7,7,2024
ABR,TE,H 49,Trasporto terrestre e mediante condotte                     ,0,0,0,4,4,2024
ABR,TE,H 50,Trasporto marittimo e per vie d'acqua                       ,0,0,0,0,0,2024
ABR,TE,H 51,Trasporto aereo                                             ,0,0,0,0,0,2024
ABR,TE,H 52,Magazzinaggio e attività di supporto ai trasporti           ,0,0,0,3,3,2024
ABR,TE,H 53,Servizi postali e attività di corriere                      ,0,0,0,0,0,2024
ABR,TE,I   ,Attività dei servizi alloggio e ristorazione                ,0,0,1,2,3,2024
ABR,TE,I 55,Alloggio                                                    ,0,0,0,0,0,2024
ABR,TE,I 56,Attività dei servizi di ristorazione                        ,0,0,1,2,3,2024
ABR,TE,J   ,Servizi di informazione e comunicazione                     ,0,0,0,1,1,2024
ABR,TE,J 58,Attività editoriali                                         ,0,0,0,0,0,2024
ABR,TE,J 59,"Attività di produzione cinematografica, di video e di pro...",0,0,0,0,0,2024
ABR,TE,J 60,Attività di programmazione e trasmissione                   ,0,0,0,0,0,2024
ABR,TE,J 61,Telecomunicazioni                                           ,0,0,0,0,0,2024
ABR,TE,J 62,"Produzione di software, consulenza informatica e attività...",0,0,0,0,0,2024
ABR,TE,J 63,Attività dei servizi d'informazione e altri servizi infor...,0,0,0,1,1,2024
ABR,TE,K   ,Attività finanziarie e assicurative                         ,0,0,0,1,1,2024
ABR,TE,K 64,Attività di servizi finanziari (escluse le assicurazioni ...,0,0,0,1,1,2024
ABR,TE,K 65,"Assicurazioni, riassicurazioni e fondi pensione (escluse ...",0,0,0,0,0,2024
ABR,TE,K 66,Attività ausiliarie dei servizi finanziari e delle attivi...,0,0,0,0,0,2024
ABR,TE,L   ,Attivita' immobiliari                                       ,0,0,0,0,0,2024
ABR,TE,L 68,Attivita' immobiliari                                       ,0,0,0,0,0,2024
ABR,TE,M   ,"Attività professionali, scientifiche e tecniche             ",0,0,0,1,1,2024
ABR,TE,M 69,Attività legali e contabilità                               ,0,0,0,0,0,2024
ABR,TE,M 70,Attività di direzione aziendale e di consulenza gestional...,0,0,0,0,0,2024
ABR,TE,M 71,Attività degli studi di architettura e d'ingegneria; coll...,0,0,0,0,0,2024
ABR,TE,M 72,Ricerca scientifica e sviluppo                              ,0,0,0,0,0,2024
ABR,TE,M 73,Pubblicità e ricerche di mercato                            ,0,0,0,1,1,2024
ABR,TE,M 74,"Altre attività professionali, scientifiche e tecniche       ",0,0,0,0,0,2024
ABR,TE,M 75,Servizi veterinari                                          ,0,0,0,0,0,2024
ABR,TE,N   ,"Noleggio, agenzie di viaggio, servizi di supporto alle im...",0,0,0,9,9,2024
ABR,TE,N 77,Attività di noleggio e leasing operativo                    ,0,0,0,0,0,2024
ABR,TE,N 78,"Attività di ricerca, selezione, fornitura di personale      ",0,0,0,0,0,2024
ABR,TE,N 79,"Attività dei servizi delle agenzie di viaggio, dei tour o...",0,0,0,0,0,2024
ABR,TE,N 80,Servizi di vigilanza e investigazione                       ,0,0,0,1,1,2024
ABR,TE,N 81,Attività di servizi per edifici e paesaggio                 ,0,0,0,7,7,2024
ABR,TE,N 82,Attività di supporto per le funzioni d'ufficio e altri se...,0,0,0,1,1,2024
ABR,TE,O   ,Amministrazione pubblica e difesa; assicurazione sociale ...,0,0,0,0,0,2024
ABR,TE,O 84,Amministrazione pubblica e difesa; assicurazione sociale ...,0,0,0,0,0,2024
ABR,TE,P   ,Istruzione                                                  ,0,0,0,0,0,2024
ABR,TE,P 85,Istruzione                                                  ,0,0,0,0,0,2024
ABR,TE,Q   ,Sanita' e assistenza sociale                                ,0,0,0,3,3,2024
ABR,TE,Q 86,Assistenza sanitaria                                        ,0,0,0,0,0,2024
ABR,TE,Q 87,Servizi di assistenza sociale residenziale                  ,0,0,0,0,0,2024
ABR,TE,Q 88,Assistenza sociale non residenziale                         ,0,0,0,3,3,2024
ABR,TE,R   ,"Attività artistiche, sportive, di intrattenimento e diver...",0,0,0,4,4,2024
ABR,TE,R 90,"Attività creative, artistiche e di intrattenimento          ",0,0,0,0,0,2024
ABR,TE,R 91,"Attività di biblioteche, archivi, musei ed altre attività...",0,0,0,3,3,2024
ABR,TE,R 92,"Attività riguardanti le lotterie, le scommesse, le case d...",0,0,0,0,0,2024
ABR,TE,R 93,"Attività sportive, di intrattenimento e di divertimento     ",0,0,0,1,1,2024
ABR,TE,S   ,Altre attività di servizi                                   ,0,0,0,2,2,2024
ABR,TE,S 94,Attività di organizzazioni associative                      ,0,0,0,0,0,2024
ABR,TE,S 95,Riparazione di computer e di beni per uso personale e per...,0,0,0,0,0,2024
ABR,TE,S 96,Altre attività di servizi per la persona                    ,0,0,0,2,2,2024
ABR,TE,T   ,Attività di famiglie e convivenze come datori di lavoro p...,0,0,0,0,0,2024
ABR,TE,T 97,Attività di famiglie e convivenze come datori di lavoro p...,0,0,0,0,0,2024
ABR,TE,T 98,Produzione di beni e servizi indifferenziati per uso prop...,0,0,0,0,0,2024
ABR,TE,U   ,Organizzazioni ed organismi extraterritoriali               ,0,0,0,0,0,2024
ABR,TE,U 99,Organizzazioni ed organismi extraterritoriali               ,0,0,0,0,0,2024
ABR,TE,XX  ,Imprese non classificate                                    ,0,0,0,21,21,2024
ABR,TE,TOT ,TOTALE                                                      ,0,3,2,77,82,2024
ABR,PE,A   ,"Agricoltura, silvicoltura pesca                             ",0,1,0,4,5,2024
ABR,PE,A 01,"Coltivazioni agricole e produzione di prodotti animali, c...",0,0,0,1,1,2024
ABR,PE,A 02,Silvicoltura ed utilizzo di aree forestali                  ,0,0,0,3,3,2024
ABR,PE,A 03,Pesca e acquacoltura                                        ,0,1,0,0,1,2024
ABR,PE,B   ,Estrazione di minerali da cave e miniere                    ,0,0,0,0,0,2024
ABR,PE,B 05,Estrazione di carbone (esclusa torba)                       ,0,0,0,0,0,2024
ABR,PE,B 06,Estraz.di petrolio greggio e di gas naturale                ,0,0,0,0,0,2024
ABR,PE,B 07,Estrazione di minerali metalliferi                          ,0,0,0,0,0,2024
ABR,PE,B 08,Altre attività di estrazione di minerali da cave e miniere  ,0,0,0,0,0,2024
ABR,PE,B 09,Attività dei servizi di supporto all'estrazione             ,0,0,0,0,0,2024
ABR,PE,C   ,Attività manifatturiere                                     ,0,6,1,4,11,2024
ABR,PE,C 10,Industrie alimentari                                        ,0,1,1,1,3,2024
ABR,PE,C 11,Industria delle bevande                                     ,0,0,0,0,0,2024
ABR,PE,C 12,Industria del tabacco                                       ,0,0,0,0,0,2024
ABR,PE,C 13,Industrie tessili                                           ,0,0,0,0,0,2024
ABR,PE,C 14,Confezione di articoli di abbigliamento; confezione di ar...,0,0,0,0,0,2024
ABR,PE,C 15,Fabbricazione di articoli in pelle e simili                 ,0,0,0,1,1,2024
ABR,PE,C 16,Industria del legno e dei prodotti in legno e sughero (es...,0,1,0,0,1,2024
ABR,PE,C 17,Fabbricazione di carta e di prodotti di carta               ,0,0,0,0,0,2024
ABR,PE,C 18,Stampa e riproduzione di supporti registrati                ,0,3,0,0,3,2024
ABR,PE,C 19,Fabbricazione di coke e prodotti derivanti dalla raffinaz...,0,0,0,0,0,2024
ABR,PE,C 20,Fabbricazione di prodotti chimici                           ,0,0,0,0,0,2024
ABR,PE,C 21,Fabbricazione di prodotti farmaceutici di base e di prepa...,0,0,0,0,0,2024
ABR,PE,C 22,Fabbricazione di articoli in gomma e materie plastiche      ,0,0,0,0,0,2024
ABR,PE,C 23,Fabbricazione di altri prodotti della lavorazione di miner..,0,0,0,0,0,2024
ABR,PE,C 24,Metallurgia                                                 ,0,0,0,0,0,2024
ABR,PE,C 25,Fabbricazione di prodotti in metallo (esclusi macchinari ...,0,1,0,1,2,2024
ABR,PE,C 26,Fabbricazione di computer e prodotti di elettronica e ott...,0,0,0,0,0,2024
ABR,PE,C 27,Fabbricazione di apparecchiature elettriche ed apparecchi...,0,0,0,0,0,2024
ABR,PE,C 28,Fabbricazione di macchinari ed apparecchiature nca          ,0,0,0,0,0,2024
ABR,PE,C 29,"Fabbricazione di autoveicoli, rimorchi e semirimorchi       ",0,0,0,1,1,2024
ABR,PE,C 30,Fabbricazione di altri mezzi di trasporto                   ,0,0,0,0,0,2024
ABR,PE,C 31,Fabbricazione di mobili                                     ,0,0,0,0,0,2024
ABR,PE,C 32,Altre industrie manifatturiere                              ,0,0,0,0,0,2024
ABR,PE,C 33,"Riparazione, manutenzione ed installazione di macchine ed...",0,0,0,0,0,2024
ABR,PE,D   ,"Fornitura di energia elettrica, gas, vapore e aria condiz...",0,0,0,0,0,2024
ABR,PE,D 35,"Fornitura di energia elettrica, gas, vapore e aria condiz...",0,0,0,0,0,2024
ABR,PE,E   ,"Fornitura di acqua; reti fognarie, attività di gestione d...",0,2,0,0,2,2024
ABR,PE,E 36,"Raccolta, trattamento e fornitura di acqua                  ",0,0,0,0,0,2024
ABR,PE,E 37,Gestione delle reti fognarie                                ,0,1,0,0,1,2024
ABR,PE,E 38,"Attività di raccolta, trattamento e smaltimento dei rifiu...",0,1,0,0,1,2024
ABR,PE,E 39,Attività di risanamento e altri servizi di gestione dei r...,0,0,0,0,0,2024
ABR,PE,F   ,Costruzioni                                                 ,0,12,2,12,26,2024
ABR,PE,F 41,Costruzione di edifici                                      ,0,8,0,7,15,2024
ABR,PE,F 42,Ingegneria civile                                           ,0,0,0,0,0,2024
ABR,PE,F 43,Lavori di costruzione specializzati                         ,0,4,2,5,11,2024
ABR,PE,G   ,Commercio all'ingrosso e al dettaglio; riparazione di aut...,0,44,7,7,58,2024
ABR,PE,G 45,Commercio all'ingrosso e al dettaglio e riparazione di au...,0,5,5,1,11,2024
ABR,PE,G 46,Commercio all'ingrosso (escluso quello di autoveicoli e d...,0,12,1,1,14,2024
ABR,PE,G 47,Commercio al dettaglio (escluso quello di autoveicoli e d...,0,27,1,5,33,2024
ABR,PE,H   ,Trasporto e magazzinaggio                                   ,0,6,0,8,14,2024
ABR,PE,H 49,Trasporto terrestre e mediante condotte                     ,0,6,0,3,9,2024
ABR,PE,H 50,Trasporto marittimo e per vie d'acqua                       ,0,0,0,0,0,2024
ABR,PE,H 51,Trasporto aereo                                             ,0,0,0,0,0,2024
ABR,PE,H 52,Magazzinaggio e attività di supporto ai trasporti           ,0,0,0,5,5,2024
ABR,PE,H 53,Servizi postali e attività di corriere                      ,0,0,0,0,0,2024
ABR,PE,I   ,Attività dei servizi alloggio e ristorazione                ,0,31,1,4,36,2024
ABR,PE,I 55,Alloggio                                                    ,0,0,0,0,0,2024
ABR,PE,I 56,Attività dei servizi di ristorazione                        ,0,31,1,4,36,2024
ABR,PE,J   ,Servizi di informazione e comunicazione                     ,0,4,1,5,10,2024
ABR,PE,J 58,Attività editoriali                                         ,0,1,0,0,1,2024
ABR,PE,J 59,"Attività di produzione cinematografica, di video e di pro...",0,0,0,0,0,2024
ABR,PE,J 60,Attività di programmazione e trasmissione                   ,0,1,0,0,1,2024
ABR,PE,J 61,Telecomunicazioni                                           ,0,1,0,0,1,2024
ABR,PE,J 62,"Produzione di software, consulenza informatica e attività...",0,1,0,0,1,2024
ABR,PE,J 63,Attività dei servizi d'informazione e altri servizi infor...,0,0,1,5,6,2024
ABR,PE,K   ,Attività finanziarie e assicurative                         ,0,1,0,0,1,2024
ABR,PE,K 64,Attività di servizi finanziari (escluse le assicurazioni ...,0,0,0,0,0,2024
ABR,PE,K 65,"Assicurazioni, riassicurazioni e fondi pensione (escluse ...",0,1,0,0,1,2024
ABR,PE,K 66,Attività ausiliarie dei servizi finanziari e delle attivi...,0,0,0,0,0,2024
ABR,PE,L   ,Attivita' immobiliari                                       ,0,1,0,0,1,2024
ABR,PE,L 68,Attivita' immobiliari                                       ,0,1,0,0,1,2024
ABR,PE,M   ,"Attività professionali, scientifiche e tecniche             ",0,10,1,4,15,2024
ABR,PE,M 69,Attività legali e contabilità                               ,0,0,0,1,1,2024
ABR,PE,M 70,Attività di direzione aziendale e di consulenza gestional...,0,1,0,3,4,2024
ABR,PE,M 71,Attività degli studi di architettura e d'ingegneria; coll...,0,1,0,0,1,2024
ABR,PE,M 72,Ricerca scientifica e sviluppo                              ,0,0,0,0,0,2024
ABR,PE,M 73,Pubblicità e ricerche di mercato                            ,0,3,0,0,3,2024
ABR,PE,M 74,"Altre attività professionali, scientifiche e tecniche       ",0,5,1,0,6,2024
ABR,PE,M 75,Servizi veterinari                                          ,0,0,0,0,0,2024
ABR,PE,N   ,"Noleggio, agenzie di viaggio, servizi di supporto alle im...",0,10,0,10,20,2024
ABR,PE,N 77,Attività di noleggio e leasing operativo                    ,0,1,0,0,1,2024
ABR,PE,N 78,"Attività di ricerca, selezione, fornitura di personale      ",0,0,0,0,0,2024
ABR,PE,N 79,"Attività dei servizi delle agenzie di viaggio, dei tour o...",0,0,0,0,0,2024
ABR,PE,N 80,Servizi di vigilanza e investigazione                       ,0,0,0,1,1,2024
ABR,PE,N 81,Attività di servizi per edifici e paesaggio                 ,0,5,0,6,11,2024
ABR,PE,N 82,Attività di supporto per le funzioni d'ufficio e altri se...,0,4,0,3,7,2024
ABR,PE,O   ,Amministrazione pubblica e difesa; assicurazione sociale ...,0,0,0,0,0,2024
ABR,PE,O 84,Amministrazione pubblica e difesa; assicurazione sociale ...,0,0,0,0,0,2024
ABR,PE,P   ,Istruzione                                                  ,0,0,0,0,0,2024
ABR,PE,P 85,Istruzione                                                  ,0,0,0,0,0,2024
ABR,PE,Q   ,Sanita' e assistenza sociale                                ,0,3,0,5,8,2024
ABR,PE,Q 86,Assistenza sanitaria                                        ,0,1,0,1,2,2024
ABR,PE,Q 87,Servizi di assistenza sociale residenziale                  ,0,0,0,0,0,2024
ABR,PE,Q 88,Assistenza sociale non residenziale                         ,0,2,0,4,6,2024
ABR,PE,R   ,"Attività artistiche, sportive, di intrattenimento e diver...",0,2,0,3,5,2024
ABR,PE,R 90,"Attività creative, artistiche e di intrattenimento          ",0,0,0,1,1,2024
ABR,PE,R 91,"Attività di biblioteche, archivi, musei ed altre attività...",0,0,0,0,0,2024
ABR,PE,R 92,"Attività riguardanti le lotterie, le scommesse, le case d...",0,0,0,0,0,2024
ABR,PE,R 93,"Attività sportive, di intrattenimento e di divertimento     ",0,2,0,2,4,2024
ABR,PE,S   ,Altre attività di servizi                                   ,0,9,0,2,11,2024
ABR,PE,S 94,Attività di organizzazioni associative                      ,0,0,0,0,0,2024
ABR,PE,S 95,Riparazione di computer e di beni per uso personale e per...,0,1,0,0,1,2024
ABR,PE,S 96,Altre attività di servizi per la persona                    ,0,8,0,2,10,2024
ABR,PE,T   ,Attività di famiglie e convivenze come datori di lavoro p...,0,0,0,0,0,2024
ABR,PE,T 97,Attività di famiglie e convivenze come datori di lavoro p...,0,0,0,0,0,2024
ABR,PE,T 98,Produzione di beni e servizi indifferenziati per uso prop...,0,0,0,0,0,2024
ABR,PE,U   ,Organizzazioni ed organismi extraterritoriali               ,0,0,0,0,0,2024
ABR,PE,U 99,Organizzazioni ed organismi extraterritoriali               ,0,0,0,0,0,2024
ABR,PE,XX  ,Imprese non classificate                                    ,0,25,3,14,42,2024
ABR,PE,TOT ,TOTALE                                                      ,0,167,16,82,265,2024
ABR,CH,A   ,"Agricoltura, silvicoltura pesca                             ",0,0,0,8,8,2024
ABR,CH,A 01,"Coltivazioni agricole e produzione di prodotti animali, c...",0,0,0,7,7,2024
ABR,CH,A 02,Silvicoltura ed utilizzo di aree forestali                  ,0,0,0,1,1,2024
ABR,CH,A 03,Pesca e acquacoltura                                        ,0,0,0,0,0,2024
ABR,CH,B   ,Estrazione di minerali da cave e miniere                    ,0,0,0,0,0,2024
ABR,CH,B 05,Estrazione di carbone (esclusa torba)                       ,0,0,0,0,0,2024
ABR,CH,B 06,Estraz.di petrolio greggio e di gas naturale                ,0,0,0,0,0,2024
ABR,CH,B 07,Estrazione di minerali metalliferi                          ,0,0,0,0,0,2024
ABR,CH,B 08,Altre attività di estrazione di minerali da cave e miniere  ,0,0,0,0,0,2024
ABR,CH,B 09,Attività dei servizi di supporto all'estrazione             ,0,0,0,0,0,2024
ABR,CH,C   ,Attività manifatturiere                                     ,42,13,0,11,66,2024
ABR,CH,C 10,Industrie alimentari                                        ,3,1,0,2,6,2024
ABR,CH,C 11,Industria delle bevande                                     ,1,0,0,0,1,2024
ABR,CH,C 12,Industria del tabacco                                       ,0,0,0,0,0,2024
ABR,CH,C 13,Industrie tessili                                           ,1,0,0,0,1,2024
ABR,CH,C 14,Confezione di articoli di abbigliamento; confezione di ar...,7,1,0,3,11,2024
ABR,CH,C 15,Fabbricazione di articoli in pelle e simili                 ,0,1,0,0,1,2024
ABR,CH,C 16,Industria del legno e dei prodotti in legno e sughero (es...,4,2,0,0,6,2024
ABR,CH,C 17,Fabbricazione di carta e di prodotti di carta               ,2,0,0,0,2,2024
ABR,CH,C 18,Stampa e riproduzione di supporti registrati                ,1,0,0,1,2,2024
ABR,CH,C 19,Fabbricazione di coke e prodotti derivanti dalla raffinaz...,0,0,0,0,0,2024
ABR,CH,C 20,Fabbricazione di prodotti chimici                           ,0,0,0,0,0,2024
ABR,CH,C 21,Fabbricazione di prodotti farmaceutici di base e di prepa...,0,0,0,0,0,2024
ABR,CH,C 22,Fabbricazione di articoli in gomma e materie plastiche      ,3,0,0,0,3,2024
ABR,CH,C 23,Fabbricazione di altri prodotti della lavorazione di miner..,3,0,0,1,4,2024
ABR,CH,C 24,Metallurgia                                                 ,0,0,0,0,0,2024
ABR,CH,C 25,Fabbricazione di prodotti in metallo (esclusi macchinari ...,10,5,0,3,18,2024
ABR,CH,C 26,Fabbricazione di computer e prodotti di elettronica e ott...,1,0,0,0,1,2024
ABR,CH,C 27,Fabbricazione di apparecchiature elettriche ed apparecchi...,0,0,0,0,0,2024
ABR,CH,C 28,Fabbricazione di macchinari ed apparecchiature nca          ,3,0,0,1,4,2024
ABR,CH,C 29,"Fabbricazione di autoveicoli, rimorchi e semirimorchi       ",0,1,0,0,1,2024
ABR,CH,C 30,Fabbricazione di altri mezzi di trasporto                   ,0,0,0,0,0,2024
ABR,CH,C 31,Fabbricazione di mobili                                     ,2,2,0,0,4,2024
ABR,CH,C 32,Altre industrie manifatturiere                              ,0,0,0,0,0,2024
ABR,CH,C 33,"Riparazione, manutenzione ed installazione di macchine ed...",1,0,0,0,1,2024
ABR,CH,D   ,"Fornitura di energia elettrica, gas, vapore e aria condiz...",0,0,0,0,0,2024
ABR,CH,D 35,"Fornitura di energia elettrica, gas, vapore e aria condiz...",0,0,0,0,0,2024
ABR,CH,E   ,"Fornitura di acqua; reti fognarie, attività di gestione d...",0,0,0,2,2,2024
ABR,CH,E 36,"Raccolta, trattamento e fornitura di acqua                  ",0,0,0,1,1,2024
ABR,CH,E 37,Gestione delle reti fognarie                                ,0,0,0,1,1,2024
ABR,CH,E 38,"Attività di raccolta, trattamento e smaltimento dei rifiu...",0,0,0,0,0,2024
ABR,CH,E 39,Attività di risanamento e altri servizi di gestione dei r...,0,0,0,0,0,2024
ABR,CH,F   ,Costruzioni                                                 ,31,4,0,16,51,2024
ABR,CH,F 41,Costruzione di edifici                                      ,16,2,0,7,25,2024
ABR,CH,F 42,Ingegneria civile                                           ,1,0,0,0,1,2024
ABR,CH,F 43,Lavori di costruzione specializzati                         ,14,2,0,9,25,2024
ABR,CH,G   ,Commercio all'ingrosso e al dettaglio; riparazione di aut...,37,17,5,6,65,2024
ABR,CH,G 45,Commercio all'ingrosso e al dettaglio e riparazione di au...,4,2,3,1,10,2024
ABR,CH,G 46,Commercio all'ingrosso (escluso quello di autoveicoli e d...,14,2,1,1,18,2024
ABR,CH,G 47,Commercio al dettaglio (escluso quello di autoveicoli e d...,19,13,1,4,37,2024
ABR,CH,H   ,Trasporto e magazzinaggio                                   ,7,4,0,4,15,2024
ABR,CH,H 49,Trasporto terrestre e mediante condotte                     ,3,2,0,1,6,2024
ABR,CH,H 50,Trasporto marittimo e per vie d'acqua                       ,1,0,0,0,1,2024
ABR,CH,H 51,Trasporto aereo                                             ,0,0,0,0,0,2024
ABR,CH,H 52,Magazzinaggio e attività di supporto ai trasporti           ,3,0,0,2,5,2024
ABR,CH,H 53,Servizi postali e attività di corriere                      ,0,2,0,1,3,2024
ABR,CH,I   ,Attività dei servizi alloggio e ristorazione                ,16,27,0,5,48,2024
ABR,CH,I 55,Alloggio                                                    ,2,2,0,1,5,2024
ABR,CH,I 56,Attività dei servizi di ristorazione                        ,14,25,0,4,43,2024
ABR,CH,J   ,Servizi di informazione e comunicazione                     ,8,2,0,6,16,2024
ABR,CH,J 58,Attività editoriali                                         ,0,0,0,2,2,2024
ABR,CH,J 59,"Attività di produzione cinematografica, di video e di pro...",0,0,0,0,0,2024
ABR,CH,J 60,Attività di programmazione e trasmissione                   ,0,0,0,0,0,2024
ABR,CH,J 61,Telecomunicazioni                                           ,1,0,0,0,1,2024
ABR,CH,J 62,"Produzione di software, consulenza informatica e attività...",2,1,0,1,4,2024
ABR,CH,J 63,Attività dei servizi d'informazione e altri servizi infor...,5,1,0,3,9,2024
ABR,CH,K   ,Attività finanziarie e assicurative                         ,6,0,0,0,6,2024
ABR,CH,K 64,Attività di servizi finanziari (escluse le assicurazioni ...,1,0,0,0,1,2024
ABR,CH,K 65,"Assicurazioni, riassicurazioni e fondi pensione (escluse ...",0,0,0,0,0,2024
ABR,CH,K 66,Attività ausiliarie dei servizi finanziari e delle attivi...,5,0,0,0,5,2024
ABR,CH,L   ,Attivita' immobiliari                                       ,3,1,0,0,4,2024
ABR,CH,L 68,Attivita' immobiliari                                       ,3,1,0,0,4,2024
ABR,CH,M   ,"Attività professionali, scientifiche e tecniche             ",12,1,0,2,15,2024
ABR,CH,M 69,Attività legali e contabilità                               ,1,0,0,0,1,2024
ABR,CH,M 70,Attività di direzione aziendale e di consulenza gestional...,2,0,0,0,2,2024
ABR,CH,M 71,Attività degli studi di architettura e d'ingegneria; coll...,3,0,0,0,3,2024
ABR,CH,M 72,Ricerca scientifica e sviluppo                              ,0,0,0,0,0,2024
ABR,CH,M 73,Pubblicità e ricerche di mercato                            ,3,0,0,1,4,2024
ABR,CH,M 74,"Altre attività professionali, scientifiche e tecniche       ",3,1,0,1,5,2024
ABR,CH,M 75,Servizi veterinari                                          ,0,0,0,0,0,2024
ABR,CH,N   ,"Noleggio, agenzie di viaggio, servizi di supporto alle im...",7,3,1,12,23,2024
ABR,CH,N 77,Attività di noleggio e leasing operativo                    ,1,1,0,0,2,2024
ABR,CH,N 78,"Attività di ricerca, selezione, fornitura di personale      ",0,0,0,0,0,2024
ABR,CH,N 79,"Attività dei servizi delle agenzie di viaggio, dei tour o...",1,1,0,0,2,2024
ABR,CH,N 80,Servizi di vigilanza e investigazione                       ,2,0,0,0,2,2024
ABR,CH,N 81,Attività di servizi per edifici e paesaggio                 ,1,1,1,8,11,2024
ABR,CH,N 82,Attività di supporto per le funzioni d'ufficio e altri se...,2,0,0,4,6,2024
ABR,CH,O   ,Amministrazione pubblica e difesa; assicurazione sociale ...,0,0,0,0,0,2024
ABR,CH,O 84,Amministrazione pubblica e difesa; assicurazione sociale ...,0,0,0,0,0,2024
ABR,CH,P   ,Istruzione                                                  ,1,0,0,0,1,2024
ABR,CH,P 85,Istruzione                                                  ,1,0,0,0,1,2024
ABR,CH,Q   ,Sanita' e assistenza sociale                                ,3,0,0,4,7,2024
ABR,CH,Q 86,Assistenza sanitaria                                        ,2,0,0,2,4,2024
ABR,CH,Q 87,Servizi di assistenza sociale residenziale                  ,1,0,0,0,1,2024
ABR,CH,Q 88,Assistenza sociale non residenziale                         ,0,0,0,2,2,2024
ABR,CH,R   ,"Attività artistiche, sportive, di intrattenimento e diver...",4,6,0,4,14,2024
ABR,CH,R 90,"Attività creative, artistiche e di intrattenimento          ",0,0,0,1,1,2024
ABR,CH,R 91,"Attività di biblioteche, archivi, musei ed altre attività...",0,0,0,1,1,2024
ABR,CH,R 92,"Attività riguardanti le lotterie, le scommesse, le case d...",0,0,0,0,0,2024
ABR,CH,R 93,"Attività sportive, di intrattenimento e di divertimento     ",4,6,0,2,12,2024
ABR,CH,S   ,Altre attività di servizi                                   ,7,4,0,5,16,2024
ABR,CH,S 94,Attività di organizzazioni associative                      ,0,0,0,0,0,2024
ABR,CH,S 95,Riparazione di computer e di beni per uso personale e per...,1,1,0,0,2,2024
ABR,CH,S 96,Altre attività di servizi per la persona                    ,6,3,0,5,14,2024
ABR,CH,T   ,Attività di famiglie e convivenze come datori di lavoro p...,0,0,0,0,0,2024
ABR,CH,T 97,Attività di famiglie e convivenze come datori di lavoro p...,0,0,0,0,0,2024
ABR,CH,T 98,Produzione di beni e servizi indifferenziati per uso prop...,0,0,0,0,0,2024
ABR,CH,U   ,Organizzazioni ed organismi extraterritoriali               ,0,0,0,0,0,2024
ABR,CH,U 99,Organizzazioni ed organismi extraterritoriali               ,0,0,0,0,0,2024
ABR,CH,XX  ,Imprese non classificate                                    ,70,20,0,20,110,2024
ABR,CH,TOT ,TOTALE                                                      ,254,102,6,105,467,2024
MOL,  ,A   ,"Agricoltura, silvicoltura pesca                             ",0,0,4,20,24,2024
MOL,  ,A 01,"Coltivazioni agricole e produzione di prodotti animali, c...",0,0,4,17,21,2024
MOL,  ,A 02,Silvicoltura ed utilizzo di aree forestali                  ,0,0,0,2,2,2024
MOL,  ,A 03,Pesca e acquacoltura                                        ,0,0,0,1,1,2024
MOL,  ,B   ,Estrazione di minerali da cave e miniere                    ,0,0,0,0,0,2024
MOL,  ,B 05,Estrazione di carbone (esclusa torba)                       ,0,0,0,0,0,2024
MOL,  ,B 06,Estraz.di petrolio greggio e di gas naturale                ,0,0,0,0,0,2024
MOL,  ,B 07,Estrazione di minerali metalliferi                          ,0,0,0,0,0,2024
MOL,  ,B 08,Altre attività di estrazione di minerali da cave e miniere  ,0,0,0,0,0,2024
MOL,  ,B 09,Attività dei servizi di supporto all'estrazione             ,0,0,0,0,0,2024
MOL,  ,C   ,Attività manifatturiere                                     ,5,0,0,13,18,2024
MOL,  ,C 10,Industrie alimentari                                        ,0,0,0,3,3,2024
MOL,  ,C 11,Industria delle bevande                                     ,0,0,0,0,0,2024
MOL,  ,C 12,Industria del tabacco                                       ,0,0,0,0,0,2024
MOL,  ,C 13,Industrie tessili                                           ,0,0,0,1,1,2024
MOL,  ,C 14,Confezione di articoli di abbigliamento; confezione di ar...,1,0,0,3,4,2024
MOL,  ,C 15,Fabbricazione di articoli in pelle e simili                 ,0,0,0,0,0,2024
MOL,  ,C 16,Industria del legno e dei prodotti in legno e sughero (es...,0,0,0,0,0,2024
MOL,  ,C 17,Fabbricazione di carta e di prodotti di carta               ,0,0,0,0,0,2024
MOL,  ,C 18,Stampa e riproduzione di supporti registrati                ,0,0,0,1,1,2024
MOL,  ,C 19,Fabbricazione di coke e prodotti derivanti dalla raffinaz...,0,0,0,0,0,2024
MOL,  ,C 20,Fabbricazione di prodotti chimici                           ,0,0,0,0,0,2024
MOL,  ,C 21,Fabbricazione di prodotti farmaceutici di base e di prepa...,0,0,0,0,0,2024
MOL,  ,C 22,Fabbricazione di articoli in gomma e materie plastiche      ,0,0,0,0,0,2024
MOL,  ,C 23,Fabbricazione di altri prodotti della lavorazione di miner..,1,0,0,0,1,2024
MOL,  ,C 24,Metallurgia                                                 ,0,0,0,0,0,2024
MOL,  ,C 25,Fabbricazione di prodotti in metallo (esclusi macchinari ...,1,0,0,2,3,2024
MOL,  ,C 26,Fabbricazione di computer e prodotti di elettronica e ott...,0,0,0,0,0,2024
MOL,  ,C 27,Fabbricazione di apparecchiature elettriche ed apparecchi...,0,0,0,2,2,2024
MOL,  ,C 28,Fabbricazione di macchinari ed apparecchiature nca          ,0,0,0,0,0,2024
MOL,  ,C 29,"Fabbricazione di autoveicoli, rimorchi e semirimorchi       ",0,0,0,0,0,2024
MOL,  ,C 30,Fabbricazione di altri mezzi di trasporto                   ,0,0,0,0,0,2024
MOL,  ,C 31,Fabbricazione di mobili                                     ,2,0,0,0,2,2024
MOL,  ,C 32,Altre industrie manifatturiere                              ,0,0,0,0,0,2024
MOL,  ,C 33,"Riparazione, manutenzione ed installazione di macchine ed...",0,0,0,1,1,2024
MOL,  ,D   ,"Fornitura di energia elettrica, gas, vapore e aria condiz...",0,0,0,0,0,2024
MOL,  ,D 35,"Fornitura di energia elettrica, gas, vapore e aria condiz...",0,0,0,0,0,2024
MOL,  ,E   ,"Fornitura di acqua; reti fognarie, attività di gestione d...",0,0,1,1,2,2024
MOL,  ,E 36,"Raccolta, trattamento e fornitura di acqua                  ",0,0,0,0,0,2024
MOL,  ,E 37,Gestione delle reti fognarie                                ,0,0,0,0,0,2024
MOL,  ,E 38,"Attività di raccolta, trattamento e smaltimento dei rifiu...",0,0,1,1,2,2024
MOL,  ,E 39,Attività di risanamento e altri servizi di gestione dei r...,0,0,0,0,0,2024
MOL,  ,F   ,Costruzioni                                                 ,16,0,0,20,36,2024
MOL,  ,F 41,Costruzione di edifici                                      ,12,0,0,17,29,2024
MOL,  ,F 42,Ingegneria civile                                           ,0,0,0,0,0,2024
MOL,  ,F 43,Lavori di costruzione specializzati                         ,4,0,0,3,7,2024
MOL,  ,G   ,Commercio all'ingrosso e al dettaglio; riparazione di aut...,20,0,5,12,37,2024
MOL,  ,G 45,Commercio all'ingrosso e al dettaglio e riparazione di au...,6,0,0,4,10,2024
MOL,  ,G 46,Commercio all'ingrosso (escluso quello di autoveicoli e d...,7,0,1,6,14,2024
MOL,  ,G 47,Commercio al dettaglio (escluso quello di autoveicoli e d...,7,0,4,2,13,2024
MOL,  ,H   ,Trasporto e magazzinaggio                                   ,1,0,0,11,12,2024
MOL,  ,H 49,Trasporto terrestre e mediante condotte                     ,0,0,0,8,8,2024
MOL,  ,H 50,Trasporto marittimo e per vie d'acqua                       ,0,0,0,2,2,2024
MOL,  ,H 51,Trasporto aereo                                             ,0,0,0,0,0,2024
MOL,  ,H 52,Magazzinaggio e attività di supporto ai trasporti           ,0,0,0,1,1,2024
MOL,  ,H 53,Servizi postali e attività di corriere                      ,1,0,0,0,1,2024
MOL,  ,I   ,Attività dei servizi alloggio e ristorazione                ,10,0,2,1,13,2024
MOL,  ,I 55,Alloggio                                                    ,1,0,1,0,2,2024
MOL,  ,I 56,Attività dei servizi di ristorazione                        ,9,0,1,1,11,2024
MOL,  ,J   ,Servizi di informazione e comunicazione                     ,2,0,0,11,13,2024
MOL,  ,J 58,Attività editoriali                                         ,0,0,0,2,2,2024
MOL,  ,J 59,"Attività di produzione cinematografica, di video e di pro...",0,0,0,0,0,2024
MOL,  ,J 60,Attività di programmazione e trasmissione                   ,0,0,0,0,0,2024
MOL,  ,J 61,Telecomunicazioni                                           ,1,0,0,0,1,2024
MOL,  ,J 62,"Produzione di software, consulenza informatica e attività...",0,0,0,2,2,2024
MOL,  ,J 63,Attività dei servizi d'informazione e altri servizi infor...,1,0,0,7,8,2024
MOL,  ,K   ,Attività finanziarie e assicurative                         ,1,0,0,0,1,2024
MOL,  ,K 64,Attività di servizi finanziari (escluse le assicurazioni ...,0,0,0,0,0,2024
MOL,  ,K 65,"Assicurazioni, riassicurazioni e fondi pensione (escluse ...",0,0,0,0,0,2024
MOL,  ,K 66,Attività ausiliarie dei servizi finanziari e delle attivi...,1,0,0,0,1,2024
MOL,  ,L   ,Attivita' immobiliari                                       ,1,0,0,1,2,2024
MOL,  ,L 68,Attivita' immobiliari                                       ,1,0,0,1,2,2024
MOL,  ,M   ,"Attività professionali, scientifiche e tecniche             ",7,0,0,8,15,2024
MOL,  ,M 69,Attività legali e contabilità                               ,0,0,0,1,1,2024
MOL,  ,M 70,Attività di direzione aziendale e di consulenza gestional...,2,0,0,4,6,2024
MOL,  ,M 71,Attività degli studi di architettura e d'ingegneria; coll...,1,0,0,0,1,2024
MOL,  ,M 72,Ricerca scientifica e sviluppo                              ,0,0,0,0,0,2024
MOL,  ,M 73,Pubblicità e ricerche di mercato                            ,2,0,0,3,5,2024
MOL,  ,M 74,"Altre attività professionali, scientifiche e tecniche       ",2,0,0,0,2,2024
MOL,  ,M 75,Servizi veterinari                                          ,0,0,0,0,0,2024
MOL,  ,N   ,"Noleggio, agenzie di viaggio, servizi di supporto alle im...",3,0,0,24,27,2024
MOL,  ,N 77,Attività di noleggio e leasing operativo                    ,2,0,0,0,2,2024
MOL,  ,N 78,"Attività di ricerca, selezione, fornitura di personale      ",0,0,0,0,0,2024
MOL,  ,N 79,"Attività dei servizi delle agenzie di viaggio, dei tour o...",0,0,0,0,0,2024
MOL,  ,N 80,Servizi di vigilanza e investigazione                       ,0,0,0,0,0,2024
MOL,  ,N 81,Attività di servizi per edifici e paesaggio                 ,1,0,0,17,18,2024
MOL,  ,N 82,Attività di supporto per le funzioni d'ufficio e altri se...,0,0,0,7,7,2024
MOL,  ,O   ,Amministrazione pubblica e difesa; assicurazione sociale ...,0,0,0,0,0,2024
MOL,  ,O 84,Amministrazione pubblica e difesa; assicurazione sociale ...,0,0,0,0,0,2024
MOL,  ,P   ,Istruzione                                                  ,0,0,0,2,2,2024
MOL,  ,P 85,Istruzione                                                  ,0,0,0,2,2,2024
MOL,  ,Q   ,Sanita' e assistenza sociale                                ,1,0,0,13,14,2024
MOL,  ,Q 86,Assistenza sanitaria                                        ,1,0,0,2,3,2024
MOL,  ,Q 87,Servizi di assistenza sociale residenziale                  ,0,0,0,1,1,2024
MOL,  ,Q 88,Assistenza sociale non residenziale                         ,0,0,0,10,10,2024
MOL,  ,R   ,"Attività artistiche, sportive, di intrattenimento e diver...",1,0,0,3,4,2024
MOL,  ,R 90,"Attività creative, artistiche e di intrattenimento          ",0,0,0,2,2,2024
MOL,  ,R 91,"Attività di biblioteche, archivi, musei ed altre attività...",0,0,0,1,1,2024
MOL,  ,R 92,"Attività riguardanti le lotterie, le scommesse, le case d...",1,0,0,0,1,2024
MOL,  ,R 93,"Attività sportive, di intrattenimento e di divertimento     ",0,0,0,0,0,2024
MOL,  ,S   ,Altre attività di servizi                                   ,0,0,2,6,8,2024
MOL,  ,S 94,Attività di organizzazioni associative                      ,0,0,0,0,0,2024
MOL,  ,S 95,Riparazione di computer e di beni per uso personale e per...,0,0,0,1,1,2024
MOL,  ,S 96,Altre attività di servizi per la persona                    ,0,0,2,5,7,2024
MOL,  ,T   ,Attività di famiglie e convivenze come datori di lavoro p...,0,0,0,0,0,2024
MOL,  ,T 97,Attività di famiglie e convivenze come datori di lavoro p...,0,0,0,0,0,2024
MOL,  ,T 98,Produzione di beni e servizi indifferenziati per uso prop...,0,0,0,0,0,2024
MOL,  ,U   ,Organizzazioni ed organismi extraterritoriali               ,0,0,0,0,0,2024
MOL,  ,U 99,Organizzazioni ed organismi extraterritoriali               ,0,0,0,0,0,2024
MOL,  ,XX  ,Imprese non classificate                                    ,21,0,0,41,62,2024
MOL,  ,TOT ,TOTALE                                                      ,89,0,14,187,290,2024
MOL,CB,A   ,"Agricoltura, silvicoltura pesca                             ",0,0,2,15,17,2024
MOL,CB,A 01,"Coltivazioni agricole e produzione di prodotti animali, c...",0,0,2,12,14,2024
MOL,CB,A 02,Silvicoltura ed utilizzo di aree forestali                  ,0,0,0,2,2,2024
MOL,CB,A 03,Pesca e acquacoltura                                        ,0,0,0,1,1,2024
MOL,CB,B   ,Estrazione di minerali da cave e miniere                    ,0,0,0,0,0,2024
MOL,CB,B 05,Estrazione di carbone (esclusa torba)                       ,0,0,0,0,0,2024
MOL,CB,B 06,Estraz.di petrolio greggio e di gas naturale                ,0,0,0,0,0,2024
MOL,CB,B 07,Estrazione di minerali metalliferi                          ,0,0,0,0,0,2024
MOL,CB,B 08,Altre attività di estrazione di minerali da cave e miniere  ,0,0,0,0,0,2024
MOL,CB,B 09,Attività dei servizi di supporto all'estrazione             ,0,0,0,0,0,2024
MOL,CB,C   ,Attività manifatturiere                                     ,3,0,0,11,14,2024
MOL,CB,C 10,Industrie alimentari                                        ,0,0,0,2,2,2024
MOL,CB,C 11,Industria delle bevande                                     ,0,0,0,0,0,2024
MOL,CB,C 12,Industria del tabacco                                       ,0,0,0,0,0,2024
MOL,CB,C 13,Industrie tessili                                           ,0,0,0,0,0,2024
MOL,CB,C 14,Confezione di articoli di abbigliamento; confezione di ar...,0,0,0,3,3,2024
MOL,CB,C 15,Fabbricazione di articoli in pelle e simili                 ,0,0,0,0,0,2024
MOL,CB,C 16,Industria del legno e dei prodotti in legno e sughero (es...,0,0,0,0,0,2024
MOL,CB,C 17,Fabbricazione di carta e di prodotti di carta               ,0,0,0,0,0,2024
MOL,CB,C 18,Stampa e riproduzione di supporti registrati                ,0,0,0,1,1,2024
MOL,CB,C 19,Fabbricazione di coke e prodotti derivanti dalla raffinaz...,0,0,0,0,0,2024
MOL,CB,C 20,Fabbricazione di prodotti chimici                           ,0,0,0,0,0,2024
MOL,CB,C 21,Fabbricazione di prodotti farmaceutici di base e di prepa...,0,0,0,0,0,2024
MOL,CB,C 22,Fabbricazione di articoli in gomma e materie plastiche      ,0,0,0,0,0,2024
MOL,CB,C 23,Fabbricazione di altri prodotti della lavorazione di miner..,1,0,0,0,1,2024
MOL,CB,C 24,Metallurgia                                                 ,0,0,0,0,0,2024
MOL,CB,C 25,Fabbricazione di prodotti in metallo (esclusi macchinari ...,1,0,0,2,3,2024
MOL,CB,C 26,Fabbricazione di computer e prodotti di elettronica e ott...,0,0,0,0,0,2024
MOL,CB,C 27,Fabbricazione di apparecchiature elettriche ed apparecchi...,0,0,0,2,2,2024
MOL,CB,C 28,Fabbricazione di macchinari ed apparecchiature nca          ,0,0,0,0,0,2024
MOL,CB,C 29,"Fabbricazione di autoveicoli, rimorchi e semirimorchi       ",0,0,0,0,0,2024
MOL,CB,C 30,Fabbricazione di altri mezzi di trasporto                   ,0,0,0,0,0,2024
MOL,CB,C 31,Fabbricazione di mobili                                     ,1,0,0,0,1,2024
MOL,CB,C 32,Altre industrie manifatturiere                              ,0,0,0,0,0,2024
MOL,CB,C 33,"Riparazione, manutenzione ed installazione di macchine ed...",0,0,0,1,1,2024
MOL,CB,D   ,"Fornitura di energia elettrica, gas, vapore e aria condiz...",0,0,0,0,0,2024
MOL,CB,D 35,"Fornitura di energia elettrica, gas, vapore e aria condiz...",0,0,0,0,0,2024
MOL,CB,E   ,"Fornitura di acqua; reti fognarie, attività di gestione d...",0,0,0,1,1,2024
MOL,CB,E 36,"Raccolta, trattamento e fornitura di acqua                  ",0,0,0,0,0,2024
MOL,CB,E 37,Gestione delle reti fognarie                                ,0,0,0,0,0,2024
MOL,CB,E 38,"Attività di raccolta, trattamento e smaltimento dei rifiu...",0,0,0,1,1,2024
MOL,CB,E 39,Attività di risanamento e altri servizi di gestione dei r...,0,0,0,0,0,2024
MOL,CB,F   ,Costruzioni                                                 ,12,0,0,16,28,2024
MOL,CB,F 41,Costruzione di edifici                                      ,8,0,0,14,22,2024
MOL,CB,F 42,Ingegneria civile                                           ,0,0,0,0,0,2024
MOL,CB,F 43,Lavori di costruzione specializzati                         ,4,0,0,2,6,2024
MOL,CB,G   ,Commercio all'ingrosso e al dettaglio; riparazione di aut...,15,0,5,7,27,2024
MOL,CB,G 45,Commercio all'ingrosso e al dettaglio e riparazione di au...,3,0,0,3,6,2024
MOL,CB,G 46,Commercio all'ingrosso (escluso quello di autoveicoli e d...,5,0,1,3,9,2024
MOL,CB,G 47,Commercio al dettaglio (escluso quello di autoveicoli e d...,7,0,4,1,12,2024
MOL,CB,H   ,Trasporto e magazzinaggio                                   ,0,0,0,7,7,2024
MOL,CB,H 49,Trasporto terrestre e mediante condotte                     ,0,0,0,4,4,2024
MOL,CB,H 50,Trasporto marittimo e per vie d'acqua                       ,0,0,0,2,2,2024
MOL,CB,H 51,Trasporto aereo                                             ,0,0,0,0,0,2024
MOL,CB,H 52,Magazzinaggio e attività di supporto ai trasporti           ,0,0,0,1,1,2024
MOL,CB,H 53,Servizi postali e attività di corriere                      ,0,0,0,0,0,2024
MOL,CB,I   ,Attività dei servizi alloggio e ristorazione                ,5,0,1,1,7,2024
MOL,CB,I 55,Alloggio                                                    ,1,0,1,0,2,2024
MOL,CB,I 56,Attività dei servizi di ristorazione                        ,4,0,0,1,5,2024
MOL,CB,J   ,Servizi di informazione e comunicazione                     ,2,0,0,10,12,2024
MOL,CB,J 58,Attività editoriali                                         ,0,0,0,2,2,2024
MOL,CB,J 59,"Attività di produzione cinematografica, di video e di pro...",0,0,0,0,0,2024
MOL,CB,J 60,Attività di programmazione e trasmissione                   ,0,0,0,0,0,2024
MOL,CB,J 61,Telecomunicazioni                                           ,1,0,0,0,1,2024
MOL,CB,J 62,"Produzione di software, consulenza informatica e attività...",0,0,0,2,2,2024
MOL,CB,J 63,Attività dei servizi d'informazione e altri servizi infor...,1,0,0,6,7,2024
MOL,CB,K   ,Attività finanziarie e assicurative                         ,1,0,0,0,1,2024
MOL,CB,K 64,Attività di servizi finanziari (escluse le assicurazioni ...,0,0,0,0,0,2024
MOL,CB,K 65,"Assicurazioni, riassicurazioni e fondi pensione (escluse ...",0,0,0,0,0,2024
MOL,CB,K 66,Attività ausiliarie dei servizi finanziari e delle attivi...,1,0,0,0,1,2024
MOL,CB,L   ,Attivita' immobiliari                                       ,1,0,0,1,2,2024
MOL,CB,L 68,Attivita' immobiliari                                       ,1,0,0,1,2,2024
MOL,CB,M   ,"Attività professionali, scientifiche e tecniche             ",6,0,0,4,10,2024
MOL,CB,M 69,Attività legali e contabilità                               ,0,0,0,1,1,2024
MOL,CB,M 70,Attività di direzione aziendale e di consulenza gestional...,2,0,0,3,5,2024
MOL,CB,M 71,Attività degli studi di architettura e d'ingegneria; coll...,0,0,0,0,0,2024
MOL,CB,M 72,Ricerca scientifica e sviluppo                              ,0,0,0,0,0,2024
MOL,CB,M 73,Pubblicità e ricerche di mercato                            ,2,0,0,0,2,2024
MOL,CB,M 74,"Altre attività professionali, scientifiche e tecniche       ",2,0,0,0,2,2024
MOL,CB,M 75,Servizi veterinari                                          ,0,0,0,0,0,2024
MOL,CB,N   ,"Noleggio, agenzie di viaggio, servizi di supporto alle im...",1,0,0,12,13,2024
MOL,CB,N 77,Attività di noleggio e leasing operativo                    ,0,0,0,0,0,2024
MOL,CB,N 78,"Attività di ricerca, selezione, fornitura di personale      ",0,0,0,0,0,2024
MOL,CB,N 79,"Attività dei servizi delle agenzie di viaggio, dei tour o...",0,0,0,0,0,2024
MOL,CB,N 80,Servizi di vigilanza e investigazione                       ,0,0,0,0,0,2024
MOL,CB,N 81,Attività di servizi per edifici e paesaggio                 ,1,0,0,7,8,2024
MOL,CB,N 82,Attività di supporto per le funzioni d'ufficio e altri se...,0,0,0,5,5,2024
MOL,CB,O   ,Amministrazione pubblica e difesa; assicurazione sociale ...,0,0,0,0,0,2024
MOL,CB,O 84,Amministrazione pubblica e difesa; assicurazione sociale ...,0,0,0,0,0,2024
MOL,CB,P   ,Istruzione                                                  ,0,0,0,2,2,2024
MOL,CB,P 85,Istruzione                                                  ,0,0,0,2,2,2024
MOL,CB,Q   ,Sanita' e assistenza sociale                                ,1,0,0,9,10,2024
MOL,CB,Q 86,Assistenza sanitaria                                        ,1,0,0,2,3,2024
MOL,CB,Q 87,Servizi di assistenza sociale residenziale                  ,0,0,0,0,0,2024
MOL,CB,Q 88,Assistenza sociale non residenziale                         ,0,0,0,7,7,2024
MOL,CB,R   ,"Attività artistiche, sportive, di intrattenimento e diver...",0,0,0,3,3,2024
MOL,CB,R 90,"Attività creative, artistiche e di intrattenimento          ",0,0,0,2,2,2024
MOL,CB,R 91,"Attività di biblioteche, archivi, musei ed altre attività...",0,0,0,1,1,2024
MOL,CB,R 92,"Attività riguardanti le lotterie, le scommesse, le case d...",0,0,0,0,0,2024
MOL,CB,R 93,"Attività sportive, di intrattenimento e di divertimento     ",0,0,0,0,0,2024
MOL,CB,S   ,Altre attività di servizi                                   ,0,0,1,5,6,2024
MOL,CB,S 94,Attività di organizzazioni associative                      ,0,0,0,0,0,2024
MOL,CB,S 95,Riparazione di computer e di beni per uso personale e per...,0,0,0,1,1,2024
MOL,CB,S 96,Altre attività di servizi per la persona                    ,0,0,1,4,5,2024
MOL,CB,T   ,Attività di famiglie e convivenze come datori di lavoro p...,0,0,0,0,0,2024
MOL,CB,T 97,Attività di famiglie e convivenze come datori di lavoro p...,0,0,0,0,0,2024
MOL,CB,T 98,Produzione di beni e servizi indifferenziati per uso prop...,0,0,0,0,0,2024
MOL,CB,U   ,Organizzazioni ed organismi extraterritoriali               ,0,0,0,0,0,2024
MOL,CB,U 99,Organizzazioni ed organismi extraterritoriali               ,0,0,0,0,0,2024
MOL,CB,XX  ,Imprese non classificate                                    ,19,0,0,29,48,2024
MOL,CB,TOT ,TOTALE                                                      ,66,0,9,133,208,2024
MOL,IS,A   ,"Agricoltura, silvicoltura pesca                             ",0,0,2,5,7,2024
MOL,IS,A 01,"Coltivazioni agricole e produzione di prodotti animali, c...",0,0,2,5,7,2024
MOL,IS,A 02,Silvicoltura ed utilizzo di aree forestali                  ,0,0,0,0,0,2024
MOL,IS,A 03,Pesca e acquacoltura                                        ,0,0,0,0,0,2024
MOL,IS,B   ,Estrazione di minerali da cave e miniere                    ,0,0,0,0,0,2024
MOL,IS,B 05,Estrazione di carbone (esclusa torba)                       ,0,0,0,0,0,2024
MOL,IS,B 06,Estraz.di petrolio greggio e di gas naturale                ,0,0,0,0,0,2024
MOL,IS,B 07,Estrazione di minerali metalliferi                          ,0,0,0,0,0,2024
MOL,IS,B 08,Altre attività di estrazione di minerali da cave e miniere  ,0,0,0,0,0,2024
MOL,IS,B 09,Attività dei servizi di supporto all'estrazione             ,0,0,0,0,0,2024
MOL,IS,C   ,Attività manifatturiere                                     ,2,0,0,2,4,2024
MOL,IS,C 10,Industrie alimentari                                        ,0,0,0,1,1,2024
MOL,IS,C 11,Industria delle bevande                                     ,0,0,0,0,0,2024
MOL,IS,C 12,Industria del tabacco                                       ,0,0,0,0,0,2024
MOL,IS,C 13,Industrie tessili                                           ,0,0,0,1,1,2024
MOL,IS,C 14,Confezione di articoli di abbigliamento; confezione di ar...,1,0,0,0,1,2024
MOL,IS,C 15,Fabbricazione di articoli in pelle e simili                 ,0,0,0,0,0,2024
MOL,IS,C 16,Industria del legno e dei prodotti in legno e sughero (es...,0,0,0,0,0,2024
MOL,IS,C 17,Fabbricazione di carta e di prodotti di carta               ,0,0,0,0,0,2024
MOL,IS,C 18,Stampa e riproduzione di supporti registrati                ,0,0,0,0,0,2024
MOL,IS,C 19,Fabbricazione di coke e prodotti derivanti dalla raffinaz...,0,0,0,0,0,2024
MOL,IS,C 20,Fabbricazione di prodotti chimici                           ,0,0,0,0,0,2024
MOL,IS,C 21,Fabbricazione di prodotti farmaceutici di base e di prepa...,0,0,0,0,0,2024
MOL,IS,C 22,Fabbricazione di articoli in gomma e materie plastiche      ,0,0,0,0,0,2024
MOL,IS,C 23,Fabbricazione di altri prodotti della lavorazione di miner..,0,0,0,0,0,2024
MOL,IS,C 24,Metallurgia                                                 ,0,0,0,0,0,2024
MOL,IS,C 25,Fabbricazione di prodotti in metallo (esclusi macchinari ...,0,0,0,0,0,2024
MOL,IS,C 26,Fabbricazione di computer e prodotti di elettronica e ott...,0,0,0,0,0,2024
MOL,IS,C 27,Fabbricazione di apparecchiature elettriche ed apparecchi...,0,0,0,0,0,2024
MOL,IS,C 28,Fabbricazione di macchinari ed apparecchiature nca          ,0,0,0,0,0,2024
MOL,IS,C 29,"Fabbricazione di autoveicoli, rimorchi e semirimorchi       ",0,0,0,0,0,2024
MOL,IS,C 30,Fabbricazione di altri mezzi di trasporto                   ,0,0,0,0,0,2024
MOL,IS,C 31,Fabbricazione di mobili                                     ,1,0,0,0,1,2024
MOL,IS,C 32,Altre industrie manifatturiere                              ,0,0,0,0,0,2024
MOL,IS,C 33,"Riparazione, manutenzione ed installazione di macchine ed...",0,0,0,0,0,2024
MOL,IS,D   ,"Fornitura di energia elettrica, gas, vapore e aria condiz...",0,0,0,0,0,2024
MOL,IS,D 35,"Fornitura di energia elettrica, gas, vapore e aria condiz...",0,0,0,0,0,2024
MOL,IS,E   ,"Fornitura di acqua; reti fognarie, attività di gestione d...",0,0,1,0,1,2024
MOL,IS,E 36,"Raccolta, trattamento e fornitura di acqua                  ",0,0,0,0,0,2024
MOL,IS,E 37,Gestione delle reti fognarie                                ,0,0,0,0,0,2024
MOL,IS,E 38,"Attività di raccolta, trattamento e smaltimento dei rifiu...",0,0,1,0,1,2024
MOL,IS,E 39,Attività di risanamento e altri servizi di gestione dei r...,0,0,0,0,0,2024
MOL,IS,F   ,Costruzioni                                                 ,4,0,0,4,8,2024
MOL,IS,F 41,Costruzione di edifici                                      ,4,0,0,3,7,2024
MOL,IS,F 42,Ingegneria civile                                           ,0,0,0,0,0,2024
MOL,IS,F 43,Lavori di costruzione specializzati                         ,0,0,0,1,1,2024
MOL,IS,G   ,Commercio all'ingrosso e al dettaglio; riparazione di aut...,5,0,0,5,10,2024
MOL,IS,G 45,Commercio all'ingrosso e al dettaglio e riparazione di au...,3,0,0,1,4,2024
MOL,IS,G 46,Commercio all'ingrosso (escluso quello di autoveicoli e d...,2,0,0,3,5,2024
MOL,IS,G 47,Commercio al dettaglio (escluso quello di autoveicoli e d...,0,0,0,1,1,2024
MOL,IS,H   ,Trasporto e magazzinaggio                                   ,1,0,0,4,5,2024
MOL,IS,H 49,Trasporto terrestre e mediante condotte                     ,0,0,0,4,4,2024
MOL,IS,H 50,Trasporto marittimo e per vie d'acqua                       ,0,0,0,0,0,2024
MOL,IS,H 51,Trasporto aereo                                             ,0,0,0,0,0,2024
MOL,IS,H 52,Magazzinaggio e attività di supporto ai trasporti           ,0,0,0,0,0,2024
MOL,IS,H 53,Servizi postali e attività di corriere                      ,1,0,0,0,1,2024
MOL,IS,I   ,Attività dei servizi alloggio e ristorazione                ,5,0,1,0,6,2024
MOL,IS,I 55,Alloggio                                                    ,0,0,0,0,0,2024
MOL,IS,I 56,Attività dei servizi di ristorazione                        ,5,0,1,0,6,2024
MOL,IS,J   ,Servizi di informazione e comunicazione                     ,0,0,0,1,1,2024
MOL,IS,J 58,Attività editoriali                                         ,0,0,0,0,0,2024
MOL,IS,J 59,"Attività di produzione cinematografica, di video e di pro...",0,0,0,0,0,2024
MOL,IS,J 60,Attività di programmazione e trasmissione                   ,0,0,0,0,0,2024
MOL,IS,J 61,Telecomunicazioni                                           ,0,0,0,0,0,2024
MOL,IS,J 62,"Produzione di software, consulenza informatica e attività...",0,0,0,0,0,2024
MOL,IS,J 63,Attività dei servizi d'informazione e altri servizi infor...,0,0,0,1,1,2024
MOL,IS,K   ,Attività finanziarie e assicurative                         ,0,0,0,0,0,2024
MOL,IS,K 64,Attività di servizi finanziari (escluse le assicurazioni ...,0,0,0,0,0,2024
MOL,IS,K 65,"Assicurazioni, riassicurazioni e fondi pensione (escluse ...",0,0,0,0,0,2024
MOL,IS,K 66,Attività ausiliarie dei servizi finanziari e delle attivi...,0,0,0,0,0,2024
MOL,IS,L   ,Attivita' immobiliari                                       ,0,0,0,0,0,2024
MOL,IS,L 68,Attivita' immobiliari                                       ,0,0,0,0,0,2024
MOL,IS,M   ,"Attività professionali, scientifiche e tecniche             ",1,0,0,4,5,2024
MOL,IS,M 69,Attività legali e contabilità                               ,0,0,0,0,0,2024
MOL,IS,M 70,Attività di direzione aziendale e di consulenza gestional...,0,0,0,1,1,2024
MOL,IS,M 71,Attività degli studi di architettura e d'ingegneria; coll...,1,0,0,0,1,2024
MOL,IS,M 72,Ricerca scientifica e sviluppo                              ,0,0,0,0,0,2024
MOL,IS,M 73,Pubblicità e ricerche di mercato                            ,0,0,0,3,3,2024
MOL,IS,M 74,"Altre attività professionali, scientifiche e tecniche       ",0,0,0,0,0,2024
MOL,IS,M 75,Servizi veterinari                                          ,0,0,0,0,0,2024
MOL,IS,N   ,"Noleggio, agenzie di viaggio, servizi di supporto alle im...",2,0,0,12,14,2024
MOL,IS,N 77,Attività di noleggio e leasing operativo                    ,2,0,0,0,2,2024
MOL,IS,N 78,"Attività di ricerca, selezione, fornitura di personale      ",0,0,0,0,0,2024
MOL,IS,N 79,"Attività dei servizi delle agenzie di viaggio, dei tour o...",0,0,0,0,0,2024
MOL,IS,N 80,Servizi di vigilanza e investigazione                       ,0,0,0,0,0,2024
MOL,IS,N 81,Attività di servizi per edifici e paesaggio                 ,0,0,0,10,10,2024
MOL,IS,N 82,Attività di supporto per le funzioni d'ufficio e altri se...,0,0,0,2,2,2024
MOL,IS,O   ,Amministrazione pubblica e difesa; assicurazione sociale ...,0,0,0,0,0,2024
MOL,IS,O 84,Amministrazione pubblica e difesa; assicurazione sociale ...,0,0,0,0,0,2024
MOL,IS,P   ,Istruzione                                                  ,0,0,0,0,0,2024
MOL,IS,P 85,Istruzione                                                  ,0,0,0,0,0,2024
MOL,IS,Q   ,Sanita' e assistenza sociale                                ,0,0,0,4,4,2024
MOL,IS,Q 86,Assistenza sanitaria                                        ,0,0,0,0,0,2024
MOL,IS,Q 87,Servizi di assistenza sociale residenziale                  ,0,0,0,1,1,2024
MOL,IS,Q 88,Assistenza sociale non residenziale                         ,0,0,0,3,3,2024
MOL,IS,R   ,"Attività artistiche, sportive, di intrattenimento e diver...",1,0,0,0,1,2024
MOL,IS,R 90,"Attività creative, artistiche e di intrattenimento          ",0,0,0,0,0,2024
MOL,IS,R 91,"Attività di biblioteche, archivi, musei ed altre attività...",0,0,0,0,0,2024
MOL,IS,R 92,"Attività riguardanti le lotterie, le scommesse, le case d...",1,0,0,0,1,2024
MOL,IS,R 93,"Attività sportive, di intrattenimento e di divertimento     ",0,0,0,0,0,2024
MOL,IS,S   ,Altre attività di servizi                                   ,0,0,1,1,2,2024
MOL,IS,S 94,Attività di organizzazioni associative                      ,0,0,0,0,0,2024
MOL,IS,S 95,Riparazione di computer e di beni per uso personale e per...,0,0,0,0,0,2024
MOL,IS,S 96,Altre attività di servizi per la persona                    ,0,0,1,1,2,2024
MOL,IS,T   ,Attività di famiglie e convivenze come datori di lavoro p...,0,0,0,0,0,2024
MOL,IS,T 97,Attività di famiglie e convivenze come datori di lavoro p...,0,0,0,0,0,2024
MOL,IS,T 98,Produzione di beni e servizi indifferenziati per uso prop...,0,0,0,0,0,2024
MOL,IS,U   ,Organizzazioni ed organismi extraterritoriali               ,0,0,0,0,0,2024
MOL,IS,U 99,Organizzazioni ed organismi extraterritoriali               ,0,0,0,0,0,2024
MOL,IS,XX  ,Imprese non classificate                                    ,2,0,0,12,14,2024
MOL,IS,TOT ,TOTALE                                                      ,23,0,5,54,82,2024
CAM,  ,A   ,"Agricoltura, silvicoltura pesca                             ",25,16,394,229,664,2024
CAM,  ,A 01,"Coltivazioni agricole e produzione di prodotti animali, c...",22,15,378,186,601,2024
CAM,  ,A 02,Silvicoltura ed utilizzo di aree forestali                  ,1,0,11,8,20,2024
CAM,  ,A 03,Pesca e acquacoltura                                        ,2,1,5,35,43,2024
CAM,  ,B   ,Estrazione di minerali da cave e miniere                    ,0,1,14,0,15,2024
CAM,  ,B 05,Estrazione di carbone (esclusa torba)                       ,0,0,0,0,0,2024
CAM,  ,B 06,Estraz.di petrolio greggio e di gas naturale                ,0,0,0,0,0,2024
CAM,  ,B 07,Estrazione di minerali metalliferi                          ,0,0,0,0,0,2024
CAM,  ,B 08,Altre attività di estrazione di minerali da cave e miniere  ,0,1,14,0,15,2024
CAM,  ,B 09,Attività dei servizi di supporto all'estrazione             ,0,0,0,0,0,2024
CAM,  ,C   ,Attività manifatturiere                                     ,797,127,539,189,1652,2024
CAM,  ,C 10,Industrie alimentari                                        ,59,26,81,41,207,2024
CAM,  ,C 11,Industria delle bevande                                     ,5,1,11,1,18,2024
CAM,  ,C 12,Industria del tabacco                                       ,0,0,0,1,1,2024
CAM,  ,C 13,Industrie tessili                                           ,9,4,14,1,28,2024
CAM,  ,C 14,Confezione di articoli di abbigliamento; confezione di ar...,141,13,105,19,278,2024
CAM,  ,C 15,Fabbricazione di articoli in pelle e simili                 ,96,15,59,9,179,2024
CAM,  ,C 16,Industria del legno e dei prodotti in legno e sughero (es...,25,9,56,7,97,2024
CAM,  ,C 17,Fabbricazione di carta e di prodotti di carta               ,15,3,2,3,23,2024
CAM,  ,C 18,Stampa e riproduzione di supporti registrati                ,27,6,4,8,45,2024
CAM,  ,C 19,Fabbricazione di coke e prodotti derivanti dalla raffinaz...,5,0,0,0,5,2024
CAM,  ,C 20,Fabbricazione di prodotti chimici                           ,14,1,6,1,22,2024
CAM,  ,C 21,Fabbricazione di prodotti farmaceutici di base e di prepa...,5,0,0,0,5,2024
CAM,  ,C 22,Fabbricazione di articoli in gomma e materie plastiche      ,19,0,4,4,27,2024
CAM,  ,C 23,Fabbricazione di altri prodotti della lavorazione di miner..,28,9,28,11,76,2024
CAM,  ,C 24,Metallurgia                                                 ,16,0,3,2,21,2024
CAM,  ,C 25,Fabbricazione di prodotti in metallo (esclusi macchinari ...,124,14,80,41,259,2024
CAM,  ,C 26,Fabbricazione di computer e prodotti di elettronica e ott...,26,1,2,3,32,2024
CAM,  ,C 27,Fabbricazione di apparecchiature elettriche ed apparecchi...,17,3,6,5,31,2024
CAM,  ,C 28,Fabbricazione di macchinari ed apparecchiature nca          ,39,3,7,5,54,2024
CAM,  ,C 29,"Fabbricazione di autoveicoli, rimorchi e semirimorchi       ",5,2,2,3,12,2024
CAM,  ,C 30,Fabbricazione di altri mezzi di trasporto                   ,29,0,5,4,38,2024
CAM,  ,C 31,Fabbricazione di mobili                                     ,25,6,12,3,46,2024
CAM,  ,C 32,Altre industrie manifatturiere                              ,23,8,30,6,67,2024
CAM,  ,C 33,"Riparazione, manutenzione ed installazione di macchine ed...",45,3,22,11,81,2024
CAM,  ,D   ,"Fornitura di energia elettrica, gas, vapore e aria condiz...",11,0,0,3,14,2024
CAM,  ,D 35,"Fornitura di energia elettrica, gas, vapore e aria condiz...",11,0,0,3,14,2024
CAM,  ,E   ,"Fornitura di acqua; reti fognarie, attività di gestione d...",19,1,2,21,43,2024
CAM,  ,E 36,"Raccolta, trattamento e fornitura di acqua                  ",0,0,0,3,3,2024
CAM,  ,E 37,Gestione delle reti fognarie                                ,0,0,2,3,5,2024
CAM,  ,E 38,"Attività di raccolta, trattamento e smaltimento dei rifiu...",18,1,0,11,30,2024
CAM,  ,E 39,Attività di risanamento e altri servizi di gestione dei r...,1,0,0,4,5,2024
CAM,  ,F   ,Costruzioni                                                 ,840,114,819,908,2681,2024
CAM,  ,F 41,Costruzione di edifici                                      ,544,68,352,701,1665,2024
CAM,  ,F 42,Ingegneria civile                                           ,22,3,4,24,53,2024
CAM,  ,F 43,Lavori di costruzione specializzati                         ,274,43,463,183,963,2024
CAM,  ,G   ,Commercio all'ingrosso e al dettaglio; riparazione di aut...,1898,345,3017,118,5378,2024
CAM,  ,G 45,Commercio all'ingrosso e al dettaglio e riparazione di au...,165,37,184,17,403,2024
CAM,  ,G 46,Commercio all'ingrosso (escluso quello di autoveicoli e d...,977,130,569,49,1725,2024
CAM,  ,G 47,Commercio al dettaglio (escluso quello di autoveicoli e d...,756,178,2264,52,3250,2024
CAM,  ,H   ,Trasporto e magazzinaggio                                   ,182,39,218,353,792,2024
CAM,  ,H 49,Trasporto terrestre e mediante condotte                     ,104,31,192,172,499,2024
CAM,  ,H 50,Trasporto marittimo e per vie d'acqua                       ,11,2,0,3,16,2024
CAM,  ,H 51,Trasporto aereo                                             ,0,0,0,0,0,2024
CAM,  ,H 52,Magazzinaggio e attività di supporto ai trasporti           ,53,3,20,172,248,2024
CAM,  ,H 53,Servizi postali e attività di corriere                      ,14,3,6,6,29,2024
CAM,  ,I   ,Attività dei servizi alloggio e ristorazione                ,360,238,326,59,983,2024
CAM,  ,I 55,Alloggio                                                    ,55,6,10,4,75,2024
CAM,  ,I 56,Attività dei servizi di ristorazione                        ,305,232,316,55,908,2024
CAM,  ,J   ,Servizi di informazione e comunicazione                     ,210,27,68,60,365,2024
CAM,  ,J 58,Attività editoriali                                         ,20,2,6,11,39,2024
CAM,  ,J 59,"Attività di produzione cinematografica, di video e di pro...",10,2,10,1,23,2024
CAM,  ,J 60,Attività di programmazione e trasmissione                   ,7,3,0,3,13,2024
CAM,  ,J 61,Telecomunicazioni                                           ,32,1,16,1,50,2024
CAM,  ,J 62,"Produzione di software, consulenza informatica e attività...",87,9,13,16,125,2024
CAM,  ,J 63,Attività dei servizi d'informazione e altri servizi infor...,54,10,23,28,115,2024
CAM,  ,K   ,Attività finanziarie e assicurative                         ,96,16,50,16,178,2024
CAM,  ,K 64,Attività di servizi finanziari (escluse le assicurazioni ...,29,0,0,7,36,2024
CAM,  ,K 65,"Assicurazioni, riassicurazioni e fondi pensione (escluse ...",4,1,0,0,5,2024
CAM,  ,K 66,Attività ausiliarie dei servizi finanziari e delle attivi...,63,15,50,9,137,2024
CAM,  ,L   ,Attivita' immobiliari                                       ,154,10,25,28,217,2024
CAM,  ,L 68,Attivita' immobiliari                                       ,154,10,25,28,217,2024
CAM,  ,M   ,"Attività professionali, scientifiche e tecniche             ",222,27,77,72,398,2024
CAM,  ,M 69,Attività legali e contabilità                               ,15,2,2,2,21,2024
CAM,  ,M 70,Attività di direzione aziendale e di consulenza gestional...,54,3,8,26,91,2024
CAM,  ,M 71,Attività degli studi di architettura e d'ingegneria; coll...,37,2,1,12,52,2024
CAM,  ,M 72,Ricerca scientifica e sviluppo                              ,6,0,1,1,8,2024
CAM,  ,M 73,Pubblicità e ricerche di mercato                            ,43,7,26,10,86,2024
CAM,  ,M 74,"Altre attività professionali, scientifiche e tecniche       ",67,13,38,21,139,2024
CAM,  ,M 75,Servizi veterinari                                          ,0,0,1,0,1,2024
CAM,  ,N   ,"Noleggio, agenzie di viaggio, servizi di supporto alle im...",286,31,122,255,694,2024
CAM,  ,N 77,Attività di noleggio e leasing operativo                    ,34,9,22,4,69,2024
CAM,  ,N 78,"Attività di ricerca, selezione, fornitura di personale      ",2,1,0,0,3,2024
CAM,  ,N 79,"Attività dei servizi delle agenzie di viaggio, dei tour o...",38,0,5,6,49,2024
CAM,  ,N 80,Servizi di vigilanza e investigazione                       ,11,0,0,6,17,2024
CAM,  ,N 81,Attività di servizi per edifici e paesaggio                 ,72,9,35,177,293,2024
CAM,  ,N 82,Attività di supporto per le funzioni d'ufficio e altri se...,129,12,60,62,263,2024
CAM,  ,O   ,Amministrazione pubblica e difesa; assicurazione sociale ...,0,0,0,0,0,2024
CAM,  ,O 84,Amministrazione pubblica e difesa; assicurazione sociale ...,0,0,0,0,0,2024
CAM,  ,P   ,Istruzione                                                  ,33,5,5,39,82,2024
CAM,  ,P 85,Istruzione                                                  ,33,5,5,39,82,2024
CAM,  ,Q   ,Sanita' e assistenza sociale                                ,45,1,3,172,221,2024
CAM,  ,Q 86,Assistenza sanitaria                                        ,38,0,1,26,65,2024
CAM,  ,Q 87,Servizi di assistenza sociale residenziale                  ,4,1,1,31,37,2024
CAM,  ,Q 88,Assistenza sociale non residenziale                         ,3,0,1,115,119,2024
CAM,  ,R   ,"Attività artistiche, sportive, di intrattenimento e diver...",121,13,48,47,229,2024
CAM,  ,R 90,"Attività creative, artistiche e di intrattenimento          ",19,1,8,20,48,2024
CAM,  ,R 91,"Attività di biblioteche, archivi, musei ed altre attività...",0,0,0,5,5,2024
CAM,  ,R 92,"Attività riguardanti le lotterie, le scommesse, le case d...",30,0,10,3,43,2024
CAM,  ,R 93,"Attività sportive, di intrattenimento e di divertimento     ",72,12,30,19,133,2024
CAM,  ,S   ,Altre attività di servizi                                   ,99,39,204,55,397,2024
CAM,  ,S 94,Attività di organizzazioni associative                      ,2,1,0,4,7,2024
CAM,  ,S 95,Riparazione di computer e di beni per uso personale e per...,11,3,49,1,64,2024
CAM,  ,S 96,Altre attività di servizi per la persona                    ,86,35,155,50,326,2024
CAM,  ,T   ,Attività di famiglie e convivenze come datori di lavoro p...,0,0,0,0,0,2024
CAM,  ,T 97,Attività di famiglie e convivenze come datori di lavoro p...,0,0,0,0,0,2024
CAM,  ,T 98,Produzione di beni e servizi indifferenziati per uso prop...,0,0,0,0,0,2024
CAM,  ,U   ,Organizzazioni ed organismi extraterritoriali               ,0,0,0,0,0,2024
CAM,  ,U 99,Organizzazioni ed organismi extraterritoriali               ,0,0,0,0,0,2024
CAM,  ,XX  ,Imprese non classificate                                    ,1069,306,1036,680,3091,2024
CAM,  ,TOT ,TOTALE                                                      ,6467,1356,6967,3304,18094,2024
CAM,CE,A   ,"Agricoltura, silvicoltura pesca                             ",0,0,43,40,83,2024
CAM,CE,A 01,"Coltivazioni agricole e produzione di prodotti animali, c...",0,0,38,39,77,2024
CAM,CE,A 02,Silvicoltura ed utilizzo di aree forestali                  ,0,0,4,1,5,2024
CAM,CE,A 03,Pesca e acquacoltura                                        ,0,0,1,0,1,2024
CAM,CE,B   ,Estrazione di minerali da cave e miniere                    ,0,0,14,0,14,2024
CAM,CE,B 05,Estrazione di carbone (esclusa torba)                       ,0,0,0,0,0,2024
CAM,CE,B 06,Estraz.di petrolio greggio e di gas naturale                ,0,0,0,0,0,2024
CAM,CE,B 07,Estrazione di minerali metalliferi                          ,0,0,0,0,0,2024
CAM,CE,B 08,Altre attività di estrazione di minerali da cave e miniere  ,0,0,14,0,14,2024
CAM,CE,B 09,Attività dei servizi di supporto all'estrazione             ,0,0,0,0,0,2024
CAM,CE,C   ,Attività manifatturiere                                     ,0,0,157,36,193,2024
CAM,CE,C 10,Industrie alimentari                                        ,0,0,22,10,32,2024
CAM,CE,C 11,Industria delle bevande                                     ,0,0,5,0,5,2024
CAM,CE,C 12,Industria del tabacco                                       ,0,0,0,0,0,2024
CAM,CE,C 13,Industrie tessili                                           ,0,0,7,0,7,2024
CAM,CE,C 14,Confezione di articoli di abbigliamento; confezione di ar...,0,0,31,1,32,2024
CAM,CE,C 15,Fabbricazione di articoli in pelle e simili                 ,0,0,29,0,29,2024
CAM,CE,C 16,Industria del legno e dei prodotti in legno e sughero (es...,0,0,19,2,21,2024
CAM,CE,C 17,Fabbricazione di carta e di prodotti di carta               ,0,0,1,0,1,2024
CAM,CE,C 18,Stampa e riproduzione di supporti registrati                ,0,0,1,0,1,2024
CAM,CE,C 19,Fabbricazione di coke e prodotti derivanti dalla raffinaz...,0,0,0,0,0,2024
CAM,CE,C 20,Fabbricazione di prodotti chimici                           ,0,0,5,0,5,2024
CAM,CE,C 21,Fabbricazione di prodotti farmaceutici di base e di prepa...,0,0,0,0,0,2024
CAM,CE,C 22,Fabbricazione di articoli in gomma e materie plastiche      ,0,0,1,1,2,2024
CAM,CE,C 23,Fabbricazione di altri prodotti della lavorazione di miner..,0,0,12,4,16,2024
CAM,CE,C 24,Metallurgia                                                 ,0,0,1,1,2,2024
CAM,CE,C 25,Fabbricazione di prodotti in metallo (esclusi macchinari ...,0,0,11,6,17,2024
CAM,CE,C 26,Fabbricazione di computer e prodotti di elettronica e ott...,0,0,0,2,2,2024
CAM,CE,C 27,Fabbricazione di apparecchiature elettriche ed apparecchi...,0,0,1,1,2,2024
CAM,CE,C 28,Fabbricazione di macchinari ed apparecchiature nca          ,0,0,2,1,3,2024
CAM,CE,C 29,"Fabbricazione di autoveicoli, rimorchi e semirimorchi       ",0,0,0,0,0,2024
CAM,CE,C 30,Fabbricazione di altri mezzi di trasporto                   ,0,0,2,3,5,2024
CAM,CE,C 31,Fabbricazione di mobili                                     ,0,0,4,0,4,2024
CAM,CE,C 32,Altre industrie manifatturiere                              ,0,0,2,1,3,2024
CAM,CE,C 33,"Riparazione, manutenzione ed installazione di macchine ed...",0,0,1,3,4,2024
CAM,CE,D   ,"Fornitura di energia elettrica, gas, vapore e aria condiz...",0,0,0,0,0,2024
CAM,CE,D 35,"Fornitura di energia elettrica, gas, vapore e aria condiz...",0,0,0,0,0,2024
CAM,CE,E   ,"Fornitura di acqua; reti fognarie, attività di gestione d...",0,0,0,5,5,2024
CAM,CE,E 36,"Raccolta, trattamento e fornitura di acqua                  ",0,0,0,0,0,2024
CAM,CE,E 37,Gestione delle reti fognarie                                ,0,0,0,2,2,2024
CAM,CE,E 38,"Attività di raccolta, trattamento e smaltimento dei rifiu...",0,0,0,1,1,2024
CAM,CE,E 39,Attività di risanamento e altri servizi di gestione dei r...,0,0,0,2,2,2024
CAM,CE,F   ,Costruzioni                                                 ,0,0,87,388,475,2024
CAM,CE,F 41,Costruzione di edifici                                      ,0,0,58,335,393,2024
CAM,CE,F 42,Ingegneria civile                                           ,0,0,0,7,7,2024
CAM,CE,F 43,Lavori di costruzione specializzati                         ,0,0,29,46,75,2024
CAM,CE,G   ,Commercio all'ingrosso e al dettaglio; riparazione di aut...,0,0,540,24,564,2024
CAM,CE,G 45,Commercio all'ingrosso e al dettaglio e riparazione di au...,0,0,18,2,20,2024
CAM,CE,G 46,Commercio all'ingrosso (escluso quello di autoveicoli e d...,0,0,46,6,52,2024
CAM,CE,G 47,Commercio al dettaglio (escluso quello di autoveicoli e d...,0,0,476,16,492,2024
CAM,CE,H   ,Trasporto e magazzinaggio                                   ,0,0,46,54,100,2024
CAM,CE,H 49,Trasporto terrestre e mediante condotte                     ,0,0,44,22,66,2024
CAM,CE,H 50,Trasporto marittimo e per vie d'acqua                       ,0,0,0,0,0,2024
CAM,CE,H 51,Trasporto aereo                                             ,0,0,0,0,0,2024
CAM,CE,H 52,Magazzinaggio e attività di supporto ai trasporti           ,0,0,2,31,33,2024
CAM,CE,H 53,Servizi postali e attività di corriere                      ,0,0,0,1,1,2024
CAM,CE,I   ,Attività dei servizi alloggio e ristorazione                ,0,0,42,15,57,2024
CAM,CE,I 55,Alloggio                                                    ,0,0,0,0,0,2024
CAM,CE,I 56,Attività dei servizi di ristorazione                        ,0,0,42,15,57,2024
CAM,CE,J   ,Servizi di informazione e comunicazione                     ,0,0,5,6,11,2024
CAM,CE,J 58,Attività editoriali                                         ,0,0,0,1,1,2024
CAM,CE,J 59,"Attività di produzione cinematografica, di video e di pro...",0,0,5,0,5,2024
CAM,CE,J 60,Attività di programmazione e trasmissione                   ,0,0,0,0,0,2024
CAM,CE,J 61,Telecomunicazioni                                           ,0,0,0,0,0,2024
CAM,CE,J 62,"Produzione di software, consulenza informatica e attività...",0,0,0,1,1,2024
CAM,CE,J 63,Attività dei servizi d'informazione e altri servizi infor...,0,0,0,4,4,2024
CAM,CE,K   ,Attività finanziarie e assicurative                         ,0,0,5,0,5,2024
CAM,CE,K 64,Attività di servizi finanziari (escluse le assicurazioni ...,0,0,0,0,0,2024
CAM,CE,K 65,"Assicurazioni, riassicurazioni e fondi pensione (escluse ...",0,0,0,0,0,2024
CAM,CE,K 66,Attività ausiliarie dei servizi finanziari e delle attivi...,0,0,5,0,5,2024
CAM,CE,L   ,Attivita' immobiliari                                       ,0,0,2,1,3,2024
CAM,CE,L 68,Attivita' immobiliari                                       ,0,0,2,1,3,2024
CAM,CE,M   ,"Attività professionali, scientifiche e tecniche             ",0,0,3,10,13,2024
CAM,CE,M 69,Attività legali e contabilità                               ,0,0,0,0,0,2024
CAM,CE,M 70,Attività di direzione aziendale e di consulenza gestional...,0,0,0,5,5,2024
CAM,CE,M 71,Attività degli studi di architettura e d'ingegneria; coll...,0,0,0,1,1,2024
CAM,CE,M 72,Ricerca scientifica e sviluppo                              ,0,0,0,0,0,2024
CAM,CE,M 73,Pubblicità e ricerche di mercato                            ,0,0,1,2,3,2024
CAM,CE,M 74,"Altre attività professionali, scientifiche e tecniche       ",0,0,2,2,4,2024
CAM,CE,M 75,Servizi veterinari                                          ,0,0,0,0,0,2024
CAM,CE,N   ,"Noleggio, agenzie di viaggio, servizi di supporto alle im...",0,0,10,43,53,2024
CAM,CE,N 77,Attività di noleggio e leasing operativo                    ,0,0,3,0,3,2024
CAM,CE,N 78,"Attività di ricerca, selezione, fornitura di personale      ",0,0,0,0,0,2024
CAM,CE,N 79,"Attività dei servizi delle agenzie di viaggio, dei tour o...",0,0,0,2,2,2024
CAM,CE,N 80,Servizi di vigilanza e investigazione                       ,0,0,0,1,1,2024
CAM,CE,N 81,Attività di servizi per edifici e paesaggio                 ,0,0,5,26,31,2024
CAM,CE,N 82,Attività di supporto per le funzioni d'ufficio e altri se...,0,0,2,14,16,2024
CAM,CE,O   ,Amministrazione pubblica e difesa; assicurazione sociale ...,0,0,0,0,0,2024
CAM,CE,O 84,Amministrazione pubblica e difesa; assicurazione sociale ...,0,0,0,0,0,2024
CAM,CE,P   ,Istruzione                                                  ,0,0,0,13,13,2024
CAM,CE,P 85,Istruzione                                                  ,0,0,0,13,13,2024
CAM,CE,Q   ,Sanita' e assistenza sociale                                ,0,0,0,29,29,2024
CAM,CE,Q 86,Assistenza sanitaria                                        ,0,0,0,0,0,2024
CAM,CE,Q 87,Servizi di assistenza sociale residenziale                  ,0,0,0,8,8,2024
CAM,CE,Q 88,Assistenza sociale non residenziale                         ,0,0,0,21,21,2024
CAM,CE,R   ,"Attività artistiche, sportive, di intrattenimento e diver...",0,0,5,5,10,2024
CAM,CE,R 90,"Attività creative, artistiche e di intrattenimento          ",0,0,1,2,3,2024
CAM,CE,R 91,"Attività di biblioteche, archivi, musei ed altre attività...",0,0,0,0,0,2024
CAM,CE,R 92,"Attività riguardanti le lotterie, le scommesse, le case d...",0,0,1,0,1,2024
CAM,CE,R 93,"Attività sportive, di intrattenimento e di divertimento     ",0,0,3,3,6,2024
CAM,CE,S   ,Altre attività di servizi                                   ,0,0,55,16,71,2024
CAM,CE,S 94,Attività di organizzazioni associative                      ,0,0,0,0,0,2024
CAM,CE,S 95,Riparazione di computer e di beni per uso personale e per...,0,0,12,0,12,2024
CAM,CE,S 96,Altre attività di servizi per la persona                    ,0,0,43,16,59,2024
CAM,CE,T   ,Attività di famiglie e convivenze come datori di lavoro p...,0,0,0,0,0,2024
CAM,CE,T 97,Attività di famiglie e convivenze come datori di lavoro p...,0,0,0,0,0,2024
CAM,CE,T 98,Produzione di beni e servizi indifferenziati per uso prop...,0,0,0,0,0,2024
CAM,CE,U   ,Organizzazioni ed organismi extraterritoriali               ,0,0,0,0,0,2024
CAM,CE,U 99,Organizzazioni ed organismi extraterritoriali               ,0,0,0,0,0,2024
CAM,CE,XX  ,Imprese non classificate                                    ,0,0,59,201,260,2024
CAM,CE,TOT ,TOTALE                                                      ,0,0,1073,886,1959,2024
CAM,BN,A   ,"Agricoltura, silvicoltura pesca                             ",1,4,193,8,206,2024
CAM,BN,A 01,"Coltivazioni agricole e produzione di prodotti animali, c...",1,4,188,8,201,2024
CAM,BN,A 02,Silvicoltura ed utilizzo di aree forestali                  ,0,0,5,0,5,2024
CAM,BN,A 03,Pesca e acquacoltura                                        ,0,0,0,0,0,2024
CAM,BN,B   ,Estrazione di minerali da cave e miniere                    ,0,1,0,0,1,2024
CAM,BN,B 05,Estrazione di carbone (esclusa torba)                       ,0,0,0,0,0,2024
CAM,BN,B 06,Estraz.di petrolio greggio e di gas naturale                ,0,0,0,0,0,2024
CAM,BN,B 07,Estrazione di minerali metalliferi                          ,0,0,0,0,0,2024
CAM,BN,B 08,Altre attività di estrazione di minerali da cave e miniere  ,0,1,0,0,1,2024
CAM,BN,B 09,Attività dei servizi di supporto all'estrazione             ,0,0,0,0,0,2024
CAM,BN,C   ,Attività manifatturiere                                     ,13,11,69,18,111,2024
CAM,BN,C 10,Industrie alimentari                                        ,0,2,17,7,26,2024
CAM,BN,C 11,Industria delle bevande                                     ,1,0,0,0,1,2024
CAM,BN,C 12,Industria del tabacco                                       ,0,0,0,1,1,2024
CAM,BN,C 13,Industrie tessili                                           ,0,0,4,0,4,2024
CAM,BN,C 14,Confezione di articoli di abbigliamento; confezione di ar...,3,4,9,0,16,2024
CAM,BN,C 15,Fabbricazione di articoli in pelle e simili                 ,2,0,3,0,5,2024
CAM,BN,C 16,Industria del legno e dei prodotti in legno e sughero (es...,0,1,8,0,9,2024
CAM,BN,C 17,Fabbricazione di carta e di prodotti di carta               ,0,0,0,0,0,2024
CAM,BN,C 18,Stampa e riproduzione di supporti registrati                ,0,0,0,1,1,2024
CAM,BN,C 19,Fabbricazione di coke e prodotti derivanti dalla raffinaz...,0,0,0,0,0,2024
CAM,BN,C 20,Fabbricazione di prodotti chimici                           ,0,0,0,0,0,2024
CAM,BN,C 21,Fabbricazione di prodotti farmaceutici di base e di prepa...,0,0,0,0,0,2024
CAM,BN,C 22,Fabbricazione di articoli in gomma e materie plastiche      ,0,0,1,0,1,2024
CAM,BN,C 23,Fabbricazione di altri prodotti della lavorazione di miner..,1,0,4,1,6,2024
CAM,BN,C 24,Metallurgia                                                 ,1,0,0,0,1,2024
CAM,BN,C 25,Fabbricazione di prodotti in metallo (esclusi macchinari ...,3,2,9,2,16,2024
CAM,BN,C 26,Fabbricazione di computer e prodotti di elettronica e ott...,0,0,2,0,2,2024
CAM,BN,C 27,Fabbricazione di apparecchiature elettriche ed apparecchi...,0,0,3,3,6,2024
CAM,BN,C 28,Fabbricazione di macchinari ed apparecchiature nca          ,0,0,1,0,1,2024
CAM,BN,C 29,"Fabbricazione di autoveicoli, rimorchi e semirimorchi       ",0,1,2,2,5,2024
CAM,BN,C 30,Fabbricazione di altri mezzi di trasporto                   ,0,0,0,0,0,2024
CAM,BN,C 31,Fabbricazione di mobili                                     ,1,0,2,0,3,2024
CAM,BN,C 32,Altre industrie manifatturiere                              ,0,0,3,0,3,2024
CAM,BN,C 33,"Riparazione, manutenzione ed installazione di macchine ed...",1,1,1,1,4,2024
CAM,BN,D   ,"Fornitura di energia elettrica, gas, vapore e aria condiz...",0,0,0,0,0,2024
CAM,BN,D 35,"Fornitura di energia elettrica, gas, vapore e aria condiz...",0,0,0,0,0,2024
CAM,BN,E   ,"Fornitura di acqua; reti fognarie, attività di gestione d...",0,1,0,1,2,2024
CAM,BN,E 36,"Raccolta, trattamento e fornitura di acqua                  ",0,0,0,0,0,2024
CAM,BN,E 37,Gestione delle reti fognarie                                ,0,0,0,0,0,2024
CAM,BN,E 38,"Attività di raccolta, trattamento e smaltimento dei rifiu...",0,1,0,1,2,2024
CAM,BN,E 39,Attività di risanamento e altri servizi di gestione dei r...,0,0,0,0,0,2024
CAM,BN,F   ,Costruzioni                                                 ,16,19,146,26,207,2024
CAM,BN,F 41,Costruzione di edifici                                      ,12,11,81,21,125,2024
CAM,BN,F 42,Ingegneria civile                                           ,1,0,1,1,3,2024
CAM,BN,F 43,Lavori di costruzione specializzati                         ,3,8,64,4,79,2024
CAM,BN,G   ,Commercio all'ingrosso e al dettaglio; riparazione di aut...,50,25,351,5,431,2024
CAM,BN,G 45,Commercio all'ingrosso e al dettaglio e riparazione di au...,6,5,37,0,48,2024
CAM,BN,G 46,Commercio all'ingrosso (escluso quello di autoveicoli e d...,16,5,68,2,91,2024
CAM,BN,G 47,Commercio al dettaglio (escluso quello di autoveicoli e d...,28,15,246,3,292,2024
CAM,BN,H   ,Trasporto e magazzinaggio                                   ,3,7,30,8,48,2024
CAM,BN,H 49,Trasporto terrestre e mediante condotte                     ,1,7,27,3,38,2024
CAM,BN,H 50,Trasporto marittimo e per vie d'acqua                       ,0,0,0,0,0,2024
CAM,BN,H 51,Trasporto aereo                                             ,0,0,0,0,0,2024
CAM,BN,H 52,Magazzinaggio e attività di supporto ai trasporti           ,2,0,3,5,10,2024
CAM,BN,H 53,Servizi postali e attività di corriere                      ,0,0,0,0,0,2024
CAM,BN,I   ,Attività dei servizi alloggio e ristorazione                ,10,28,85,4,127,2024
CAM,BN,I 55,Alloggio                                                    ,1,0,3,0,4,2024
CAM,BN,I 56,Attività dei servizi di ristorazione                        ,9,28,82,4,123,2024
CAM,BN,J   ,Servizi di informazione e comunicazione                     ,2,3,16,5,26,2024
CAM,BN,J 58,Attività editoriali                                         ,0,0,2,2,4,2024
CAM,BN,J 59,"Attività di produzione cinematografica, di video e di pro...",0,0,1,0,1,2024
CAM,BN,J 60,Attività di programmazione e trasmissione                   ,0,1,0,0,1,2024
CAM,BN,J 61,Telecomunicazioni                                           ,0,0,2,0,2,2024
CAM,BN,J 62,"Produzione di software, consulenza informatica e attività...",0,1,4,0,5,2024
CAM,BN,J 63,Attività dei servizi d'informazione e altri servizi infor...,2,1,7,3,13,2024
CAM,BN,K   ,Attività finanziarie e assicurative                         ,1,1,16,3,21,2024
CAM,BN,K 64,Attività di servizi finanziari (escluse le assicurazioni ...,1,0,0,1,2,2024
CAM,BN,K 65,"Assicurazioni, riassicurazioni e fondi pensione (escluse ...",0,0,0,0,0,2024
CAM,BN,K 66,Attività ausiliarie dei servizi finanziari e delle attivi...,0,1,16,2,19,2024
CAM,BN,L   ,Attivita' immobiliari                                       ,4,1,8,0,13,2024
CAM,BN,L 68,Attivita' immobiliari                                       ,4,1,8,0,13,2024
CAM,BN,M   ,"Attività professionali, scientifiche e tecniche             ",4,5,15,4,28,2024
CAM,BN,M 69,Attività legali e contabilità                               ,2,2,0,0,4,2024
CAM,BN,M 70,Attività di direzione aziendale e di consulenza gestional...,2,0,1,2,5,2024
CAM,BN,M 71,Attività degli studi di architettura e d'ingegneria; coll...,0,1,0,0,1,2024
CAM,BN,M 72,Ricerca scientifica e sviluppo                              ,0,0,0,0,0,2024
CAM,BN,M 73,Pubblicità e ricerche di mercato                            ,0,0,6,0,6,2024
CAM,BN,M 74,"Altre attività professionali, scientifiche e tecniche       ",0,2,8,2,12,2024
CAM,BN,M 75,Servizi veterinari                                          ,0,0,0,0,0,2024
CAM,BN,N   ,"Noleggio, agenzie di viaggio, servizi di supporto alle im...",1,5,22,15,43,2024
CAM,BN,N 77,Attività di noleggio e leasing operativo                    ,0,0,3,0,3,2024
CAM,BN,N 78,"Attività di ricerca, selezione, fornitura di personale      ",0,0,0,0,0,2024
CAM,BN,N 79,"Attività dei servizi delle agenzie di viaggio, dei tour o...",0,0,1,0,1,2024
CAM,BN,N 80,Servizi di vigilanza e investigazione                       ,0,0,0,0,0,2024
CAM,BN,N 81,Attività di servizi per edifici e paesaggio                 ,0,3,8,8,19,2024
CAM,BN,N 82,Attività di supporto per le funzioni d'ufficio e altri se...,1,2,10,7,20,2024
CAM,BN,O   ,Amministrazione pubblica e difesa; assicurazione sociale ...,0,0,0,0,0,2024
CAM,BN,O 84,Amministrazione pubblica e difesa; assicurazione sociale ...,0,0,0,0,0,2024
CAM,BN,P   ,Istruzione                                                  ,2,1,2,4,9,2024
CAM,BN,P 85,Istruzione                                                  ,2,1,2,4,9,2024
CAM,BN,Q   ,Sanita' e assistenza sociale                                ,0,0,1,14,15,2024
CAM,BN,Q 86,Assistenza sanitaria                                        ,0,0,1,1,2,2024
CAM,BN,Q 87,Servizi di assistenza sociale residenziale                  ,0,0,0,4,4,2024
CAM,BN,Q 88,Assistenza sociale non residenziale                         ,0,0,0,9,9,2024
CAM,BN,R   ,"Attività artistiche, sportive, di intrattenimento e diver...",1,2,14,2,19,2024
CAM,BN,R 90,"Attività creative, artistiche e di intrattenimento          ",0,0,3,1,4,2024
CAM,BN,R 91,"Attività di biblioteche, archivi, musei ed altre attività...",0,0,0,0,0,2024
CAM,BN,R 92,"Attività riguardanti le lotterie, le scommesse, le case d...",0,0,0,0,0,2024
CAM,BN,R 93,"Attività sportive, di intrattenimento e di divertimento     ",1,2,11,1,15,2024
CAM,BN,S   ,Altre attività di servizi                                   ,4,4,32,1,41,2024
CAM,BN,S 94,Attività di organizzazioni associative                      ,0,0,0,0,0,2024
CAM,BN,S 95,Riparazione di computer e di beni per uso personale e per...,1,0,9,0,10,2024
CAM,BN,S 96,Altre attività di servizi per la persona                    ,3,4,23,1,31,2024
CAM,BN,T   ,Attività di famiglie e convivenze come datori di lavoro p...,0,0,0,0,0,2024
CAM,BN,T 97,Attività di famiglie e convivenze come datori di lavoro p...,0,0,0,0,0,2024
CAM,BN,T 98,Produzione di beni e servizi indifferenziati per uso prop...,0,0,0,0,0,2024
CAM,BN,U   ,Organizzazioni ed organismi extraterritoriali               ,0,0,0,0,0,2024
CAM,BN,U 99,Organizzazioni ed organismi extraterritoriali               ,0,0,0,0,0,2024
CAM,BN,XX  ,Imprese non classificate                                    ,21,82,60,39,202,2024
CAM,BN,TOT ,TOTALE                                                      ,133,200,1060,157,1550,2024
CAM,NA,A   ,"Agricoltura, silvicoltura pesca                             ",22,1,62,40,125,2024
CAM,NA,A 01,"Coltivazioni agricole e produzione di prodotti animali, c...",20,1,57,15,93,2024
CAM,NA,A 02,Silvicoltura ed utilizzo di aree forestali                  ,0,0,2,0,2,2024
CAM,NA,A 03,Pesca e acquacoltura                                        ,2,0,3,25,30,2024
CAM,NA,B   ,Estrazione di minerali da cave e miniere                    ,0,0,0,0,0,2024
CAM,NA,B 05,Estrazione di carbone (esclusa torba)                       ,0,0,0,0,0,2024
CAM,NA,B 06,Estraz.di petrolio greggio e di gas naturale                ,0,0,0,0,0,2024
CAM,NA,B 07,Estrazione di minerali metalliferi                          ,0,0,0,0,0,2024
CAM,NA,B 08,Altre attività di estrazione di minerali da cave e miniere  ,0,0,0,0,0,2024
CAM,NA,B 09,Attività dei servizi di supporto all'estrazione             ,0,0,0,0,0,2024
CAM,NA,C   ,Attività manifatturiere                                     ,762,53,206,41,1062,2024
CAM,NA,C 10,Industrie alimentari                                        ,59,5,24,6,94,2024
CAM,NA,C 11,Industria delle bevande                                     ,4,1,6,0,11,2024
CAM,NA,C 12,Industria del tabacco                                       ,0,0,0,0,0,2024
CAM,NA,C 13,Industrie tessili                                           ,9,1,3,0,13,2024
CAM,NA,C 14,Confezione di articoli di abbigliamento; confezione di ar...,135,3,55,2,195,2024
CAM,NA,C 15,Fabbricazione di articoli in pelle e simili                 ,86,11,10,3,110,2024
CAM,NA,C 16,Industria del legno e dei prodotti in legno e sughero (es...,23,2,18,0,43,2024
CAM,NA,C 17,Fabbricazione di carta e di prodotti di carta               ,15,2,1,1,19,2024
CAM,NA,C 18,Stampa e riproduzione di supporti registrati                ,26,1,3,2,32,2024
CAM,NA,C 19,Fabbricazione di coke e prodotti derivanti dalla raffinaz...,5,0,0,0,5,2024
CAM,NA,C 20,Fabbricazione di prodotti chimici                           ,14,1,1,0,16,2024
CAM,NA,C 21,Fabbricazione di prodotti farmaceutici di base e di prepa...,5,0,0,0,5,2024
CAM,NA,C 22,Fabbricazione di articoli in gomma e materie plastiche      ,19,0,2,1,22,2024
CAM,NA,C 23,Fabbricazione di altri prodotti della lavorazione di miner..,26,2,8,2,38,2024
CAM,NA,C 24,Metallurgia                                                 ,15,0,2,1,18,2024
CAM,NA,C 25,Fabbricazione di prodotti in metallo (esclusi macchinari ...,120,6,36,15,177,2024
CAM,NA,C 26,Fabbricazione di computer e prodotti di elettronica e ott...,26,0,0,1,27,2024
CAM,NA,C 27,Fabbricazione di apparecchiature elettriche ed apparecchi...,15,3,1,0,19,2024
CAM,NA,C 28,Fabbricazione di macchinari ed apparecchiature nca          ,37,3,1,1,42,2024
CAM,NA,C 29,"Fabbricazione di autoveicoli, rimorchi e semirimorchi       ",5,1,0,0,6,2024
CAM,NA,C 30,Fabbricazione di altri mezzi di trasporto                   ,29,0,3,0,32,2024
CAM,NA,C 31,Fabbricazione di mobili                                     ,24,4,4,1,33,2024
CAM,NA,C 32,Altre industrie manifatturiere                              ,23,6,15,2,46,2024
CAM,NA,C 33,"Riparazione, manutenzione ed installazione di macchine ed...",42,1,13,3,59,2024
CAM,NA,D   ,"Fornitura di energia elettrica, gas, vapore e aria condiz...",10,0,0,2,12,2024
CAM,NA,D 35,"Fornitura di energia elettrica, gas, vapore e aria condiz...",10,0,0,2,12,2024
CAM,NA,E   ,"Fornitura di acqua; reti fognarie, attività di gestione d...",19,0,1,7,27,2024
CAM,NA,E 36,"Raccolta, trattamento e fornitura di acqua                  ",0,0,0,1,1,2024
CAM,NA,E 37,Gestione delle reti fognarie                                ,0,0,1,1,2,2024
CAM,NA,E 38,"Attività di raccolta, trattamento e smaltimento dei rifiu...",18,0,0,4,22,2024
CAM,NA,E 39,Attività di risanamento e altri servizi di gestione dei r...,1,0,0,1,2,2024
CAM,NA,F   ,Costruzioni                                                 ,801,44,462,243,1550,2024
CAM,NA,F 41,Costruzione di edifici                                      ,518,28,158,172,876,2024
CAM,NA,F 42,Ingegneria civile                                           ,21,2,3,11,37,2024
CAM,NA,F 43,Lavori di costruzione specializzati                         ,262,14,301,60,637,2024
CAM,NA,G   ,Commercio all'ingrosso e al dettaglio; riparazione di aut...,1813,212,1865,26,3916,2024
CAM,NA,G 45,Commercio all'ingrosso e al dettaglio e riparazione di au...,158,20,81,5,264,2024
CAM,NA,G 46,Commercio all'ingrosso (escluso quello di autoveicoli e d...,947,91,404,14,1456,2024
CAM,NA,G 47,Commercio al dettaglio (escluso quello di autoveicoli e d...,708,101,1380,7,2196,2024
CAM,NA,H   ,Trasporto e magazzinaggio                                   ,178,20,111,150,459,2024
CAM,NA,H 49,Trasporto terrestre e mediante condotte                     ,102,17,94,67,280,2024
CAM,NA,H 50,Trasporto marittimo e per vie d'acqua                       ,11,2,0,0,13,2024
CAM,NA,H 51,Trasporto aereo                                             ,0,0,0,0,0,2024
CAM,NA,H 52,Magazzinaggio e attività di supporto ai trasporti           ,51,1,12,80,144,2024
CAM,NA,H 53,Servizi postali e attività di corriere                      ,14,0,5,3,22,2024
CAM,NA,I   ,Attività dei servizi alloggio e ristorazione                ,339,60,148,10,557,2024
CAM,NA,I 55,Alloggio                                                    ,53,3,5,2,63,2024
CAM,NA,I 56,Attività dei servizi di ristorazione                        ,286,57,143,8,494,2024
CAM,NA,J   ,Servizi di informazione e comunicazione                     ,205,8,39,20,272,2024
CAM,NA,J 58,Attività editoriali                                         ,20,2,2,5,29,2024
CAM,NA,J 59,"Attività di produzione cinematografica, di video e di pro...",10,0,4,1,15,2024
CAM,NA,J 60,Attività di programmazione e trasmissione                   ,7,1,0,1,9,2024
CAM,NA,J 61,Telecomunicazioni                                           ,31,0,13,0,44,2024
CAM,NA,J 62,"Produzione di software, consulenza informatica e attività...",87,3,7,5,102,2024
CAM,NA,J 63,Attività dei servizi d'informazione e altri servizi infor...,50,2,13,8,73,2024
CAM,NA,K   ,Attività finanziarie e assicurative                         ,95,8,19,5,127,2024
CAM,NA,K 64,Attività di servizi finanziari (escluse le assicurazioni ...,28,0,0,1,29,2024
CAM,NA,K 65,"Assicurazioni, riassicurazioni e fondi pensione (escluse ...",4,0,0,0,4,2024
CAM,NA,K 66,Attività ausiliarie dei servizi finanziari e delle attivi...,63,8,19,4,94,2024
CAM,NA,L   ,Attivita' immobiliari                                       ,143,8,12,6,169,2024
CAM,NA,L 68,Attivita' immobiliari                                       ,143,8,12,6,169,2024
CAM,NA,M   ,"Attività professionali, scientifiche e tecniche             ",209,12,52,27,300,2024
CAM,NA,M 69,Attività legali e contabilità                               ,12,0,2,0,14,2024
CAM,NA,M 70,Attività di direzione aziendale e di consulenza gestional...,51,1,7,9,68,2024
CAM,NA,M 71,Attività degli studi di architettura e d'ingegneria; coll...,32,0,1,4,37,2024
CAM,NA,M 72,Ricerca scientifica e sviluppo                              ,5,0,1,1,7,2024
CAM,NA,M 73,Pubblicità e ricerche di mercato                            ,43,6,18,1,68,2024
CAM,NA,M 74,"Altre attività professionali, scientifiche e tecniche       ",66,5,23,12,106,2024
CAM,NA,M 75,Servizi veterinari                                          ,0,0,0,0,0,2024
CAM,NA,N   ,"Noleggio, agenzie di viaggio, servizi di supporto alle im...",276,14,70,60,420,2024
CAM,NA,N 77,Attività di noleggio e leasing operativo                    ,30,3,11,0,44,2024
CAM,NA,N 78,"Attività di ricerca, selezione, fornitura di personale      ",2,0,0,0,2,2024
CAM,NA,N 79,"Attività dei servizi delle agenzie di viaggio, dei tour o...",38,0,3,2,43,2024
CAM,NA,N 80,Servizi di vigilanza e investigazione                       ,11,0,0,2,13,2024
CAM,NA,N 81,Attività di servizi per edifici e paesaggio                 ,70,4,17,36,127,2024
CAM,NA,N 82,Attività di supporto per le funzioni d'ufficio e altri se...,125,7,39,20,191,2024
CAM,NA,O   ,Amministrazione pubblica e difesa; assicurazione sociale ...,0,0,0,0,0,2024
CAM,NA,O 84,Amministrazione pubblica e difesa; assicurazione sociale ...,0,0,0,0,0,2024
CAM,NA,P   ,Istruzione                                                  ,29,1,2,8,40,2024
CAM,NA,P 85,Istruzione                                                  ,29,1,2,8,40,2024
CAM,NA,Q   ,Sanita' e assistenza sociale                                ,45,1,1,63,110,2024
CAM,NA,Q 86,Assistenza sanitaria                                        ,38,0,0,14,52,2024
CAM,NA,Q 87,Servizi di assistenza sociale residenziale                  ,4,1,0,14,19,2024
CAM,NA,Q 88,Assistenza sociale non residenziale                         ,3,0,1,35,39,2024
CAM,NA,R   ,"Attività artistiche, sportive, di intrattenimento e diver...",111,1,27,9,148,2024
CAM,NA,R 90,"Attività creative, artistiche e di intrattenimento          ",18,0,4,5,27,2024
CAM,NA,R 91,"Attività di biblioteche, archivi, musei ed altre attività...",0,0,0,1,1,2024
CAM,NA,R 92,"Attività riguardanti le lotterie, le scommesse, le case d...",26,0,8,0,34,2024
CAM,NA,R 93,"Attività sportive, di intrattenimento e di divertimento     ",67,1,15,3,86,2024
CAM,NA,S   ,Altre attività di servizi                                   ,92,11,85,21,209,2024
CAM,NA,S 94,Attività di organizzazioni associative                      ,2,1,0,4,7,2024
CAM,NA,S 95,Riparazione di computer e di beni per uso personale e per...,9,0,21,0,30,2024
CAM,NA,S 96,Altre attività di servizi per la persona                    ,81,10,64,17,172,2024
CAM,NA,T   ,Attività di famiglie e convivenze come datori di lavoro p...,0,0,0,0,0,2024
CAM,NA,T 97,Attività di famiglie e convivenze come datori di lavoro p...,0,0,0,0,0,2024
CAM,NA,T 98,Produzione di beni e servizi indifferenziati per uso prop...,0,0,0,0,0,2024
CAM,NA,U   ,Organizzazioni ed organismi extraterritoriali               ,0,0,0,0,0,2024
CAM,NA,U 99,Organizzazioni ed organismi extraterritoriali               ,0,0,0,0,0,2024
CAM,NA,XX  ,Imprese non classificate                                    ,1000,44,858,104,2006,2024
CAM,NA,TOT ,TOTALE                                                      ,6149,498,4020,842,11509,2024
CAM,AV,A   ,"Agricoltura, silvicoltura pesca                             ",1,2,84,13,100,2024
CAM,AV,A 01,"Coltivazioni agricole e produzione di prodotti animali, c...",0,2,84,13,99,2024
CAM,AV,A 02,Silvicoltura ed utilizzo di aree forestali                  ,1,0,0,0,1,2024
CAM,AV,A 03,Pesca e acquacoltura                                        ,0,0,0,0,0,2024
CAM,AV,B   ,Estrazione di minerali da cave e miniere                    ,0,0,0,0,0,2024
CAM,AV,B 05,Estrazione di carbone (esclusa torba)                       ,0,0,0,0,0,2024
CAM,AV,B 06,Estraz.di petrolio greggio e di gas naturale                ,0,0,0,0,0,2024
CAM,AV,B 07,Estrazione di minerali metalliferi                          ,0,0,0,0,0,2024
CAM,AV,B 08,Altre attività di estrazione di minerali da cave e miniere  ,0,0,0,0,0,2024
CAM,AV,B 09,Attività dei servizi di supporto all'estrazione             ,0,0,0,0,0,2024
CAM,AV,C   ,Attività manifatturiere                                     ,21,13,58,17,109,2024
CAM,AV,C 10,Industrie alimentari                                        ,0,3,5,2,10,2024
CAM,AV,C 11,Industria delle bevande                                     ,0,0,0,0,0,2024
CAM,AV,C 12,Industria del tabacco                                       ,0,0,0,0,0,2024
CAM,AV,C 13,Industrie tessili                                           ,0,1,0,0,1,2024
CAM,AV,C 14,Confezione di articoli di abbigliamento; confezione di ar...,3,1,9,5,18,2024
CAM,AV,C 15,Fabbricazione di articoli in pelle e simili                 ,8,3,17,4,32,2024
CAM,AV,C 16,Industria del legno e dei prodotti in legno e sughero (es...,2,1,1,1,5,2024
CAM,AV,C 17,Fabbricazione di carta e di prodotti di carta               ,0,0,0,0,0,2024
CAM,AV,C 18,Stampa e riproduzione di supporti registrati                ,1,0,0,0,1,2024
CAM,AV,C 19,Fabbricazione di coke e prodotti derivanti dalla raffinaz...,0,0,0,0,0,2024
CAM,AV,C 20,Fabbricazione di prodotti chimici                           ,0,0,0,0,0,2024
CAM,AV,C 21,Fabbricazione di prodotti farmaceutici di base e di prepa...,0,0,0,0,0,2024
CAM,AV,C 22,Fabbricazione di articoli in gomma e materie plastiche      ,0,0,0,0,0,2024
CAM,AV,C 23,Fabbricazione di altri prodotti della lavorazione di miner..,1,1,3,0,5,2024
CAM,AV,C 24,Metallurgia                                                 ,0,0,0,0,0,2024
CAM,AV,C 25,Fabbricazione di prodotti in metallo (esclusi macchinari ...,1,3,10,2,16,2024
CAM,AV,C 26,Fabbricazione di computer e prodotti di elettronica e ott...,0,0,0,0,0,2024
CAM,AV,C 27,Fabbricazione di apparecchiature elettriche ed apparecchi...,2,0,0,0,2,2024
CAM,AV,C 28,Fabbricazione di macchinari ed apparecchiature nca          ,2,0,2,0,4,2024
CAM,AV,C 29,"Fabbricazione di autoveicoli, rimorchi e semirimorchi       ",0,0,0,0,0,2024
CAM,AV,C 30,Fabbricazione di altri mezzi di trasporto                   ,0,0,0,0,0,2024
CAM,AV,C 31,Fabbricazione di mobili                                     ,0,0,2,0,2,2024
CAM,AV,C 32,Altre industrie manifatturiere                              ,0,0,3,2,5,2024
CAM,AV,C 33,"Riparazione, manutenzione ed installazione di macchine ed...",1,0,6,1,8,2024
CAM,AV,D   ,"Fornitura di energia elettrica, gas, vapore e aria condiz...",1,0,0,0,1,2024
CAM,AV,D 35,"Fornitura di energia elettrica, gas, vapore e aria condiz...",1,0,0,0,1,2024
CAM,AV,E   ,"Fornitura di acqua; reti fognarie, attività di gestione d...",0,0,0,1,1,2024
CAM,AV,E 36,"Raccolta, trattamento e fornitura di acqua                  ",0,0,0,0,0,2024
CAM,AV,E 37,Gestione delle reti fognarie                                ,0,0,0,0,0,2024
CAM,AV,E 38,"Attività di raccolta, trattamento e smaltimento dei rifiu...",0,0,0,0,0,2024
CAM,AV,E 39,Attività di risanamento e altri servizi di gestione dei r...,0,0,0,1,1,2024
CAM,AV,F   ,Costruzioni                                                 ,20,14,59,35,128,2024
CAM,AV,F 41,Costruzione di edifici                                      ,13,6,25,19,63,2024
CAM,AV,F 42,Ingegneria civile                                           ,0,0,0,2,2,2024
CAM,AV,F 43,Lavori di costruzione specializzati                         ,7,8,34,14,63,2024
CAM,AV,G   ,Commercio all'ingrosso e al dettaglio; riparazione di aut...,29,15,165,8,217,2024
CAM,AV,G 45,Commercio all'ingrosso e al dettaglio e riparazione di au...,1,4,22,2,29,2024
CAM,AV,G 46,Commercio all'ingrosso (escluso quello di autoveicoli e d...,10,6,39,5,60,2024
CAM,AV,G 47,Commercio al dettaglio (escluso quello di autoveicoli e d...,18,5,104,1,128,2024
CAM,AV,H   ,Trasporto e magazzinaggio                                   ,0,2,11,19,32,2024
CAM,AV,H 49,Trasporto terrestre e mediante condotte                     ,0,1,8,5,14,2024
CAM,AV,H 50,Trasporto marittimo e per vie d'acqua                       ,0,0,0,0,0,2024
CAM,AV,H 51,Trasporto aereo                                             ,0,0,0,0,0,2024
CAM,AV,H 52,Magazzinaggio e attività di supporto ai trasporti           ,0,0,2,13,15,2024
CAM,AV,H 53,Servizi postali e attività di corriere                      ,0,1,1,1,3,2024
CAM,AV,I   ,Attività dei servizi alloggio e ristorazione                ,10,18,38,5,71,2024
CAM,AV,I 55,Alloggio                                                    ,1,0,1,1,3,2024
CAM,AV,I 56,Attività dei servizi di ristorazione                        ,9,18,37,4,68,2024
CAM,AV,J   ,Servizi di informazione e comunicazione                     ,2,2,5,5,14,2024
CAM,AV,J 58,Attività editoriali                                         ,0,0,1,2,3,2024
CAM,AV,J 59,"Attività di produzione cinematografica, di video e di pro...",0,1,0,0,1,2024
CAM,AV,J 60,Attività di programmazione e trasmissione                   ,0,0,0,1,1,2024
CAM,AV,J 61,Telecomunicazioni                                           ,1,1,1,0,3,2024
CAM,AV,J 62,"Produzione di software, consulenza informatica e attività...",0,0,2,2,4,2024
CAM,AV,J 63,Attività dei servizi d'informazione e altri servizi infor...,1,0,1,0,2,2024
CAM,AV,K   ,Attività finanziarie e assicurative                         ,0,2,8,2,12,2024
CAM,AV,K 64,Attività di servizi finanziari (escluse le assicurazioni ...,0,0,0,1,1,2024
CAM,AV,K 65,"Assicurazioni, riassicurazioni e fondi pensione (escluse ...",0,1,0,0,1,2024
CAM,AV,K 66,Attività ausiliarie dei servizi finanziari e delle attivi...,0,1,8,1,10,2024
CAM,AV,L   ,Attivita' immobiliari                                       ,5,0,3,1,9,2024
CAM,AV,L 68,Attivita' immobiliari                                       ,5,0,3,1,9,2024
CAM,AV,M   ,"Attività professionali, scientifiche e tecniche             ",9,2,5,7,23,2024
CAM,AV,M 69,Attività legali e contabilità                               ,1,0,0,1,2,2024
CAM,AV,M 70,Attività di direzione aziendale e di consulenza gestional...,1,0,0,4,5,2024
CAM,AV,M 71,Attività degli studi di architettura e d'ingegneria; coll...,5,0,0,1,6,2024
CAM,AV,M 72,Ricerca scientifica e sviluppo                              ,1,0,0,0,1,2024
CAM,AV,M 73,Pubblicità e ricerche di mercato                            ,0,0,1,1,2,2024
CAM,AV,M 74,"Altre attività professionali, scientifiche e tecniche       ",1,2,3,0,6,2024
CAM,AV,M 75,Servizi veterinari                                          ,0,0,1,0,1,2024
CAM,AV,N   ,"Noleggio, agenzie di viaggio, servizi di supporto alle im...",7,3,12,22,44,2024
CAM,AV,N 77,Attività di noleggio e leasing operativo                    ,2,2,3,0,7,2024
CAM,AV,N 78,"Attività di ricerca, selezione, fornitura di personale      ",0,0,0,0,0,2024
CAM,AV,N 79,"Attività dei servizi delle agenzie di viaggio, dei tour o...",0,0,1,0,1,2024
CAM,AV,N 80,Servizi di vigilanza e investigazione                       ,0,0,0,0,0,2024
CAM,AV,N 81,Attività di servizi per edifici e paesaggio                 ,2,0,3,19,24,2024
CAM,AV,N 82,Attività di supporto per le funzioni d'ufficio e altri se...,3,1,5,3,12,2024
CAM,AV,O   ,Amministrazione pubblica e difesa; assicurazione sociale ...,0,0,0,0,0,2024
CAM,AV,O 84,Amministrazione pubblica e difesa; assicurazione sociale ...,0,0,0,0,0,2024
CAM,AV,P   ,Istruzione                                                  ,1,1,0,2,4,2024
CAM,AV,P 85,Istruzione                                                  ,1,1,0,2,4,2024
CAM,AV,Q   ,Sanita' e assistenza sociale                                ,0,0,1,20,21,2024
CAM,AV,Q 86,Assistenza sanitaria                                        ,0,0,0,3,3,2024
CAM,AV,Q 87,Servizi di assistenza sociale residenziale                  ,0,0,1,0,1,2024
CAM,AV,Q 88,Assistenza sociale non residenziale                         ,0,0,0,17,17,2024
CAM,AV,R   ,"Attività artistiche, sportive, di intrattenimento e diver...",7,1,2,7,17,2024
CAM,AV,R 90,"Attività creative, artistiche e di intrattenimento          ",1,0,0,3,4,2024
CAM,AV,R 91,"Attività di biblioteche, archivi, musei ed altre attività...",0,0,0,1,1,2024
CAM,AV,R 92,"Attività riguardanti le lotterie, le scommesse, le case d...",3,0,1,0,4,2024
CAM,AV,R 93,"Attività sportive, di intrattenimento e di divertimento     ",3,1,1,3,8,2024
CAM,AV,S   ,Altre attività di servizi                                   ,3,4,11,1,19,2024
CAM,AV,S 94,Attività di organizzazioni associative                      ,0,0,0,0,0,2024
CAM,AV,S 95,Riparazione di computer e di beni per uso personale e per...,1,1,2,0,4,2024
CAM,AV,S 96,Altre attività di servizi per la persona                    ,2,3,9,1,15,2024
CAM,AV,T   ,Attività di famiglie e convivenze come datori di lavoro p...,0,0,0,0,0,2024
CAM,AV,T 97,Attività di famiglie e convivenze come datori di lavoro p...,0,0,0,0,0,2024
CAM,AV,T 98,Produzione di beni e servizi indifferenziati per uso prop...,0,0,0,0,0,2024
CAM,AV,U   ,Organizzazioni ed organismi extraterritoriali               ,0,0,0,0,0,2024
CAM,AV,U 99,Organizzazioni ed organismi extraterritoriali               ,0,0,0,0,0,2024
CAM,AV,XX  ,Imprese non classificate                                    ,43,41,59,60,203,2024
CAM,AV,TOT ,TOTALE                                                      ,159,120,521,225,1025,2024
CAM,SA,A   ,"Agricoltura, silvicoltura pesca                             ",1,9,12,128,150,2024
CAM,SA,A 01,"Coltivazioni agricole e produzione di prodotti animali, c...",1,8,11,111,131,2024
CAM,SA,A 02,Silvicoltura ed utilizzo di aree forestali                  ,0,0,0,7,7,2024
CAM,SA,A 03,Pesca e acquacoltura                                        ,0,1,1,10,12,2024
CAM,SA,B   ,Estrazione di minerali da cave e miniere                    ,0,0,0,0,0,2024
CAM,SA,B 05,Estrazione di carbone (esclusa torba)                       ,0,0,0,0,0,2024
CAM,SA,B 06,Estraz.di petrolio greggio e di gas naturale                ,0,0,0,0,0,2024
CAM,SA,B 07,Estrazione di minerali metalliferi                          ,0,0,0,0,0,2024
CAM,SA,B 08,Altre attività di estrazione di minerali da cave e miniere  ,0,0,0,0,0,2024
CAM,SA,B 09,Attività dei servizi di supporto all'estrazione             ,0,0,0,0,0,2024
CAM,SA,C   ,Attività manifatturiere                                     ,1,50,49,77,177,2024
CAM,SA,C 10,Industrie alimentari                                        ,0,16,13,16,45,2024
CAM,SA,C 11,Industria delle bevande                                     ,0,0,0,1,1,2024
CAM,SA,C 12,Industria del tabacco                                       ,0,0,0,0,0,2024
CAM,SA,C 13,Industrie tessili                                           ,0,2,0,1,3,2024
CAM,SA,C 14,Confezione di articoli di abbigliamento; confezione di ar...,0,5,1,11,17,2024
CAM,SA,C 15,Fabbricazione di articoli in pelle e simili                 ,0,1,0,2,3,2024
CAM,SA,C 16,Industria del legno e dei prodotti in legno e sughero (es...,0,5,10,4,19,2024
CAM,SA,C 17,Fabbricazione di carta e di prodotti di carta               ,0,1,0,2,3,2024
CAM,SA,C 18,Stampa e riproduzione di supporti registrati                ,0,5,0,5,10,2024
CAM,SA,C 19,Fabbricazione di coke e prodotti derivanti dalla raffinaz...,0,0,0,0,0,2024
CAM,SA,C 20,Fabbricazione di prodotti chimici                           ,0,0,0,1,1,2024
CAM,SA,C 21,Fabbricazione di prodotti farmaceutici di base e di prepa...,0,0,0,0,0,2024
CAM,SA,C 22,Fabbricazione di articoli in gomma e materie plastiche      ,0,0,0,2,2,2024
CAM,SA,C 23,Fabbricazione di altri prodotti della lavorazione di miner..,0,6,1,4,11,2024
CAM,SA,C 24,Metallurgia                                                 ,0,0,0,0,0,2024
CAM,SA,C 25,Fabbricazione di prodotti in metallo (esclusi macchinari ...,0,3,14,16,33,2024
CAM,SA,C 26,Fabbricazione di computer e prodotti di elettronica e ott...,0,1,0,0,1,2024
CAM,SA,C 27,Fabbricazione di apparecchiature elettriche ed apparecchi...,0,0,1,1,2,2024
CAM,SA,C 28,Fabbricazione di macchinari ed apparecchiature nca          ,0,0,1,3,4,2024
CAM,SA,C 29,"Fabbricazione di autoveicoli, rimorchi e semirimorchi       ",0,0,0,1,1,2024
CAM,SA,C 30,Fabbricazione di altri mezzi di trasporto                   ,0,0,0,1,1,2024
CAM,SA,C 31,Fabbricazione di mobili                                     ,0,2,0,2,4,2024
CAM,SA,C 32,Altre industrie manifatturiere                              ,0,2,7,1,10,2024
CAM,SA,C 33,"Riparazione, manutenzione ed installazione di macchine ed...",1,1,1,3,6,2024
CAM,SA,D   ,"Fornitura di energia elettrica, gas, vapore e aria condiz...",0,0,0,1,1,2024
CAM,SA,D 35,"Fornitura di energia elettrica, gas, vapore e aria condiz...",0,0,0,1,1,2024
CAM,SA,E   ,"Fornitura di acqua; reti fognarie, attività di gestione d...",0,0,1,7,8,2024
CAM,SA,E 36,"Raccolta, trattamento e fornitura di acqua                  ",0,0,0,2,2,2024
CAM,SA,E 37,Gestione delle reti fognarie                                ,0,0,1,0,1,2024
CAM,SA,E 38,"Attività di raccolta, trattamento e smaltimento dei rifiu...",0,0,0,5,5,2024
CAM,SA,E 39,Attività di risanamento e altri servizi di gestione dei r...,0,0,0,0,0,2024
CAM,SA,F   ,Costruzioni                                                 ,3,37,65,216,321,2024
CAM,SA,F 41,Costruzione di edifici                                      ,1,23,30,154,208,2024
CAM,SA,F 42,Ingegneria civile                                           ,0,1,0,3,4,2024
CAM,SA,F 43,Lavori di costruzione specializzati                         ,2,13,35,59,109,2024
CAM,SA,G   ,Commercio all'ingrosso e al dettaglio; riparazione di aut...,6,93,96,55,250,2024
CAM,SA,G 45,Commercio all'ingrosso e al dettaglio e riparazione di au...,0,8,26,8,42,2024
CAM,SA,G 46,Commercio all'ingrosso (escluso quello di autoveicoli e d...,4,28,12,22,66,2024
CAM,SA,G 47,Commercio al dettaglio (escluso quello di autoveicoli e d...,2,57,58,25,142,2024
CAM,SA,H   ,Trasporto e magazzinaggio                                   ,1,10,20,122,153,2024
CAM,SA,H 49,Trasporto terrestre e mediante condotte                     ,1,6,19,75,101,2024
CAM,SA,H 50,Trasporto marittimo e per vie d'acqua                       ,0,0,0,3,3,2024
CAM,SA,H 51,Trasporto aereo                                             ,0,0,0,0,0,2024
CAM,SA,H 52,Magazzinaggio e attività di supporto ai trasporti           ,0,2,1,43,46,2024
CAM,SA,H 53,Servizi postali e attività di corriere                      ,0,2,0,1,3,2024
CAM,SA,I   ,Attività dei servizi alloggio e ristorazione                ,1,132,13,25,171,2024
CAM,SA,I 55,Alloggio                                                    ,0,3,1,1,5,2024
CAM,SA,I 56,Attività dei servizi di ristorazione                        ,1,129,12,24,166,2024
CAM,SA,J   ,Servizi di informazione e comunicazione                     ,1,14,3,24,42,2024
CAM,SA,J 58,Attività editoriali                                         ,0,0,1,1,2,2024
CAM,SA,J 59,"Attività di produzione cinematografica, di video e di pro...",0,1,0,0,1,2024
CAM,SA,J 60,Attività di programmazione e trasmissione                   ,0,1,0,1,2,2024
CAM,SA,J 61,Telecomunicazioni                                           ,0,0,0,1,1,2024
CAM,SA,J 62,"Produzione di software, consulenza informatica e attività...",0,5,0,8,13,2024
CAM,SA,J 63,Attività dei servizi d'informazione e altri servizi infor...,1,7,2,13,23,2024
CAM,SA,K   ,Attività finanziarie e assicurative                         ,0,5,2,6,13,2024
CAM,SA,K 64,Attività di servizi finanziari (escluse le assicurazioni ...,0,0,0,4,4,2024
CAM,SA,K 65,"Assicurazioni, riassicurazioni e fondi pensione (escluse ...",0,0,0,0,0,2024
CAM,SA,K 66,Attività ausiliarie dei servizi finanziari e delle attivi...,0,5,2,2,9,2024
CAM,SA,L   ,Attivita' immobiliari                                       ,2,1,0,20,23,2024
CAM,SA,L 68,Attivita' immobiliari                                       ,2,1,0,20,23,2024
CAM,SA,M   ,"Attività professionali, scientifiche e tecniche             ",0,8,2,24,34,2024
CAM,SA,M 69,Attività legali e contabilità                               ,0,0,0,1,1,2024
CAM,SA,M 70,Attività di direzione aziendale e di consulenza gestional...,0,2,0,6,8,2024
CAM,SA,M 71,Attività degli studi di architettura e d'ingegneria; coll...,0,1,0,6,7,2024
CAM,SA,M 72,Ricerca scientifica e sviluppo                              ,0,0,0,0,0,2024
CAM,SA,M 73,Pubblicità e ricerche di mercato                            ,0,1,0,6,7,2024
CAM,SA,M 74,"Altre attività professionali, scientifiche e tecniche       ",0,4,2,5,11,2024
CAM,SA,M 75,Servizi veterinari                                          ,0,0,0,0,0,2024
CAM,SA,N   ,"Noleggio, agenzie di viaggio, servizi di supporto alle im...",2,9,8,115,134,2024
CAM,SA,N 77,Attività di noleggio e leasing operativo                    ,2,4,2,4,12,2024
CAM,SA,N 78,"Attività di ricerca, selezione, fornitura di personale      ",0,1,0,0,1,2024
CAM,SA,N 79,"Attività dei servizi delle agenzie di viaggio, dei tour o...",0,0,0,2,2,2024
CAM,SA,N 80,Servizi di vigilanza e investigazione                       ,0,0,0,3,3,2024
CAM,SA,N 81,Attività di servizi per edifici e paesaggio                 ,0,2,2,88,92,2024
CAM,SA,N 82,Attività di supporto per le funzioni d'ufficio e altri se...,0,2,4,18,24,2024
CAM,SA,O   ,Amministrazione pubblica e difesa; assicurazione sociale ...,0,0,0,0,0,2024
CAM,SA,O 84,Amministrazione pubblica e difesa; assicurazione sociale ...,0,0,0,0,0,2024
CAM,SA,P   ,Istruzione                                                  ,1,2,1,12,16,2024
CAM,SA,P 85,Istruzione                                                  ,1,2,1,12,16,2024
CAM,SA,Q   ,Sanita' e assistenza sociale                                ,0,0,0,46,46,2024
CAM,SA,Q 86,Assistenza sanitaria                                        ,0,0,0,8,8,2024
CAM,SA,Q 87,Servizi di assistenza sociale residenziale                  ,0,0,0,5,5,2024
CAM,SA,Q 88,Assistenza sociale non residenziale                         ,0,0,0,33,33,2024
CAM,SA,R   ,"Attività artistiche, sportive, di intrattenimento e diver...",2,9,0,24,35,2024
CAM,SA,R 90,"Attività creative, artistiche e di intrattenimento          ",0,1,0,9,10,2024
CAM,SA,R 91,"Attività di biblioteche, archivi, musei ed altre attività...",0,0,0,3,3,2024
CAM,SA,R 92,"Attività riguardanti le lotterie, le scommesse, le case d...",1,0,0,3,4,2024
CAM,SA,R 93,"Attività sportive, di intrattenimento e di divertimento     ",1,8,0,9,18,2024
CAM,SA,S   ,Altre attività di servizi                                   ,0,20,21,16,57,2024
CAM,SA,S 94,Attività di organizzazioni associative                      ,0,0,0,0,0,2024
CAM,SA,S 95,Riparazione di computer e di beni per uso personale e per...,0,2,5,1,8,2024
CAM,SA,S 96,Altre attività di servizi per la persona                    ,0,18,16,15,49,2024
CAM,SA,T   ,Attività di famiglie e convivenze come datori di lavoro p...,0,0,0,0,0,2024
CAM,SA,T 97,Attività di famiglie e convivenze come datori di lavoro p...,0,0,0,0,0,2024
CAM,SA,T 98,Produzione di beni e servizi indifferenziati per uso prop...,0,0,0,0,0,2024
CAM,SA,U   ,Organizzazioni ed organismi extraterritoriali               ,0,0,0,0,0,2024
CAM,SA,U 99,Organizzazioni ed organismi extraterritoriali               ,0,0,0,0,0,2024
CAM,SA,XX  ,Imprese non classificate                                    ,5,139,0,276,420,2024
CAM,SA,TOT ,TOTALE                                                      ,26,538,293,1194,2051,2024
PUG,  ,A   ,"Agricoltura, silvicoltura pesca                             ",23,20,1527,315,1885,2024
PUG,  ,A 01,"Coltivazioni agricole e produzione di prodotti animali, c...",20,16,1516,275,1827,2024
PUG,  ,A 02,Silvicoltura ed utilizzo di aree forestali                  ,1,0,2,8,11,2024
PUG,  ,A 03,Pesca e acquacoltura                                        ,2,4,9,32,47,2024
PUG,  ,B   ,Estrazione di minerali da cave e miniere                    ,23,1,2,1,27,2024
PUG,  ,B 05,Estrazione di carbone (esclusa torba)                       ,0,0,0,0,0,2024
PUG,  ,B 06,Estraz.di petrolio greggio e di gas naturale                ,0,0,0,0,0,2024
PUG,  ,B 07,Estrazione di minerali metalliferi                          ,0,0,0,0,0,2024
PUG,  ,B 08,Altre attività di estrazione di minerali da cave e miniere  ,23,1,2,1,27,2024
PUG,  ,B 09,Attività dei servizi di supporto all'estrazione             ,0,0,0,0,0,2024
PUG,  ,C   ,Attività manifatturiere                                     ,224,99,372,192,887,2024
PUG,  ,C 10,Industrie alimentari                                        ,24,20,53,45,142,2024
PUG,  ,C 11,Industria delle bevande                                     ,7,2,5,4,18,2024
PUG,  ,C 12,Industria del tabacco                                       ,0,1,0,0,1,2024
PUG,  ,C 13,Industrie tessili                                           ,7,3,21,4,35,2024
PUG,  ,C 14,Confezione di articoli di abbigliamento; confezione di ar...,36,19,71,28,154,2024
PUG,  ,C 15,Fabbricazione di articoli in pelle e simili                 ,9,3,6,6,24,2024
PUG,  ,C 16,Industria del legno e dei prodotti in legno e sughero (es...,10,9,27,13,59,2024
PUG,  ,C 17,Fabbricazione di carta e di prodotti di carta               ,3,1,3,2,9,2024
PUG,  ,C 18,Stampa e riproduzione di supporti registrati                ,5,6,20,9,40,2024
PUG,  ,C 19,Fabbricazione di coke e prodotti derivanti dalla raffinaz...,1,0,0,1,2,2024
PUG,  ,C 20,Fabbricazione di prodotti chimici                           ,8,0,3,1,12,2024
PUG,  ,C 21,Fabbricazione di prodotti farmaceutici di base e di prepa...,3,0,0,0,3,2024
PUG,  ,C 22,Fabbricazione di articoli in gomma e materie plastiche      ,4,1,2,1,8,2024
PUG,  ,C 23,Fabbricazione di altri prodotti della lavorazione di miner..,21,8,16,14,59,2024
PUG,  ,C 24,Metallurgia                                                 ,2,0,0,0,2,2024
PUG,  ,C 25,Fabbricazione di prodotti in metallo (esclusi macchinari ...,22,11,57,32,122,2024
PUG,  ,C 26,Fabbricazione di computer e prodotti di elettronica e ott...,5,0,2,0,7,2024
PUG,  ,C 27,Fabbricazione di apparecchiature elettriche ed apparecchi...,9,2,1,1,13,2024
PUG,  ,C 28,Fabbricazione di macchinari ed apparecchiature nca          ,11,1,9,4,25,2024
PUG,  ,C 29,"Fabbricazione di autoveicoli, rimorchi e semirimorchi       ",7,0,0,1,8,2024
PUG,  ,C 30,Fabbricazione di altri mezzi di trasporto                   ,1,2,2,3,8,2024
PUG,  ,C 31,Fabbricazione di mobili                                     ,23,5,18,10,56,2024
PUG,  ,C 32,Altre industrie manifatturiere                              ,4,4,31,5,44,2024
PUG,  ,C 33,"Riparazione, manutenzione ed installazione di macchine ed...",2,1,25,8,36,2024
PUG,  ,D   ,"Fornitura di energia elettrica, gas, vapore e aria condiz...",2,0,1,0,3,2024
PUG,  ,D 35,"Fornitura di energia elettrica, gas, vapore e aria condiz...",2,0,1,0,3,2024
PUG,  ,E   ,"Fornitura di acqua; reti fognarie, attività di gestione d...",6,0,8,6,20,2024
PUG,  ,E 36,"Raccolta, trattamento e fornitura di acqua                  ",0,0,1,0,1,2024
PUG,  ,E 37,Gestione delle reti fognarie                                ,1,0,3,0,4,2024
PUG,  ,E 38,"Attività di raccolta, trattamento e smaltimento dei rifiu...",4,0,3,3,10,2024
PUG,  ,E 39,Attività di risanamento e altri servizi di gestione dei r...,1,0,1,3,5,2024
PUG,  ,F   ,Costruzioni                                                 ,204,93,581,783,1661,2024
PUG,  ,F 41,Costruzione di edifici                                      ,132,48,133,488,801,2024
PUG,  ,F 42,Ingegneria civile                                           ,13,2,9,12,36,2024
PUG,  ,F 43,Lavori di costruzione specializzati                         ,59,43,439,283,824,2024
PUG,  ,G   ,Commercio all'ingrosso e al dettaglio; riparazione di aut...,378,182,2023,131,2714,2024
PUG,  ,G 45,Commercio all'ingrosso e al dettaglio e riparazione di au...,45,24,162,17,248,2024
PUG,  ,G 46,Commercio all'ingrosso (escluso quello di autoveicoli e d...,185,51,497,48,781,2024
PUG,  ,G 47,Commercio al dettaglio (escluso quello di autoveicoli e d...,148,107,1364,66,1685,2024
PUG,  ,H   ,Trasporto e magazzinaggio                                   ,53,11,133,309,506,2024
PUG,  ,H 49,Trasporto terrestre e mediante condotte                     ,26,6,99,219,350,2024
PUG,  ,H 50,Trasporto marittimo e per vie d'acqua                       ,2,0,0,1,3,2024
PUG,  ,H 51,Trasporto aereo                                             ,1,0,0,0,1,2024
PUG,  ,H 52,Magazzinaggio e attività di supporto ai trasporti           ,23,5,26,82,136,2024
PUG,  ,H 53,Servizi postali e attività di corriere                      ,1,0,8,7,16,2024
PUG,  ,I   ,Attività dei servizi alloggio e ristorazione                ,77,180,334,85,676,2024
PUG,  ,I 55,Alloggio                                                    ,10,6,17,9,42,2024
PUG,  ,I 56,Attività dei servizi di ristorazione                        ,67,174,317,76,634,2024
PUG,  ,J   ,Servizi di informazione e comunicazione                     ,34,15,73,66,188,2024
PUG,  ,J 58,Attività editoriali                                         ,2,3,11,12,28,2024
PUG,  ,J 59,"Attività di produzione cinematografica, di video e di pro...",5,1,4,2,12,2024
PUG,  ,J 60,Attività di programmazione e trasmissione                   ,1,0,0,4,5,2024
PUG,  ,J 61,Telecomunicazioni                                           ,1,2,18,1,22,2024
PUG,  ,J 62,"Produzione di software, consulenza informatica e attività...",11,4,17,6,38,2024
PUG,  ,J 63,Attività dei servizi d'informazione e altri servizi infor...,14,5,23,41,83,2024
PUG,  ,K   ,Attività finanziarie e assicurative                         ,17,11,119,14,161,2024
PUG,  ,K 64,Attività di servizi finanziari (escluse le assicurazioni ...,12,0,1,12,25,2024
PUG,  ,K 65,"Assicurazioni, riassicurazioni e fondi pensione (escluse ...",0,0,1,0,1,2024
PUG,  ,K 66,Attività ausiliarie dei servizi finanziari e delle attivi...,5,11,117,2,135,2024
PUG,  ,L   ,Attivita' immobiliari                                       ,37,14,30,27,108,2024
PUG,  ,L 68,Attivita' immobiliari                                       ,37,14,30,27,108,2024
PUG,  ,M   ,"Attività professionali, scientifiche e tecniche             ",47,13,136,83,279,2024
PUG,  ,M 69,Attività legali e contabilità                               ,2,0,5,7,14,2024
PUG,  ,M 70,Attività di direzione aziendale e di consulenza gestional...,17,4,20,21,62,2024
PUG,  ,M 71,Attività degli studi di architettura e d'ingegneria; coll...,11,0,8,7,26,2024
PUG,  ,M 72,Ricerca scientifica e sviluppo                              ,2,0,0,3,5,2024
PUG,  ,M 73,Pubblicità e ricerche di mercato                            ,8,5,37,26,76,2024
PUG,  ,M 74,"Altre attività professionali, scientifiche e tecniche       ",7,4,65,19,95,2024
PUG,  ,M 75,Servizi veterinari                                          ,0,0,1,0,1,2024
PUG,  ,N   ,"Noleggio, agenzie di viaggio, servizi di supporto alle im...",38,17,146,309,510,2024
PUG,  ,N 77,Attività di noleggio e leasing operativo                    ,5,2,12,11,30,2024
PUG,  ,N 78,"Attività di ricerca, selezione, fornitura di personale      ",0,0,0,2,2,2024
PUG,  ,N 79,"Attività dei servizi delle agenzie di viaggio, dei tour o...",8,3,6,11,28,2024
PUG,  ,N 80,Servizi di vigilanza e investigazione                       ,5,0,1,17,23,2024
PUG,  ,N 81,Attività di servizi per edifici e paesaggio                 ,6,5,69,202,282,2024
PUG,  ,N 82,Attività di supporto per le funzioni d'ufficio e altri se...,14,7,58,66,145,2024
PUG,  ,O   ,Amministrazione pubblica e difesa; assicurazione sociale ...,0,0,0,0,0,2024
PUG,  ,O 84,Amministrazione pubblica e difesa; assicurazione sociale ...,0,0,0,0,0,2024
PUG,  ,P   ,Istruzione                                                  ,8,0,6,38,52,2024
PUG,  ,P 85,Istruzione                                                  ,8,0,6,38,52,2024
PUG,  ,Q   ,Sanita' e assistenza sociale                                ,1,6,8,107,122,2024
PUG,  ,Q 86,Assistenza sanitaria                                        ,1,4,6,14,25,2024
PUG,  ,Q 87,Servizi di assistenza sociale residenziale                  ,0,0,1,15,16,2024
PUG,  ,Q 88,Assistenza sociale non residenziale                         ,0,2,1,78,81,2024
PUG,  ,R   ,"Attività artistiche, sportive, di intrattenimento e diver...",15,21,40,58,134,2024
PUG,  ,R 90,"Attività creative, artistiche e di intrattenimento          ",4,0,9,27,40,2024
PUG,  ,R 91,"Attività di biblioteche, archivi, musei ed altre attività...",0,0,1,8,9,2024
PUG,  ,R 92,"Attività riguardanti le lotterie, le scommesse, le case d...",3,5,2,0,10,2024
PUG,  ,R 93,"Attività sportive, di intrattenimento e di divertimento     ",8,16,28,23,75,2024
PUG,  ,S   ,Altre attività di servizi                                   ,11,17,221,63,312,2024
PUG,  ,S 94,Attività di organizzazioni associative                      ,0,0,0,2,2,2024
PUG,  ,S 95,Riparazione di computer e di beni per uso personale e per...,2,2,59,8,71,2024
PUG,  ,S 96,Altre attività di servizi per la persona                    ,9,15,162,53,239,2024
PUG,  ,T   ,Attività di famiglie e convivenze come datori di lavoro p...,0,0,0,0,0,2024
PUG,  ,T 97,Attività di famiglie e convivenze come datori di lavoro p...,0,0,0,0,0,2024
PUG,  ,T 98,Produzione di beni e servizi indifferenziati per uso prop...,0,0,0,0,0,2024
PUG,  ,U   ,Organizzazioni ed organismi extraterritoriali               ,0,0,0,0,0,2024
PUG,  ,U 99,Organizzazioni ed organismi extraterritoriali               ,0,0,0,0,0,2024
PUG,  ,XX  ,Imprese non classificate                                    ,244,294,86,954,1578,2024
PUG,  ,TOT ,TOTALE                                                      ,1442,994,5846,3541,11823,2024
PUG,FG,A   ,"Agricoltura, silvicoltura pesca                             ",10,3,81,133,227,2024
PUG,FG,A 01,"Coltivazioni agricole e produzione di prodotti animali, c...",10,3,79,116,208,2024
PUG,FG,A 02,Silvicoltura ed utilizzo di aree forestali                  ,0,0,0,8,8,2024
PUG,FG,A 03,Pesca e acquacoltura                                        ,0,0,2,9,11,2024
PUG,FG,B   ,Estrazione di minerali da cave e miniere                    ,0,1,0,0,1,2024
PUG,FG,B 05,Estrazione di carbone (esclusa torba)                       ,0,0,0,0,0,2024
PUG,FG,B 06,Estraz.di petrolio greggio e di gas naturale                ,0,0,0,0,0,2024
PUG,FG,B 07,Estrazione di minerali metalliferi                          ,0,0,0,0,0,2024
PUG,FG,B 08,Altre attività di estrazione di minerali da cave e miniere  ,0,1,0,0,1,2024
PUG,FG,B 09,Attività dei servizi di supporto all'estrazione             ,0,0,0,0,0,2024
PUG,FG,C   ,Attività manifatturiere                                     ,32,3,14,35,84,2024
PUG,FG,C 10,Industrie alimentari                                        ,6,1,3,10,20,2024
PUG,FG,C 11,Industria delle bevande                                     ,3,1,1,1,6,2024
PUG,FG,C 12,Industria del tabacco                                       ,0,0,0,0,0,2024
PUG,FG,C 13,Industrie tessili                                           ,0,0,0,1,1,2024
PUG,FG,C 14,Confezione di articoli di abbigliamento; confezione di ar...,5,0,0,3,8,2024
PUG,FG,C 15,Fabbricazione di articoli in pelle e simili                 ,0,0,0,0,0,2024
PUG,FG,C 16,Industria del legno e dei prodotti in legno e sughero (es...,1,0,1,1,3,2024
PUG,FG,C 17,Fabbricazione di carta e di prodotti di carta               ,1,0,0,1,2,2024
PUG,FG,C 18,Stampa e riproduzione di supporti registrati                ,1,0,1,2,4,2024
PUG,FG,C 19,Fabbricazione di coke e prodotti derivanti dalla raffinaz...,0,0,0,0,0,2024
PUG,FG,C 20,Fabbricazione di prodotti chimici                           ,1,0,0,0,1,2024
PUG,FG,C 21,Fabbricazione di prodotti farmaceutici di base e di prepa...,0,0,0,0,0,2024
PUG,FG,C 22,Fabbricazione di articoli in gomma e materie plastiche      ,0,0,0,0,0,2024
PUG,FG,C 23,Fabbricazione di altri prodotti della lavorazione di miner..,2,1,0,1,4,2024
PUG,FG,C 24,Metallurgia                                                 ,0,0,0,0,0,2024
PUG,FG,C 25,Fabbricazione di prodotti in metallo (esclusi macchinari ...,2,0,1,9,12,2024
PUG,FG,C 26,Fabbricazione di computer e prodotti di elettronica e ott...,1,0,0,0,1,2024
PUG,FG,C 27,Fabbricazione di apparecchiature elettriche ed apparecchi...,2,0,1,1,4,2024
PUG,FG,C 28,Fabbricazione di macchinari ed apparecchiature nca          ,2,0,0,0,2,2024
PUG,FG,C 29,"Fabbricazione di autoveicoli, rimorchi e semirimorchi       ",1,0,0,1,2,2024
PUG,FG,C 30,Fabbricazione di altri mezzi di trasporto                   ,0,0,1,1,2,2024
PUG,FG,C 31,Fabbricazione di mobili                                     ,2,0,2,2,6,2024
PUG,FG,C 32,Altre industrie manifatturiere                              ,1,0,2,0,3,2024
PUG,FG,C 33,"Riparazione, manutenzione ed installazione di macchine ed...",1,0,1,1,3,2024
PUG,FG,D   ,"Fornitura di energia elettrica, gas, vapore e aria condiz...",1,0,0,0,1,2024
PUG,FG,D 35,"Fornitura di energia elettrica, gas, vapore e aria condiz...",1,0,0,0,1,2024
PUG,FG,E   ,"Fornitura di acqua; reti fognarie, attività di gestione d...",1,0,0,1,2,2024
PUG,FG,E 36,"Raccolta, trattamento e fornitura di acqua                  ",0,0,0,0,0,2024
PUG,FG,E 37,Gestione delle reti fognarie                                ,0,0,0,0,0,2024
PUG,FG,E 38,"Attività di raccolta, trattamento e smaltimento dei rifiu...",1,0,0,1,2,2024
PUG,FG,E 39,Attività di risanamento e altri servizi di gestione dei r...,0,0,0,0,0,2024
PUG,FG,F   ,Costruzioni                                                 ,53,12,27,252,344,2024
PUG,FG,F 41,Costruzione di edifici                                      ,41,8,11,180,240,2024
PUG,FG,F 42,Ingegneria civile                                           ,2,1,2,5,10,2024
PUG,FG,F 43,Lavori di costruzione specializzati                         ,10,3,14,67,94,2024
PUG,FG,G   ,Commercio all'ingrosso e al dettaglio; riparazione di aut...,53,21,75,34,183,2024
PUG,FG,G 45,Commercio all'ingrosso e al dettaglio e riparazione di au...,10,3,11,5,29,2024
PUG,FG,G 46,Commercio all'ingrosso (escluso quello di autoveicoli e d...,25,9,12,16,62,2024
PUG,FG,G 47,Commercio al dettaglio (escluso quello di autoveicoli e d...,18,9,52,13,92,2024
PUG,FG,H   ,Trasporto e magazzinaggio                                   ,10,3,6,153,172,2024
PUG,FG,H 49,Trasporto terrestre e mediante condotte                     ,6,2,5,138,151,2024
PUG,FG,H 50,Trasporto marittimo e per vie d'acqua                       ,1,0,0,0,1,2024
PUG,FG,H 51,Trasporto aereo                                             ,1,0,0,0,1,2024
PUG,FG,H 52,Magazzinaggio e attività di supporto ai trasporti           ,2,1,1,13,17,2024
PUG,FG,H 53,Servizi postali e attività di corriere                      ,0,0,0,2,2,2024
PUG,FG,I   ,Attività dei servizi alloggio e ristorazione                ,10,6,18,31,65,2024
PUG,FG,I 55,Alloggio                                                    ,2,2,0,2,6,2024
PUG,FG,I 56,Attività dei servizi di ristorazione                        ,8,4,18,29,59,2024
PUG,FG,J   ,Servizi di informazione e comunicazione                     ,4,0,2,10,16,2024
PUG,FG,J 58,Attività editoriali                                         ,0,0,0,1,1,2024
PUG,FG,J 59,"Attività di produzione cinematografica, di video e di pro...",0,0,0,0,0,2024
PUG,FG,J 60,Attività di programmazione e trasmissione                   ,0,0,0,0,0,2024
PUG,FG,J 61,Telecomunicazioni                                           ,0,0,0,0,0,2024
PUG,FG,J 62,"Produzione di software, consulenza informatica e attività...",3,0,1,1,5,2024
PUG,FG,J 63,Attività dei servizi d'informazione e altri servizi infor...,1,0,1,8,10,2024
PUG,FG,K   ,Attività finanziarie e assicurative                         ,2,0,4,3,9,2024
PUG,FG,K 64,Attività di servizi finanziari (escluse le assicurazioni ...,1,0,0,3,4,2024
PUG,FG,K 65,"Assicurazioni, riassicurazioni e fondi pensione (escluse ...",0,0,0,0,0,2024
PUG,FG,K 66,Attività ausiliarie dei servizi finanziari e delle attivi...,1,0,4,0,5,2024
PUG,FG,L   ,Attivita' immobiliari                                       ,3,2,0,13,18,2024
PUG,FG,L 68,Attivita' immobiliari                                       ,3,2,0,13,18,2024
PUG,FG,M   ,"Attività professionali, scientifiche e tecniche             ",10,2,1,14,27,2024
PUG,FG,M 69,Attività legali e contabilità                               ,0,0,0,0,0,2024
PUG,FG,M 70,Attività di direzione aziendale e di consulenza gestional...,2,2,0,5,9,2024
PUG,FG,M 71,Attività degli studi di architettura e d'ingegneria; coll...,5,0,0,1,6,2024
PUG,FG,M 72,Ricerca scientifica e sviluppo                              ,1,0,0,0,1,2024
PUG,FG,M 73,Pubblicità e ricerche di mercato                            ,1,0,0,2,3,2024
PUG,FG,M 74,"Altre attività professionali, scientifiche e tecniche       ",1,0,1,6,8,2024
PUG,FG,M 75,Servizi veterinari                                          ,0,0,0,0,0,2024
PUG,FG,N   ,"Noleggio, agenzie di viaggio, servizi di supporto alle im...",8,1,3,72,84,2024
PUG,FG,N 77,Attività di noleggio e leasing operativo                    ,0,0,0,3,3,2024
PUG,FG,N 78,"Attività di ricerca, selezione, fornitura di personale      ",0,0,0,0,0,2024
PUG,FG,N 79,"Attività dei servizi delle agenzie di viaggio, dei tour o...",1,0,0,1,2,2024
PUG,FG,N 80,Servizi di vigilanza e investigazione                       ,2,0,0,10,12,2024
PUG,FG,N 81,Attività di servizi per edifici e paesaggio                 ,2,1,2,45,50,2024
PUG,FG,N 82,Attività di supporto per le funzioni d'ufficio e altri se...,3,0,1,13,17,2024
PUG,FG,O   ,Amministrazione pubblica e difesa; assicurazione sociale ...,0,0,0,0,0,2024
PUG,FG,O 84,Amministrazione pubblica e difesa; assicurazione sociale ...,0,0,0,0,0,2024
PUG,FG,P   ,Istruzione                                                  ,2,0,0,4,6,2024
PUG,FG,P 85,Istruzione                                                  ,2,0,0,4,6,2024
PUG,FG,Q   ,Sanita' e assistenza sociale                                ,0,1,0,27,28,2024
PUG,FG,Q 86,Assistenza sanitaria                                        ,0,1,0,8,9,2024
PUG,FG,Q 87,Servizi di assistenza sociale residenziale                  ,0,0,0,3,3,2024
PUG,FG,Q 88,Assistenza sociale non residenziale                         ,0,0,0,16,16,2024
PUG,FG,R   ,"Attività artistiche, sportive, di intrattenimento e diver...",2,1,2,9,14,2024
PUG,FG,R 90,"Attività creative, artistiche e di intrattenimento          ",0,0,0,4,4,2024
PUG,FG,R 91,"Attività di biblioteche, archivi, musei ed altre attività...",0,0,1,2,3,2024
PUG,FG,R 92,"Attività riguardanti le lotterie, le scommesse, le case d...",1,0,0,0,1,2024
PUG,FG,R 93,"Attività sportive, di intrattenimento e di divertimento     ",1,1,1,3,6,2024
PUG,FG,S   ,Altre attività di servizi                                   ,2,0,14,4,20,2024
PUG,FG,S 94,Attività di organizzazioni associative                      ,0,0,0,0,0,2024
PUG,FG,S 95,Riparazione di computer e di beni per uso personale e per...,0,0,1,0,1,2024
PUG,FG,S 96,Altre attività di servizi per la persona                    ,2,0,13,4,19,2024
PUG,FG,T   ,Attività di famiglie e convivenze come datori di lavoro p...,0,0,0,0,0,2024
PUG,FG,T 97,Attività di famiglie e convivenze come datori di lavoro p...,0,0,0,0,0,2024
PUG,FG,T 98,Produzione di beni e servizi indifferenziati per uso prop...,0,0,0,0,0,2024
PUG,FG,U   ,Organizzazioni ed organismi extraterritoriali               ,0,0,0,0,0,2024
PUG,FG,U 99,Organizzazioni ed organismi extraterritoriali               ,0,0,0,0,0,2024
PUG,FG,XX  ,Imprese non classificate                                    ,82,15,18,264,379,2024
PUG,FG,TOT ,TOTALE                                                      ,285,71,265,1059,1680,2024
PUG,BA,A   ,"Agricoltura, silvicoltura pesca                             ",12,13,1330,37,1392,2024
PUG,BA,A 01,"Coltivazioni agricole e produzione di prodotti animali, c...",9,10,1324,33,1376,2024
PUG,BA,A 02,Silvicoltura ed utilizzo di aree forestali                  ,1,0,2,0,3,2024
PUG,BA,A 03,Pesca e acquacoltura                                        ,2,3,4,4,13,2024
PUG,BA,B   ,Estrazione di minerali da cave e miniere                    ,22,0,1,1,24,2024
PUG,BA,B 05,Estrazione di carbone (esclusa torba)                       ,0,0,0,0,0,2024
PUG,BA,B 06,Estraz.di petrolio greggio e di gas naturale                ,0,0,0,0,0,2024
PUG,BA,B 07,Estrazione di minerali metalliferi                          ,0,0,0,0,0,2024
PUG,BA,B 08,Altre attività di estrazione di minerali da cave e miniere  ,22,0,1,1,24,2024
PUG,BA,B 09,Attività dei servizi di supporto all'estrazione             ,0,0,0,0,0,2024
PUG,BA,C   ,Attività manifatturiere                                     ,171,31,325,49,576,2024
PUG,BA,C 10,Industrie alimentari                                        ,17,9,43,7,76,2024
PUG,BA,C 11,Industria delle bevande                                     ,4,0,4,0,8,2024
PUG,BA,C 12,Industria del tabacco                                       ,0,0,0,0,0,2024
PUG,BA,C 13,Industrie tessili                                           ,7,2,17,0,26,2024
PUG,BA,C 14,Confezione di articoli di abbigliamento; confezione di ar...,25,2,65,10,102,2024
PUG,BA,C 15,Fabbricazione di articoli in pelle e simili                 ,5,2,6,2,15,2024
PUG,BA,C 16,Industria del legno e dei prodotti in legno e sughero (es...,7,2,21,4,34,2024
PUG,BA,C 17,Fabbricazione di carta e di prodotti di carta               ,2,1,2,1,6,2024
PUG,BA,C 18,Stampa e riproduzione di supporti registrati                ,4,2,17,1,24,2024
PUG,BA,C 19,Fabbricazione di coke e prodotti derivanti dalla raffinaz...,1,0,0,1,2,2024
PUG,BA,C 20,Fabbricazione di prodotti chimici                           ,7,0,2,0,9,2024
PUG,BA,C 21,Fabbricazione di prodotti farmaceutici di base e di prepa...,3,0,0,0,3,2024
PUG,BA,C 22,Fabbricazione di articoli in gomma e materie plastiche      ,4,0,2,1,7,2024
PUG,BA,C 23,Fabbricazione di altri prodotti della lavorazione di miner..,19,2,15,4,40,2024
PUG,BA,C 24,Metallurgia                                                 ,2,0,0,0,2,2024
PUG,BA,C 25,Fabbricazione di prodotti in metallo (esclusi macchinari ...,16,4,51,7,78,2024
PUG,BA,C 26,Fabbricazione di computer e prodotti di elettronica e ott...,4,0,2,0,6,2024
PUG,BA,C 27,Fabbricazione di apparecchiature elettriche ed apparecchi...,7,1,0,0,8,2024
PUG,BA,C 28,Fabbricazione di macchinari ed apparecchiature nca          ,9,0,9,2,20,2024
PUG,BA,C 29,"Fabbricazione di autoveicoli, rimorchi e semirimorchi       ",6,0,0,0,6,2024
PUG,BA,C 30,Fabbricazione di altri mezzi di trasporto                   ,0,1,1,0,2,2024
PUG,BA,C 31,Fabbricazione di mobili                                     ,21,2,16,5,44,2024
PUG,BA,C 32,Altre industrie manifatturiere                              ,1,1,28,1,31,2024
PUG,BA,C 33,"Riparazione, manutenzione ed installazione di macchine ed...",0,0,24,3,27,2024
PUG,BA,D   ,"Fornitura di energia elettrica, gas, vapore e aria condiz...",1,0,1,0,2,2024
PUG,BA,D 35,"Fornitura di energia elettrica, gas, vapore e aria condiz...",1,0,1,0,2,2024
PUG,BA,E   ,"Fornitura di acqua; reti fognarie, attività di gestione d...",4,0,5,2,11,2024
PUG,BA,E 36,"Raccolta, trattamento e fornitura di acqua                  ",0,0,0,0,0,2024
PUG,BA,E 37,Gestione delle reti fognarie                                ,1,0,3,0,4,2024
PUG,BA,E 38,"Attività di raccolta, trattamento e smaltimento dei rifiu...",2,0,1,0,3,2024
PUG,BA,E 39,Attività di risanamento e altri servizi di gestione dei r...,1,0,1,2,4,2024
PUG,BA,F   ,Costruzioni                                                 ,118,15,494,157,784,2024
PUG,BA,F 41,Costruzione di edifici                                      ,75,5,105,120,305,2024
PUG,BA,F 42,Ingegneria civile                                           ,9,0,7,4,20,2024
PUG,BA,F 43,Lavori di costruzione specializzati                         ,34,10,382,33,459,2024
PUG,BA,G   ,Commercio all'ingrosso e al dettaglio; riparazione di aut...,279,72,1667,23,2041,2024
PUG,BA,G 45,Commercio all'ingrosso e al dettaglio e riparazione di au...,30,8,137,2,177,2024
PUG,BA,G 46,Commercio all'ingrosso (escluso quello di autoveicoli e d...,142,25,444,11,622,2024
PUG,BA,G 47,Commercio al dettaglio (escluso quello di autoveicoli e d...,107,39,1086,10,1242,2024
PUG,BA,H   ,Trasporto e magazzinaggio                                   ,42,7,117,97,263,2024
PUG,BA,H 49,Trasporto terrestre e mediante condotte                     ,19,3,87,51,160,2024
PUG,BA,H 50,Trasporto marittimo e per vie d'acqua                       ,1,0,0,0,1,2024
PUG,BA,H 51,Trasporto aereo                                             ,0,0,0,0,0,2024
PUG,BA,H 52,Magazzinaggio e attività di supporto ai trasporti           ,21,4,24,46,95,2024
PUG,BA,H 53,Servizi postali e attività di corriere                      ,1,0,6,0,7,2024
PUG,BA,I   ,Attività dei servizi alloggio e ristorazione                ,43,56,263,14,376,2024
PUG,BA,I 55,Alloggio                                                    ,5,0,13,3,21,2024
PUG,BA,I 56,Attività dei servizi di ristorazione                        ,38,56,250,11,355,2024
PUG,BA,J   ,Servizi di informazione e comunicazione                     ,24,6,61,20,111,2024
PUG,BA,J 58,Attività editoriali                                         ,1,1,7,5,14,2024
PUG,BA,J 59,"Attività di produzione cinematografica, di video e di pro...",5,1,3,1,10,2024
PUG,BA,J 60,Attività di programmazione e trasmissione                   ,1,0,0,3,4,2024
PUG,BA,J 61,Telecomunicazioni                                           ,1,1,18,0,20,2024
PUG,BA,J 62,"Produzione di software, consulenza informatica e attività...",7,1,14,2,24,2024
PUG,BA,J 63,Attività dei servizi d'informazione e altri servizi infor...,9,2,19,9,39,2024
PUG,BA,K   ,Attività finanziarie e assicurative                         ,14,4,103,6,127,2024
PUG,BA,K 64,Attività di servizi finanziari (escluse le assicurazioni ...,10,0,1,5,16,2024
PUG,BA,K 65,"Assicurazioni, riassicurazioni e fondi pensione (escluse ...",0,0,0,0,0,2024
PUG,BA,K 66,Attività ausiliarie dei servizi finanziari e delle attivi...,4,4,102,1,111,2024
PUG,BA,L   ,Attivita' immobiliari                                       ,29,5,28,10,72,2024
PUG,BA,L 68,Attivita' immobiliari                                       ,29,5,28,10,72,2024
PUG,BA,M   ,"Attività professionali, scientifiche e tecniche             ",30,4,123,31,188,2024
PUG,BA,M 69,Attività legali e contabilità                               ,2,0,5,2,9,2024
PUG,BA,M 70,Attività di direzione aziendale e di consulenza gestional...,13,1,20,6,40,2024
PUG,BA,M 71,Attività degli studi di architettura e d'ingegneria; coll...,4,0,5,2,11,2024
PUG,BA,M 72,Ricerca scientifica e sviluppo                              ,1,0,0,1,2,2024
PUG,BA,M 73,Pubblicità e ricerche di mercato                            ,4,3,33,13,53,2024
PUG,BA,M 74,"Altre attività professionali, scientifiche e tecniche       ",6,0,59,7,72,2024
PUG,BA,M 75,Servizi veterinari                                          ,0,0,1,0,1,2024
PUG,BA,N   ,"Noleggio, agenzie di viaggio, servizi di supporto alle im...",26,5,130,82,243,2024
PUG,BA,N 77,Attività di noleggio e leasing operativo                    ,4,0,10,1,15,2024
PUG,BA,N 78,"Attività di ricerca, selezione, fornitura di personale      ",0,0,0,1,1,2024
PUG,BA,N 79,"Attività dei servizi delle agenzie di viaggio, dei tour o...",6,0,5,4,15,2024
PUG,BA,N 80,Servizi di vigilanza e investigazione                       ,3,0,1,2,6,2024
PUG,BA,N 81,Attività di servizi per edifici e paesaggio                 ,4,3,62,58,127,2024
PUG,BA,N 82,Attività di supporto per le funzioni d'ufficio e altri se...,9,2,52,16,79,2024
PUG,BA,O   ,Amministrazione pubblica e difesa; assicurazione sociale ...,0,0,0,0,0,2024
PUG,BA,O 84,Amministrazione pubblica e difesa; assicurazione sociale ...,0,0,0,0,0,2024
PUG,BA,P   ,Istruzione                                                  ,4,0,5,13,22,2024
PUG,BA,P 85,Istruzione                                                  ,4,0,5,13,22,2024
PUG,BA,Q   ,Sanita' e assistenza sociale                                ,1,1,7,34,43,2024
PUG,BA,Q 86,Assistenza sanitaria                                        ,1,0,5,3,9,2024
PUG,BA,Q 87,Servizi di assistenza sociale residenziale                  ,0,0,1,6,7,2024
PUG,BA,Q 88,Assistenza sociale non residenziale                         ,0,1,1,25,27,2024
PUG,BA,R   ,"Attività artistiche, sportive, di intrattenimento e diver...",11,9,33,16,69,2024
PUG,BA,R 90,"Attività creative, artistiche e di intrattenimento          ",3,0,9,10,22,2024
PUG,BA,R 91,"Attività di biblioteche, archivi, musei ed altre attività...",0,0,0,2,2,2024
PUG,BA,R 92,"Attività riguardanti le lotterie, le scommesse, le case d...",2,3,2,0,7,2024
PUG,BA,R 93,"Attività sportive, di intrattenimento e di divertimento     ",6,6,22,4,38,2024
PUG,BA,S   ,Altre attività di servizi                                   ,8,9,188,12,217,2024
PUG,BA,S 94,Attività di organizzazioni associative                      ,0,0,0,1,1,2024
PUG,BA,S 95,Riparazione di computer e di beni per uso personale e per...,2,1,52,0,55,2024
PUG,BA,S 96,Altre attività di servizi per la persona                    ,6,8,136,11,161,2024
PUG,BA,T   ,Attività di famiglie e convivenze come datori di lavoro p...,0,0,0,0,0,2024
PUG,BA,T 97,Attività di famiglie e convivenze come datori di lavoro p...,0,0,0,0,0,2024
PUG,BA,T 98,Produzione di beni e servizi indifferenziati per uso prop...,0,0,0,0,0,2024
PUG,BA,U   ,Organizzazioni ed organismi extraterritoriali               ,0,0,0,0,0,2024
PUG,BA,U 99,Organizzazioni ed organismi extraterritoriali               ,0,0,0,0,0,2024
PUG,BA,XX  ,Imprese non classificate                                    ,132,43,13,308,496,2024
PUG,BA,TOT ,TOTALE                                                      ,971,280,4894,912,7057,2024
PUG,TA,A   ,"Agricoltura, silvicoltura pesca                             ",0,0,6,47,53,2024
PUG,TA,A 01,"Coltivazioni agricole e produzione di prodotti animali, c...",0,0,6,30,36,2024
PUG,TA,A 02,Silvicoltura ed utilizzo di aree forestali                  ,0,0,0,0,0,2024
PUG,TA,A 03,Pesca e acquacoltura                                        ,0,0,0,17,17,2024
PUG,TA,B   ,Estrazione di minerali da cave e miniere                    ,0,0,0,0,0,2024
PUG,TA,B 05,Estrazione di carbone (esclusa torba)                       ,0,0,0,0,0,2024
PUG,TA,B 06,Estraz.di petrolio greggio e di gas naturale                ,0,0,0,0,0,2024
PUG,TA,B 07,Estrazione di minerali metalliferi                          ,0,0,0,0,0,2024
PUG,TA,B 08,Altre attività di estrazione di minerali da cave e miniere  ,0,0,0,0,0,2024
PUG,TA,B 09,Attività dei servizi di supporto all'estrazione             ,0,0,0,0,0,2024
PUG,TA,C   ,Attività manifatturiere                                     ,1,0,2,25,28,2024
PUG,TA,C 10,Industrie alimentari                                        ,0,0,2,4,6,2024
PUG,TA,C 11,Industria delle bevande                                     ,0,0,0,0,0,2024
PUG,TA,C 12,Industria del tabacco                                       ,0,0,0,0,0,2024
PUG,TA,C 13,Industrie tessili                                           ,0,0,0,0,0,2024
PUG,TA,C 14,Confezione di articoli di abbigliamento; confezione di ar...,1,0,0,2,3,2024
PUG,TA,C 15,Fabbricazione di articoli in pelle e simili                 ,0,0,0,0,0,2024
PUG,TA,C 16,Industria del legno e dei prodotti in legno e sughero (es...,0,0,0,0,0,2024
PUG,TA,C 17,Fabbricazione di carta e di prodotti di carta               ,0,0,0,0,0,2024
PUG,TA,C 18,Stampa e riproduzione di supporti registrati                ,0,0,0,2,2,2024
PUG,TA,C 19,Fabbricazione di coke e prodotti derivanti dalla raffinaz...,0,0,0,0,0,2024
PUG,TA,C 20,Fabbricazione di prodotti chimici                           ,0,0,0,0,0,2024
PUG,TA,C 21,Fabbricazione di prodotti farmaceutici di base e di prepa...,0,0,0,0,0,2024
PUG,TA,C 22,Fabbricazione di articoli in gomma e materie plastiche      ,0,0,0,0,0,2024
PUG,TA,C 23,Fabbricazione di altri prodotti della lavorazione di miner..,0,0,0,5,5,2024
PUG,TA,C 24,Metallurgia                                                 ,0,0,0,0,0,2024
PUG,TA,C 25,Fabbricazione di prodotti in metallo (esclusi macchinari ...,0,0,0,6,6,2024
PUG,TA,C 26,Fabbricazione di computer e prodotti di elettronica e ott...,0,0,0,0,0,2024
PUG,TA,C 27,Fabbricazione di apparecchiature elettriche ed apparecchi...,0,0,0,0,0,2024
PUG,TA,C 28,Fabbricazione di macchinari ed apparecchiature nca          ,0,0,0,2,2,2024
PUG,TA,C 29,"Fabbricazione di autoveicoli, rimorchi e semirimorchi       ",0,0,0,0,0,2024
PUG,TA,C 30,Fabbricazione di altri mezzi di trasporto                   ,0,0,0,0,0,2024
PUG,TA,C 31,Fabbricazione di mobili                                     ,0,0,0,0,0,2024
PUG,TA,C 32,Altre industrie manifatturiere                              ,0,0,0,3,3,2024
PUG,TA,C 33,"Riparazione, manutenzione ed installazione di macchine ed...",0,0,0,1,1,2024
PUG,TA,D   ,"Fornitura di energia elettrica, gas, vapore e aria condiz...",0,0,0,0,0,2024
PUG,TA,D 35,"Fornitura di energia elettrica, gas, vapore e aria condiz...",0,0,0,0,0,2024
PUG,TA,E   ,"Fornitura di acqua; reti fognarie, attività di gestione d...",0,0,0,0,0,2024
PUG,TA,E 36,"Raccolta, trattamento e fornitura di acqua                  ",0,0,0,0,0,2024
PUG,TA,E 37,Gestione delle reti fognarie                                ,0,0,0,0,0,2024
PUG,TA,E 38,"Attività di raccolta, trattamento e smaltimento dei rifiu...",0,0,0,0,0,2024
PUG,TA,E 39,Attività di risanamento e altri servizi di gestione dei r...,0,0,0,0,0,2024
PUG,TA,F   ,Costruzioni                                                 ,1,0,1,84,86,2024
PUG,TA,F 41,Costruzione di edifici                                      ,1,0,1,50,52,2024
PUG,TA,F 42,Ingegneria civile                                           ,0,0,0,0,0,2024
PUG,TA,F 43,Lavori di costruzione specializzati                         ,0,0,0,34,34,2024
PUG,TA,G   ,Commercio all'ingrosso e al dettaglio; riparazione di aut...,0,2,3,21,26,2024
PUG,TA,G 45,Commercio all'ingrosso e al dettaglio e riparazione di au...,0,0,0,1,1,2024
PUG,TA,G 46,Commercio all'ingrosso (escluso quello di autoveicoli e d...,0,0,1,12,13,2024
PUG,TA,G 47,Commercio al dettaglio (escluso quello di autoveicoli e d...,0,2,2,8,12,2024
PUG,TA,H   ,Trasporto e magazzinaggio                                   ,0,0,0,17,17,2024
PUG,TA,H 49,Trasporto terrestre e mediante condotte                     ,0,0,0,10,10,2024
PUG,TA,H 50,Trasporto marittimo e per vie d'acqua                       ,0,0,0,1,1,2024
PUG,TA,H 51,Trasporto aereo                                             ,0,0,0,0,0,2024
PUG,TA,H 52,Magazzinaggio e attività di supporto ai trasporti           ,0,0,0,5,5,2024
PUG,TA,H 53,Servizi postali e attività di corriere                      ,0,0,0,1,1,2024
PUG,TA,I   ,Attività dei servizi alloggio e ristorazione                ,0,2,0,7,9,2024
PUG,TA,I 55,Alloggio                                                    ,0,0,0,1,1,2024
PUG,TA,I 56,Attività dei servizi di ristorazione                        ,0,2,0,6,8,2024
PUG,TA,J   ,Servizi di informazione e comunicazione                     ,0,0,0,10,10,2024
PUG,TA,J 58,Attività editoriali                                         ,0,0,0,3,3,2024
PUG,TA,J 59,"Attività di produzione cinematografica, di video e di pro...",0,0,0,1,1,2024
PUG,TA,J 60,Attività di programmazione e trasmissione                   ,0,0,0,0,0,2024
PUG,TA,J 61,Telecomunicazioni                                           ,0,0,0,1,1,2024
PUG,TA,J 62,"Produzione di software, consulenza informatica e attività...",0,0,0,0,0,2024
PUG,TA,J 63,Attività dei servizi d'informazione e altri servizi infor...,0,0,0,5,5,2024
PUG,TA,K   ,Attività finanziarie e assicurative                         ,0,0,1,2,3,2024
PUG,TA,K 64,Attività di servizi finanziari (escluse le assicurazioni ...,0,0,0,1,1,2024
PUG,TA,K 65,"Assicurazioni, riassicurazioni e fondi pensione (escluse ...",0,0,0,0,0,2024
PUG,TA,K 66,Attività ausiliarie dei servizi finanziari e delle attivi...,0,0,1,1,2,2024
PUG,TA,L   ,Attivita' immobiliari                                       ,0,1,0,0,1,2024
PUG,TA,L 68,Attivita' immobiliari                                       ,0,1,0,0,1,2024
PUG,TA,M   ,"Attività professionali, scientifiche e tecniche             ",0,0,0,13,13,2024
PUG,TA,M 69,Attività legali e contabilità                               ,0,0,0,1,1,2024
PUG,TA,M 70,Attività di direzione aziendale e di consulenza gestional...,0,0,0,4,4,2024
PUG,TA,M 71,Attività degli studi di architettura e d'ingegneria; coll...,0,0,0,3,3,2024
PUG,TA,M 72,Ricerca scientifica e sviluppo                              ,0,0,0,1,1,2024
PUG,TA,M 73,Pubblicità e ricerche di mercato                            ,0,0,0,3,3,2024
PUG,TA,M 74,"Altre attività professionali, scientifiche e tecniche       ",0,0,0,1,1,2024
PUG,TA,M 75,Servizi veterinari                                          ,0,0,0,0,0,2024
PUG,TA,N   ,"Noleggio, agenzie di viaggio, servizi di supporto alle im...",0,0,0,51,51,2024
PUG,TA,N 77,Attività di noleggio e leasing operativo                    ,0,0,0,3,3,2024
PUG,TA,N 78,"Attività di ricerca, selezione, fornitura di personale      ",0,0,0,0,0,2024
PUG,TA,N 79,"Attività dei servizi delle agenzie di viaggio, dei tour o...",0,0,0,0,0,2024
PUG,TA,N 80,Servizi di vigilanza e investigazione                       ,0,0,0,1,1,2024
PUG,TA,N 81,Attività di servizi per edifici e paesaggio                 ,0,0,0,36,36,2024
PUG,TA,N 82,Attività di supporto per le funzioni d'ufficio e altri se...,0,0,0,11,11,2024
PUG,TA,O   ,Amministrazione pubblica e difesa; assicurazione sociale ...,0,0,0,0,0,2024
PUG,TA,O 84,Amministrazione pubblica e difesa; assicurazione sociale ...,0,0,0,0,0,2024
PUG,TA,P   ,Istruzione                                                  ,0,0,0,7,7,2024
PUG,TA,P 85,Istruzione                                                  ,0,0,0,7,7,2024
PUG,TA,Q   ,Sanita' e assistenza sociale                                ,0,0,0,13,13,2024
PUG,TA,Q 86,Assistenza sanitaria                                        ,0,0,0,1,1,2024
PUG,TA,Q 87,Servizi di assistenza sociale residenziale                  ,0,0,0,0,0,2024
PUG,TA,Q 88,Assistenza sociale non residenziale                         ,0,0,0,12,12,2024
PUG,TA,R   ,"Attività artistiche, sportive, di intrattenimento e diver...",0,0,0,10,10,2024
PUG,TA,R 90,"Attività creative, artistiche e di intrattenimento          ",0,0,0,3,3,2024
PUG,TA,R 91,"Attività di biblioteche, archivi, musei ed altre attività...",0,0,0,0,0,2024
PUG,TA,R 92,"Attività riguardanti le lotterie, le scommesse, le case d...",0,0,0,0,0,2024
PUG,TA,R 93,"Attività sportive, di intrattenimento e di divertimento     ",0,0,0,7,7,2024
PUG,TA,S   ,Altre attività di servizi                                   ,0,1,1,11,13,2024
PUG,TA,S 94,Attività di organizzazioni associative                      ,0,0,0,1,1,2024
PUG,TA,S 95,Riparazione di computer e di beni per uso personale e per...,0,0,0,1,1,2024
PUG,TA,S 96,Altre attività di servizi per la persona                    ,0,1,1,9,11,2024
PUG,TA,T   ,Attività di famiglie e convivenze come datori di lavoro p...,0,0,0,0,0,2024
PUG,TA,T 97,Attività di famiglie e convivenze come datori di lavoro p...,0,0,0,0,0,2024
PUG,TA,T 98,Produzione di beni e servizi indifferenziati per uso prop...,0,0,0,0,0,2024
PUG,TA,U   ,Organizzazioni ed organismi extraterritoriali               ,0,0,0,0,0,2024
PUG,TA,U 99,Organizzazioni ed organismi extraterritoriali               ,0,0,0,0,0,2024
PUG,TA,XX  ,Imprese non classificate                                    ,2,5,0,108,115,2024
PUG,TA,TOT ,TOTALE                                                      ,4,11,14,426,455,2024
PUG,BR,A   ,"Agricoltura, silvicoltura pesca                             ",1,0,0,51,52,2024
PUG,BR,A 01,"Coltivazioni agricole e produzione di prodotti animali, c...",1,0,0,50,51,2024
PUG,BR,A 02,Silvicoltura ed utilizzo di aree forestali                  ,0,0,0,0,0,2024
PUG,BR,A 03,Pesca e acquacoltura                                        ,0,0,0,1,1,2024
PUG,BR,B   ,Estrazione di minerali da cave e miniere                    ,0,0,0,0,0,2024
PUG,BR,B 05,Estrazione di carbone (esclusa torba)                       ,0,0,0,0,0,2024
PUG,BR,B 06,Estraz.di petrolio greggio e di gas naturale                ,0,0,0,0,0,2024
PUG,BR,B 07,Estrazione di minerali metalliferi                          ,0,0,0,0,0,2024
PUG,BR,B 08,Altre attività di estrazione di minerali da cave e miniere  ,0,0,0,0,0,2024
PUG,BR,B 09,Attività dei servizi di supporto all'estrazione             ,0,0,0,0,0,2024
PUG,BR,C   ,Attività manifatturiere                                     ,1,3,0,28,32,2024
PUG,BR,C 10,Industrie alimentari                                        ,0,0,0,7,7,2024
PUG,BR,C 11,Industria delle bevande                                     ,0,0,0,1,1,2024
PUG,BR,C 12,Industria del tabacco                                       ,0,0,0,0,0,2024
PUG,BR,C 13,Industrie tessili                                           ,0,0,0,0,0,2024
PUG,BR,C 14,Confezione di articoli di abbigliamento; confezione di ar...,0,0,0,4,4,2024
PUG,BR,C 15,Fabbricazione di articoli in pelle e simili                 ,0,0,0,1,1,2024
PUG,BR,C 16,Industria del legno e dei prodotti in legno e sughero (es...,0,0,0,2,2,2024
PUG,BR,C 17,Fabbricazione di carta e di prodotti di carta               ,0,0,0,0,0,2024
PUG,BR,C 18,Stampa e riproduzione di supporti registrati                ,0,0,0,2,2,2024
PUG,BR,C 19,Fabbricazione di coke e prodotti derivanti dalla raffinaz...,0,0,0,0,0,2024
PUG,BR,C 20,Fabbricazione di prodotti chimici                           ,0,0,0,1,1,2024
PUG,BR,C 21,Fabbricazione di prodotti farmaceutici di base e di prepa...,0,0,0,0,0,2024
PUG,BR,C 22,Fabbricazione di articoli in gomma e materie plastiche      ,0,0,0,0,0,2024
PUG,BR,C 23,Fabbricazione di altri prodotti della lavorazione di miner..,0,1,0,2,3,2024
PUG,BR,C 24,Metallurgia                                                 ,0,0,0,0,0,2024
PUG,BR,C 25,Fabbricazione di prodotti in metallo (esclusi macchinari ...,1,1,0,6,8,2024
PUG,BR,C 26,Fabbricazione di computer e prodotti di elettronica e ott...,0,0,0,0,0,2024
PUG,BR,C 27,Fabbricazione di apparecchiature elettriche ed apparecchi...,0,0,0,0,0,2024
PUG,BR,C 28,Fabbricazione di macchinari ed apparecchiature nca          ,0,0,0,0,0,2024
PUG,BR,C 29,"Fabbricazione di autoveicoli, rimorchi e semirimorchi       ",0,0,0,0,0,2024
PUG,BR,C 30,Fabbricazione di altri mezzi di trasporto                   ,0,0,0,0,0,2024
PUG,BR,C 31,Fabbricazione di mobili                                     ,0,0,0,1,1,2024
PUG,BR,C 32,Altre industrie manifatturiere                              ,0,1,0,1,2,2024
PUG,BR,C 33,"Riparazione, manutenzione ed installazione di macchine ed...",0,0,0,0,0,2024
PUG,BR,D   ,"Fornitura di energia elettrica, gas, vapore e aria condiz...",0,0,0,0,0,2024
PUG,BR,D 35,"Fornitura di energia elettrica, gas, vapore e aria condiz...",0,0,0,0,0,2024
PUG,BR,E   ,"Fornitura di acqua; reti fognarie, attività di gestione d...",0,0,0,2,2,2024
PUG,BR,E 36,"Raccolta, trattamento e fornitura di acqua                  ",0,0,0,0,0,2024
PUG,BR,E 37,Gestione delle reti fognarie                                ,0,0,0,0,0,2024
PUG,BR,E 38,"Attività di raccolta, trattamento e smaltimento dei rifiu...",0,0,0,2,2,2024
PUG,BR,E 39,Attività di risanamento e altri servizi di gestione dei r...,0,0,0,0,0,2024
PUG,BR,F   ,Costruzioni                                                 ,7,2,0,142,151,2024
PUG,BR,F 41,Costruzione di edifici                                      ,3,0,0,75,78,2024
PUG,BR,F 42,Ingegneria civile                                           ,1,0,0,2,3,2024
PUG,BR,F 43,Lavori di costruzione specializzati                         ,3,2,0,65,70,2024
PUG,BR,G   ,Commercio all'ingrosso e al dettaglio; riparazione di aut...,12,3,1,16,32,2024
PUG,BR,G 45,Commercio all'ingrosso e al dettaglio e riparazione di au...,1,0,0,4,5,2024
PUG,BR,G 46,Commercio all'ingrosso (escluso quello di autoveicoli e d...,5,2,1,2,10,2024
PUG,BR,G 47,Commercio al dettaglio (escluso quello di autoveicoli e d...,6,1,0,10,17,2024
PUG,BR,H   ,Trasporto e magazzinaggio                                   ,1,0,0,19,20,2024
PUG,BR,H 49,Trasporto terrestre e mediante condotte                     ,1,0,0,9,10,2024
PUG,BR,H 50,Trasporto marittimo e per vie d'acqua                       ,0,0,0,0,0,2024
PUG,BR,H 51,Trasporto aereo                                             ,0,0,0,0,0,2024
PUG,BR,H 52,Magazzinaggio e attività di supporto ai trasporti           ,0,0,0,8,8,2024
PUG,BR,H 53,Servizi postali e attività di corriere                      ,0,0,0,2,2,2024
PUG,BR,I   ,Attività dei servizi alloggio e ristorazione                ,5,4,0,10,19,2024
PUG,BR,I 55,Alloggio                                                    ,0,0,0,1,1,2024
PUG,BR,I 56,Attività dei servizi di ristorazione                        ,5,4,0,9,18,2024
PUG,BR,J   ,Servizi di informazione e comunicazione                     ,1,0,0,13,14,2024
PUG,BR,J 58,Attività editoriali                                         ,0,0,0,2,2,2024
PUG,BR,J 59,"Attività di produzione cinematografica, di video e di pro...",0,0,0,0,0,2024
PUG,BR,J 60,Attività di programmazione e trasmissione                   ,0,0,0,0,0,2024
PUG,BR,J 61,Telecomunicazioni                                           ,0,0,0,0,0,2024
PUG,BR,J 62,"Produzione di software, consulenza informatica e attività...",1,0,0,1,2,2024
PUG,BR,J 63,Attività dei servizi d'informazione e altri servizi infor...,0,0,0,10,10,2024
PUG,BR,K   ,Attività finanziarie e assicurative                         ,0,0,0,1,1,2024
PUG,BR,K 64,Attività di servizi finanziari (escluse le assicurazioni ...,0,0,0,1,1,2024
PUG,BR,K 65,"Assicurazioni, riassicurazioni e fondi pensione (escluse ...",0,0,0,0,0,2024
PUG,BR,K 66,Attività ausiliarie dei servizi finanziari e delle attivi...,0,0,0,0,0,2024
PUG,BR,L   ,Attivita' immobiliari                                       ,2,0,0,1,3,2024
PUG,BR,L 68,Attivita' immobiliari                                       ,2,0,0,1,3,2024
PUG,BR,M   ,"Attività professionali, scientifiche e tecniche             ",0,1,0,10,11,2024
PUG,BR,M 69,Attività legali e contabilità                               ,0,0,0,2,2,2024
PUG,BR,M 70,Attività di direzione aziendale e di consulenza gestional...,0,0,0,4,4,2024
PUG,BR,M 71,Attività degli studi di architettura e d'ingegneria; coll...,0,0,0,0,0,2024
PUG,BR,M 72,Ricerca scientifica e sviluppo                              ,0,0,0,1,1,2024
PUG,BR,M 73,Pubblicità e ricerche di mercato                            ,0,0,0,1,1,2024
PUG,BR,M 74,"Altre attività professionali, scientifiche e tecniche       ",0,1,0,2,3,2024
PUG,BR,M 75,Servizi veterinari                                          ,0,0,0,0,0,2024
PUG,BR,N   ,"Noleggio, agenzie di viaggio, servizi di supporto alle im...",1,0,0,44,45,2024
PUG,BR,N 77,Attività di noleggio e leasing operativo                    ,1,0,0,0,1,2024
PUG,BR,N 78,"Attività di ricerca, selezione, fornitura di personale      ",0,0,0,1,1,2024
PUG,BR,N 79,"Attività dei servizi delle agenzie di viaggio, dei tour o...",0,0,0,4,4,2024
PUG,BR,N 80,Servizi di vigilanza e investigazione                       ,0,0,0,2,2,2024
PUG,BR,N 81,Attività di servizi per edifici e paesaggio                 ,0,0,0,26,26,2024
PUG,BR,N 82,Attività di supporto per le funzioni d'ufficio e altri se...,0,0,0,11,11,2024
PUG,BR,O   ,Amministrazione pubblica e difesa; assicurazione sociale ...,0,0,0,0,0,2024
PUG,BR,O 84,Amministrazione pubblica e difesa; assicurazione sociale ...,0,0,0,0,0,2024
PUG,BR,P   ,Istruzione                                                  ,0,0,0,9,9,2024
PUG,BR,P 85,Istruzione                                                  ,0,0,0,9,9,2024
PUG,BR,Q   ,Sanita' e assistenza sociale                                ,0,1,0,13,14,2024
PUG,BR,Q 86,Assistenza sanitaria                                        ,0,1,0,2,3,2024
PUG,BR,Q 87,Servizi di assistenza sociale residenziale                  ,0,0,0,1,1,2024
PUG,BR,Q 88,Assistenza sociale non residenziale                         ,0,0,0,10,10,2024
PUG,BR,R   ,"Attività artistiche, sportive, di intrattenimento e diver...",0,0,0,8,8,2024
PUG,BR,R 90,"Attività creative, artistiche e di intrattenimento          ",0,0,0,2,2,2024
PUG,BR,R 91,"Attività di biblioteche, archivi, musei ed altre attività...",0,0,0,2,2,2024
PUG,BR,R 92,"Attività riguardanti le lotterie, le scommesse, le case d...",0,0,0,0,0,2024
PUG,BR,R 93,"Attività sportive, di intrattenimento e di divertimento     ",0,0,0,4,4,2024
PUG,BR,S   ,Altre attività di servizi                                   ,0,0,0,15,15,2024
PUG,BR,S 94,Attività di organizzazioni associative                      ,0,0,0,0,0,2024
PUG,BR,S 95,Riparazione di computer e di beni per uso personale e per...,0,0,0,2,2,2024
PUG,BR,S 96,Altre attività di servizi per la persona                    ,0,0,0,13,13,2024
PUG,BR,T   ,Attività di famiglie e convivenze come datori di lavoro p...,0,0,0,0,0,2024
PUG,BR,T 97,Attività di famiglie e convivenze come datori di lavoro p...,0,0,0,0,0,2024
PUG,BR,T 98,Produzione di beni e servizi indifferenziati per uso prop...,0,0,0,0,0,2024
PUG,BR,U   ,Organizzazioni ed organismi extraterritoriali               ,0,0,0,0,0,2024
PUG,BR,U 99,Organizzazioni ed organismi extraterritoriali               ,0,0,0,0,0,2024
PUG,BR,XX  ,Imprese non classificate                                    ,6,5,0,82,93,2024
PUG,BR,TOT ,TOTALE                                                      ,37,19,1,464,521,2024
PUG,LE,A   ,"Agricoltura, silvicoltura pesca                             ",0,4,110,47,161,2024
PUG,LE,A 01,"Coltivazioni agricole e produzione di prodotti animali, c...",0,3,107,46,156,2024
PUG,LE,A 02,Silvicoltura ed utilizzo di aree forestali                  ,0,0,0,0,0,2024
PUG,LE,A 03,Pesca e acquacoltura                                        ,0,1,3,1,5,2024
PUG,LE,B   ,Estrazione di minerali da cave e miniere                    ,1,0,1,0,2,2024
PUG,LE,B 05,Estrazione di carbone (esclusa torba)                       ,0,0,0,0,0,2024
PUG,LE,B 06,Estraz.di petrolio greggio e di gas naturale                ,0,0,0,0,0,2024
PUG,LE,B 07,Estrazione di minerali metalliferi                          ,0,0,0,0,0,2024
PUG,LE,B 08,Altre attività di estrazione di minerali da cave e miniere  ,1,0,1,0,2,2024
PUG,LE,B 09,Attività dei servizi di supporto all'estrazione             ,0,0,0,0,0,2024
PUG,LE,C   ,Attività manifatturiere                                     ,19,62,31,55,167,2024
PUG,LE,C 10,Industrie alimentari                                        ,1,10,5,17,33,2024
PUG,LE,C 11,Industria delle bevande                                     ,0,1,0,2,3,2024
PUG,LE,C 12,Industria del tabacco                                       ,0,1,0,0,1,2024
PUG,LE,C 13,Industrie tessili                                           ,0,1,4,3,8,2024
PUG,LE,C 14,Confezione di articoli di abbigliamento; confezione di ar...,5,17,6,9,37,2024
PUG,LE,C 15,Fabbricazione di articoli in pelle e simili                 ,4,1,0,3,8,2024
PUG,LE,C 16,Industria del legno e dei prodotti in legno e sughero (es...,2,7,5,6,20,2024
PUG,LE,C 17,Fabbricazione di carta e di prodotti di carta               ,0,0,1,0,1,2024
PUG,LE,C 18,Stampa e riproduzione di supporti registrati                ,0,4,2,2,8,2024
PUG,LE,C 19,Fabbricazione di coke e prodotti derivanti dalla raffinaz...,0,0,0,0,0,2024
PUG,LE,C 20,Fabbricazione di prodotti chimici                           ,0,0,1,0,1,2024
PUG,LE,C 21,Fabbricazione di prodotti farmaceutici di base e di prepa...,0,0,0,0,0,2024
PUG,LE,C 22,Fabbricazione di articoli in gomma e materie plastiche      ,0,1,0,0,1,2024
PUG,LE,C 23,Fabbricazione di altri prodotti della lavorazione di miner..,0,4,1,2,7,2024
PUG,LE,C 24,Metallurgia                                                 ,0,0,0,0,0,2024
PUG,LE,C 25,Fabbricazione di prodotti in metallo (esclusi macchinari ...,3,6,5,4,18,2024
PUG,LE,C 26,Fabbricazione di computer e prodotti di elettronica e ott...,0,0,0,0,0,2024
PUG,LE,C 27,Fabbricazione di apparecchiature elettriche ed apparecchi...,0,1,0,0,1,2024
PUG,LE,C 28,Fabbricazione di macchinari ed apparecchiature nca          ,0,1,0,0,1,2024
PUG,LE,C 29,"Fabbricazione di autoveicoli, rimorchi e semirimorchi       ",0,0,0,0,0,2024
PUG,LE,C 30,Fabbricazione di altri mezzi di trasporto                   ,1,1,0,2,4,2024
PUG,LE,C 31,Fabbricazione di mobili                                     ,0,3,0,2,5,2024
PUG,LE,C 32,Altre industrie manifatturiere                              ,2,2,1,0,5,2024
PUG,LE,C 33,"Riparazione, manutenzione ed installazione di macchine ed...",1,1,0,3,5,2024
PUG,LE,D   ,"Fornitura di energia elettrica, gas, vapore e aria condiz...",0,0,0,0,0,2024
PUG,LE,D 35,"Fornitura di energia elettrica, gas, vapore e aria condiz...",0,0,0,0,0,2024
PUG,LE,E   ,"Fornitura di acqua; reti fognarie, attività di gestione d...",1,0,3,1,5,2024
PUG,LE,E 36,"Raccolta, trattamento e fornitura di acqua                  ",0,0,1,0,1,2024
PUG,LE,E 37,Gestione delle reti fognarie                                ,0,0,0,0,0,2024
PUG,LE,E 38,"Attività di raccolta, trattamento e smaltimento dei rifiu...",1,0,2,0,3,2024
PUG,LE,E 39,Attività di risanamento e altri servizi di gestione dei r...,0,0,0,1,1,2024
PUG,LE,F   ,Costruzioni                                                 ,25,64,59,148,296,2024
PUG,LE,F 41,Costruzione di edifici                                      ,12,35,16,63,126,2024
PUG,LE,F 42,Ingegneria civile                                           ,1,1,0,1,3,2024
PUG,LE,F 43,Lavori di costruzione specializzati                         ,12,28,43,84,167,2024
PUG,LE,G   ,Commercio all'ingrosso e al dettaglio; riparazione di aut...,34,84,277,37,432,2024
PUG,LE,G 45,Commercio all'ingrosso e al dettaglio e riparazione di au...,4,13,14,5,36,2024
PUG,LE,G 46,Commercio all'ingrosso (escluso quello di autoveicoli e d...,13,15,39,7,74,2024
PUG,LE,G 47,Commercio al dettaglio (escluso quello di autoveicoli e d...,17,56,224,25,322,2024
PUG,LE,H   ,Trasporto e magazzinaggio                                   ,0,1,10,23,34,2024
PUG,LE,H 49,Trasporto terrestre e mediante condotte                     ,0,1,7,11,19,2024
PUG,LE,H 50,Trasporto marittimo e per vie d'acqua                       ,0,0,0,0,0,2024
PUG,LE,H 51,Trasporto aereo                                             ,0,0,0,0,0,2024
PUG,LE,H 52,Magazzinaggio e attività di supporto ai trasporti           ,0,0,1,10,11,2024
PUG,LE,H 53,Servizi postali e attività di corriere                      ,0,0,2,2,4,2024
PUG,LE,I   ,Attività dei servizi alloggio e ristorazione                ,19,112,53,23,207,2024
PUG,LE,I 55,Alloggio                                                    ,3,4,4,2,13,2024
PUG,LE,I 56,Attività dei servizi di ristorazione                        ,16,108,49,21,194,2024
PUG,LE,J   ,Servizi di informazione e comunicazione                     ,5,9,10,13,37,2024
PUG,LE,J 58,Attività editoriali                                         ,1,2,4,1,8,2024
PUG,LE,J 59,"Attività di produzione cinematografica, di video e di pro...",0,0,1,0,1,2024
PUG,LE,J 60,Attività di programmazione e trasmissione                   ,0,0,0,1,1,2024
PUG,LE,J 61,Telecomunicazioni                                           ,0,1,0,0,1,2024
PUG,LE,J 62,"Produzione di software, consulenza informatica e attività...",0,3,2,2,7,2024
PUG,LE,J 63,Attività dei servizi d'informazione e altri servizi infor...,4,3,3,9,19,2024
PUG,LE,K   ,Attività finanziarie e assicurative                         ,1,7,11,2,21,2024
PUG,LE,K 64,Attività di servizi finanziari (escluse le assicurazioni ...,1,0,0,2,3,2024
PUG,LE,K 65,"Assicurazioni, riassicurazioni e fondi pensione (escluse ...",0,0,1,0,1,2024
PUG,LE,K 66,Attività ausiliarie dei servizi finanziari e delle attivi...,0,7,10,0,17,2024
PUG,LE,L   ,Attivita' immobiliari                                       ,3,6,2,3,14,2024
PUG,LE,L 68,Attivita' immobiliari                                       ,3,6,2,3,14,2024
PUG,LE,M   ,"Attività professionali, scientifiche e tecniche             ",7,6,12,15,40,2024
PUG,LE,M 69,Attività legali e contabilità                               ,0,0,0,2,2,2024
PUG,LE,M 70,Attività di direzione aziendale e di consulenza gestional...,2,1,0,2,5,2024
PUG,LE,M 71,Attività degli studi di architettura e d'ingegneria; coll...,2,0,3,1,6,2024
PUG,LE,M 72,Ricerca scientifica e sviluppo                              ,0,0,0,0,0,2024
PUG,LE,M 73,Pubblicità e ricerche di mercato                            ,3,2,4,7,16,2024
PUG,LE,M 74,"Altre attività professionali, scientifiche e tecniche       ",0,3,5,3,11,2024
PUG,LE,M 75,Servizi veterinari                                          ,0,0,0,0,0,2024
PUG,LE,N   ,"Noleggio, agenzie di viaggio, servizi di supporto alle im...",3,11,13,60,87,2024
PUG,LE,N 77,Attività di noleggio e leasing operativo                    ,0,2,2,4,8,2024
PUG,LE,N 78,"Attività di ricerca, selezione, fornitura di personale      ",0,0,0,0,0,2024
PUG,LE,N 79,"Attività dei servizi delle agenzie di viaggio, dei tour o...",1,3,1,2,7,2024
PUG,LE,N 80,Servizi di vigilanza e investigazione                       ,0,0,0,2,2,2024
PUG,LE,N 81,Attività di servizi per edifici e paesaggio                 ,0,1,5,37,43,2024
PUG,LE,N 82,Attività di supporto per le funzioni d'ufficio e altri se...,2,5,5,15,27,2024
PUG,LE,O   ,Amministrazione pubblica e difesa; assicurazione sociale ...,0,0,0,0,0,2024
PUG,LE,O 84,Amministrazione pubblica e difesa; assicurazione sociale ...,0,0,0,0,0,2024
PUG,LE,P   ,Istruzione                                                  ,2,0,1,5,8,2024
PUG,LE,P 85,Istruzione                                                  ,2,0,1,5,8,2024
PUG,LE,Q   ,Sanita' e assistenza sociale                                ,0,3,1,20,24,2024
PUG,LE,Q 86,Assistenza sanitaria                                        ,0,2,1,0,3,2024
PUG,LE,Q 87,Servizi di assistenza sociale residenziale                  ,0,0,0,5,5,2024
PUG,LE,Q 88,Assistenza sociale non residenziale                         ,0,1,0,15,16,2024
PUG,LE,R   ,"Attività artistiche, sportive, di intrattenimento e diver...",2,11,5,15,33,2024
PUG,LE,R 90,"Attività creative, artistiche e di intrattenimento          ",1,0,0,8,9,2024
PUG,LE,R 91,"Attività di biblioteche, archivi, musei ed altre attività...",0,0,0,2,2,2024
PUG,LE,R 92,"Attività riguardanti le lotterie, le scommesse, le case d...",0,2,0,0,2,2024
PUG,LE,R 93,"Attività sportive, di intrattenimento e di divertimento     ",1,9,5,5,20,2024
PUG,LE,S   ,Altre attività di servizi                                   ,1,7,18,21,47,2024
PUG,LE,S 94,Attività di organizzazioni associative                      ,0,0,0,0,0,2024
PUG,LE,S 95,Riparazione di computer e di beni per uso personale e per...,0,1,6,5,12,2024
PUG,LE,S 96,Altre attività di servizi per la persona                    ,1,6,12,16,35,2024
PUG,LE,T   ,Attività di famiglie e convivenze come datori di lavoro p...,0,0,0,0,0,2024
PUG,LE,T 97,Attività di famiglie e convivenze come datori di lavoro p...,0,0,0,0,0,2024
PUG,LE,T 98,Produzione di beni e servizi indifferenziati per uso prop...,0,0,0,0,0,2024
PUG,LE,U   ,Organizzazioni ed organismi extraterritoriali               ,0,0,0,0,0,2024
PUG,LE,U 99,Organizzazioni ed organismi extraterritoriali               ,0,0,0,0,0,2024
PUG,LE,XX  ,Imprese non classificate                                    ,22,226,55,192,495,2024
PUG,LE,TOT ,TOTALE                                                      ,145,613,672,680,2110,2024
BAS,  ,A   ,"Agricoltura, silvicoltura pesca                             ",6,7,73,53,139,2024
BAS,  ,A 01,"Coltivazioni agricole e produzione di prodotti animali, c...",6,7,69,50,132,2024
BAS,  ,A 02,Silvicoltura ed utilizzo di aree forestali                  ,0,0,4,2,6,2024
BAS,  ,A 03,Pesca e acquacoltura                                        ,0,0,0,1,1,2024
BAS,  ,B   ,Estrazione di minerali da cave e miniere                    ,0,1,1,0,2,2024
BAS,  ,B 05,Estrazione di carbone (esclusa torba)                       ,0,0,0,0,0,2024
BAS,  ,B 06,Estraz.di petrolio greggio e di gas naturale                ,0,0,0,0,0,2024
BAS,  ,B 07,Estrazione di minerali metalliferi                          ,0,0,0,0,0,2024
BAS,  ,B 08,Altre attività di estrazione di minerali da cave e miniere  ,0,1,1,0,2,2024
BAS,  ,B 09,Attività dei servizi di supporto all'estrazione             ,0,0,0,0,0,2024
BAS,  ,C   ,Attività manifatturiere                                     ,31,11,20,28,90,2024
BAS,  ,C 10,Industrie alimentari                                        ,6,2,5,7,20,2024
BAS,  ,C 11,Industria delle bevande                                     ,0,0,0,0,0,2024
BAS,  ,C 12,Industria del tabacco                                       ,0,0,0,0,0,2024
BAS,  ,C 13,Industrie tessili                                           ,1,0,0,0,1,2024
BAS,  ,C 14,Confezione di articoli di abbigliamento; confezione di ar...,5,2,1,7,15,2024
BAS,  ,C 15,Fabbricazione di articoli in pelle e simili                 ,0,1,0,0,1,2024
BAS,  ,C 16,Industria del legno e dei prodotti in legno e sughero (es...,2,1,3,1,7,2024
BAS,  ,C 17,Fabbricazione di carta e di prodotti di carta               ,0,0,0,0,0,2024
BAS,  ,C 18,Stampa e riproduzione di supporti registrati                ,1,0,0,0,1,2024
BAS,  ,C 19,Fabbricazione di coke e prodotti derivanti dalla raffinaz...,0,0,0,0,0,2024
BAS,  ,C 20,Fabbricazione di prodotti chimici                           ,0,0,0,0,0,2024
BAS,  ,C 21,Fabbricazione di prodotti farmaceutici di base e di prepa...,0,0,0,0,0,2024
BAS,  ,C 22,Fabbricazione di articoli in gomma e materie plastiche      ,1,2,0,0,3,2024
BAS,  ,C 23,Fabbricazione di altri prodotti della lavorazione di miner..,1,0,1,2,4,2024
BAS,  ,C 24,Metallurgia                                                 ,1,0,0,0,1,2024
BAS,  ,C 25,Fabbricazione di prodotti in metallo (esclusi macchinari ...,4,0,6,4,14,2024
BAS,  ,C 26,Fabbricazione di computer e prodotti di elettronica e ott...,0,1,0,0,1,2024
BAS,  ,C 27,Fabbricazione di apparecchiature elettriche ed apparecchi...,4,0,0,3,7,2024
BAS,  ,C 28,Fabbricazione di macchinari ed apparecchiature nca          ,0,1,0,2,3,2024
BAS,  ,C 29,"Fabbricazione di autoveicoli, rimorchi e semirimorchi       ",1,0,0,0,1,2024
BAS,  ,C 30,Fabbricazione di altri mezzi di trasporto                   ,0,0,0,0,0,2024
BAS,  ,C 31,Fabbricazione di mobili                                     ,3,0,2,1,6,2024
BAS,  ,C 32,Altre industrie manifatturiere                              ,1,1,1,1,4,2024
BAS,  ,C 33,"Riparazione, manutenzione ed installazione di macchine ed...",0,0,1,0,1,2024
BAS,  ,D   ,"Fornitura di energia elettrica, gas, vapore e aria condiz...",0,0,0,0,0,2024
BAS,  ,D 35,"Fornitura di energia elettrica, gas, vapore e aria condiz...",0,0,0,0,0,2024
BAS,  ,E   ,"Fornitura di acqua; reti fognarie, attività di gestione d...",0,0,0,2,2,2024
BAS,  ,E 36,"Raccolta, trattamento e fornitura di acqua                  ",0,0,0,1,1,2024
BAS,  ,E 37,Gestione delle reti fognarie                                ,0,0,0,0,0,2024
BAS,  ,E 38,"Attività di raccolta, trattamento e smaltimento dei rifiu...",0,0,0,1,1,2024
BAS,  ,E 39,Attività di risanamento e altri servizi di gestione dei r...,0,0,0,0,0,2024
BAS,  ,F   ,Costruzioni                                                 ,37,12,47,81,177,2024
BAS,  ,F 41,Costruzione di edifici                                      ,24,6,17,67,114,2024
BAS,  ,F 42,Ingegneria civile                                           ,3,0,0,1,4,2024
BAS,  ,F 43,Lavori di costruzione specializzati                         ,10,6,30,13,59,2024
BAS,  ,G   ,Commercio all'ingrosso e al dettaglio; riparazione di aut...,44,28,66,39,177,2024
BAS,  ,G 45,Commercio all'ingrosso e al dettaglio e riparazione di au...,4,4,14,6,28,2024
BAS,  ,G 46,Commercio all'ingrosso (escluso quello di autoveicoli e d...,23,6,10,12,51,2024
BAS,  ,G 47,Commercio al dettaglio (escluso quello di autoveicoli e d...,17,18,42,21,98,2024
BAS,  ,H   ,Trasporto e magazzinaggio                                   ,6,1,8,25,40,2024
BAS,  ,H 49,Trasporto terrestre e mediante condotte                     ,6,1,7,19,33,2024
BAS,  ,H 50,Trasporto marittimo e per vie d'acqua                       ,0,0,0,0,0,2024
BAS,  ,H 51,Trasporto aereo                                             ,0,0,0,0,0,2024
BAS,  ,H 52,Magazzinaggio e attività di supporto ai trasporti           ,0,0,0,6,6,2024
BAS,  ,H 53,Servizi postali e attività di corriere                      ,0,0,1,0,1,2024
BAS,  ,I   ,Attività dei servizi alloggio e ristorazione                ,12,18,18,17,65,2024
BAS,  ,I 55,Alloggio                                                    ,5,2,1,1,9,2024
BAS,  ,I 56,Attività dei servizi di ristorazione                        ,7,16,17,16,56,2024
BAS,  ,J   ,Servizi di informazione e comunicazione                     ,9,1,4,20,34,2024
BAS,  ,J 58,Attività editoriali                                         ,0,0,0,2,2,2024
BAS,  ,J 59,"Attività di produzione cinematografica, di video e di pro...",0,0,2,1,3,2024
BAS,  ,J 60,Attività di programmazione e trasmissione                   ,2,0,0,0,2,2024
BAS,  ,J 61,Telecomunicazioni                                           ,0,0,1,2,3,2024
BAS,  ,J 62,"Produzione di software, consulenza informatica e attività...",4,1,0,2,7,2024
BAS,  ,J 63,Attività dei servizi d'informazione e altri servizi infor...,3,0,1,13,17,2024
BAS,  ,K   ,Attività finanziarie e assicurative                         ,3,3,1,1,8,2024
BAS,  ,K 64,Attività di servizi finanziari (escluse le assicurazioni ...,2,1,0,0,3,2024
BAS,  ,K 65,"Assicurazioni, riassicurazioni e fondi pensione (escluse ...",0,0,0,0,0,2024
BAS,  ,K 66,Attività ausiliarie dei servizi finanziari e delle attivi...,1,2,1,1,5,2024
BAS,  ,L   ,Attivita' immobiliari                                       ,1,0,1,2,4,2024
BAS,  ,L 68,Attivita' immobiliari                                       ,1,0,1,2,4,2024
BAS,  ,M   ,"Attività professionali, scientifiche e tecniche             ",8,1,2,20,31,2024
BAS,  ,M 69,Attività legali e contabilità                               ,0,0,0,2,2,2024
BAS,  ,M 70,Attività di direzione aziendale e di consulenza gestional...,2,1,0,5,8,2024
BAS,  ,M 71,Attività degli studi di architettura e d'ingegneria; coll...,2,0,0,2,4,2024
BAS,  ,M 72,Ricerca scientifica e sviluppo                              ,0,0,0,1,1,2024
BAS,  ,M 73,Pubblicità e ricerche di mercato                            ,3,0,1,4,8,2024
BAS,  ,M 74,"Altre attività professionali, scientifiche e tecniche       ",1,0,1,6,8,2024
BAS,  ,M 75,Servizi veterinari                                          ,0,0,0,0,0,2024
BAS,  ,N   ,"Noleggio, agenzie di viaggio, servizi di supporto alle im...",4,3,6,45,58,2024
BAS,  ,N 77,Attività di noleggio e leasing operativo                    ,1,0,0,0,1,2024
BAS,  ,N 78,"Attività di ricerca, selezione, fornitura di personale      ",0,0,0,0,0,2024
BAS,  ,N 79,"Attività dei servizi delle agenzie di viaggio, dei tour o...",1,1,0,3,5,2024
BAS,  ,N 80,Servizi di vigilanza e investigazione                       ,0,0,0,1,1,2024
BAS,  ,N 81,Attività di servizi per edifici e paesaggio                 ,1,0,5,29,35,2024
BAS,  ,N 82,Attività di supporto per le funzioni d'ufficio e altri se...,1,2,1,12,16,2024
BAS,  ,O   ,Amministrazione pubblica e difesa; assicurazione sociale ...,0,0,0,0,0,2024
BAS,  ,O 84,Amministrazione pubblica e difesa; assicurazione sociale ...,0,0,0,0,0,2024
BAS,  ,P   ,Istruzione                                                  ,0,4,0,7,11,2024
BAS,  ,P 85,Istruzione                                                  ,0,4,0,7,11,2024
BAS,  ,Q   ,Sanita' e assistenza sociale                                ,2,0,0,12,14,2024
BAS,  ,Q 86,Assistenza sanitaria                                        ,2,0,0,0,2,2024
BAS,  ,Q 87,Servizi di assistenza sociale residenziale                  ,0,0,0,2,2,2024
BAS,  ,Q 88,Assistenza sociale non residenziale                         ,0,0,0,10,10,2024
BAS,  ,R   ,"Attività artistiche, sportive, di intrattenimento e diver...",3,1,2,16,22,2024
BAS,  ,R 90,"Attività creative, artistiche e di intrattenimento          ",0,0,0,5,5,2024
BAS,  ,R 91,"Attività di biblioteche, archivi, musei ed altre attività...",0,0,0,1,1,2024
BAS,  ,R 92,"Attività riguardanti le lotterie, le scommesse, le case d...",0,0,1,0,1,2024
BAS,  ,R 93,"Attività sportive, di intrattenimento e di divertimento     ",3,1,1,10,15,2024
BAS,  ,S   ,Altre attività di servizi                                   ,0,0,13,7,20,2024
BAS,  ,S 94,Attività di organizzazioni associative                      ,0,0,0,0,0,2024
BAS,  ,S 95,Riparazione di computer e di beni per uso personale e per...,0,0,1,1,2,2024
BAS,  ,S 96,Altre attività di servizi per la persona                    ,0,0,12,6,18,2024
BAS,  ,T   ,Attività di famiglie e convivenze come datori di lavoro p...,0,0,0,0,0,2024
BAS,  ,T 97,Attività di famiglie e convivenze come datori di lavoro p...,0,0,0,0,0,2024
BAS,  ,T 98,Produzione di beni e servizi indifferenziati per uso prop...,0,0,0,0,0,2024
BAS,  ,U   ,Organizzazioni ed organismi extraterritoriali               ,0,0,0,0,0,2024
BAS,  ,U 99,Organizzazioni ed organismi extraterritoriali               ,0,0,0,0,0,2024
BAS,  ,XX  ,Imprese non classificate                                    ,75,22,14,76,187,2024
BAS,  ,TOT ,TOTALE                                                      ,241,113,276,451,1081,2024
BAS,PZ,A   ,"Agricoltura, silvicoltura pesca                             ",4,4,54,40,102,2024
BAS,PZ,A 01,"Coltivazioni agricole e produzione di prodotti animali, c...",4,4,50,37,95,2024
BAS,PZ,A 02,Silvicoltura ed utilizzo di aree forestali                  ,0,0,4,2,6,2024
BAS,PZ,A 03,Pesca e acquacoltura                                        ,0,0,0,1,1,2024
BAS,PZ,B   ,Estrazione di minerali da cave e miniere                    ,0,1,1,0,2,2024
BAS,PZ,B 05,Estrazione di carbone (esclusa torba)                       ,0,0,0,0,0,2024
BAS,PZ,B 06,Estraz.di petrolio greggio e di gas naturale                ,0,0,0,0,0,2024
BAS,PZ,B 07,Estrazione di minerali metalliferi                          ,0,0,0,0,0,2024
BAS,PZ,B 08,Altre attività di estrazione di minerali da cave e miniere  ,0,1,1,0,2,2024
BAS,PZ,B 09,Attività dei servizi di supporto all'estrazione             ,0,0,0,0,0,2024
BAS,PZ,C   ,Attività manifatturiere                                     ,20,9,16,21,66,2024
BAS,PZ,C 10,Industrie alimentari                                        ,5,2,4,4,15,2024
BAS,PZ,C 11,Industria delle bevande                                     ,0,0,0,0,0,2024
BAS,PZ,C 12,Industria del tabacco                                       ,0,0,0,0,0,2024
BAS,PZ,C 13,Industrie tessili                                           ,0,0,0,0,0,2024
BAS,PZ,C 14,Confezione di articoli di abbigliamento; confezione di ar...,3,2,0,5,10,2024
BAS,PZ,C 15,Fabbricazione di articoli in pelle e simili                 ,0,1,0,0,1,2024
BAS,PZ,C 16,Industria del legno e dei prodotti in legno e sughero (es...,2,1,3,1,7,2024
BAS,PZ,C 17,Fabbricazione di carta e di prodotti di carta               ,0,0,0,0,0,2024
BAS,PZ,C 18,Stampa e riproduzione di supporti registrati                ,1,0,0,0,1,2024
BAS,PZ,C 19,Fabbricazione di coke e prodotti derivanti dalla raffinaz...,0,0,0,0,0,2024
BAS,PZ,C 20,Fabbricazione di prodotti chimici                           ,0,0,0,0,0,2024
BAS,PZ,C 21,Fabbricazione di prodotti farmaceutici di base e di prepa...,0,0,0,0,0,2024
BAS,PZ,C 22,Fabbricazione di articoli in gomma e materie plastiche      ,1,2,0,0,3,2024
BAS,PZ,C 23,Fabbricazione di altri prodotti della lavorazione di miner..,1,0,1,2,4,2024
BAS,PZ,C 24,Metallurgia                                                 ,1,0,0,0,1,2024
BAS,PZ,C 25,Fabbricazione di prodotti in metallo (esclusi macchinari ...,2,0,5,3,10,2024
BAS,PZ,C 26,Fabbricazione di computer e prodotti di elettronica e ott...,0,0,0,0,0,2024
BAS,PZ,C 27,Fabbricazione di apparecchiature elettriche ed apparecchi...,2,0,0,3,5,2024
BAS,PZ,C 28,Fabbricazione di macchinari ed apparecchiature nca          ,0,1,0,2,3,2024
BAS,PZ,C 29,"Fabbricazione di autoveicoli, rimorchi e semirimorchi       ",1,0,0,0,1,2024
BAS,PZ,C 30,Fabbricazione di altri mezzi di trasporto                   ,0,0,0,0,0,2024
BAS,PZ,C 31,Fabbricazione di mobili                                     ,0,0,1,0,1,2024
BAS,PZ,C 32,Altre industrie manifatturiere                              ,1,0,1,1,3,2024
BAS,PZ,C 33,"Riparazione, manutenzione ed installazione di macchine ed...",0,0,1,0,1,2024
BAS,PZ,D   ,"Fornitura di energia elettrica, gas, vapore e aria condiz...",0,0,0,0,0,2024
BAS,PZ,D 35,"Fornitura di energia elettrica, gas, vapore e aria condiz...",0,0,0,0,0,2024
BAS,PZ,E   ,"Fornitura di acqua; reti fognarie, attività di gestione d...",0,0,0,2,2,2024
BAS,PZ,E 36,"Raccolta, trattamento e fornitura di acqua                  ",0,0,0,1,1,2024
BAS,PZ,E 37,Gestione delle reti fognarie                                ,0,0,0,0,0,2024
BAS,PZ,E 38,"Attività di raccolta, trattamento e smaltimento dei rifiu...",0,0,0,1,1,2024
BAS,PZ,E 39,Attività di risanamento e altri servizi di gestione dei r...,0,0,0,0,0,2024
BAS,PZ,F   ,Costruzioni                                                 ,33,9,40,45,127,2024
BAS,PZ,F 41,Costruzione di edifici                                      ,21,5,13,35,74,2024
BAS,PZ,F 42,Ingegneria civile                                           ,3,0,0,0,3,2024
BAS,PZ,F 43,Lavori di costruzione specializzati                         ,9,4,27,10,50,2024
BAS,PZ,G   ,Commercio all'ingrosso e al dettaglio; riparazione di aut...,33,19,49,24,125,2024
BAS,PZ,G 45,Commercio all'ingrosso e al dettaglio e riparazione di au...,0,4,12,4,20,2024
BAS,PZ,G 46,Commercio all'ingrosso (escluso quello di autoveicoli e d...,17,6,7,10,40,2024
BAS,PZ,G 47,Commercio al dettaglio (escluso quello di autoveicoli e d...,16,9,30,10,65,2024
BAS,PZ,H   ,Trasporto e magazzinaggio                                   ,6,1,6,13,26,2024
BAS,PZ,H 49,Trasporto terrestre e mediante condotte                     ,6,1,5,10,22,2024
BAS,PZ,H 50,Trasporto marittimo e per vie d'acqua                       ,0,0,0,0,0,2024
BAS,PZ,H 51,Trasporto aereo                                             ,0,0,0,0,0,2024
BAS,PZ,H 52,Magazzinaggio e attività di supporto ai trasporti           ,0,0,0,3,3,2024
BAS,PZ,H 53,Servizi postali e attività di corriere                      ,0,0,1,0,1,2024
BAS,PZ,I   ,Attività dei servizi alloggio e ristorazione                ,10,8,15,15,48,2024
BAS,PZ,I 55,Alloggio                                                    ,4,1,1,1,7,2024
BAS,PZ,I 56,Attività dei servizi di ristorazione                        ,6,7,14,14,41,2024
BAS,PZ,J   ,Servizi di informazione e comunicazione                     ,6,1,3,12,22,2024
BAS,PZ,J 58,Attività editoriali                                         ,0,0,0,0,0,2024
BAS,PZ,J 59,"Attività di produzione cinematografica, di video e di pro...",0,0,1,0,1,2024
BAS,PZ,J 60,Attività di programmazione e trasmissione                   ,1,0,0,0,1,2024
BAS,PZ,J 61,Telecomunicazioni                                           ,0,0,1,2,3,2024
BAS,PZ,J 62,"Produzione di software, consulenza informatica e attività...",3,1,0,1,5,2024
BAS,PZ,J 63,Attività dei servizi d'informazione e altri servizi infor...,2,0,1,9,12,2024
BAS,PZ,K   ,Attività finanziarie e assicurative                         ,1,3,0,1,5,2024
BAS,PZ,K 64,Attività di servizi finanziari (escluse le assicurazioni ...,0,1,0,0,1,2024
BAS,PZ,K 65,"Assicurazioni, riassicurazioni e fondi pensione (escluse ...",0,0,0,0,0,2024
BAS,PZ,K 66,Attività ausiliarie dei servizi finanziari e delle attivi...,1,2,0,1,4,2024
BAS,PZ,L   ,Attivita' immobiliari                                       ,1,0,1,1,3,2024
BAS,PZ,L 68,Attivita' immobiliari                                       ,1,0,1,1,3,2024
BAS,PZ,M   ,"Attività professionali, scientifiche e tecniche             ",8,1,2,16,27,2024
BAS,PZ,M 69,Attività legali e contabilità                               ,0,0,0,2,2,2024
BAS,PZ,M 70,Attività di direzione aziendale e di consulenza gestional...,2,1,0,4,7,2024
BAS,PZ,M 71,Attività degli studi di architettura e d'ingegneria; coll...,2,0,0,1,3,2024
BAS,PZ,M 72,Ricerca scientifica e sviluppo                              ,0,0,0,1,1,2024
BAS,PZ,M 73,Pubblicità e ricerche di mercato                            ,3,0,1,4,8,2024
BAS,PZ,M 74,"Altre attività professionali, scientifiche e tecniche       ",1,0,1,4,6,2024
BAS,PZ,M 75,Servizi veterinari                                          ,0,0,0,0,0,2024
BAS,PZ,N   ,"Noleggio, agenzie di viaggio, servizi di supporto alle im...",1,3,3,24,31,2024
BAS,PZ,N 77,Attività di noleggio e leasing operativo                    ,0,0,0,0,0,2024
BAS,PZ,N 78,"Attività di ricerca, selezione, fornitura di personale      ",0,0,0,0,0,2024
BAS,PZ,N 79,"Attività dei servizi delle agenzie di viaggio, dei tour o...",0,1,0,3,4,2024
BAS,PZ,N 80,Servizi di vigilanza e investigazione                       ,0,0,0,1,1,2024
BAS,PZ,N 81,Attività di servizi per edifici e paesaggio                 ,0,0,2,10,12,2024
BAS,PZ,N 82,Attività di supporto per le funzioni d'ufficio e altri se...,1,2,1,10,14,2024
BAS,PZ,O   ,Amministrazione pubblica e difesa; assicurazione sociale ...,0,0,0,0,0,2024
BAS,PZ,O 84,Amministrazione pubblica e difesa; assicurazione sociale ...,0,0,0,0,0,2024
BAS,PZ,P   ,Istruzione                                                  ,0,4,0,1,5,2024
BAS,PZ,P 85,Istruzione                                                  ,0,4,0,1,5,2024
BAS,PZ,Q   ,Sanita' e assistenza sociale                                ,2,0,0,8,10,2024
BAS,PZ,Q 86,Assistenza sanitaria                                        ,2,0,0,0,2,2024
BAS,PZ,Q 87,Servizi di assistenza sociale residenziale                  ,0,0,0,2,2,2024
BAS,PZ,Q 88,Assistenza sociale non residenziale                         ,0,0,0,6,6,2024
BAS,PZ,R   ,"Attività artistiche, sportive, di intrattenimento e diver...",2,0,2,12,16,2024
BAS,PZ,R 90,"Attività creative, artistiche e di intrattenimento          ",0,0,0,2,2,2024
BAS,PZ,R 91,"Attività di biblioteche, archivi, musei ed altre attività...",0,0,0,1,1,2024
BAS,PZ,R 92,"Attività riguardanti le lotterie, le scommesse, le case d...",0,0,1,0,1,2024
BAS,PZ,R 93,"Attività sportive, di intrattenimento e di divertimento     ",2,0,1,9,12,2024
BAS,PZ,S   ,Altre attività di servizi                                   ,0,0,10,4,14,2024
BAS,PZ,S 94,Attività di organizzazioni associative                      ,0,0,0,0,0,2024
BAS,PZ,S 95,Riparazione di computer e di beni per uso personale e per...,0,0,1,1,2,2024
BAS,PZ,S 96,Altre attività di servizi per la persona                    ,0,0,9,3,12,2024
BAS,PZ,T   ,Attività di famiglie e convivenze come datori di lavoro p...,0,0,0,0,0,2024
BAS,PZ,T 97,Attività di famiglie e convivenze come datori di lavoro p...,0,0,0,0,0,2024
BAS,PZ,T 98,Produzione di beni e servizi indifferenziati per uso prop...,0,0,0,0,0,2024
BAS,PZ,U   ,Organizzazioni ed organismi extraterritoriali               ,0,0,0,0,0,2024
BAS,PZ,U 99,Organizzazioni ed organismi extraterritoriali               ,0,0,0,0,0,2024
BAS,PZ,XX  ,Imprese non classificate                                    ,72,17,12,42,143,2024
BAS,PZ,TOT ,TOTALE                                                      ,199,80,214,281,774,2024
BAS,MT,A   ,"Agricoltura, silvicoltura pesca                             ",2,3,19,13,37,2024
BAS,MT,A 01,"Coltivazioni agricole e produzione di prodotti animali, c...",2,3,19,13,37,2024
BAS,MT,A 02,Silvicoltura ed utilizzo di aree forestali                  ,0,0,0,0,0,2024
BAS,MT,A 03,Pesca e acquacoltura                                        ,0,0,0,0,0,2024
BAS,MT,B   ,Estrazione di minerali da cave e miniere                    ,0,0,0,0,0,2024
BAS,MT,B 05,Estrazione di carbone (esclusa torba)                       ,0,0,0,0,0,2024
BAS,MT,B 06,Estraz.di petrolio greggio e di gas naturale                ,0,0,0,0,0,2024
BAS,MT,B 07,Estrazione di minerali metalliferi                          ,0,0,0,0,0,2024
BAS,MT,B 08,Altre attività di estrazione di minerali da cave e miniere  ,0,0,0,0,0,2024
BAS,MT,B 09,Attività dei servizi di supporto all'estrazione             ,0,0,0,0,0,2024
BAS,MT,C   ,Attività manifatturiere                                     ,11,2,4,7,24,2024
BAS,MT,C 10,Industrie alimentari                                        ,1,0,1,3,5,2024
BAS,MT,C 11,Industria delle bevande                                     ,0,0,0,0,0,2024
BAS,MT,C 12,Industria del tabacco                                       ,0,0,0,0,0,2024
BAS,MT,C 13,Industrie tessili                                           ,1,0,0,0,1,2024
BAS,MT,C 14,Confezione di articoli di abbigliamento; confezione di ar...,2,0,1,2,5,2024
BAS,MT,C 15,Fabbricazione di articoli in pelle e simili                 ,0,0,0,0,0,2024
BAS,MT,C 16,Industria del legno e dei prodotti in legno e sughero (es...,0,0,0,0,0,2024
BAS,MT,C 17,Fabbricazione di carta e di prodotti di carta               ,0,0,0,0,0,2024
BAS,MT,C 18,Stampa e riproduzione di supporti registrati                ,0,0,0,0,0,2024
BAS,MT,C 19,Fabbricazione di coke e prodotti derivanti dalla raffinaz...,0,0,0,0,0,2024
BAS,MT,C 20,Fabbricazione di prodotti chimici                           ,0,0,0,0,0,2024
BAS,MT,C 21,Fabbricazione di prodotti farmaceutici di base e di prepa...,0,0,0,0,0,2024
BAS,MT,C 22,Fabbricazione di articoli in gomma e materie plastiche      ,0,0,0,0,0,2024
BAS,MT,C 23,Fabbricazione di altri prodotti della lavorazione di miner..,0,0,0,0,0,2024
BAS,MT,C 24,Metallurgia                                                 ,0,0,0,0,0,2024
BAS,MT,C 25,Fabbricazione di prodotti in metallo (esclusi macchinari ...,2,0,1,1,4,2024
BAS,MT,C 26,Fabbricazione di computer e prodotti di elettronica e ott...,0,1,0,0,1,2024
BAS,MT,C 27,Fabbricazione di apparecchiature elettriche ed apparecchi...,2,0,0,0,2,2024
BAS,MT,C 28,Fabbricazione di macchinari ed apparecchiature nca          ,0,0,0,0,0,2024
BAS,MT,C 29,"Fabbricazione di autoveicoli, rimorchi e semirimorchi       ",0,0,0,0,0,2024
BAS,MT,C 30,Fabbricazione di altri mezzi di trasporto                   ,0,0,0,0,0,2024
BAS,MT,C 31,Fabbricazione di mobili                                     ,3,0,1,1,5,2024
BAS,MT,C 32,Altre industrie manifatturiere                              ,0,1,0,0,1,2024
BAS,MT,C 33,"Riparazione, manutenzione ed installazione di macchine ed...",0,0,0,0,0,2024
BAS,MT,D   ,"Fornitura di energia elettrica, gas, vapore e aria condiz...",0,0,0,0,0,2024
BAS,MT,D 35,"Fornitura di energia elettrica, gas, vapore e aria condiz...",0,0,0,0,0,2024
BAS,MT,E   ,"Fornitura di acqua; reti fognarie, attività di gestione d...",0,0,0,0,0,2024
BAS,MT,E 36,"Raccolta, trattamento e fornitura di acqua                  ",0,0,0,0,0,2024
BAS,MT,E 37,Gestione delle reti fognarie                                ,0,0,0,0,0,2024
BAS,MT,E 38,"Attività di raccolta, trattamento e smaltimento dei rifiu...",0,0,0,0,0,2024
BAS,MT,E 39,Attività di risanamento e altri servizi di gestione dei r...,0,0,0,0,0,2024
BAS,MT,F   ,Costruzioni                                                 ,4,3,7,36,50,2024
BAS,MT,F 41,Costruzione di edifici                                      ,3,1,4,32,40,2024
BAS,MT,F 42,Ingegneria civile                                           ,0,0,0,1,1,2024
BAS,MT,F 43,Lavori di costruzione specializzati                         ,1,2,3,3,9,2024
BAS,MT,G   ,Commercio all'ingrosso e al dettaglio; riparazione di aut...,11,9,17,15,52,2024
BAS,MT,G 45,Commercio all'ingrosso e al dettaglio e riparazione di au...,4,0,2,2,8,2024
BAS,MT,G 46,Commercio all'ingrosso (escluso quello di autoveicoli e d...,6,0,3,2,11,2024
BAS,MT,G 47,Commercio al dettaglio (escluso quello di autoveicoli e d...,1,9,12,11,33,2024
BAS,MT,H   ,Trasporto e magazzinaggio                                   ,0,0,2,12,14,2024
BAS,MT,H 49,Trasporto terrestre e mediante condotte                     ,0,0,2,9,11,2024
BAS,MT,H 50,Trasporto marittimo e per vie d'acqua                       ,0,0,0,0,0,2024
BAS,MT,H 51,Trasporto aereo                                             ,0,0,0,0,0,2024
BAS,MT,H 52,Magazzinaggio e attività di supporto ai trasporti           ,0,0,0,3,3,2024
BAS,MT,H 53,Servizi postali e attività di corriere                      ,0,0,0,0,0,2024
BAS,MT,I   ,Attività dei servizi alloggio e ristorazione                ,2,10,3,2,17,2024
BAS,MT,I 55,Alloggio                                                    ,1,1,0,0,2,2024
BAS,MT,I 56,Attività dei servizi di ristorazione                        ,1,9,3,2,15,2024
BAS,MT,J   ,Servizi di informazione e comunicazione                     ,3,0,1,8,12,2024
BAS,MT,J 58,Attività editoriali                                         ,0,0,0,2,2,2024
BAS,MT,J 59,"Attività di produzione cinematografica, di video e di pro...",0,0,1,1,2,2024
BAS,MT,J 60,Attività di programmazione e trasmissione                   ,1,0,0,0,1,2024
BAS,MT,J 61,Telecomunicazioni                                           ,0,0,0,0,0,2024
BAS,MT,J 62,"Produzione di software, consulenza informatica e attività...",1,0,0,1,2,2024
BAS,MT,J 63,Attività dei servizi d'informazione e altri servizi infor...,1,0,0,4,5,2024
BAS,MT,K   ,Attività finanziarie e assicurative                         ,2,0,1,0,3,2024
BAS,MT,K 64,Attività di servizi finanziari (escluse le assicurazioni ...,2,0,0,0,2,2024
BAS,MT,K 65,"Assicurazioni, riassicurazioni e fondi pensione (escluse ...",0,0,0,0,0,2024
BAS,MT,K 66,Attività ausiliarie dei servizi finanziari e delle attivi...,0,0,1,0,1,2024
BAS,MT,L   ,Attivita' immobiliari                                       ,0,0,0,1,1,2024
BAS,MT,L 68,Attivita' immobiliari                                       ,0,0,0,1,1,2024
BAS,MT,M   ,"Attività professionali, scientifiche e tecniche             ",0,0,0,4,4,2024
BAS,MT,M 69,Attività legali e contabilità                               ,0,0,0,0,0,2024
BAS,MT,M 70,Attività di direzione aziendale e di consulenza gestional...,0,0,0,1,1,2024
BAS,MT,M 71,Attività degli studi di architettura e d'ingegneria; coll...,0,0,0,1,1,2024
BAS,MT,M 72,Ricerca scientifica e sviluppo                              ,0,0,0,0,0,2024
BAS,MT,M 73,Pubblicità e ricerche di mercato                            ,0,0,0,0,0,2024
BAS,MT,M 74,"Altre attività professionali, scientifiche e tecniche       ",0,0,0,2,2,2024
BAS,MT,M 75,Servizi veterinari                                          ,0,0,0,0,0,2024
BAS,MT,N   ,"Noleggio, agenzie di viaggio, servizi di supporto alle im...",3,0,3,21,27,2024
BAS,MT,N 77,Attività di noleggio e leasing operativo                    ,1,0,0,0,1,2024
BAS,MT,N 78,"Attività di ricerca, selezione, fornitura di personale      ",0,0,0,0,0,2024
BAS,MT,N 79,"Attività dei servizi delle agenzie di viaggio, dei tour o...",1,0,0,0,1,2024
BAS,MT,N 80,Servizi di vigilanza e investigazione                       ,0,0,0,0,0,2024
BAS,MT,N 81,Attività di servizi per edifici e paesaggio                 ,1,0,3,19,23,2024
BAS,MT,N 82,Attività di supporto per le funzioni d'ufficio e altri se...,0,0,0,2,2,2024
BAS,MT,O   ,Amministrazione pubblica e difesa; assicurazione sociale ...,0,0,0,0,0,2024
BAS,MT,O 84,Amministrazione pubblica e difesa; assicurazione sociale ...,0,0,0,0,0,2024
BAS,MT,P   ,Istruzione                                                  ,0,0,0,6,6,2024
BAS,MT,P 85,Istruzione                                                  ,0,0,0,6,6,2024
BAS,MT,Q   ,Sanita' e assistenza sociale                                ,0,0,0,4,4,2024
BAS,MT,Q 86,Assistenza sanitaria                                        ,0,0,0,0,0,2024
BAS,MT,Q 87,Servizi di assistenza sociale residenziale                  ,0,0,0,0,0,2024
BAS,MT,Q 88,Assistenza sociale non residenziale                         ,0,0,0,4,4,2024
BAS,MT,R   ,"Attività artistiche, sportive, di intrattenimento e diver...",1,1,0,4,6,2024
BAS,MT,R 90,"Attività creative, artistiche e di intrattenimento          ",0,0,0,3,3,2024
BAS,MT,R 91,"Attività di biblioteche, archivi, musei ed altre attività...",0,0,0,0,0,2024
BAS,MT,R 92,"Attività riguardanti le lotterie, le scommesse, le case d...",0,0,0,0,0,2024
BAS,MT,R 93,"Attività sportive, di intrattenimento e di divertimento     ",1,1,0,1,3,2024
BAS,MT,S   ,Altre attività di servizi                                   ,0,0,3,3,6,2024
BAS,MT,S 94,Attività di organizzazioni associative                      ,0,0,0,0,0,2024
BAS,MT,S 95,Riparazione di computer e di beni per uso personale e per...,0,0,0,0,0,2024
BAS,MT,S 96,Altre attività di servizi per la persona                    ,0,0,3,3,6,2024
BAS,MT,T   ,Attività di famiglie e convivenze come datori di lavoro p...,0,0,0,0,0,2024
BAS,MT,T 97,Attività di famiglie e convivenze come datori di lavoro p...,0,0,0,0,0,2024
BAS,MT,T 98,Produzione di beni e servizi indifferenziati per uso prop...,0,0,0,0,0,2024
BAS,MT,U   ,Organizzazioni ed organismi extraterritoriali               ,0,0,0,0,0,2024
BAS,MT,U 99,Organizzazioni ed organismi extraterritoriali               ,0,0,0,0,0,2024
BAS,MT,XX  ,Imprese non classificate                                    ,3,5,2,34,44,2024
BAS,MT,TOT ,TOTALE                                                      ,42,33,62,170,307,2024
CAL,  ,A   ,"Agricoltura, silvicoltura pesca                             ",5,1,778,244,1028,2024
CAL,  ,A 01,"Coltivazioni agricole e produzione di prodotti animali, c...",4,1,760,229,994,2024
CAL,  ,A 02,Silvicoltura ed utilizzo di aree forestali                  ,1,0,13,8,22,2024
CAL,  ,A 03,Pesca e acquacoltura                                        ,0,0,5,7,12,2024
CAL,  ,B   ,Estrazione di minerali da cave e miniere                    ,1,0,4,0,5,2024
CAL,  ,B 05,Estrazione di carbone (esclusa torba)                       ,0,0,0,0,0,2024
CAL,  ,B 06,Estraz.di petrolio greggio e di gas naturale                ,0,0,0,0,0,2024
CAL,  ,B 07,Estrazione di minerali metalliferi                          ,0,0,0,0,0,2024
CAL,  ,B 08,Altre attività di estrazione di minerali da cave e miniere  ,1,0,4,0,5,2024
CAL,  ,B 09,Attività dei servizi di supporto all'estrazione             ,0,0,0,0,0,2024
CAL,  ,C   ,Attività manifatturiere                                     ,39,2,180,53,274,2024
CAL,  ,C 10,Industrie alimentari                                        ,6,0,47,13,66,2024
CAL,  ,C 11,Industria delle bevande                                     ,0,0,1,0,1,2024
CAL,  ,C 12,Industria del tabacco                                       ,0,0,0,0,0,2024
CAL,  ,C 13,Industrie tessili                                           ,0,0,7,4,11,2024
CAL,  ,C 14,Confezione di articoli di abbigliamento; confezione di ar...,2,1,14,5,22,2024
CAL,  ,C 15,Fabbricazione di articoli in pelle e simili                 ,0,0,2,0,2,2024
CAL,  ,C 16,Industria del legno e dei prodotti in legno e sughero (es...,1,0,25,2,28,2024
CAL,  ,C 17,Fabbricazione di carta e di prodotti di carta               ,3,0,1,1,5,2024
CAL,  ,C 18,Stampa e riproduzione di supporti registrati                ,0,0,7,7,14,2024
CAL,  ,C 19,Fabbricazione di coke e prodotti derivanti dalla raffinaz...,0,0,0,0,0,2024
CAL,  ,C 20,Fabbricazione di prodotti chimici                           ,2,0,1,2,5,2024
CAL,  ,C 21,Fabbricazione di prodotti farmaceutici di base e di prepa...,0,0,0,0,0,2024
CAL,  ,C 22,Fabbricazione di articoli in gomma e materie plastiche      ,2,0,2,0,4,2024
CAL,  ,C 23,Fabbricazione di altri prodotti della lavorazione di miner..,4,0,13,4,21,2024
CAL,  ,C 24,Metallurgia                                                 ,0,0,0,0,0,2024
CAL,  ,C 25,Fabbricazione di prodotti in metallo (esclusi macchinari ...,2,1,29,5,37,2024
CAL,  ,C 26,Fabbricazione di computer e prodotti di elettronica e ott...,5,0,4,1,10,2024
CAL,  ,C 27,Fabbricazione di apparecchiature elettriche ed apparecchi...,2,0,1,1,4,2024
CAL,  ,C 28,Fabbricazione di macchinari ed apparecchiature nca          ,2,0,5,0,7,2024
CAL,  ,C 29,"Fabbricazione di autoveicoli, rimorchi e semirimorchi       ",0,0,0,0,0,2024
CAL,  ,C 30,Fabbricazione di altri mezzi di trasporto                   ,1,0,1,1,3,2024
CAL,  ,C 31,Fabbricazione di mobili                                     ,3,0,8,1,12,2024
CAL,  ,C 32,Altre industrie manifatturiere                              ,3,0,7,6,16,2024
CAL,  ,C 33,"Riparazione, manutenzione ed installazione di macchine ed...",1,0,5,0,6,2024
CAL,  ,D   ,"Fornitura di energia elettrica, gas, vapore e aria condiz...",2,0,2,0,4,2024
CAL,  ,D 35,"Fornitura di energia elettrica, gas, vapore e aria condiz...",2,0,2,0,4,2024
CAL,  ,E   ,"Fornitura di acqua; reti fognarie, attività di gestione d...",2,1,4,16,23,2024
CAL,  ,E 36,"Raccolta, trattamento e fornitura di acqua                  ",0,0,0,0,0,2024
CAL,  ,E 37,Gestione delle reti fognarie                                ,0,0,2,1,3,2024
CAL,  ,E 38,"Attività di raccolta, trattamento e smaltimento dei rifiu...",2,1,2,3,8,2024
CAL,  ,E 39,Attività di risanamento e altri servizi di gestione dei r...,0,0,0,12,12,2024
CAL,  ,F   ,Costruzioni                                                 ,62,3,338,154,557,2024
CAL,  ,F 41,Costruzione di edifici                                      ,52,1,181,114,348,2024
CAL,  ,F 42,Ingegneria civile                                           ,4,0,5,12,21,2024
CAL,  ,F 43,Lavori di costruzione specializzati                         ,6,2,152,28,188,2024
CAL,  ,G   ,Commercio all'ingrosso e al dettaglio; riparazione di aut...,95,13,1038,74,1220,2024
CAL,  ,G 45,Commercio all'ingrosso e al dettaglio e riparazione di au...,13,2,115,6,136,2024
CAL,  ,G 46,Commercio all'ingrosso (escluso quello di autoveicoli e d...,37,4,214,36,291,2024
CAL,  ,G 47,Commercio al dettaglio (escluso quello di autoveicoli e d...,45,7,709,32,793,2024
CAL,  ,H   ,Trasporto e magazzinaggio                                   ,8,0,44,47,99,2024
CAL,  ,H 49,Trasporto terrestre e mediante condotte                     ,6,0,36,25,67,2024
CAL,  ,H 50,Trasporto marittimo e per vie d'acqua                       ,0,0,0,1,1,2024
CAL,  ,H 51,Trasporto aereo                                             ,0,0,0,0,0,2024
CAL,  ,H 52,Magazzinaggio e attività di supporto ai trasporti           ,2,0,3,20,25,2024
CAL,  ,H 53,Servizi postali e attività di corriere                      ,0,0,5,1,6,2024
CAL,  ,I   ,Attività dei servizi alloggio e ristorazione                ,26,8,233,20,287,2024
CAL,  ,I 55,Alloggio                                                    ,4,0,13,2,19,2024
CAL,  ,I 56,Attività dei servizi di ristorazione                        ,22,8,220,18,268,2024
CAL,  ,J   ,Servizi di informazione e comunicazione                     ,14,2,32,40,88,2024
CAL,  ,J 58,Attività editoriali                                         ,2,0,6,2,10,2024
CAL,  ,J 59,"Attività di produzione cinematografica, di video e di pro...",0,0,4,1,5,2024
CAL,  ,J 60,Attività di programmazione e trasmissione                   ,2,0,0,4,6,2024
CAL,  ,J 61,Telecomunicazioni                                           ,0,0,9,1,10,2024
CAL,  ,J 62,"Produzione di software, consulenza informatica e attività...",4,0,3,10,17,2024
CAL,  ,J 63,Attività dei servizi d'informazione e altri servizi infor...,6,2,10,22,40,2024
CAL,  ,K   ,Attività finanziarie e assicurative                         ,1,1,27,4,33,2024
CAL,  ,K 64,Attività di servizi finanziari (escluse le assicurazioni ...,0,0,0,2,2,2024
CAL,  ,K 65,"Assicurazioni, riassicurazioni e fondi pensione (escluse ...",0,0,0,0,0,2024
CAL,  ,K 66,Attività ausiliarie dei servizi finanziari e delle attivi...,1,1,27,2,31,2024
CAL,  ,L   ,Attivita' immobiliari                                       ,7,0,11,2,20,2024
CAL,  ,L 68,Attivita' immobiliari                                       ,7,0,11,2,20,2024
CAL,  ,M   ,"Attività professionali, scientifiche e tecniche             ",11,3,22,37,73,2024
CAL,  ,M 69,Attività legali e contabilità                               ,0,3,2,3,8,2024
CAL,  ,M 70,Attività di direzione aziendale e di consulenza gestional...,2,0,3,14,19,2024
CAL,  ,M 71,Attività degli studi di architettura e d'ingegneria; coll...,3,0,1,4,8,2024
CAL,  ,M 72,Ricerca scientifica e sviluppo                              ,1,0,0,2,3,2024
CAL,  ,M 73,Pubblicità e ricerche di mercato                            ,2,0,4,2,8,2024
CAL,  ,M 74,"Altre attività professionali, scientifiche e tecniche       ",3,0,12,12,27,2024
CAL,  ,M 75,Servizi veterinari                                          ,0,0,0,0,0,2024
CAL,  ,N   ,"Noleggio, agenzie di viaggio, servizi di supporto alle im...",15,1,66,96,178,2024
CAL,  ,N 77,Attività di noleggio e leasing operativo                    ,3,0,12,2,17,2024
CAL,  ,N 78,"Attività di ricerca, selezione, fornitura di personale      ",0,0,0,0,0,2024
CAL,  ,N 79,"Attività dei servizi delle agenzie di viaggio, dei tour o...",0,0,3,3,6,2024
CAL,  ,N 80,Servizi di vigilanza e investigazione                       ,2,0,4,0,6,2024
CAL,  ,N 81,Attività di servizi per edifici e paesaggio                 ,1,0,25,70,96,2024
CAL,  ,N 82,Attività di supporto per le funzioni d'ufficio e altri se...,9,1,22,21,53,2024
CAL,  ,O   ,Amministrazione pubblica e difesa; assicurazione sociale ...,0,0,0,1,1,2024
CAL,  ,O 84,Amministrazione pubblica e difesa; assicurazione sociale ...,0,0,0,1,1,2024
CAL,  ,P   ,Istruzione                                                  ,2,0,5,28,35,2024
CAL,  ,P 85,Istruzione                                                  ,2,0,5,28,35,2024
CAL,  ,Q   ,Sanita' e assistenza sociale                                ,3,0,3,41,47,2024
CAL,  ,Q 86,Assistenza sanitaria                                        ,2,0,1,1,4,2024
CAL,  ,Q 87,Servizi di assistenza sociale residenziale                  ,1,0,1,8,10,2024
CAL,  ,Q 88,Assistenza sociale non residenziale                         ,0,0,1,32,33,2024
CAL,  ,R   ,"Attività artistiche, sportive, di intrattenimento e diver...",7,1,28,19,55,2024
CAL,  ,R 90,"Attività creative, artistiche e di intrattenimento          ",2,1,8,9,20,2024
CAL,  ,R 91,"Attività di biblioteche, archivi, musei ed altre attività...",0,0,0,4,4,2024
CAL,  ,R 92,"Attività riguardanti le lotterie, le scommesse, le case d...",1,0,3,0,4,2024
CAL,  ,R 93,"Attività sportive, di intrattenimento e di divertimento     ",4,0,17,6,27,2024
CAL,  ,S   ,Altre attività di servizi                                   ,0,0,43,16,59,2024
CAL,  ,S 94,Attività di organizzazioni associative                      ,0,0,0,2,2,2024
CAL,  ,S 95,Riparazione di computer e di beni per uso personale e per...,0,0,17,3,20,2024
CAL,  ,S 96,Altre attività di servizi per la persona                    ,0,0,26,11,37,2024
CAL,  ,T   ,Attività di famiglie e convivenze come datori di lavoro p...,0,0,0,0,0,2024
CAL,  ,T 97,Attività di famiglie e convivenze come datori di lavoro p...,0,0,0,0,0,2024
CAL,  ,T 98,Produzione di beni e servizi indifferenziati per uso prop...,0,0,0,0,0,2024
CAL,  ,U   ,Organizzazioni ed organismi extraterritoriali               ,0,0,0,0,0,2024
CAL,  ,U 99,Organizzazioni ed organismi extraterritoriali               ,0,0,0,0,0,2024
CAL,  ,XX  ,Imprese non classificate                                    ,195,26,106,361,688,2024
CAL,  ,TOT ,TOTALE                                                      ,495,62,2964,1253,4774,2024
CAL,CS,A   ,"Agricoltura, silvicoltura pesca                             ",0,0,775,156,931,2024
CAL,CS,A 01,"Coltivazioni agricole e produzione di prodotti animali, c...",0,0,757,145,902,2024
CAL,CS,A 02,Silvicoltura ed utilizzo di aree forestali                  ,0,0,13,7,20,2024
CAL,CS,A 03,Pesca e acquacoltura                                        ,0,0,5,4,9,2024
CAL,CS,B   ,Estrazione di minerali da cave e miniere                    ,0,0,4,0,4,2024
CAL,CS,B 05,Estrazione di carbone (esclusa torba)                       ,0,0,0,0,0,2024
CAL,CS,B 06,Estraz.di petrolio greggio e di gas naturale                ,0,0,0,0,0,2024
CAL,CS,B 07,Estrazione di minerali metalliferi                          ,0,0,0,0,0,2024
CAL,CS,B 08,Altre attività di estrazione di minerali da cave e miniere  ,0,0,4,0,4,2024
CAL,CS,B 09,Attività dei servizi di supporto all'estrazione             ,0,0,0,0,0,2024
CAL,CS,C   ,Attività manifatturiere                                     ,0,0,180,20,200,2024
CAL,CS,C 10,Industrie alimentari                                        ,0,0,47,7,54,2024
CAL,CS,C 11,Industria delle bevande                                     ,0,0,1,0,1,2024
CAL,CS,C 12,Industria del tabacco                                       ,0,0,0,0,0,2024
CAL,CS,C 13,Industrie tessili                                           ,0,0,7,1,8,2024
CAL,CS,C 14,Confezione di articoli di abbigliamento; confezione di ar...,0,0,14,2,16,2024
CAL,CS,C 15,Fabbricazione di articoli in pelle e simili                 ,0,0,2,0,2,2024
CAL,CS,C 16,Industria del legno e dei prodotti in legno e sughero (es...,0,0,25,1,26,2024
CAL,CS,C 17,Fabbricazione di carta e di prodotti di carta               ,0,0,1,0,1,2024
CAL,CS,C 18,Stampa e riproduzione di supporti registrati                ,0,0,7,2,9,2024
CAL,CS,C 19,Fabbricazione di coke e prodotti derivanti dalla raffinaz...,0,0,0,0,0,2024
CAL,CS,C 20,Fabbricazione di prodotti chimici                           ,0,0,1,0,1,2024
CAL,CS,C 21,Fabbricazione di prodotti farmaceutici di base e di prepa...,0,0,0,0,0,2024
CAL,CS,C 22,Fabbricazione di articoli in gomma e materie plastiche      ,0,0,2,0,2,2024
CAL,CS,C 23,Fabbricazione di altri prodotti della lavorazione di miner..,0,0,13,1,14,2024
CAL,CS,C 24,Metallurgia                                                 ,0,0,0,0,0,2024
CAL,CS,C 25,Fabbricazione di prodotti in metallo (esclusi macchinari ...,0,0,29,2,31,2024
CAL,CS,C 26,Fabbricazione di computer e prodotti di elettronica e ott...,0,0,4,0,4,2024
CAL,CS,C 27,Fabbricazione di apparecchiature elettriche ed apparecchi...,0,0,1,0,1,2024
CAL,CS,C 28,Fabbricazione di macchinari ed apparecchiature nca          ,0,0,5,0,5,2024
CAL,CS,C 29,"Fabbricazione di autoveicoli, rimorchi e semirimorchi       ",0,0,0,0,0,2024
CAL,CS,C 30,Fabbricazione di altri mezzi di trasporto                   ,0,0,1,0,1,2024
CAL,CS,C 31,Fabbricazione di mobili                                     ,0,0,8,1,9,2024
CAL,CS,C 32,Altre industrie manifatturiere                              ,0,0,7,3,10,2024
CAL,CS,C 33,"Riparazione, manutenzione ed installazione di macchine ed...",0,0,5,0,5,2024
CAL,CS,D   ,"Fornitura di energia elettrica, gas, vapore e aria condiz...",0,0,2,0,2,2024
CAL,CS,D 35,"Fornitura di energia elettrica, gas, vapore e aria condiz...",0,0,2,0,2,2024
CAL,CS,E   ,"Fornitura di acqua; reti fognarie, attività di gestione d...",0,0,4,10,14,2024
CAL,CS,E 36,"Raccolta, trattamento e fornitura di acqua                  ",0,0,0,0,0,2024
CAL,CS,E 37,Gestione delle reti fognarie                                ,0,0,2,0,2,2024
CAL,CS,E 38,"Attività di raccolta, trattamento e smaltimento dei rifiu...",0,0,2,2,4,2024
CAL,CS,E 39,Attività di risanamento e altri servizi di gestione dei r...,0,0,0,8,8,2024
CAL,CS,F   ,Costruzioni                                                 ,0,0,336,88,424,2024
CAL,CS,F 41,Costruzione di edifici                                      ,0,0,180,65,245,2024
CAL,CS,F 42,Ingegneria civile                                           ,0,0,5,6,11,2024
CAL,CS,F 43,Lavori di costruzione specializzati                         ,0,0,151,17,168,2024
CAL,CS,G   ,Commercio all'ingrosso e al dettaglio; riparazione di aut...,0,0,1033,39,1072,2024
CAL,CS,G 45,Commercio all'ingrosso e al dettaglio e riparazione di au...,0,0,112,3,115,2024
CAL,CS,G 46,Commercio all'ingrosso (escluso quello di autoveicoli e d...,0,0,213,13,226,2024
CAL,CS,G 47,Commercio al dettaglio (escluso quello di autoveicoli e d...,0,0,708,23,731,2024
CAL,CS,H   ,Trasporto e magazzinaggio                                   ,0,0,44,22,66,2024
CAL,CS,H 49,Trasporto terrestre e mediante condotte                     ,0,0,36,13,49,2024
CAL,CS,H 50,Trasporto marittimo e per vie d'acqua                       ,0,0,0,0,0,2024
CAL,CS,H 51,Trasporto aereo                                             ,0,0,0,0,0,2024
CAL,CS,H 52,Magazzinaggio e attività di supporto ai trasporti           ,0,0,3,9,12,2024
CAL,CS,H 53,Servizi postali e attività di corriere                      ,0,0,5,0,5,2024
CAL,CS,I   ,Attività dei servizi alloggio e ristorazione                ,0,0,233,15,248,2024
CAL,CS,I 55,Alloggio                                                    ,0,0,13,2,15,2024
CAL,CS,I 56,Attività dei servizi di ristorazione                        ,0,0,220,13,233,2024
CAL,CS,J   ,Servizi di informazione e comunicazione                     ,0,0,32,15,47,2024
CAL,CS,J 58,Attività editoriali                                         ,0,0,6,0,6,2024
CAL,CS,J 59,"Attività di produzione cinematografica, di video e di pro...",0,0,4,0,4,2024
CAL,CS,J 60,Attività di programmazione e trasmissione                   ,0,0,0,0,0,2024
CAL,CS,J 61,Telecomunicazioni                                           ,0,0,9,1,10,2024
CAL,CS,J 62,"Produzione di software, consulenza informatica e attività...",0,0,3,5,8,2024
CAL,CS,J 63,Attività dei servizi d'informazione e altri servizi infor...,0,0,10,9,19,2024
CAL,CS,K   ,Attività finanziarie e assicurative                         ,0,0,26,3,29,2024
CAL,CS,K 64,Attività di servizi finanziari (escluse le assicurazioni ...,0,0,0,1,1,2024
CAL,CS,K 65,"Assicurazioni, riassicurazioni e fondi pensione (escluse ...",0,0,0,0,0,2024
CAL,CS,K 66,Attività ausiliarie dei servizi finanziari e delle attivi...,0,0,26,2,28,2024
CAL,CS,L   ,Attivita' immobiliari                                       ,0,0,11,1,12,2024
CAL,CS,L 68,Attivita' immobiliari                                       ,0,0,11,1,12,2024
CAL,CS,M   ,"Attività professionali, scientifiche e tecniche             ",0,0,22,11,33,2024
CAL,CS,M 69,Attività legali e contabilità                               ,0,0,2,2,4,2024
CAL,CS,M 70,Attività di direzione aziendale e di consulenza gestional...,0,0,3,4,7,2024
CAL,CS,M 71,Attività degli studi di architettura e d'ingegneria; coll...,0,0,1,2,3,2024
CAL,CS,M 72,Ricerca scientifica e sviluppo                              ,0,0,0,0,0,2024
CAL,CS,M 73,Pubblicità e ricerche di mercato                            ,0,0,4,1,5,2024
CAL,CS,M 74,"Altre attività professionali, scientifiche e tecniche       ",0,0,12,2,14,2024
CAL,CS,M 75,Servizi veterinari                                          ,0,0,0,0,0,2024
CAL,CS,N   ,"Noleggio, agenzie di viaggio, servizi di supporto alle im...",0,0,66,54,120,2024
CAL,CS,N 77,Attività di noleggio e leasing operativo                    ,0,0,12,2,14,2024
CAL,CS,N 78,"Attività di ricerca, selezione, fornitura di personale      ",0,0,0,0,0,2024
CAL,CS,N 79,"Attività dei servizi delle agenzie di viaggio, dei tour o...",0,0,3,2,5,2024
CAL,CS,N 80,Servizi di vigilanza e investigazione                       ,0,0,4,0,4,2024
CAL,CS,N 81,Attività di servizi per edifici e paesaggio                 ,0,0,25,46,71,2024
CAL,CS,N 82,Attività di supporto per le funzioni d'ufficio e altri se...,0,0,22,4,26,2024
CAL,CS,O   ,Amministrazione pubblica e difesa; assicurazione sociale ...,0,0,0,0,0,2024
CAL,CS,O 84,Amministrazione pubblica e difesa; assicurazione sociale ...,0,0,0,0,0,2024
CAL,CS,P   ,Istruzione                                                  ,0,0,5,8,13,2024
CAL,CS,P 85,Istruzione                                                  ,0,0,5,8,13,2024
CAL,CS,Q   ,Sanita' e assistenza sociale                                ,0,0,3,27,30,2024
CAL,CS,Q 86,Assistenza sanitaria                                        ,0,0,1,1,2,2024
CAL,CS,Q 87,Servizi di assistenza sociale residenziale                  ,0,0,1,4,5,2024
CAL,CS,Q 88,Assistenza sociale non residenziale                         ,0,0,1,22,23,2024
CAL,CS,R   ,"Attività artistiche, sportive, di intrattenimento e diver...",0,0,28,8,36,2024
CAL,CS,R 90,"Attività creative, artistiche e di intrattenimento          ",0,0,8,4,12,2024
CAL,CS,R 91,"Attività di biblioteche, archivi, musei ed altre attività...",0,0,0,2,2,2024
CAL,CS,R 92,"Attività riguardanti le lotterie, le scommesse, le case d...",0,0,3,0,3,2024
CAL,CS,R 93,"Attività sportive, di intrattenimento e di divertimento     ",0,0,17,2,19,2024
CAL,CS,S   ,Altre attività di servizi                                   ,0,0,43,9,52,2024
CAL,CS,S 94,Attività di organizzazioni associative                      ,0,0,0,0,0,2024
CAL,CS,S 95,Riparazione di computer e di beni per uso personale e per...,0,0,17,3,20,2024
CAL,CS,S 96,Altre attività di servizi per la persona                    ,0,0,26,6,32,2024
CAL,CS,T   ,Attività di famiglie e convivenze come datori di lavoro p...,0,0,0,0,0,2024
CAL,CS,T 97,Attività di famiglie e convivenze come datori di lavoro p...,0,0,0,0,0,2024
CAL,CS,T 98,Produzione di beni e servizi indifferenziati per uso prop...,0,0,0,0,0,2024
CAL,CS,U   ,Organizzazioni ed organismi extraterritoriali               ,0,0,0,0,0,2024
CAL,CS,U 99,Organizzazioni ed organismi extraterritoriali               ,0,0,0,0,0,2024
CAL,CS,XX  ,Imprese non classificate                                    ,0,0,106,117,223,2024
CAL,CS,TOT ,TOTALE                                                      ,0,0,2953,603,3556,2024
CAL,CZ,A   ,"Agricoltura, silvicoltura pesca                             ",1,0,0,8,9,2024
CAL,CZ,A 01,"Coltivazioni agricole e produzione di prodotti animali, c...",1,0,0,8,9,2024
CAL,CZ,A 02,Silvicoltura ed utilizzo di aree forestali                  ,0,0,0,0,0,2024
CAL,CZ,A 03,Pesca e acquacoltura                                        ,0,0,0,0,0,2024
CAL,CZ,B   ,Estrazione di minerali da cave e miniere                    ,0,0,0,0,0,2024
CAL,CZ,B 05,Estrazione di carbone (esclusa torba)                       ,0,0,0,0,0,2024
CAL,CZ,B 06,Estraz.di petrolio greggio e di gas naturale                ,0,0,0,0,0,2024
CAL,CZ,B 07,Estrazione di minerali metalliferi                          ,0,0,0,0,0,2024
CAL,CZ,B 08,Altre attività di estrazione di minerali da cave e miniere  ,0,0,0,0,0,2024
CAL,CZ,B 09,Attività dei servizi di supporto all'estrazione             ,0,0,0,0,0,2024
CAL,CZ,C   ,Attività manifatturiere                                     ,5,0,0,2,7,2024
CAL,CZ,C 10,Industrie alimentari                                        ,1,0,0,0,1,2024
CAL,CZ,C 11,Industria delle bevande                                     ,0,0,0,0,0,2024
CAL,CZ,C 12,Industria del tabacco                                       ,0,0,0,0,0,2024
CAL,CZ,C 13,Industrie tessili                                           ,0,0,0,0,0,2024
CAL,CZ,C 14,Confezione di articoli di abbigliamento; confezione di ar...,1,0,0,0,1,2024
CAL,CZ,C 15,Fabbricazione di articoli in pelle e simili                 ,0,0,0,0,0,2024
CAL,CZ,C 16,Industria del legno e dei prodotti in legno e sughero (es...,0,0,0,0,0,2024
CAL,CZ,C 17,Fabbricazione di carta e di prodotti di carta               ,0,0,0,0,0,2024
CAL,CZ,C 18,Stampa e riproduzione di supporti registrati                ,0,0,0,0,0,2024
CAL,CZ,C 19,Fabbricazione di coke e prodotti derivanti dalla raffinaz...,0,0,0,0,0,2024
CAL,CZ,C 20,Fabbricazione di prodotti chimici                           ,0,0,0,0,0,2024
CAL,CZ,C 21,Fabbricazione di prodotti farmaceutici di base e di prepa...,0,0,0,0,0,2024
CAL,CZ,C 22,Fabbricazione di articoli in gomma e materie plastiche      ,0,0,0,0,0,2024
CAL,CZ,C 23,Fabbricazione di altri prodotti della lavorazione di miner..,0,0,0,1,1,2024
CAL,CZ,C 24,Metallurgia                                                 ,0,0,0,0,0,2024
CAL,CZ,C 25,Fabbricazione di prodotti in metallo (esclusi macchinari ...,1,0,0,0,1,2024
CAL,CZ,C 26,Fabbricazione di computer e prodotti di elettronica e ott...,0,0,0,0,0,2024
CAL,CZ,C 27,Fabbricazione di apparecchiature elettriche ed apparecchi...,0,0,0,0,0,2024
CAL,CZ,C 28,Fabbricazione di macchinari ed apparecchiature nca          ,0,0,0,0,0,2024
CAL,CZ,C 29,"Fabbricazione di autoveicoli, rimorchi e semirimorchi       ",0,0,0,0,0,2024
CAL,CZ,C 30,Fabbricazione di altri mezzi di trasporto                   ,0,0,0,0,0,2024
CAL,CZ,C 31,Fabbricazione di mobili                                     ,1,0,0,0,1,2024
CAL,CZ,C 32,Altre industrie manifatturiere                              ,1,0,0,1,2,2024
CAL,CZ,C 33,"Riparazione, manutenzione ed installazione di macchine ed...",0,0,0,0,0,2024
CAL,CZ,D   ,"Fornitura di energia elettrica, gas, vapore e aria condiz...",0,0,0,0,0,2024
CAL,CZ,D 35,"Fornitura di energia elettrica, gas, vapore e aria condiz...",0,0,0,0,0,2024
CAL,CZ,E   ,"Fornitura di acqua; reti fognarie, attività di gestione d...",2,0,0,0,2,2024
CAL,CZ,E 36,"Raccolta, trattamento e fornitura di acqua                  ",0,0,0,0,0,2024
CAL,CZ,E 37,Gestione delle reti fognarie                                ,0,0,0,0,0,2024
CAL,CZ,E 38,"Attività di raccolta, trattamento e smaltimento dei rifiu...",2,0,0,0,2,2024
CAL,CZ,E 39,Attività di risanamento e altri servizi di gestione dei r...,0,0,0,0,0,2024
CAL,CZ,F   ,Costruzioni                                                 ,8,0,0,5,13,2024
CAL,CZ,F 41,Costruzione di edifici                                      ,4,0,0,5,9,2024
CAL,CZ,F 42,Ingegneria civile                                           ,1,0,0,0,1,2024
CAL,CZ,F 43,Lavori di costruzione specializzati                         ,3,0,0,0,3,2024
CAL,CZ,G   ,Commercio all'ingrosso e al dettaglio; riparazione di aut...,19,0,0,5,24,2024
CAL,CZ,G 45,Commercio all'ingrosso e al dettaglio e riparazione di au...,2,0,0,0,2,2024
CAL,CZ,G 46,Commercio all'ingrosso (escluso quello di autoveicoli e d...,3,0,0,3,6,2024
CAL,CZ,G 47,Commercio al dettaglio (escluso quello di autoveicoli e d...,14,0,0,2,16,2024
CAL,CZ,H   ,Trasporto e magazzinaggio                                   ,1,0,0,3,4,2024
CAL,CZ,H 49,Trasporto terrestre e mediante condotte                     ,1,0,0,2,3,2024
CAL,CZ,H 50,Trasporto marittimo e per vie d'acqua                       ,0,0,0,0,0,2024
CAL,CZ,H 51,Trasporto aereo                                             ,0,0,0,0,0,2024
CAL,CZ,H 52,Magazzinaggio e attività di supporto ai trasporti           ,0,0,0,1,1,2024
CAL,CZ,H 53,Servizi postali e attività di corriere                      ,0,0,0,0,0,2024
CAL,CZ,I   ,Attività dei servizi alloggio e ristorazione                ,6,0,0,0,6,2024
CAL,CZ,I 55,Alloggio                                                    ,0,0,0,0,0,2024
CAL,CZ,I 56,Attività dei servizi di ristorazione                        ,6,0,0,0,6,2024
CAL,CZ,J   ,Servizi di informazione e comunicazione                     ,4,0,0,7,11,2024
CAL,CZ,J 58,Attività editoriali                                         ,0,0,0,1,1,2024
CAL,CZ,J 59,"Attività di produzione cinematografica, di video e di pro...",0,0,0,1,1,2024
CAL,CZ,J 60,Attività di programmazione e trasmissione                   ,0,0,0,0,0,2024
CAL,CZ,J 61,Telecomunicazioni                                           ,0,0,0,0,0,2024
CAL,CZ,J 62,"Produzione di software, consulenza informatica e attività...",0,0,0,1,1,2024
CAL,CZ,J 63,Attività dei servizi d'informazione e altri servizi infor...,4,0,0,4,8,2024
CAL,CZ,K   ,Attività finanziarie e assicurative                         ,0,0,0,0,0,2024
CAL,CZ,K 64,Attività di servizi finanziari (escluse le assicurazioni ...,0,0,0,0,0,2024
CAL,CZ,K 65,"Assicurazioni, riassicurazioni e fondi pensione (escluse ...",0,0,0,0,0,2024
CAL,CZ,K 66,Attività ausiliarie dei servizi finanziari e delle attivi...,0,0,0,0,0,2024
CAL,CZ,L   ,Attivita' immobiliari                                       ,3,0,0,0,3,2024
CAL,CZ,L 68,Attivita' immobiliari                                       ,3,0,0,0,3,2024
CAL,CZ,M   ,"Attività professionali, scientifiche e tecniche             ",2,0,0,8,10,2024
CAL,CZ,M 69,Attività legali e contabilità                               ,0,0,0,0,0,2024
CAL,CZ,M 70,Attività di direzione aziendale e di consulenza gestional...,0,0,0,3,3,2024
CAL,CZ,M 71,Attività degli studi di architettura e d'ingegneria; coll...,0,0,0,2,2,2024
CAL,CZ,M 72,Ricerca scientifica e sviluppo                              ,0,0,0,0,0,2024
CAL,CZ,M 73,Pubblicità e ricerche di mercato                            ,2,0,0,0,2,2024
CAL,CZ,M 74,"Altre attività professionali, scientifiche e tecniche       ",0,0,0,3,3,2024
CAL,CZ,M 75,Servizi veterinari                                          ,0,0,0,0,0,2024
CAL,CZ,N   ,"Noleggio, agenzie di viaggio, servizi di supporto alle im...",2,0,0,11,13,2024
CAL,CZ,N 77,Attività di noleggio e leasing operativo                    ,0,0,0,0,0,2024
CAL,CZ,N 78,"Attività di ricerca, selezione, fornitura di personale      ",0,0,0,0,0,2024
CAL,CZ,N 79,"Attività dei servizi delle agenzie di viaggio, dei tour o...",0,0,0,0,0,2024
CAL,CZ,N 80,Servizi di vigilanza e investigazione                       ,0,0,0,0,0,2024
CAL,CZ,N 81,Attività di servizi per edifici e paesaggio                 ,0,0,0,5,5,2024
CAL,CZ,N 82,Attività di supporto per le funzioni d'ufficio e altri se...,2,0,0,6,8,2024
CAL,CZ,O   ,Amministrazione pubblica e difesa; assicurazione sociale ...,0,0,0,0,0,2024
CAL,CZ,O 84,Amministrazione pubblica e difesa; assicurazione sociale ...,0,0,0,0,0,2024
CAL,CZ,P   ,Istruzione                                                  ,1,0,0,2,3,2024
CAL,CZ,P 85,Istruzione                                                  ,1,0,0,2,3,2024
CAL,CZ,Q   ,Sanita' e assistenza sociale                                ,2,0,0,3,5,2024
CAL,CZ,Q 86,Assistenza sanitaria                                        ,1,0,0,0,1,2024
CAL,CZ,Q 87,Servizi di assistenza sociale residenziale                  ,1,0,0,0,1,2024
CAL,CZ,Q 88,Assistenza sociale non residenziale                         ,0,0,0,3,3,2024
CAL,CZ,R   ,"Attività artistiche, sportive, di intrattenimento e diver...",2,0,0,0,2,2024
CAL,CZ,R 90,"Attività creative, artistiche e di intrattenimento          ",1,0,0,0,1,2024
CAL,CZ,R 91,"Attività di biblioteche, archivi, musei ed altre attività...",0,0,0,0,0,2024
CAL,CZ,R 92,"Attività riguardanti le lotterie, le scommesse, le case d...",0,0,0,0,0,2024
CAL,CZ,R 93,"Attività sportive, di intrattenimento e di divertimento     ",1,0,0,0,1,2024
CAL,CZ,S   ,Altre attività di servizi                                   ,0,0,0,3,3,2024
CAL,CZ,S 94,Attività di organizzazioni associative                      ,0,0,0,2,2,2024
CAL,CZ,S 95,Riparazione di computer e di beni per uso personale e per...,0,0,0,0,0,2024
CAL,CZ,S 96,Altre attività di servizi per la persona                    ,0,0,0,1,1,2024
CAL,CZ,T   ,Attività di famiglie e convivenze come datori di lavoro p...,0,0,0,0,0,2024
CAL,CZ,T 97,Attività di famiglie e convivenze come datori di lavoro p...,0,0,0,0,0,2024
CAL,CZ,T 98,Produzione di beni e servizi indifferenziati per uso prop...,0,0,0,0,0,2024
CAL,CZ,U   ,Organizzazioni ed organismi extraterritoriali               ,0,0,0,0,0,2024
CAL,CZ,U 99,Organizzazioni ed organismi extraterritoriali               ,0,0,0,0,0,2024
CAL,CZ,XX  ,Imprese non classificate                                    ,25,0,0,22,47,2024
CAL,CZ,TOT ,TOTALE                                                      ,83,0,0,79,162,2024
CAL,RC,A   ,"Agricoltura, silvicoltura pesca                             ",1,1,3,59,64,2024
CAL,RC,A 01,"Coltivazioni agricole e produzione di prodotti animali, c...",1,1,3,56,61,2024
CAL,RC,A 02,Silvicoltura ed utilizzo di aree forestali                  ,0,0,0,0,0,2024
CAL,RC,A 03,Pesca e acquacoltura                                        ,0,0,0,3,3,2024
CAL,RC,B   ,Estrazione di minerali da cave e miniere                    ,1,0,0,0,1,2024
CAL,RC,B 05,Estrazione di carbone (esclusa torba)                       ,0,0,0,0,0,2024
CAL,RC,B 06,Estraz.di petrolio greggio e di gas naturale                ,0,0,0,0,0,2024
CAL,RC,B 07,Estrazione di minerali metalliferi                          ,0,0,0,0,0,2024
CAL,RC,B 08,Altre attività di estrazione di minerali da cave e miniere  ,1,0,0,0,1,2024
CAL,RC,B 09,Attività dei servizi di supporto all'estrazione             ,0,0,0,0,0,2024
CAL,RC,C   ,Attività manifatturiere                                     ,17,2,0,19,38,2024
CAL,RC,C 10,Industrie alimentari                                        ,3,0,0,4,7,2024
CAL,RC,C 11,Industria delle bevande                                     ,0,0,0,0,0,2024
CAL,RC,C 12,Industria del tabacco                                       ,0,0,0,0,0,2024
CAL,RC,C 13,Industrie tessili                                           ,0,0,0,2,2,2024
CAL,RC,C 14,Confezione di articoli di abbigliamento; confezione di ar...,0,1,0,3,4,2024
CAL,RC,C 15,Fabbricazione di articoli in pelle e simili                 ,0,0,0,0,0,2024
CAL,RC,C 16,Industria del legno e dei prodotti in legno e sughero (es...,1,0,0,0,1,2024
CAL,RC,C 17,Fabbricazione di carta e di prodotti di carta               ,3,0,0,1,4,2024
CAL,RC,C 18,Stampa e riproduzione di supporti registrati                ,0,0,0,3,3,2024
CAL,RC,C 19,Fabbricazione di coke e prodotti derivanti dalla raffinaz...,0,0,0,0,0,2024
CAL,RC,C 20,Fabbricazione di prodotti chimici                           ,0,0,0,2,2,2024
CAL,RC,C 21,Fabbricazione di prodotti farmaceutici di base e di prepa...,0,0,0,0,0,2024
CAL,RC,C 22,Fabbricazione di articoli in gomma e materie plastiche      ,1,0,0,0,1,2024
CAL,RC,C 23,Fabbricazione di altri prodotti della lavorazione di miner..,1,0,0,1,2,2024
CAL,RC,C 24,Metallurgia                                                 ,0,0,0,0,0,2024
CAL,RC,C 25,Fabbricazione di prodotti in metallo (esclusi macchinari ...,0,1,0,0,1,2024
CAL,RC,C 26,Fabbricazione di computer e prodotti di elettronica e ott...,4,0,0,0,4,2024
CAL,RC,C 27,Fabbricazione di apparecchiature elettriche ed apparecchi...,1,0,0,1,2,2024
CAL,RC,C 28,Fabbricazione di macchinari ed apparecchiature nca          ,0,0,0,0,0,2024
CAL,RC,C 29,"Fabbricazione di autoveicoli, rimorchi e semirimorchi       ",0,0,0,0,0,2024
CAL,RC,C 30,Fabbricazione di altri mezzi di trasporto                   ,1,0,0,0,1,2024
CAL,RC,C 31,Fabbricazione di mobili                                     ,1,0,0,0,1,2024
CAL,RC,C 32,Altre industrie manifatturiere                              ,1,0,0,2,3,2024
CAL,RC,C 33,"Riparazione, manutenzione ed installazione di macchine ed...",0,0,0,0,0,2024
CAL,RC,D   ,"Fornitura di energia elettrica, gas, vapore e aria condiz...",0,0,0,0,0,2024
CAL,RC,D 35,"Fornitura di energia elettrica, gas, vapore e aria condiz...",0,0,0,0,0,2024
CAL,RC,E   ,"Fornitura di acqua; reti fognarie, attività di gestione d...",0,1,0,5,6,2024
CAL,RC,E 36,"Raccolta, trattamento e fornitura di acqua                  ",0,0,0,0,0,2024
CAL,RC,E 37,Gestione delle reti fognarie                                ,0,0,0,1,1,2024
CAL,RC,E 38,"Attività di raccolta, trattamento e smaltimento dei rifiu...",0,1,0,0,1,2024
CAL,RC,E 39,Attività di risanamento e altri servizi di gestione dei r...,0,0,0,4,4,2024
CAL,RC,F   ,Costruzioni                                                 ,10,3,2,31,46,2024
CAL,RC,F 41,Costruzione di edifici                                      ,10,1,1,21,33,2024
CAL,RC,F 42,Ingegneria civile                                           ,0,0,0,5,5,2024
CAL,RC,F 43,Lavori di costruzione specializzati                         ,0,2,1,5,8,2024
CAL,RC,G   ,Commercio all'ingrosso e al dettaglio; riparazione di aut...,36,13,5,20,74,2024
CAL,RC,G 45,Commercio all'ingrosso e al dettaglio e riparazione di au...,4,2,3,0,9,2024
CAL,RC,G 46,Commercio all'ingrosso (escluso quello di autoveicoli e d...,20,4,1,17,42,2024
CAL,RC,G 47,Commercio al dettaglio (escluso quello di autoveicoli e d...,12,7,1,3,23,2024
CAL,RC,H   ,Trasporto e magazzinaggio                                   ,5,0,0,13,18,2024
CAL,RC,H 49,Trasporto terrestre e mediante condotte                     ,3,0,0,6,9,2024
CAL,RC,H 50,Trasporto marittimo e per vie d'acqua                       ,0,0,0,0,0,2024
CAL,RC,H 51,Trasporto aereo                                             ,0,0,0,0,0,2024
CAL,RC,H 52,Magazzinaggio e attività di supporto ai trasporti           ,2,0,0,6,8,2024
CAL,RC,H 53,Servizi postali e attività di corriere                      ,0,0,0,1,1,2024
CAL,RC,I   ,Attività dei servizi alloggio e ristorazione                ,5,8,0,1,14,2024
CAL,RC,I 55,Alloggio                                                    ,1,0,0,0,1,2024
CAL,RC,I 56,Attività dei servizi di ristorazione                        ,4,8,0,1,13,2024
CAL,RC,J   ,Servizi di informazione e comunicazione                     ,5,2,0,9,16,2024
CAL,RC,J 58,Attività editoriali                                         ,1,0,0,1,2,2024
CAL,RC,J 59,"Attività di produzione cinematografica, di video e di pro...",0,0,0,0,0,2024
CAL,RC,J 60,Attività di programmazione e trasmissione                   ,1,0,0,2,3,2024
CAL,RC,J 61,Telecomunicazioni                                           ,0,0,0,0,0,2024
CAL,RC,J 62,"Produzione di software, consulenza informatica e attività...",3,0,0,3,6,2024
CAL,RC,J 63,Attività dei servizi d'informazione e altri servizi infor...,0,2,0,3,5,2024
CAL,RC,K   ,Attività finanziarie e assicurative                         ,0,1,1,0,2,2024
CAL,RC,K 64,Attività di servizi finanziari (escluse le assicurazioni ...,0,0,0,0,0,2024
CAL,RC,K 65,"Assicurazioni, riassicurazioni e fondi pensione (escluse ...",0,0,0,0,0,2024
CAL,RC,K 66,Attività ausiliarie dei servizi finanziari e delle attivi...,0,1,1,0,2,2024
CAL,RC,L   ,Attivita' immobiliari                                       ,1,0,0,1,2,2024
CAL,RC,L 68,Attivita' immobiliari                                       ,1,0,0,1,2,2024
CAL,RC,M   ,"Attività professionali, scientifiche e tecniche             ",3,3,0,12,18,2024
CAL,RC,M 69,Attività legali e contabilità                               ,0,3,0,1,4,2024
CAL,RC,M 70,Attività di direzione aziendale e di consulenza gestional...,1,0,0,5,6,2024
CAL,RC,M 71,Attività degli studi di architettura e d'ingegneria; coll...,0,0,0,0,0,2024
CAL,RC,M 72,Ricerca scientifica e sviluppo                              ,0,0,0,0,0,2024
CAL,RC,M 73,Pubblicità e ricerche di mercato                            ,0,0,0,1,1,2024
CAL,RC,M 74,"Altre attività professionali, scientifiche e tecniche       ",2,0,0,5,7,2024
CAL,RC,M 75,Servizi veterinari                                          ,0,0,0,0,0,2024
CAL,RC,N   ,"Noleggio, agenzie di viaggio, servizi di supporto alle im...",2,1,0,19,22,2024
CAL,RC,N 77,Attività di noleggio e leasing operativo                    ,1,0,0,0,1,2024
CAL,RC,N 78,"Attività di ricerca, selezione, fornitura di personale      ",0,0,0,0,0,2024
CAL,RC,N 79,"Attività dei servizi delle agenzie di viaggio, dei tour o...",0,0,0,0,0,2024
CAL,RC,N 80,Servizi di vigilanza e investigazione                       ,0,0,0,0,0,2024
CAL,RC,N 81,Attività di servizi per edifici e paesaggio                 ,0,0,0,13,13,2024
CAL,RC,N 82,Attività di supporto per le funzioni d'ufficio e altri se...,1,1,0,6,8,2024
CAL,RC,O   ,Amministrazione pubblica e difesa; assicurazione sociale ...,0,0,0,1,1,2024
CAL,RC,O 84,Amministrazione pubblica e difesa; assicurazione sociale ...,0,0,0,1,1,2024
CAL,RC,P   ,Istruzione                                                  ,0,0,0,12,12,2024
CAL,RC,P 85,Istruzione                                                  ,0,0,0,12,12,2024
CAL,RC,Q   ,Sanita' e assistenza sociale                                ,0,0,0,10,10,2024
CAL,RC,Q 86,Assistenza sanitaria                                        ,0,0,0,0,0,2024
CAL,RC,Q 87,Servizi di assistenza sociale residenziale                  ,0,0,0,4,4,2024
CAL,RC,Q 88,Assistenza sociale non residenziale                         ,0,0,0,6,6,2024
CAL,RC,R   ,"Attività artistiche, sportive, di intrattenimento e diver...",2,1,0,7,10,2024
CAL,RC,R 90,"Attività creative, artistiche e di intrattenimento          ",0,1,0,4,5,2024
CAL,RC,R 91,"Attività di biblioteche, archivi, musei ed altre attività...",0,0,0,1,1,2024
CAL,RC,R 92,"Attività riguardanti le lotterie, le scommesse, le case d...",0,0,0,0,0,2024
CAL,RC,R 93,"Attività sportive, di intrattenimento e di divertimento     ",2,0,0,2,4,2024
CAL,RC,S   ,Altre attività di servizi                                   ,0,0,0,4,4,2024
CAL,RC,S 94,Attività di organizzazioni associative                      ,0,0,0,0,0,2024
CAL,RC,S 95,Riparazione di computer e di beni per uso personale e per...,0,0,0,0,0,2024
CAL,RC,S 96,Altre attività di servizi per la persona                    ,0,0,0,4,4,2024
CAL,RC,T   ,Attività di famiglie e convivenze come datori di lavoro p...,0,0,0,0,0,2024
CAL,RC,T 97,Attività di famiglie e convivenze come datori di lavoro p...,0,0,0,0,0,2024
CAL,RC,T 98,Produzione di beni e servizi indifferenziati per uso prop...,0,0,0,0,0,2024
CAL,RC,U   ,Organizzazioni ed organismi extraterritoriali               ,0,0,0,0,0,2024
CAL,RC,U 99,Organizzazioni ed organismi extraterritoriali               ,0,0,0,0,0,2024
CAL,RC,XX  ,Imprese non classificate                                    ,113,26,0,156,295,2024
CAL,RC,TOT ,TOTALE                                                      ,201,62,11,379,653,2024
CAL,KR,A   ,"Agricoltura, silvicoltura pesca                             ",3,0,0,13,16,2024
CAL,KR,A 01,"Coltivazioni agricole e produzione di prodotti animali, c...",2,0,0,12,14,2024
CAL,KR,A 02,Silvicoltura ed utilizzo di aree forestali                  ,1,0,0,1,2,2024
CAL,KR,A 03,Pesca e acquacoltura                                        ,0,0,0,0,0,2024
CAL,KR,B   ,Estrazione di minerali da cave e miniere                    ,0,0,0,0,0,2024
CAL,KR,B 05,Estrazione di carbone (esclusa torba)                       ,0,0,0,0,0,2024
CAL,KR,B 06,Estraz.di petrolio greggio e di gas naturale                ,0,0,0,0,0,2024
CAL,KR,B 07,Estrazione di minerali metalliferi                          ,0,0,0,0,0,2024
CAL,KR,B 08,Altre attività di estrazione di minerali da cave e miniere  ,0,0,0,0,0,2024
CAL,KR,B 09,Attività dei servizi di supporto all'estrazione             ,0,0,0,0,0,2024
CAL,KR,C   ,Attività manifatturiere                                     ,11,0,0,8,19,2024
CAL,KR,C 10,Industrie alimentari                                        ,2,0,0,2,4,2024
CAL,KR,C 11,Industria delle bevande                                     ,0,0,0,0,0,2024
CAL,KR,C 12,Industria del tabacco                                       ,0,0,0,0,0,2024
CAL,KR,C 13,Industrie tessili                                           ,0,0,0,1,1,2024
CAL,KR,C 14,Confezione di articoli di abbigliamento; confezione di ar...,1,0,0,0,1,2024
CAL,KR,C 15,Fabbricazione di articoli in pelle e simili                 ,0,0,0,0,0,2024
CAL,KR,C 16,Industria del legno e dei prodotti in legno e sughero (es...,0,0,0,0,0,2024
CAL,KR,C 17,Fabbricazione di carta e di prodotti di carta               ,0,0,0,0,0,2024
CAL,KR,C 18,Stampa e riproduzione di supporti registrati                ,0,0,0,1,1,2024
CAL,KR,C 19,Fabbricazione di coke e prodotti derivanti dalla raffinaz...,0,0,0,0,0,2024
CAL,KR,C 20,Fabbricazione di prodotti chimici                           ,2,0,0,0,2,2024
CAL,KR,C 21,Fabbricazione di prodotti farmaceutici di base e di prepa...,0,0,0,0,0,2024
CAL,KR,C 22,Fabbricazione di articoli in gomma e materie plastiche      ,1,0,0,0,1,2024
CAL,KR,C 23,Fabbricazione di altri prodotti della lavorazione di miner..,2,0,0,1,3,2024
CAL,KR,C 24,Metallurgia                                                 ,0,0,0,0,0,2024
CAL,KR,C 25,Fabbricazione di prodotti in metallo (esclusi macchinari ...,0,0,0,1,1,2024
CAL,KR,C 26,Fabbricazione di computer e prodotti di elettronica e ott...,1,0,0,1,2,2024
CAL,KR,C 27,Fabbricazione di apparecchiature elettriche ed apparecchi...,0,0,0,0,0,2024
CAL,KR,C 28,Fabbricazione di macchinari ed apparecchiature nca          ,1,0,0,0,1,2024
CAL,KR,C 29,"Fabbricazione di autoveicoli, rimorchi e semirimorchi       ",0,0,0,0,0,2024
CAL,KR,C 30,Fabbricazione di altri mezzi di trasporto                   ,0,0,0,1,1,2024
CAL,KR,C 31,Fabbricazione di mobili                                     ,0,0,0,0,0,2024
CAL,KR,C 32,Altre industrie manifatturiere                              ,1,0,0,0,1,2024
CAL,KR,C 33,"Riparazione, manutenzione ed installazione di macchine ed...",0,0,0,0,0,2024
CAL,KR,D   ,"Fornitura di energia elettrica, gas, vapore e aria condiz...",0,0,0,0,0,2024
CAL,KR,D 35,"Fornitura di energia elettrica, gas, vapore e aria condiz...",0,0,0,0,0,2024
CAL,KR,E   ,"Fornitura di acqua; reti fognarie, attività di gestione d...",0,0,0,1,1,2024
CAL,KR,E 36,"Raccolta, trattamento e fornitura di acqua                  ",0,0,0,0,0,2024
CAL,KR,E 37,Gestione delle reti fognarie                                ,0,0,0,0,0,2024
CAL,KR,E 38,"Attività di raccolta, trattamento e smaltimento dei rifiu...",0,0,0,1,1,2024
CAL,KR,E 39,Attività di risanamento e altri servizi di gestione dei r...,0,0,0,0,0,2024
CAL,KR,F   ,Costruzioni                                                 ,32,0,0,11,43,2024
CAL,KR,F 41,Costruzione di edifici                                      ,27,0,0,9,36,2024
CAL,KR,F 42,Ingegneria civile                                           ,3,0,0,1,4,2024
CAL,KR,F 43,Lavori di costruzione specializzati                         ,2,0,0,1,3,2024
CAL,KR,G   ,Commercio all'ingrosso e al dettaglio; riparazione di aut...,26,0,0,5,31,2024
CAL,KR,G 45,Commercio all'ingrosso e al dettaglio e riparazione di au...,3,0,0,0,3,2024
CAL,KR,G 46,Commercio all'ingrosso (escluso quello di autoveicoli e d...,10,0,0,3,13,2024
CAL,KR,G 47,Commercio al dettaglio (escluso quello di autoveicoli e d...,13,0,0,2,15,2024
CAL,KR,H   ,Trasporto e magazzinaggio                                   ,1,0,0,5,6,2024
CAL,KR,H 49,Trasporto terrestre e mediante condotte                     ,1,0,0,3,4,2024
CAL,KR,H 50,Trasporto marittimo e per vie d'acqua                       ,0,0,0,0,0,2024
CAL,KR,H 51,Trasporto aereo                                             ,0,0,0,0,0,2024
CAL,KR,H 52,Magazzinaggio e attività di supporto ai trasporti           ,0,0,0,2,2,2024
CAL,KR,H 53,Servizi postali e attività di corriere                      ,0,0,0,0,0,2024
CAL,KR,I   ,Attività dei servizi alloggio e ristorazione                ,10,0,0,2,12,2024
CAL,KR,I 55,Alloggio                                                    ,1,0,0,0,1,2024
CAL,KR,I 56,Attività dei servizi di ristorazione                        ,9,0,0,2,11,2024
CAL,KR,J   ,Servizi di informazione e comunicazione                     ,4,0,0,7,11,2024
CAL,KR,J 58,Attività editoriali                                         ,1,0,0,0,1,2024
CAL,KR,J 59,"Attività di produzione cinematografica, di video e di pro...",0,0,0,0,0,2024
CAL,KR,J 60,Attività di programmazione e trasmissione                   ,1,0,0,1,2,2024
CAL,KR,J 61,Telecomunicazioni                                           ,0,0,0,0,0,2024
CAL,KR,J 62,"Produzione di software, consulenza informatica e attività...",1,0,0,0,1,2024
CAL,KR,J 63,Attività dei servizi d'informazione e altri servizi infor...,1,0,0,6,7,2024
CAL,KR,K   ,Attività finanziarie e assicurative                         ,1,0,0,1,2,2024
CAL,KR,K 64,Attività di servizi finanziari (escluse le assicurazioni ...,0,0,0,1,1,2024
CAL,KR,K 65,"Assicurazioni, riassicurazioni e fondi pensione (escluse ...",0,0,0,0,0,2024
CAL,KR,K 66,Attività ausiliarie dei servizi finanziari e delle attivi...,1,0,0,0,1,2024
CAL,KR,L   ,Attivita' immobiliari                                       ,1,0,0,0,1,2024
CAL,KR,L 68,Attivita' immobiliari                                       ,1,0,0,0,1,2024
CAL,KR,M   ,"Attività professionali, scientifiche e tecniche             ",4,0,0,4,8,2024
CAL,KR,M 69,Attività legali e contabilità                               ,0,0,0,0,0,2024
CAL,KR,M 70,Attività di direzione aziendale e di consulenza gestional...,0,0,0,1,1,2024
CAL,KR,M 71,Attività degli studi di architettura e d'ingegneria; coll...,2,0,0,0,2,2024
CAL,KR,M 72,Ricerca scientifica e sviluppo                              ,1,0,0,2,3,2024
CAL,KR,M 73,Pubblicità e ricerche di mercato                            ,0,0,0,0,0,2024
CAL,KR,M 74,"Altre attività professionali, scientifiche e tecniche       ",1,0,0,1,2,2024
CAL,KR,M 75,Servizi veterinari                                          ,0,0,0,0,0,2024
CAL,KR,N   ,"Noleggio, agenzie di viaggio, servizi di supporto alle im...",5,0,0,6,11,2024
CAL,KR,N 77,Attività di noleggio e leasing operativo                    ,1,0,0,0,1,2024
CAL,KR,N 78,"Attività di ricerca, selezione, fornitura di personale      ",0,0,0,0,0,2024
CAL,KR,N 79,"Attività dei servizi delle agenzie di viaggio, dei tour o...",0,0,0,1,1,2024
CAL,KR,N 80,Servizi di vigilanza e investigazione                       ,1,0,0,0,1,2024
CAL,KR,N 81,Attività di servizi per edifici e paesaggio                 ,0,0,0,2,2,2024
CAL,KR,N 82,Attività di supporto per le funzioni d'ufficio e altri se...,3,0,0,3,6,2024
CAL,KR,O   ,Amministrazione pubblica e difesa; assicurazione sociale ...,0,0,0,0,0,2024
CAL,KR,O 84,Amministrazione pubblica e difesa; assicurazione sociale ...,0,0,0,0,0,2024
CAL,KR,P   ,Istruzione                                                  ,0,0,0,4,4,2024
CAL,KR,P 85,Istruzione                                                  ,0,0,0,4,4,2024
CAL,KR,Q   ,Sanita' e assistenza sociale                                ,1,0,0,1,2,2024
CAL,KR,Q 86,Assistenza sanitaria                                        ,1,0,0,0,1,2024
CAL,KR,Q 87,Servizi di assistenza sociale residenziale                  ,0,0,0,0,0,2024
CAL,KR,Q 88,Assistenza sociale non residenziale                         ,0,0,0,1,1,2024
CAL,KR,R   ,"Attività artistiche, sportive, di intrattenimento e diver...",1,0,0,1,2,2024
CAL,KR,R 90,"Attività creative, artistiche e di intrattenimento          ",0,0,0,0,0,2024
CAL,KR,R 91,"Attività di biblioteche, archivi, musei ed altre attività...",0,0,0,0,0,2024
CAL,KR,R 92,"Attività riguardanti le lotterie, le scommesse, le case d...",0,0,0,0,0,2024
CAL,KR,R 93,"Attività sportive, di intrattenimento e di divertimento     ",1,0,0,1,2,2024
CAL,KR,S   ,Altre attività di servizi                                   ,0,0,0,0,0,2024
CAL,KR,S 94,Attività di organizzazioni associative                      ,0,0,0,0,0,2024
CAL,KR,S 95,Riparazione di computer e di beni per uso personale e per...,0,0,0,0,0,2024
CAL,KR,S 96,Altre attività di servizi per la persona                    ,0,0,0,0,0,2024
CAL,KR,T   ,Attività di famiglie e convivenze come datori di lavoro p...,0,0,0,0,0,2024
CAL,KR,T 97,Attività di famiglie e convivenze come datori di lavoro p...,0,0,0,0,0,2024
CAL,KR,T 98,Produzione di beni e servizi indifferenziati per uso prop...,0,0,0,0,0,2024
CAL,KR,U   ,Organizzazioni ed organismi extraterritoriali               ,0,0,0,0,0,2024
CAL,KR,U 99,Organizzazioni ed organismi extraterritoriali               ,0,0,0,0,0,2024
CAL,KR,XX  ,Imprese non classificate                                    ,41,0,0,39,80,2024
CAL,KR,TOT ,TOTALE                                                      ,141,0,0,108,249,2024
CAL,VV,A   ,"Agricoltura, silvicoltura pesca                             ",0,0,0,8,8,2024
CAL,VV,A 01,"Coltivazioni agricole e produzione di prodotti animali, c...",0,0,0,8,8,2024
CAL,VV,A 02,Silvicoltura ed utilizzo di aree forestali                  ,0,0,0,0,0,2024
CAL,VV,A 03,Pesca e acquacoltura                                        ,0,0,0,0,0,2024
CAL,VV,B   ,Estrazione di minerali da cave e miniere                    ,0,0,0,0,0,2024
CAL,VV,B 05,Estrazione di carbone (esclusa torba)                       ,0,0,0,0,0,2024
CAL,VV,B 06,Estraz.di petrolio greggio e di gas naturale                ,0,0,0,0,0,2024
CAL,VV,B 07,Estrazione di minerali metalliferi                          ,0,0,0,0,0,2024
CAL,VV,B 08,Altre attività di estrazione di minerali da cave e miniere  ,0,0,0,0,0,2024
CAL,VV,B 09,Attività dei servizi di supporto all'estrazione             ,0,0,0,0,0,2024
CAL,VV,C   ,Attività manifatturiere                                     ,6,0,0,4,10,2024
CAL,VV,C 10,Industrie alimentari                                        ,0,0,0,0,0,2024
CAL,VV,C 11,Industria delle bevande                                     ,0,0,0,0,0,2024
CAL,VV,C 12,Industria del tabacco                                       ,0,0,0,0,0,2024
CAL,VV,C 13,Industrie tessili                                           ,0,0,0,0,0,2024
CAL,VV,C 14,Confezione di articoli di abbigliamento; confezione di ar...,0,0,0,0,0,2024
CAL,VV,C 15,Fabbricazione di articoli in pelle e simili                 ,0,0,0,0,0,2024
CAL,VV,C 16,Industria del legno e dei prodotti in legno e sughero (es...,0,0,0,1,1,2024
CAL,VV,C 17,Fabbricazione di carta e di prodotti di carta               ,0,0,0,0,0,2024
CAL,VV,C 18,Stampa e riproduzione di supporti registrati                ,0,0,0,1,1,2024
CAL,VV,C 19,Fabbricazione di coke e prodotti derivanti dalla raffinaz...,0,0,0,0,0,2024
CAL,VV,C 20,Fabbricazione di prodotti chimici                           ,0,0,0,0,0,2024
CAL,VV,C 21,Fabbricazione di prodotti farmaceutici di base e di prepa...,0,0,0,0,0,2024
CAL,VV,C 22,Fabbricazione di articoli in gomma e materie plastiche      ,0,0,0,0,0,2024
CAL,VV,C 23,Fabbricazione di altri prodotti della lavorazione di miner..,1,0,0,0,1,2024
CAL,VV,C 24,Metallurgia                                                 ,0,0,0,0,0,2024
CAL,VV,C 25,Fabbricazione di prodotti in metallo (esclusi macchinari ...,1,0,0,2,3,2024
CAL,VV,C 26,Fabbricazione di computer e prodotti di elettronica e ott...,0,0,0,0,0,2024
CAL,VV,C 27,Fabbricazione di apparecchiature elettriche ed apparecchi...,1,0,0,0,1,2024
CAL,VV,C 28,Fabbricazione di macchinari ed apparecchiature nca          ,1,0,0,0,1,2024
CAL,VV,C 29,"Fabbricazione di autoveicoli, rimorchi e semirimorchi       ",0,0,0,0,0,2024
CAL,VV,C 30,Fabbricazione di altri mezzi di trasporto                   ,0,0,0,0,0,2024
CAL,VV,C 31,Fabbricazione di mobili                                     ,1,0,0,0,1,2024
CAL,VV,C 32,Altre industrie manifatturiere                              ,0,0,0,0,0,2024
CAL,VV,C 33,"Riparazione, manutenzione ed installazione di macchine ed...",1,0,0,0,1,2024
CAL,VV,D   ,"Fornitura di energia elettrica, gas, vapore e aria condiz...",2,0,0,0,2,2024
CAL,VV,D 35,"Fornitura di energia elettrica, gas, vapore e aria condiz...",2,0,0,0,2,2024
CAL,VV,E   ,"Fornitura di acqua; reti fognarie, attività di gestione d...",0,0,0,0,0,2024
CAL,VV,E 36,"Raccolta, trattamento e fornitura di acqua                  ",0,0,0,0,0,2024
CAL,VV,E 37,Gestione delle reti fognarie                                ,0,0,0,0,0,2024
CAL,VV,E 38,"Attività di raccolta, trattamento e smaltimento dei rifiu...",0,0,0,0,0,2024
CAL,VV,E 39,Attività di risanamento e altri servizi di gestione dei r...,0,0,0,0,0,2024
CAL,VV,F   ,Costruzioni                                                 ,12,0,0,19,31,2024
CAL,VV,F 41,Costruzione di edifici                                      ,11,0,0,14,25,2024
CAL,VV,F 42,Ingegneria civile                                           ,0,0,0,0,0,2024
CAL,VV,F 43,Lavori di costruzione specializzati                         ,1,0,0,5,6,2024
CAL,VV,G   ,Commercio all'ingrosso e al dettaglio; riparazione di aut...,14,0,0,5,19,2024
CAL,VV,G 45,Commercio all'ingrosso e al dettaglio e riparazione di au...,4,0,0,3,7,2024
CAL,VV,G 46,Commercio all'ingrosso (escluso quello di autoveicoli e d...,4,0,0,0,4,2024
CAL,VV,G 47,Commercio al dettaglio (escluso quello di autoveicoli e d...,6,0,0,2,8,2024
CAL,VV,H   ,Trasporto e magazzinaggio                                   ,1,0,0,4,5,2024
CAL,VV,H 49,Trasporto terrestre e mediante condotte                     ,1,0,0,1,2,2024
CAL,VV,H 50,Trasporto marittimo e per vie d'acqua                       ,0,0,0,1,1,2024
CAL,VV,H 51,Trasporto aereo                                             ,0,0,0,0,0,2024
CAL,VV,H 52,Magazzinaggio e attività di supporto ai trasporti           ,0,0,0,2,2,2024
CAL,VV,H 53,Servizi postali e attività di corriere                      ,0,0,0,0,0,2024
CAL,VV,I   ,Attività dei servizi alloggio e ristorazione                ,5,0,0,2,7,2024
CAL,VV,I 55,Alloggio                                                    ,2,0,0,0,2,2024
CAL,VV,I 56,Attività dei servizi di ristorazione                        ,3,0,0,2,5,2024
CAL,VV,J   ,Servizi di informazione e comunicazione                     ,1,0,0,2,3,2024
CAL,VV,J 58,Attività editoriali                                         ,0,0,0,0,0,2024
CAL,VV,J 59,"Attività di produzione cinematografica, di video e di pro...",0,0,0,0,0,2024
CAL,VV,J 60,Attività di programmazione e trasmissione                   ,0,0,0,1,1,2024
CAL,VV,J 61,Telecomunicazioni                                           ,0,0,0,0,0,2024
CAL,VV,J 62,"Produzione di software, consulenza informatica e attività...",0,0,0,1,1,2024
CAL,VV,J 63,Attività dei servizi d'informazione e altri servizi infor...,1,0,0,0,1,2024
CAL,VV,K   ,Attività finanziarie e assicurative                         ,0,0,0,0,0,2024
CAL,VV,K 64,Attività di servizi finanziari (escluse le assicurazioni ...,0,0,0,0,0,2024
CAL,VV,K 65,"Assicurazioni, riassicurazioni e fondi pensione (escluse ...",0,0,0,0,0,2024
CAL,VV,K 66,Attività ausiliarie dei servizi finanziari e delle attivi...,0,0,0,0,0,2024
CAL,VV,L   ,Attivita' immobiliari                                       ,2,0,0,0,2,2024
CAL,VV,L 68,Attivita' immobiliari                                       ,2,0,0,0,2,2024
CAL,VV,M   ,"Attività professionali, scientifiche e tecniche             ",2,0,0,2,4,2024
CAL,VV,M 69,Attività legali e contabilità                               ,0,0,0,0,0,2024
CAL,VV,M 70,Attività di direzione aziendale e di consulenza gestional...,1,0,0,1,2,2024
CAL,VV,M 71,Attività degli studi di architettura e d'ingegneria; coll...,1,0,0,0,1,2024
CAL,VV,M 72,Ricerca scientifica e sviluppo                              ,0,0,0,0,0,2024
CAL,VV,M 73,Pubblicità e ricerche di mercato                            ,0,0,0,0,0,2024
CAL,VV,M 74,"Altre attività professionali, scientifiche e tecniche       ",0,0,0,1,1,2024
CAL,VV,M 75,Servizi veterinari                                          ,0,0,0,0,0,2024
CAL,VV,N   ,"Noleggio, agenzie di viaggio, servizi di supporto alle im...",6,0,0,6,12,2024
CAL,VV,N 77,Attività di noleggio e leasing operativo                    ,1,0,0,0,1,2024
CAL,VV,N 78,"Attività di ricerca, selezione, fornitura di personale      ",0,0,0,0,0,2024
CAL,VV,N 79,"Attività dei servizi delle agenzie di viaggio, dei tour o...",0,0,0,0,0,2024
CAL,VV,N 80,Servizi di vigilanza e investigazione                       ,1,0,0,0,1,2024
CAL,VV,N 81,Attività di servizi per edifici e paesaggio                 ,1,0,0,4,5,2024
CAL,VV,N 82,Attività di supporto per le funzioni d'ufficio e altri se...,3,0,0,2,5,2024
CAL,VV,O   ,Amministrazione pubblica e difesa; assicurazione sociale ...,0,0,0,0,0,2024
CAL,VV,O 84,Amministrazione pubblica e difesa; assicurazione sociale ...,0,0,0,0,0,2024
CAL,VV,P   ,Istruzione                                                  ,1,0,0,2,3,2024
CAL,VV,P 85,Istruzione                                                  ,1,0,0,2,3,2024
CAL,VV,Q   ,Sanita' e assistenza sociale                                ,0,0,0,0,0,2024
CAL,VV,Q 86,Assistenza sanitaria                                        ,0,0,0,0,0,2024
CAL,VV,Q 87,Servizi di assistenza sociale residenziale                  ,0,0,0,0,0,2024
CAL,VV,Q 88,Assistenza sociale non residenziale                         ,0,0,0,0,0,2024
CAL,VV,R   ,"Attività artistiche, sportive, di intrattenimento e diver...",2,0,0,3,5,2024
CAL,VV,R 90,"Attività creative, artistiche e di intrattenimento          ",1,0,0,1,2,2024
CAL,VV,R 91,"Attività di biblioteche, archivi, musei ed altre attività...",0,0,0,1,1,2024
CAL,VV,R 92,"Attività riguardanti le lotterie, le scommesse, le case d...",1,0,0,0,1,2024
CAL,VV,R 93,"Attività sportive, di intrattenimento e di divertimento     ",0,0,0,1,1,2024
CAL,VV,S   ,Altre attività di servizi                                   ,0,0,0,0,0,2024
CAL,VV,S 94,Attività di organizzazioni associative                      ,0,0,0,0,0,2024
CAL,VV,S 95,Riparazione di computer e di beni per uso personale e per...,0,0,0,0,0,2024
CAL,VV,S 96,Altre attività di servizi per la persona                    ,0,0,0,0,0,2024
CAL,VV,T   ,Attività di famiglie e convivenze come datori di lavoro p...,0,0,0,0,0,2024
CAL,VV,T 97,Attività di famiglie e convivenze come datori di lavoro p...,0,0,0,0,0,2024
CAL,VV,T 98,Produzione di beni e servizi indifferenziati per uso prop...,0,0,0,0,0,2024
CAL,VV,U   ,Organizzazioni ed organismi extraterritoriali               ,0,0,0,0,0,2024
CAL,VV,U 99,Organizzazioni ed organismi extraterritoriali               ,0,0,0,0,0,2024
CAL,VV,XX  ,Imprese non classificate                                    ,16,0,0,27,43,2024
CAL,VV,TOT ,TOTALE                                                      ,70,0,0,84,154,2024
SIC,  ,A   ,"Agricoltura, silvicoltura pesca                             ",7,1,1769,4,1781,2024
SIC,  ,A 01,"Coltivazioni agricole e produzione di prodotti animali, c...",6,1,1709,4,1720,2024
SIC,  ,A 02,Silvicoltura ed utilizzo di aree forestali                  ,1,0,3,0,4,2024
SIC,  ,A 03,Pesca e acquacoltura                                        ,0,0,57,0,57,2024
SIC,  ,B   ,Estrazione di minerali da cave e miniere                    ,0,1,3,0,4,2024
SIC,  ,B 05,Estrazione di carbone (esclusa torba)                       ,0,0,0,0,0,2024
SIC,  ,B 06,Estraz.di petrolio greggio e di gas naturale                ,0,0,0,0,0,2024
SIC,  ,B 07,Estrazione di minerali metalliferi                          ,0,0,0,0,0,2024
SIC,  ,B 08,Altre attività di estrazione di minerali da cave e miniere  ,0,1,3,0,4,2024
SIC,  ,B 09,Attività dei servizi di supporto all'estrazione             ,0,0,0,0,0,2024
SIC,  ,C   ,Attività manifatturiere                                     ,37,3,705,4,749,2024
SIC,  ,C 10,Industrie alimentari                                        ,4,0,176,0,180,2024
SIC,  ,C 11,Industria delle bevande                                     ,0,0,3,1,4,2024
SIC,  ,C 12,Industria del tabacco                                       ,0,0,0,0,0,2024
SIC,  ,C 13,Industrie tessili                                           ,0,0,12,0,12,2024
SIC,  ,C 14,Confezione di articoli di abbigliamento; confezione di ar...,1,0,41,1,43,2024
SIC,  ,C 15,Fabbricazione di articoli in pelle e simili                 ,1,0,8,0,9,2024
SIC,  ,C 16,Industria del legno e dei prodotti in legno e sughero (es...,1,0,75,1,77,2024
SIC,  ,C 17,Fabbricazione di carta e di prodotti di carta               ,1,0,8,0,9,2024
SIC,  ,C 18,Stampa e riproduzione di supporti registrati                ,2,0,23,1,26,2024
SIC,  ,C 19,Fabbricazione di coke e prodotti derivanti dalla raffinaz...,0,0,0,0,0,2024
SIC,  ,C 20,Fabbricazione di prodotti chimici                           ,0,0,6,0,6,2024
SIC,  ,C 21,Fabbricazione di prodotti farmaceutici di base e di prepa...,0,0,0,0,0,2024
SIC,  ,C 22,Fabbricazione di articoli in gomma e materie plastiche      ,4,0,9,0,13,2024
SIC,  ,C 23,Fabbricazione di altri prodotti della lavorazione di miner..,4,2,59,0,65,2024
SIC,  ,C 24,Metallurgia                                                 ,0,0,3,0,3,2024
SIC,  ,C 25,Fabbricazione di prodotti in metallo (esclusi macchinari ...,10,0,133,0,143,2024
SIC,  ,C 26,Fabbricazione di computer e prodotti di elettronica e ott...,1,0,8,0,9,2024
SIC,  ,C 27,Fabbricazione di apparecchiature elettriche ed apparecchi...,0,0,11,0,11,2024
SIC,  ,C 28,Fabbricazione di macchinari ed apparecchiature nca          ,1,1,10,0,12,2024
SIC,  ,C 29,"Fabbricazione di autoveicoli, rimorchi e semirimorchi       ",0,0,4,0,4,2024
SIC,  ,C 30,Fabbricazione di altri mezzi di trasporto                   ,1,0,11,0,12,2024
SIC,  ,C 31,Fabbricazione di mobili                                     ,0,0,28,0,28,2024
SIC,  ,C 32,Altre industrie manifatturiere                              ,2,0,43,0,45,2024
SIC,  ,C 33,"Riparazione, manutenzione ed installazione di macchine ed...",4,0,34,0,38,2024
SIC,  ,D   ,"Fornitura di energia elettrica, gas, vapore e aria condiz...",0,0,1,0,1,2024
SIC,  ,D 35,"Fornitura di energia elettrica, gas, vapore e aria condiz...",0,0,1,0,1,2024
SIC,  ,E   ,"Fornitura di acqua; reti fognarie, attività di gestione d...",1,0,19,1,21,2024
SIC,  ,E 36,"Raccolta, trattamento e fornitura di acqua                  ",0,0,1,0,1,2024
SIC,  ,E 37,Gestione delle reti fognarie                                ,0,0,1,0,1,2024
SIC,  ,E 38,"Attività di raccolta, trattamento e smaltimento dei rifiu...",1,0,15,1,17,2024
SIC,  ,E 39,Attività di risanamento e altri servizi di gestione dei r...,0,0,2,0,2,2024
SIC,  ,F   ,Costruzioni                                                 ,57,6,1342,9,1414,2024
SIC,  ,F 41,Costruzione di edifici                                      ,33,3,654,7,697,2024
SIC,  ,F 42,Ingegneria civile                                           ,0,0,18,1,19,2024
SIC,  ,F 43,Lavori di costruzione specializzati                         ,24,3,670,1,698,2024
SIC,  ,G   ,Commercio all'ingrosso e al dettaglio; riparazione di aut...,103,13,3615,3,3734,2024
SIC,  ,G 45,Commercio all'ingrosso e al dettaglio e riparazione di au...,11,0,317,0,328,2024
SIC,  ,G 46,Commercio all'ingrosso (escluso quello di autoveicoli e d...,36,11,673,2,722,2024
SIC,  ,G 47,Commercio al dettaglio (escluso quello di autoveicoli e d...,56,2,2625,1,2684,2024
SIC,  ,H   ,Trasporto e magazzinaggio                                   ,9,2,330,0,341,2024
SIC,  ,H 49,Trasporto terrestre e mediante condotte                     ,7,2,299,0,308,2024
SIC,  ,H 50,Trasporto marittimo e per vie d'acqua                       ,0,0,0,0,0,2024
SIC,  ,H 51,Trasporto aereo                                             ,0,0,0,0,0,2024
SIC,  ,H 52,Magazzinaggio e attività di supporto ai trasporti           ,2,0,24,0,26,2024
SIC,  ,H 53,Servizi postali e attività di corriere                      ,0,0,7,0,7,2024
SIC,  ,I   ,Attività dei servizi alloggio e ristorazione                ,38,3,625,1,667,2024
SIC,  ,I 55,Alloggio                                                    ,1,0,17,0,18,2024
SIC,  ,I 56,Attività dei servizi di ristorazione                        ,37,3,608,1,649,2024
SIC,  ,J   ,Servizi di informazione e comunicazione                     ,20,0,147,5,172,2024
SIC,  ,J 58,Attività editoriali                                         ,2,0,12,0,14,2024
SIC,  ,J 59,"Attività di produzione cinematografica, di video e di pro...",3,0,11,0,14,2024
SIC,  ,J 60,Attività di programmazione e trasmissione                   ,0,0,4,0,4,2024
SIC,  ,J 61,Telecomunicazioni                                           ,2,0,35,0,37,2024
SIC,  ,J 62,"Produzione di software, consulenza informatica e attività...",3,0,28,0,31,2024
SIC,  ,J 63,Attività dei servizi d'informazione e altri servizi infor...,10,0,57,5,72,2024
SIC,  ,K   ,Attività finanziarie e assicurative                         ,7,0,90,0,97,2024
SIC,  ,K 64,Attività di servizi finanziari (escluse le assicurazioni ...,1,0,0,0,1,2024
SIC,  ,K 65,"Assicurazioni, riassicurazioni e fondi pensione (escluse ...",0,0,0,0,0,2024
SIC,  ,K 66,Attività ausiliarie dei servizi finanziari e delle attivi...,6,0,90,0,96,2024
SIC,  ,L   ,Attivita' immobiliari                                       ,4,0,28,0,32,2024
SIC,  ,L 68,Attivita' immobiliari                                       ,4,0,28,0,32,2024
SIC,  ,M   ,"Attività professionali, scientifiche e tecniche             ",20,0,123,1,144,2024
SIC,  ,M 69,Attività legali e contabilità                               ,2,0,5,0,7,2024
SIC,  ,M 70,Attività di direzione aziendale e di consulenza gestional...,4,0,10,1,15,2024
SIC,  ,M 71,Attività degli studi di architettura e d'ingegneria; coll...,5,0,7,0,12,2024
SIC,  ,M 72,Ricerca scientifica e sviluppo                              ,1,0,0,0,1,2024
SIC,  ,M 73,Pubblicità e ricerche di mercato                            ,5,0,36,0,41,2024
SIC,  ,M 74,"Altre attività professionali, scientifiche e tecniche       ",3,0,64,0,67,2024
SIC,  ,M 75,Servizi veterinari                                          ,0,0,1,0,1,2024
SIC,  ,N   ,"Noleggio, agenzie di viaggio, servizi di supporto alle im...",12,0,262,7,281,2024
SIC,  ,N 77,Attività di noleggio e leasing operativo                    ,2,0,50,1,53,2024
SIC,  ,N 78,"Attività di ricerca, selezione, fornitura di personale      ",0,0,1,0,1,2024
SIC,  ,N 79,"Attività dei servizi delle agenzie di viaggio, dei tour o...",1,0,14,1,16,2024
SIC,  ,N 80,Servizi di vigilanza e investigazione                       ,0,0,8,0,8,2024
SIC,  ,N 81,Attività di servizi per edifici e paesaggio                 ,1,0,115,4,120,2024
SIC,  ,N 82,Attività di supporto per le funzioni d'ufficio e altri se...,8,0,74,1,83,2024
SIC,  ,O   ,Amministrazione pubblica e difesa; assicurazione sociale ...,0,0,0,0,0,2024
SIC,  ,O 84,Amministrazione pubblica e difesa; assicurazione sociale ...,0,0,0,0,0,2024
SIC,  ,P   ,Istruzione                                                  ,0,0,4,3,7,2024
SIC,  ,P 85,Istruzione                                                  ,0,0,4,3,7,2024
SIC,  ,Q   ,Sanita' e assistenza sociale                                ,4,0,20,0,24,2024
SIC,  ,Q 86,Assistenza sanitaria                                        ,4,0,4,0,8,2024
SIC,  ,Q 87,Servizi di assistenza sociale residenziale                  ,0,0,9,0,9,2024
SIC,  ,Q 88,Assistenza sociale non residenziale                         ,0,0,7,0,7,2024
SIC,  ,R   ,"Attività artistiche, sportive, di intrattenimento e diver...",6,0,104,1,111,2024
SIC,  ,R 90,"Attività creative, artistiche e di intrattenimento          ",2,0,25,0,27,2024
SIC,  ,R 91,"Attività di biblioteche, archivi, musei ed altre attività...",0,0,0,0,0,2024
SIC,  ,R 92,"Attività riguardanti le lotterie, le scommesse, le case d...",0,0,9,0,9,2024
SIC,  ,R 93,"Attività sportive, di intrattenimento e di divertimento     ",4,0,70,1,75,2024
SIC,  ,S   ,Altre attività di servizi                                   ,5,0,289,0,294,2024
SIC,  ,S 94,Attività di organizzazioni associative                      ,0,0,0,0,0,2024
SIC,  ,S 95,Riparazione di computer e di beni per uso personale e per...,0,0,89,0,89,2024
SIC,  ,S 96,Altre attività di servizi per la persona                    ,5,0,200,0,205,2024
SIC,  ,T   ,Attività di famiglie e convivenze come datori di lavoro p...,0,0,0,0,0,2024
SIC,  ,T 97,Attività di famiglie e convivenze come datori di lavoro p...,0,0,0,0,0,2024
SIC,  ,T 98,Produzione di beni e servizi indifferenziati per uso prop...,0,0,0,0,0,2024
SIC,  ,U   ,Organizzazioni ed organismi extraterritoriali               ,0,0,0,0,0,2024
SIC,  ,U 99,Organizzazioni ed organismi extraterritoriali               ,0,0,0,0,0,2024
SIC,  ,XX  ,Imprese non classificate                                    ,97,9,1548,29,1683,2024
SIC,  ,TOT ,TOTALE                                                      ,427,38,11024,68,11557,2024
SIC,TP,A   ,"Agricoltura, silvicoltura pesca                             ",0,0,0,0,0,2024
SIC,TP,A 01,"Coltivazioni agricole e produzione di prodotti animali, c...",0,0,0,0,0,2024
SIC,TP,A 02,Silvicoltura ed utilizzo di aree forestali                  ,0,0,0,0,0,2024
SIC,TP,A 03,Pesca e acquacoltura                                        ,0,0,0,0,0,2024
SIC,TP,B   ,Estrazione di minerali da cave e miniere                    ,0,0,0,0,0,2024
SIC,TP,B 05,Estrazione di carbone (esclusa torba)                       ,0,0,0,0,0,2024
SIC,TP,B 06,Estraz.di petrolio greggio e di gas naturale                ,0,0,0,0,0,2024
SIC,TP,B 07,Estrazione di minerali metalliferi                          ,0,0,0,0,0,2024
SIC,TP,B 08,Altre attività di estrazione di minerali da cave e miniere  ,0,0,0,0,0,2024
SIC,TP,B 09,Attività dei servizi di supporto all'estrazione             ,0,0,0,0,0,2024
SIC,TP,C   ,Attività manifatturiere                                     ,0,0,0,0,0,2024
SIC,TP,C 10,Industrie alimentari                                        ,0,0,0,0,0,2024
SIC,TP,C 11,Industria delle bevande                                     ,0,0,0,0,0,2024
SIC,TP,C 12,Industria del tabacco                                       ,0,0,0,0,0,2024
SIC,TP,C 13,Industrie tessili                                           ,0,0,0,0,0,2024
SIC,TP,C 14,Confezione di articoli di abbigliamento; confezione di ar...,0,0,0,0,0,2024
SIC,TP,C 15,Fabbricazione di articoli in pelle e simili                 ,0,0,0,0,0,2024
SIC,TP,C 16,Industria del legno e dei prodotti in legno e sughero (es...,0,0,0,0,0,2024
SIC,TP,C 17,Fabbricazione di carta e di prodotti di carta               ,0,0,0,0,0,2024
SIC,TP,C 18,Stampa e riproduzione di supporti registrati                ,0,0,0,0,0,2024
SIC,TP,C 19,Fabbricazione di coke e prodotti derivanti dalla raffinaz...,0,0,0,0,0,2024
SIC,TP,C 20,Fabbricazione di prodotti chimici                           ,0,0,0,0,0,2024
SIC,TP,C 21,Fabbricazione di prodotti farmaceutici di base e di prepa...,0,0,0,0,0,2024
SIC,TP,C 22,Fabbricazione di articoli in gomma e materie plastiche      ,0,0,0,0,0,2024
SIC,TP,C 23,Fabbricazione di altri prodotti della lavorazione di miner..,0,0,0,0,0,2024
SIC,TP,C 24,Metallurgia                                                 ,0,0,0,0,0,2024
SIC,TP,C 25,Fabbricazione di prodotti in metallo (esclusi macchinari ...,0,0,0,0,0,2024
SIC,TP,C 26,Fabbricazione di computer e prodotti di elettronica e ott...,0,0,0,0,0,2024
SIC,TP,C 27,Fabbricazione di apparecchiature elettriche ed apparecchi...,0,0,0,0,0,2024
SIC,TP,C 28,Fabbricazione di macchinari ed apparecchiature nca          ,0,0,0,0,0,2024
SIC,TP,C 29,"Fabbricazione di autoveicoli, rimorchi e semirimorchi       ",0,0,0,0,0,2024
SIC,TP,C 30,Fabbricazione di altri mezzi di trasporto                   ,0,0,0,0,0,2024
SIC,TP,C 31,Fabbricazione di mobili                                     ,0,0,0,0,0,2024
SIC,TP,C 32,Altre industrie manifatturiere                              ,0,0,0,0,0,2024
SIC,TP,C 33,"Riparazione, manutenzione ed installazione di macchine ed...",0,0,0,0,0,2024
SIC,TP,D   ,"Fornitura di energia elettrica, gas, vapore e aria condiz...",0,0,0,0,0,2024
SIC,TP,D 35,"Fornitura di energia elettrica, gas, vapore e aria condiz...",0,0,0,0,0,2024
SIC,TP,E   ,"Fornitura di acqua; reti fognarie, attività di gestione d...",0,0,0,0,0,2024
SIC,TP,E 36,"Raccolta, trattamento e fornitura di acqua                  ",0,0,0,0,0,2024
SIC,TP,E 37,Gestione delle reti fognarie                                ,0,0,0,0,0,2024
SIC,TP,E 38,"Attività di raccolta, trattamento e smaltimento dei rifiu...",0,0,0,0,0,2024
SIC,TP,E 39,Attività di risanamento e altri servizi di gestione dei r...,0,0,0,0,0,2024
SIC,TP,F   ,Costruzioni                                                 ,0,0,0,0,0,2024
SIC,TP,F 41,Costruzione di edifici                                      ,0,0,0,0,0,2024
SIC,TP,F 42,Ingegneria civile                                           ,0,0,0,0,0,2024
SIC,TP,F 43,Lavori di costruzione specializzati                         ,0,0,0,0,0,2024
SIC,TP,G   ,Commercio all'ingrosso e al dettaglio; riparazione di aut...,0,0,0,0,0,2024
SIC,TP,G 45,Commercio all'ingrosso e al dettaglio e riparazione di au...,0,0,0,0,0,2024
SIC,TP,G 46,Commercio all'ingrosso (escluso quello di autoveicoli e d...,0,0,0,0,0,2024
SIC,TP,G 47,Commercio al dettaglio (escluso quello di autoveicoli e d...,0,0,0,0,0,2024
SIC,TP,H   ,Trasporto e magazzinaggio                                   ,0,0,0,0,0,2024
SIC,TP,H 49,Trasporto terrestre e mediante condotte                     ,0,0,0,0,0,2024
SIC,TP,H 50,Trasporto marittimo e per vie d'acqua                       ,0,0,0,0,0,2024
SIC,TP,H 51,Trasporto aereo                                             ,0,0,0,0,0,2024
SIC,TP,H 52,Magazzinaggio e attività di supporto ai trasporti           ,0,0,0,0,0,2024
SIC,TP,H 53,Servizi postali e attività di corriere                      ,0,0,0,0,0,2024
SIC,TP,I   ,Attività dei servizi alloggio e ristorazione                ,0,0,1,0,1,2024
SIC,TP,I 55,Alloggio                                                    ,0,0,0,0,0,2024
SIC,TP,I 56,Attività dei servizi di ristorazione                        ,0,0,1,0,1,2024
SIC,TP,J   ,Servizi di informazione e comunicazione                     ,0,0,0,0,0,2024
SIC,TP,J 58,Attività editoriali                                         ,0,0,0,0,0,2024
SIC,TP,J 59,"Attività di produzione cinematografica, di video e di pro...",0,0,0,0,0,2024
SIC,TP,J 60,Attività di programmazione e trasmissione                   ,0,0,0,0,0,2024
SIC,TP,J 61,Telecomunicazioni                                           ,0,0,0,0,0,2024
SIC,TP,J 62,"Produzione di software, consulenza informatica e attività...",0,0,0,0,0,2024
SIC,TP,J 63,Attività dei servizi d'informazione e altri servizi infor...,0,0,0,0,0,2024
SIC,TP,K   ,Attività finanziarie e assicurative                         ,0,0,0,0,0,2024
SIC,TP,K 64,Attività di servizi finanziari (escluse le assicurazioni ...,0,0,0,0,0,2024
SIC,TP,K 65,"Assicurazioni, riassicurazioni e fondi pensione (escluse ...",0,0,0,0,0,2024
SIC,TP,K 66,Attività ausiliarie dei servizi finanziari e delle attivi...,0,0,0,0,0,2024
SIC,TP,L   ,Attivita' immobiliari                                       ,0,0,0,0,0,2024
SIC,TP,L 68,Attivita' immobiliari                                       ,0,0,0,0,0,2024
SIC,TP,M   ,"Attività professionali, scientifiche e tecniche             ",0,0,0,0,0,2024
SIC,TP,M 69,Attività legali e contabilità                               ,0,0,0,0,0,2024
SIC,TP,M 70,Attività di direzione aziendale e di consulenza gestional...,0,0,0,0,0,2024
SIC,TP,M 71,Attività degli studi di architettura e d'ingegneria; coll...,0,0,0,0,0,2024
SIC,TP,M 72,Ricerca scientifica e sviluppo                              ,0,0,0,0,0,2024
SIC,TP,M 73,Pubblicità e ricerche di mercato                            ,0,0,0,0,0,2024
SIC,TP,M 74,"Altre attività professionali, scientifiche e tecniche       ",0,0,0,0,0,2024
SIC,TP,M 75,Servizi veterinari                                          ,0,0,0,0,0,2024
SIC,TP,N   ,"Noleggio, agenzie di viaggio, servizi di supporto alle im...",0,0,0,0,0,2024
SIC,TP,N 77,Attività di noleggio e leasing operativo                    ,0,0,0,0,0,2024
SIC,TP,N 78,"Attività di ricerca, selezione, fornitura di personale      ",0,0,0,0,0,2024
SIC,TP,N 79,"Attività dei servizi delle agenzie di viaggio, dei tour o...",0,0,0,0,0,2024
SIC,TP,N 80,Servizi di vigilanza e investigazione                       ,0,0,0,0,0,2024
SIC,TP,N 81,Attività di servizi per edifici e paesaggio                 ,0,0,0,0,0,2024
SIC,TP,N 82,Attività di supporto per le funzioni d'ufficio e altri se...,0,0,0,0,0,2024
SIC,TP,O   ,Amministrazione pubblica e difesa; assicurazione sociale ...,0,0,0,0,0,2024
SIC,TP,O 84,Amministrazione pubblica e difesa; assicurazione sociale ...,0,0,0,0,0,2024
SIC,TP,P   ,Istruzione                                                  ,0,0,0,0,0,2024
SIC,TP,P 85,Istruzione                                                  ,0,0,0,0,0,2024
SIC,TP,Q   ,Sanita' e assistenza sociale                                ,0,0,0,0,0,2024
SIC,TP,Q 86,Assistenza sanitaria                                        ,0,0,0,0,0,2024
SIC,TP,Q 87,Servizi di assistenza sociale residenziale                  ,0,0,0,0,0,2024
SIC,TP,Q 88,Assistenza sociale non residenziale                         ,0,0,0,0,0,2024
SIC,TP,R   ,"Attività artistiche, sportive, di intrattenimento e diver...",0,0,0,0,0,2024
SIC,TP,R 90,"Attività creative, artistiche e di intrattenimento          ",0,0,0,0,0,2024
SIC,TP,R 91,"Attività di biblioteche, archivi, musei ed altre attività...",0,0,0,0,0,2024
SIC,TP,R 92,"Attività riguardanti le lotterie, le scommesse, le case d...",0,0,0,0,0,2024
SIC,TP,R 93,"Attività sportive, di intrattenimento e di divertimento     ",0,0,0,0,0,2024
SIC,TP,S   ,Altre attività di servizi                                   ,0,0,0,0,0,2024
SIC,TP,S 94,Attività di organizzazioni associative                      ,0,0,0,0,0,2024
SIC,TP,S 95,Riparazione di computer e di beni per uso personale e per...,0,0,0,0,0,2024
SIC,TP,S 96,Altre attività di servizi per la persona                    ,0,0,0,0,0,2024
SIC,TP,T   ,Attività di famiglie e convivenze come datori di lavoro p...,0,0,0,0,0,2024
SIC,TP,T 97,Attività di famiglie e convivenze come datori di lavoro p...,0,0,0,0,0,2024
SIC,TP,T 98,Produzione di beni e servizi indifferenziati per uso prop...,0,0,0,0,0,2024
SIC,TP,U   ,Organizzazioni ed organismi extraterritoriali               ,0,0,0,0,0,2024
SIC,TP,U 99,Organizzazioni ed organismi extraterritoriali               ,0,0,0,0,0,2024
SIC,TP,XX  ,Imprese non classificate                                    ,0,0,0,2,2,2024
SIC,TP,TOT ,TOTALE                                                      ,0,0,1,2,3,2024
SIC,PA,A   ,"Agricoltura, silvicoltura pesca                             ",0,0,0,0,0,2024
SIC,PA,A 01,"Coltivazioni agricole e produzione di prodotti animali, c...",0,0,0,0,0,2024
SIC,PA,A 02,Silvicoltura ed utilizzo di aree forestali                  ,0,0,0,0,0,2024
SIC,PA,A 03,Pesca e acquacoltura                                        ,0,0,0,0,0,2024
SIC,PA,B   ,Estrazione di minerali da cave e miniere                    ,0,0,0,0,0,2024
SIC,PA,B 05,Estrazione di carbone (esclusa torba)                       ,0,0,0,0,0,2024
SIC,PA,B 06,Estraz.di petrolio greggio e di gas naturale                ,0,0,0,0,0,2024
SIC,PA,B 07,Estrazione di minerali metalliferi                          ,0,0,0,0,0,2024
SIC,PA,B 08,Altre attività di estrazione di minerali da cave e miniere  ,0,0,0,0,0,2024
SIC,PA,B 09,Attività dei servizi di supporto all'estrazione             ,0,0,0,0,0,2024
SIC,PA,C   ,Attività manifatturiere                                     ,0,0,0,1,1,2024
SIC,PA,C 10,Industrie alimentari                                        ,0,0,0,0,0,2024
SIC,PA,C 11,Industria delle bevande                                     ,0,0,0,1,1,2024
SIC,PA,C 12,Industria del tabacco                                       ,0,0,0,0,0,2024
SIC,PA,C 13,Industrie tessili                                           ,0,0,0,0,0,2024
SIC,PA,C 14,Confezione di articoli di abbigliamento; confezione di ar...,0,0,0,0,0,2024
SIC,PA,C 15,Fabbricazione di articoli in pelle e simili                 ,0,0,0,0,0,2024
SIC,PA,C 16,Industria del legno e dei prodotti in legno e sughero (es...,0,0,0,0,0,2024
SIC,PA,C 17,Fabbricazione di carta e di prodotti di carta               ,0,0,0,0,0,2024
SIC,PA,C 18,Stampa e riproduzione di supporti registrati                ,0,0,0,0,0,2024
SIC,PA,C 19,Fabbricazione di coke e prodotti derivanti dalla raffinaz...,0,0,0,0,0,2024
SIC,PA,C 20,Fabbricazione di prodotti chimici                           ,0,0,0,0,0,2024
SIC,PA,C 21,Fabbricazione di prodotti farmaceutici di base e di prepa...,0,0,0,0,0,2024
SIC,PA,C 22,Fabbricazione di articoli in gomma e materie plastiche      ,0,0,0,0,0,2024
SIC,PA,C 23,Fabbricazione di altri prodotti della lavorazione di miner..,0,0,0,0,0,2024
SIC,PA,C 24,Metallurgia                                                 ,0,0,0,0,0,2024
SIC,PA,C 25,Fabbricazione di prodotti in metallo (esclusi macchinari ...,0,0,0,0,0,2024
SIC,PA,C 26,Fabbricazione di computer e prodotti di elettronica e ott...,0,0,0,0,0,2024
SIC,PA,C 27,Fabbricazione di apparecchiature elettriche ed apparecchi...,0,0,0,0,0,2024
SIC,PA,C 28,Fabbricazione di macchinari ed apparecchiature nca          ,0,0,0,0,0,2024
SIC,PA,C 29,"Fabbricazione di autoveicoli, rimorchi e semirimorchi       ",0,0,0,0,0,2024
SIC,PA,C 30,Fabbricazione di altri mezzi di trasporto                   ,0,0,0,0,0,2024
SIC,PA,C 31,Fabbricazione di mobili                                     ,0,0,0,0,0,2024
SIC,PA,C 32,Altre industrie manifatturiere                              ,0,0,0,0,0,2024
SIC,PA,C 33,"Riparazione, manutenzione ed installazione di macchine ed...",0,0,0,0,0,2024
SIC,PA,D   ,"Fornitura di energia elettrica, gas, vapore e aria condiz...",0,0,0,0,0,2024
SIC,PA,D 35,"Fornitura di energia elettrica, gas, vapore e aria condiz...",0,0,0,0,0,2024
SIC,PA,E   ,"Fornitura di acqua; reti fognarie, attività di gestione d...",0,0,0,0,0,2024
SIC,PA,E 36,"Raccolta, trattamento e fornitura di acqua                  ",0,0,0,0,0,2024
SIC,PA,E 37,Gestione delle reti fognarie                                ,0,0,0,0,0,2024
SIC,PA,E 38,"Attività di raccolta, trattamento e smaltimento dei rifiu...",0,0,0,0,0,2024
SIC,PA,E 39,Attività di risanamento e altri servizi di gestione dei r...,0,0,0,0,0,2024
SIC,PA,F   ,Costruzioni                                                 ,0,0,1,0,1,2024
SIC,PA,F 41,Costruzione di edifici                                      ,0,0,0,0,0,2024
SIC,PA,F 42,Ingegneria civile                                           ,0,0,0,0,0,2024
SIC,PA,F 43,Lavori di costruzione specializzati                         ,0,0,1,0,1,2024
SIC,PA,G   ,Commercio all'ingrosso e al dettaglio; riparazione di aut...,0,0,1,1,2,2024
SIC,PA,G 45,Commercio all'ingrosso e al dettaglio e riparazione di au...,0,0,0,0,0,2024
SIC,PA,G 46,Commercio all'ingrosso (escluso quello di autoveicoli e d...,0,0,0,0,0,2024
SIC,PA,G 47,Commercio al dettaglio (escluso quello di autoveicoli e d...,0,0,1,1,2,2024
SIC,PA,H   ,Trasporto e magazzinaggio                                   ,0,0,0,0,0,2024
SIC,PA,H 49,Trasporto terrestre e mediante condotte                     ,0,0,0,0,0,2024
SIC,PA,H 50,Trasporto marittimo e per vie d'acqua                       ,0,0,0,0,0,2024
SIC,PA,H 51,Trasporto aereo                                             ,0,0,0,0,0,2024
SIC,PA,H 52,Magazzinaggio e attività di supporto ai trasporti           ,0,0,0,0,0,2024
SIC,PA,H 53,Servizi postali e attività di corriere                      ,0,0,0,0,0,2024
SIC,PA,I   ,Attività dei servizi alloggio e ristorazione                ,0,0,0,0,0,2024
SIC,PA,I 55,Alloggio                                                    ,0,0,0,0,0,2024
SIC,PA,I 56,Attività dei servizi di ristorazione                        ,0,0,0,0,0,2024
SIC,PA,J   ,Servizi di informazione e comunicazione                     ,0,0,0,2,2,2024
SIC,PA,J 58,Attività editoriali                                         ,0,0,0,0,0,2024
SIC,PA,J 59,"Attività di produzione cinematografica, di video e di pro...",0,0,0,0,0,2024
SIC,PA,J 60,Attività di programmazione e trasmissione                   ,0,0,0,0,0,2024
SIC,PA,J 61,Telecomunicazioni                                           ,0,0,0,0,0,2024
SIC,PA,J 62,"Produzione di software, consulenza informatica e attività...",0,0,0,0,0,2024
SIC,PA,J 63,Attività dei servizi d'informazione e altri servizi infor...,0,0,0,2,2,2024
SIC,PA,K   ,Attività finanziarie e assicurative                         ,0,0,0,0,0,2024
SIC,PA,K 64,Attività di servizi finanziari (escluse le assicurazioni ...,0,0,0,0,0,2024
SIC,PA,K 65,"Assicurazioni, riassicurazioni e fondi pensione (escluse ...",0,0,0,0,0,2024
SIC,PA,K 66,Attività ausiliarie dei servizi finanziari e delle attivi...,0,0,0,0,0,2024
SIC,PA,L   ,Attivita' immobiliari                                       ,0,0,0,0,0,2024
SIC,PA,L 68,Attivita' immobiliari                                       ,0,0,0,0,0,2024
SIC,PA,M   ,"Attività professionali, scientifiche e tecniche             ",0,0,0,1,1,2024
SIC,PA,M 69,Attività legali e contabilità                               ,0,0,0,0,0,2024
SIC,PA,M 70,Attività di direzione aziendale e di consulenza gestional...,0,0,0,1,1,2024
SIC,PA,M 71,Attività degli studi di architettura e d'ingegneria; coll...,0,0,0,0,0,2024
SIC,PA,M 72,Ricerca scientifica e sviluppo                              ,0,0,0,0,0,2024
SIC,PA,M 73,Pubblicità e ricerche di mercato                            ,0,0,0,0,0,2024
SIC,PA,M 74,"Altre attività professionali, scientifiche e tecniche       ",0,0,0,0,0,2024
SIC,PA,M 75,Servizi veterinari                                          ,0,0,0,0,0,2024
SIC,PA,N   ,"Noleggio, agenzie di viaggio, servizi di supporto alle im...",0,0,0,3,3,2024
SIC,PA,N 77,Attività di noleggio e leasing operativo                    ,0,0,0,1,1,2024
SIC,PA,N 78,"Attività di ricerca, selezione, fornitura di personale      ",0,0,0,0,0,2024
SIC,PA,N 79,"Attività dei servizi delle agenzie di viaggio, dei tour o...",0,0,0,1,1,2024
SIC,PA,N 80,Servizi di vigilanza e investigazione                       ,0,0,0,0,0,2024
SIC,PA,N 81,Attività di servizi per edifici e paesaggio                 ,0,0,0,0,0,2024
SIC,PA,N 82,Attività di supporto per le funzioni d'ufficio e altri se...,0,0,0,1,1,2024
SIC,PA,O   ,Amministrazione pubblica e difesa; assicurazione sociale ...,0,0,0,0,0,2024
SIC,PA,O 84,Amministrazione pubblica e difesa; assicurazione sociale ...,0,0,0,0,0,2024
SIC,PA,P   ,Istruzione                                                  ,0,0,0,1,1,2024
SIC,PA,P 85,Istruzione                                                  ,0,0,0,1,1,2024
SIC,PA,Q   ,Sanita' e assistenza sociale                                ,0,0,0,0,0,2024
SIC,PA,Q 86,Assistenza sanitaria                                        ,0,0,0,0,0,2024
SIC,PA,Q 87,Servizi di assistenza sociale residenziale                  ,0,0,0,0,0,2024
SIC,PA,Q 88,Assistenza sociale non residenziale                         ,0,0,0,0,0,2024
SIC,PA,R   ,"Attività artistiche, sportive, di intrattenimento e diver...",0,0,0,1,1,2024
SIC,PA,R 90,"Attività creative, artistiche e di intrattenimento          ",0,0,0,0,0,2024
SIC,PA,R 91,"Attività di biblioteche, archivi, musei ed altre attività...",0,0,0,0,0,2024
SIC,PA,R 92,"Attività riguardanti le lotterie, le scommesse, le case d...",0,0,0,0,0,2024
SIC,PA,R 93,"Attività sportive, di intrattenimento e di divertimento     ",0,0,0,1,1,2024
SIC,PA,S   ,Altre attività di servizi                                   ,0,0,0,0,0,2024
SIC,PA,S 94,Attività di organizzazioni associative                      ,0,0,0,0,0,2024
SIC,PA,S 95,Riparazione di computer e di beni per uso personale e per...,0,0,0,0,0,2024
SIC,PA,S 96,Altre attività di servizi per la persona                    ,0,0,0,0,0,2024
SIC,PA,T   ,Attività di famiglie e convivenze come datori di lavoro p...,0,0,0,0,0,2024
SIC,PA,T 97,Attività di famiglie e convivenze come datori di lavoro p...,0,0,0,0,0,2024
SIC,PA,T 98,Produzione di beni e servizi indifferenziati per uso prop...,0,0,0,0,0,2024
SIC,PA,U   ,Organizzazioni ed organismi extraterritoriali               ,0,0,0,0,0,2024
SIC,PA,U 99,Organizzazioni ed organismi extraterritoriali               ,0,0,0,0,0,2024
SIC,PA,XX  ,Imprese non classificate                                    ,0,0,0,7,7,2024
SIC,PA,TOT ,TOTALE                                                      ,0,0,2,17,19,2024
SIC,ME,A   ,"Agricoltura, silvicoltura pesca                             ",0,0,0,0,0,2024
SIC,ME,A 01,"Coltivazioni agricole e produzione di prodotti animali, c...",0,0,0,0,0,2024
SIC,ME,A 02,Silvicoltura ed utilizzo di aree forestali                  ,0,0,0,0,0,2024
SIC,ME,A 03,Pesca e acquacoltura                                        ,0,0,0,0,0,2024
SIC,ME,B   ,Estrazione di minerali da cave e miniere                    ,0,0,0,0,0,2024
SIC,ME,B 05,Estrazione di carbone (esclusa torba)                       ,0,0,0,0,0,2024
SIC,ME,B 06,Estraz.di petrolio greggio e di gas naturale                ,0,0,0,0,0,2024
SIC,ME,B 07,Estrazione di minerali metalliferi                          ,0,0,0,0,0,2024
SIC,ME,B 08,Altre attività di estrazione di minerali da cave e miniere  ,0,0,0,0,0,2024
SIC,ME,B 09,Attività dei servizi di supporto all'estrazione             ,0,0,0,0,0,2024
SIC,ME,C   ,Attività manifatturiere                                     ,1,0,0,0,1,2024
SIC,ME,C 10,Industrie alimentari                                        ,0,0,0,0,0,2024
SIC,ME,C 11,Industria delle bevande                                     ,0,0,0,0,0,2024
SIC,ME,C 12,Industria del tabacco                                       ,0,0,0,0,0,2024
SIC,ME,C 13,Industrie tessili                                           ,0,0,0,0,0,2024
SIC,ME,C 14,Confezione di articoli di abbigliamento; confezione di ar...,0,0,0,0,0,2024
SIC,ME,C 15,Fabbricazione di articoli in pelle e simili                 ,0,0,0,0,0,2024
SIC,ME,C 16,Industria del legno e dei prodotti in legno e sughero (es...,0,0,0,0,0,2024
SIC,ME,C 17,Fabbricazione di carta e di prodotti di carta               ,0,0,0,0,0,2024
SIC,ME,C 18,Stampa e riproduzione di supporti registrati                ,0,0,0,0,0,2024
SIC,ME,C 19,Fabbricazione di coke e prodotti derivanti dalla raffinaz...,0,0,0,0,0,2024
SIC,ME,C 20,Fabbricazione di prodotti chimici                           ,0,0,0,0,0,2024
SIC,ME,C 21,Fabbricazione di prodotti farmaceutici di base e di prepa...,0,0,0,0,0,2024
SIC,ME,C 22,Fabbricazione di articoli in gomma e materie plastiche      ,0,0,0,0,0,2024
SIC,ME,C 23,Fabbricazione di altri prodotti della lavorazione di miner..,0,0,0,0,0,2024
SIC,ME,C 24,Metallurgia                                                 ,0,0,0,0,0,2024
SIC,ME,C 25,Fabbricazione di prodotti in metallo (esclusi macchinari ...,0,0,0,0,0,2024
SIC,ME,C 26,Fabbricazione di computer e prodotti di elettronica e ott...,0,0,0,0,0,2024
SIC,ME,C 27,Fabbricazione di apparecchiature elettriche ed apparecchi...,0,0,0,0,0,2024
SIC,ME,C 28,Fabbricazione di macchinari ed apparecchiature nca          ,0,0,0,0,0,2024
SIC,ME,C 29,"Fabbricazione di autoveicoli, rimorchi e semirimorchi       ",0,0,0,0,0,2024
SIC,ME,C 30,Fabbricazione di altri mezzi di trasporto                   ,1,0,0,0,1,2024
SIC,ME,C 31,Fabbricazione di mobili                                     ,0,0,0,0,0,2024
SIC,ME,C 32,Altre industrie manifatturiere                              ,0,0,0,0,0,2024
SIC,ME,C 33,"Riparazione, manutenzione ed installazione di macchine ed...",0,0,0,0,0,2024
SIC,ME,D   ,"Fornitura di energia elettrica, gas, vapore e aria condiz...",0,0,0,0,0,2024
SIC,ME,D 35,"Fornitura di energia elettrica, gas, vapore e aria condiz...",0,0,0,0,0,2024
SIC,ME,E   ,"Fornitura di acqua; reti fognarie, attività di gestione d...",0,0,0,0,0,2024
SIC,ME,E 36,"Raccolta, trattamento e fornitura di acqua                  ",0,0,0,0,0,2024
SIC,ME,E 37,Gestione delle reti fognarie                                ,0,0,0,0,0,2024
SIC,ME,E 38,"Attività di raccolta, trattamento e smaltimento dei rifiu...",0,0,0,0,0,2024
SIC,ME,E 39,Attività di risanamento e altri servizi di gestione dei r...,0,0,0,0,0,2024
SIC,ME,F   ,Costruzioni                                                 ,1,0,1,2,4,2024
SIC,ME,F 41,Costruzione di edifici                                      ,1,0,1,2,4,2024
SIC,ME,F 42,Ingegneria civile                                           ,0,0,0,0,0,2024
SIC,ME,F 43,Lavori di costruzione specializzati                         ,0,0,0,0,0,2024
SIC,ME,G   ,Commercio all'ingrosso e al dettaglio; riparazione di aut...,1,0,1,0,2,2024
SIC,ME,G 45,Commercio all'ingrosso e al dettaglio e riparazione di au...,0,0,0,0,0,2024
SIC,ME,G 46,Commercio all'ingrosso (escluso quello di autoveicoli e d...,1,0,0,0,1,2024
SIC,ME,G 47,Commercio al dettaglio (escluso quello di autoveicoli e d...,0,0,1,0,1,2024
SIC,ME,H   ,Trasporto e magazzinaggio                                   ,0,0,0,0,0,2024
SIC,ME,H 49,Trasporto terrestre e mediante condotte                     ,0,0,0,0,0,2024
SIC,ME,H 50,Trasporto marittimo e per vie d'acqua                       ,0,0,0,0,0,2024
SIC,ME,H 51,Trasporto aereo                                             ,0,0,0,0,0,2024
SIC,ME,H 52,Magazzinaggio e attività di supporto ai trasporti           ,0,0,0,0,0,2024
SIC,ME,H 53,Servizi postali e attività di corriere                      ,0,0,0,0,0,2024
SIC,ME,I   ,Attività dei servizi alloggio e ristorazione                ,0,0,0,0,0,2024
SIC,ME,I 55,Alloggio                                                    ,0,0,0,0,0,2024
SIC,ME,I 56,Attività dei servizi di ristorazione                        ,0,0,0,0,0,2024
SIC,ME,J   ,Servizi di informazione e comunicazione                     ,0,0,0,0,0,2024
SIC,ME,J 58,Attività editoriali                                         ,0,0,0,0,0,2024
SIC,ME,J 59,"Attività di produzione cinematografica, di video e di pro...",0,0,0,0,0,2024
SIC,ME,J 60,Attività di programmazione e trasmissione                   ,0,0,0,0,0,2024
SIC,ME,J 61,Telecomunicazioni                                           ,0,0,0,0,0,2024
SIC,ME,J 62,"Produzione di software, consulenza informatica e attività...",0,0,0,0,0,2024
SIC,ME,J 63,Attività dei servizi d'informazione e altri servizi infor...,0,0,0,0,0,2024
SIC,ME,K   ,Attività finanziarie e assicurative                         ,1,0,0,0,1,2024
SIC,ME,K 64,Attività di servizi finanziari (escluse le assicurazioni ...,0,0,0,0,0,2024
SIC,ME,K 65,"Assicurazioni, riassicurazioni e fondi pensione (escluse ...",0,0,0,0,0,2024
SIC,ME,K 66,Attività ausiliarie dei servizi finanziari e delle attivi...,1,0,0,0,1,2024
SIC,ME,L   ,Attivita' immobiliari                                       ,0,0,0,0,0,2024
SIC,ME,L 68,Attivita' immobiliari                                       ,0,0,0,0,0,2024
SIC,ME,M   ,"Attività professionali, scientifiche e tecniche             ",0,0,0,0,0,2024
SIC,ME,M 69,Attività legali e contabilità                               ,0,0,0,0,0,2024
SIC,ME,M 70,Attività di direzione aziendale e di consulenza gestional...,0,0,0,0,0,2024
SIC,ME,M 71,Attività degli studi di architettura e d'ingegneria; coll...,0,0,0,0,0,2024
SIC,ME,M 72,Ricerca scientifica e sviluppo                              ,0,0,0,0,0,2024
SIC,ME,M 73,Pubblicità e ricerche di mercato                            ,0,0,0,0,0,2024
SIC,ME,M 74,"Altre attività professionali, scientifiche e tecniche       ",0,0,0,0,0,2024
SIC,ME,M 75,Servizi veterinari                                          ,0,0,0,0,0,2024
SIC,ME,N   ,"Noleggio, agenzie di viaggio, servizi di supporto alle im...",0,0,0,1,1,2024
SIC,ME,N 77,Attività di noleggio e leasing operativo                    ,0,0,0,0,0,2024
SIC,ME,N 78,"Attività di ricerca, selezione, fornitura di personale      ",0,0,0,0,0,2024
SIC,ME,N 79,"Attività dei servizi delle agenzie di viaggio, dei tour o...",0,0,0,0,0,2024
SIC,ME,N 80,Servizi di vigilanza e investigazione                       ,0,0,0,0,0,2024
SIC,ME,N 81,Attività di servizi per edifici e paesaggio                 ,0,0,0,1,1,2024
SIC,ME,N 82,Attività di supporto per le funzioni d'ufficio e altri se...,0,0,0,0,0,2024
SIC,ME,O   ,Amministrazione pubblica e difesa; assicurazione sociale ...,0,0,0,0,0,2024
SIC,ME,O 84,Amministrazione pubblica e difesa; assicurazione sociale ...,0,0,0,0,0,2024
SIC,ME,P   ,Istruzione                                                  ,0,0,0,0,0,2024
SIC,ME,P 85,Istruzione                                                  ,0,0,0,0,0,2024
SIC,ME,Q   ,Sanita' e assistenza sociale                                ,0,0,0,0,0,2024
SIC,ME,Q 86,Assistenza sanitaria                                        ,0,0,0,0,0,2024
SIC,ME,Q 87,Servizi di assistenza sociale residenziale                  ,0,0,0,0,0,2024
SIC,ME,Q 88,Assistenza sociale non residenziale                         ,0,0,0,0,0,2024
SIC,ME,R   ,"Attività artistiche, sportive, di intrattenimento e diver...",0,0,0,0,0,2024
SIC,ME,R 90,"Attività creative, artistiche e di intrattenimento          ",0,0,0,0,0,2024
SIC,ME,R 91,"Attività di biblioteche, archivi, musei ed altre attività...",0,0,0,0,0,2024
SIC,ME,R 92,"Attività riguardanti le lotterie, le scommesse, le case d...",0,0,0,0,0,2024
SIC,ME,R 93,"Attività sportive, di intrattenimento e di divertimento     ",0,0,0,0,0,2024
SIC,ME,S   ,Altre attività di servizi                                   ,0,0,0,0,0,2024
SIC,ME,S 94,Attività di organizzazioni associative                      ,0,0,0,0,0,2024
SIC,ME,S 95,Riparazione di computer e di beni per uso personale e per...,0,0,0,0,0,2024
SIC,ME,S 96,Altre attività di servizi per la persona                    ,0,0,0,0,0,2024
SIC,ME,T   ,Attività di famiglie e convivenze come datori di lavoro p...,0,0,0,0,0,2024
SIC,ME,T 97,Attività di famiglie e convivenze come datori di lavoro p...,0,0,0,0,0,2024
SIC,ME,T 98,Produzione di beni e servizi indifferenziati per uso prop...,0,0,0,0,0,2024
SIC,ME,U   ,Organizzazioni ed organismi extraterritoriali               ,0,0,0,0,0,2024
SIC,ME,U 99,Organizzazioni ed organismi extraterritoriali               ,0,0,0,0,0,2024
SIC,ME,XX  ,Imprese non classificate                                    ,0,0,0,2,2,2024
SIC,ME,TOT ,TOTALE                                                      ,4,0,2,5,11,2024
SIC,AG,A   ,"Agricoltura, silvicoltura pesca                             ",0,0,353,0,353,2024
SIC,AG,A 01,"Coltivazioni agricole e produzione di prodotti animali, c...",0,0,351,0,351,2024
SIC,AG,A 02,Silvicoltura ed utilizzo di aree forestali                  ,0,0,0,0,0,2024
SIC,AG,A 03,Pesca e acquacoltura                                        ,0,0,2,0,2,2024
SIC,AG,B   ,Estrazione di minerali da cave e miniere                    ,0,0,0,0,0,2024
SIC,AG,B 05,Estrazione di carbone (esclusa torba)                       ,0,0,0,0,0,2024
SIC,AG,B 06,Estraz.di petrolio greggio e di gas naturale                ,0,0,0,0,0,2024
SIC,AG,B 07,Estrazione di minerali metalliferi                          ,0,0,0,0,0,2024
SIC,AG,B 08,Altre attività di estrazione di minerali da cave e miniere  ,0,0,0,0,0,2024
SIC,AG,B 09,Attività dei servizi di supporto all'estrazione             ,0,0,0,0,0,2024
SIC,AG,C   ,Attività manifatturiere                                     ,0,0,7,1,8,2024
SIC,AG,C 10,Industrie alimentari                                        ,0,0,3,0,3,2024
SIC,AG,C 11,Industria delle bevande                                     ,0,0,0,0,0,2024
SIC,AG,C 12,Industria del tabacco                                       ,0,0,0,0,0,2024
SIC,AG,C 13,Industrie tessili                                           ,0,0,0,0,0,2024
SIC,AG,C 14,Confezione di articoli di abbigliamento; confezione di ar...,0,0,0,0,0,2024
SIC,AG,C 15,Fabbricazione di articoli in pelle e simili                 ,0,0,0,0,0,2024
SIC,AG,C 16,Industria del legno e dei prodotti in legno e sughero (es...,0,0,1,1,2,2024
SIC,AG,C 17,Fabbricazione di carta e di prodotti di carta               ,0,0,0,0,0,2024
SIC,AG,C 18,Stampa e riproduzione di supporti registrati                ,0,0,0,0,0,2024
SIC,AG,C 19,Fabbricazione di coke e prodotti derivanti dalla raffinaz...,0,0,0,0,0,2024
SIC,AG,C 20,Fabbricazione di prodotti chimici                           ,0,0,0,0,0,2024
SIC,AG,C 21,Fabbricazione di prodotti farmaceutici di base e di prepa...,0,0,0,0,0,2024
SIC,AG,C 22,Fabbricazione di articoli in gomma e materie plastiche      ,0,0,1,0,1,2024
SIC,AG,C 23,Fabbricazione di altri prodotti della lavorazione di miner..,0,0,2,0,2,2024
SIC,AG,C 24,Metallurgia                                                 ,0,0,0,0,0,2024
SIC,AG,C 25,Fabbricazione di prodotti in metallo (esclusi macchinari ...,0,0,0,0,0,2024
SIC,AG,C 26,Fabbricazione di computer e prodotti di elettronica e ott...,0,0,0,0,0,2024
SIC,AG,C 27,Fabbricazione di apparecchiature elettriche ed apparecchi...,0,0,0,0,0,2024
SIC,AG,C 28,Fabbricazione di macchinari ed apparecchiature nca          ,0,0,0,0,0,2024
SIC,AG,C 29,"Fabbricazione di autoveicoli, rimorchi e semirimorchi       ",0,0,0,0,0,2024
SIC,AG,C 30,Fabbricazione di altri mezzi di trasporto                   ,0,0,0,0,0,2024
SIC,AG,C 31,Fabbricazione di mobili                                     ,0,0,0,0,0,2024
SIC,AG,C 32,Altre industrie manifatturiere                              ,0,0,0,0,0,2024
SIC,AG,C 33,"Riparazione, manutenzione ed installazione di macchine ed...",0,0,0,0,0,2024
SIC,AG,D   ,"Fornitura di energia elettrica, gas, vapore e aria condiz...",0,0,0,0,0,2024
SIC,AG,D 35,"Fornitura di energia elettrica, gas, vapore e aria condiz...",0,0,0,0,0,2024
SIC,AG,E   ,"Fornitura di acqua; reti fognarie, attività di gestione d...",0,0,0,0,0,2024
SIC,AG,E 36,"Raccolta, trattamento e fornitura di acqua                  ",0,0,0,0,0,2024
SIC,AG,E 37,Gestione delle reti fognarie                                ,0,0,0,0,0,2024
SIC,AG,E 38,"Attività di raccolta, trattamento e smaltimento dei rifiu...",0,0,0,0,0,2024
SIC,AG,E 39,Attività di risanamento e altri servizi di gestione dei r...,0,0,0,0,0,2024
SIC,AG,F   ,Costruzioni                                                 ,0,0,6,1,7,2024
SIC,AG,F 41,Costruzione di edifici                                      ,0,0,2,0,2,2024
SIC,AG,F 42,Ingegneria civile                                           ,0,0,0,0,0,2024
SIC,AG,F 43,Lavori di costruzione specializzati                         ,0,0,4,1,5,2024
SIC,AG,G   ,Commercio all'ingrosso e al dettaglio; riparazione di aut...,0,0,21,0,21,2024
SIC,AG,G 45,Commercio all'ingrosso e al dettaglio e riparazione di au...,0,0,1,0,1,2024
SIC,AG,G 46,Commercio all'ingrosso (escluso quello di autoveicoli e d...,0,0,2,0,2,2024
SIC,AG,G 47,Commercio al dettaglio (escluso quello di autoveicoli e d...,0,0,18,0,18,2024
SIC,AG,H   ,Trasporto e magazzinaggio                                   ,0,0,7,0,7,2024
SIC,AG,H 49,Trasporto terrestre e mediante condotte                     ,0,0,7,0,7,2024
SIC,AG,H 50,Trasporto marittimo e per vie d'acqua                       ,0,0,0,0,0,2024
SIC,AG,H 51,Trasporto aereo                                             ,0,0,0,0,0,2024
SIC,AG,H 52,Magazzinaggio e attività di supporto ai trasporti           ,0,0,0,0,0,2024
SIC,AG,H 53,Servizi postali e attività di corriere                      ,0,0,0,0,0,2024
SIC,AG,I   ,Attività dei servizi alloggio e ristorazione                ,0,0,1,0,1,2024
SIC,AG,I 55,Alloggio                                                    ,0,0,1,0,1,2024
SIC,AG,I 56,Attività dei servizi di ristorazione                        ,0,0,0,0,0,2024
SIC,AG,J   ,Servizi di informazione e comunicazione                     ,0,0,0,0,0,2024
SIC,AG,J 58,Attività editoriali                                         ,0,0,0,0,0,2024
SIC,AG,J 59,"Attività di produzione cinematografica, di video e di pro...",0,0,0,0,0,2024
SIC,AG,J 60,Attività di programmazione e trasmissione                   ,0,0,0,0,0,2024
SIC,AG,J 61,Telecomunicazioni                                           ,0,0,0,0,0,2024
SIC,AG,J 62,"Produzione di software, consulenza informatica e attività...",0,0,0,0,0,2024
SIC,AG,J 63,Attività dei servizi d'informazione e altri servizi infor...,0,0,0,0,0,2024
SIC,AG,K   ,Attività finanziarie e assicurative                         ,0,0,0,0,0,2024
SIC,AG,K 64,Attività di servizi finanziari (escluse le assicurazioni ...,0,0,0,0,0,2024
SIC,AG,K 65,"Assicurazioni, riassicurazioni e fondi pensione (escluse ...",0,0,0,0,0,2024
SIC,AG,K 66,Attività ausiliarie dei servizi finanziari e delle attivi...,0,0,0,0,0,2024
SIC,AG,L   ,Attivita' immobiliari                                       ,0,0,1,0,1,2024
SIC,AG,L 68,Attivita' immobiliari                                       ,0,0,1,0,1,2024
SIC,AG,M   ,"Attività professionali, scientifiche e tecniche             ",0,0,0,0,0,2024
SIC,AG,M 69,Attività legali e contabilità                               ,0,0,0,0,0,2024
SIC,AG,M 70,Attività di direzione aziendale e di consulenza gestional...,0,0,0,0,0,2024
SIC,AG,M 71,Attività degli studi di architettura e d'ingegneria; coll...,0,0,0,0,0,2024
SIC,AG,M 72,Ricerca scientifica e sviluppo                              ,0,0,0,0,0,2024
SIC,AG,M 73,Pubblicità e ricerche di mercato                            ,0,0,0,0,0,2024
SIC,AG,M 74,"Altre attività professionali, scientifiche e tecniche       ",0,0,0,0,0,2024
SIC,AG,M 75,Servizi veterinari                                          ,0,0,0,0,0,2024
SIC,AG,N   ,"Noleggio, agenzie di viaggio, servizi di supporto alle im...",0,0,1,0,1,2024
SIC,AG,N 77,Attività di noleggio e leasing operativo                    ,0,0,0,0,0,2024
SIC,AG,N 78,"Attività di ricerca, selezione, fornitura di personale      ",0,0,0,0,0,2024
SIC,AG,N 79,"Attività dei servizi delle agenzie di viaggio, dei tour o...",0,0,0,0,0,2024
SIC,AG,N 80,Servizi di vigilanza e investigazione                       ,0,0,0,0,0,2024
SIC,AG,N 81,Attività di servizi per edifici e paesaggio                 ,0,0,1,0,1,2024
SIC,AG,N 82,Attività di supporto per le funzioni d'ufficio e altri se...,0,0,0,0,0,2024
SIC,AG,O   ,Amministrazione pubblica e difesa; assicurazione sociale ...,0,0,0,0,0,2024
SIC,AG,O 84,Amministrazione pubblica e difesa; assicurazione sociale ...,0,0,0,0,0,2024
SIC,AG,P   ,Istruzione                                                  ,0,0,0,0,0,2024
SIC,AG,P 85,Istruzione                                                  ,0,0,0,0,0,2024
SIC,AG,Q   ,Sanita' e assistenza sociale                                ,0,0,0,0,0,2024
SIC,AG,Q 86,Assistenza sanitaria                                        ,0,0,0,0,0,2024
SIC,AG,Q 87,Servizi di assistenza sociale residenziale                  ,0,0,0,0,0,2024
SIC,AG,Q 88,Assistenza sociale non residenziale                         ,0,0,0,0,0,2024
SIC,AG,R   ,"Attività artistiche, sportive, di intrattenimento e diver...",0,0,0,0,0,2024
SIC,AG,R 90,"Attività creative, artistiche e di intrattenimento          ",0,0,0,0,0,2024
SIC,AG,R 91,"Attività di biblioteche, archivi, musei ed altre attività...",0,0,0,0,0,2024
SIC,AG,R 92,"Attività riguardanti le lotterie, le scommesse, le case d...",0,0,0,0,0,2024
SIC,AG,R 93,"Attività sportive, di intrattenimento e di divertimento     ",0,0,0,0,0,2024
SIC,AG,S   ,Altre attività di servizi                                   ,0,0,1,0,1,2024
SIC,AG,S 94,Attività di organizzazioni associative                      ,0,0,0,0,0,2024
SIC,AG,S 95,Riparazione di computer e di beni per uso personale e per...,0,0,0,0,0,2024
SIC,AG,S 96,Altre attività di servizi per la persona                    ,0,0,1,0,1,2024
SIC,AG,T   ,Attività di famiglie e convivenze come datori di lavoro p...,0,0,0,0,0,2024
SIC,AG,T 97,Attività di famiglie e convivenze come datori di lavoro p...,0,0,0,0,0,2024
SIC,AG,T 98,Produzione di beni e servizi indifferenziati per uso prop...,0,0,0,0,0,2024
SIC,AG,U   ,Organizzazioni ed organismi extraterritoriali               ,0,0,0,0,0,2024
SIC,AG,U 99,Organizzazioni ed organismi extraterritoriali               ,0,0,0,0,0,2024
SIC,AG,XX  ,Imprese non classificate                                    ,0,0,2,3,5,2024
SIC,AG,TOT ,TOTALE                                                      ,0,0,400,5,405,2024
SIC,CL,A   ,"Agricoltura, silvicoltura pesca                             ",1,0,0,0,1,2024
SIC,CL,A 01,"Coltivazioni agricole e produzione di prodotti animali, c...",1,0,0,0,1,2024
SIC,CL,A 02,Silvicoltura ed utilizzo di aree forestali                  ,0,0,0,0,0,2024
SIC,CL,A 03,Pesca e acquacoltura                                        ,0,0,0,0,0,2024
SIC,CL,B   ,Estrazione di minerali da cave e miniere                    ,0,0,0,0,0,2024
SIC,CL,B 05,Estrazione di carbone (esclusa torba)                       ,0,0,0,0,0,2024
SIC,CL,B 06,Estraz.di petrolio greggio e di gas naturale                ,0,0,0,0,0,2024
SIC,CL,B 07,Estrazione di minerali metalliferi                          ,0,0,0,0,0,2024
SIC,CL,B 08,Altre attività di estrazione di minerali da cave e miniere  ,0,0,0,0,0,2024
SIC,CL,B 09,Attività dei servizi di supporto all'estrazione             ,0,0,0,0,0,2024
SIC,CL,C   ,Attività manifatturiere                                     ,15,0,0,0,15,2024
SIC,CL,C 10,Industrie alimentari                                        ,1,0,0,0,1,2024
SIC,CL,C 11,Industria delle bevande                                     ,0,0,0,0,0,2024
SIC,CL,C 12,Industria del tabacco                                       ,0,0,0,0,0,2024
SIC,CL,C 13,Industrie tessili                                           ,0,0,0,0,0,2024
SIC,CL,C 14,Confezione di articoli di abbigliamento; confezione di ar...,1,0,0,0,1,2024
SIC,CL,C 15,Fabbricazione di articoli in pelle e simili                 ,0,0,0,0,0,2024
SIC,CL,C 16,Industria del legno e dei prodotti in legno e sughero (es...,0,0,0,0,0,2024
SIC,CL,C 17,Fabbricazione di carta e di prodotti di carta               ,0,0,0,0,0,2024
SIC,CL,C 18,Stampa e riproduzione di supporti registrati                ,1,0,0,0,1,2024
SIC,CL,C 19,Fabbricazione di coke e prodotti derivanti dalla raffinaz...,0,0,0,0,0,2024
SIC,CL,C 20,Fabbricazione di prodotti chimici                           ,0,0,0,0,0,2024
SIC,CL,C 21,Fabbricazione di prodotti farmaceutici di base e di prepa...,0,0,0,0,0,2024
SIC,CL,C 22,Fabbricazione di articoli in gomma e materie plastiche      ,2,0,0,0,2,2024
SIC,CL,C 23,Fabbricazione di altri prodotti della lavorazione di miner..,2,0,0,0,2,2024
SIC,CL,C 24,Metallurgia                                                 ,0,0,0,0,0,2024
SIC,CL,C 25,Fabbricazione di prodotti in metallo (esclusi macchinari ...,5,0,0,0,5,2024
SIC,CL,C 26,Fabbricazione di computer e prodotti di elettronica e ott...,0,0,0,0,0,2024
SIC,CL,C 27,Fabbricazione di apparecchiature elettriche ed apparecchi...,0,0,0,0,0,2024
SIC,CL,C 28,Fabbricazione di macchinari ed apparecchiature nca          ,1,0,0,0,1,2024
SIC,CL,C 29,"Fabbricazione di autoveicoli, rimorchi e semirimorchi       ",0,0,0,0,0,2024
SIC,CL,C 30,Fabbricazione di altri mezzi di trasporto                   ,0,0,0,0,0,2024
SIC,CL,C 31,Fabbricazione di mobili                                     ,0,0,0,0,0,2024
SIC,CL,C 32,Altre industrie manifatturiere                              ,1,0,0,0,1,2024
SIC,CL,C 33,"Riparazione, manutenzione ed installazione di macchine ed...",1,0,0,0,1,2024
SIC,CL,D   ,"Fornitura di energia elettrica, gas, vapore e aria condiz...",0,0,0,0,0,2024
SIC,CL,D 35,"Fornitura di energia elettrica, gas, vapore e aria condiz...",0,0,0,0,0,2024
SIC,CL,E   ,"Fornitura di acqua; reti fognarie, attività di gestione d...",1,0,0,0,1,2024
SIC,CL,E 36,"Raccolta, trattamento e fornitura di acqua                  ",0,0,0,0,0,2024
SIC,CL,E 37,Gestione delle reti fognarie                                ,0,0,0,0,0,2024
SIC,CL,E 38,"Attività di raccolta, trattamento e smaltimento dei rifiu...",1,0,0,0,1,2024
SIC,CL,E 39,Attività di risanamento e altri servizi di gestione dei r...,0,0,0,0,0,2024
SIC,CL,F   ,Costruzioni                                                 ,21,0,0,2,23,2024
SIC,CL,F 41,Costruzione di edifici                                      ,12,0,0,1,13,2024
SIC,CL,F 42,Ingegneria civile                                           ,0,0,0,1,1,2024
SIC,CL,F 43,Lavori di costruzione specializzati                         ,9,0,0,0,9,2024
SIC,CL,G   ,Commercio all'ingrosso e al dettaglio; riparazione di aut...,24,0,0,0,24,2024
SIC,CL,G 45,Commercio all'ingrosso e al dettaglio e riparazione di au...,3,0,0,0,3,2024
SIC,CL,G 46,Commercio all'ingrosso (escluso quello di autoveicoli e d...,9,0,0,0,9,2024
SIC,CL,G 47,Commercio al dettaglio (escluso quello di autoveicoli e d...,12,0,0,0,12,2024
SIC,CL,H   ,Trasporto e magazzinaggio                                   ,1,0,0,0,1,2024
SIC,CL,H 49,Trasporto terrestre e mediante condotte                     ,1,0,0,0,1,2024
SIC,CL,H 50,Trasporto marittimo e per vie d'acqua                       ,0,0,0,0,0,2024
SIC,CL,H 51,Trasporto aereo                                             ,0,0,0,0,0,2024
SIC,CL,H 52,Magazzinaggio e attività di supporto ai trasporti           ,0,0,0,0,0,2024
SIC,CL,H 53,Servizi postali e attività di corriere                      ,0,0,0,0,0,2024
SIC,CL,I   ,Attività dei servizi alloggio e ristorazione                ,6,0,0,0,6,2024
SIC,CL,I 55,Alloggio                                                    ,0,0,0,0,0,2024
SIC,CL,I 56,Attività dei servizi di ristorazione                        ,6,0,0,0,6,2024
SIC,CL,J   ,Servizi di informazione e comunicazione                     ,2,0,0,0,2,2024
SIC,CL,J 58,Attività editoriali                                         ,0,0,0,0,0,2024
SIC,CL,J 59,"Attività di produzione cinematografica, di video e di pro...",0,0,0,0,0,2024
SIC,CL,J 60,Attività di programmazione e trasmissione                   ,0,0,0,0,0,2024
SIC,CL,J 61,Telecomunicazioni                                           ,0,0,0,0,0,2024
SIC,CL,J 62,"Produzione di software, consulenza informatica e attività...",0,0,0,0,0,2024
SIC,CL,J 63,Attività dei servizi d'informazione e altri servizi infor...,2,0,0,0,2,2024
SIC,CL,K   ,Attività finanziarie e assicurative                         ,1,0,0,0,1,2024
SIC,CL,K 64,Attività di servizi finanziari (escluse le assicurazioni ...,1,0,0,0,1,2024
SIC,CL,K 65,"Assicurazioni, riassicurazioni e fondi pensione (escluse ...",0,0,0,0,0,2024
SIC,CL,K 66,Attività ausiliarie dei servizi finanziari e delle attivi...,0,0,0,0,0,2024
SIC,CL,L   ,Attivita' immobiliari                                       ,0,0,0,0,0,2024
SIC,CL,L 68,Attivita' immobiliari                                       ,0,0,0,0,0,2024
SIC,CL,M   ,"Attività professionali, scientifiche e tecniche             ",4,0,0,0,4,2024
SIC,CL,M 69,Attività legali e contabilità                               ,1,0,0,0,1,2024
SIC,CL,M 70,Attività di direzione aziendale e di consulenza gestional...,1,0,0,0,1,2024
SIC,CL,M 71,Attività degli studi di architettura e d'ingegneria; coll...,1,0,0,0,1,2024
SIC,CL,M 72,Ricerca scientifica e sviluppo                              ,0,0,0,0,0,2024
SIC,CL,M 73,Pubblicità e ricerche di mercato                            ,1,0,0,0,1,2024
SIC,CL,M 74,"Altre attività professionali, scientifiche e tecniche       ",0,0,0,0,0,2024
SIC,CL,M 75,Servizi veterinari                                          ,0,0,0,0,0,2024
SIC,CL,N   ,"Noleggio, agenzie di viaggio, servizi di supporto alle im...",2,0,0,0,2,2024
SIC,CL,N 77,Attività di noleggio e leasing operativo                    ,0,0,0,0,0,2024
SIC,CL,N 78,"Attività di ricerca, selezione, fornitura di personale      ",0,0,0,0,0,2024
SIC,CL,N 79,"Attività dei servizi delle agenzie di viaggio, dei tour o...",0,0,0,0,0,2024
SIC,CL,N 80,Servizi di vigilanza e investigazione                       ,0,0,0,0,0,2024
SIC,CL,N 81,Attività di servizi per edifici e paesaggio                 ,0,0,0,0,0,2024
SIC,CL,N 82,Attività di supporto per le funzioni d'ufficio e altri se...,2,0,0,0,2,2024
SIC,CL,O   ,Amministrazione pubblica e difesa; assicurazione sociale ...,0,0,0,0,0,2024
SIC,CL,O 84,Amministrazione pubblica e difesa; assicurazione sociale ...,0,0,0,0,0,2024
SIC,CL,P   ,Istruzione                                                  ,0,0,0,0,0,2024
SIC,CL,P 85,Istruzione                                                  ,0,0,0,0,0,2024
SIC,CL,Q   ,Sanita' e assistenza sociale                                ,2,0,0,0,2,2024
SIC,CL,Q 86,Assistenza sanitaria                                        ,2,0,0,0,2,2024
SIC,CL,Q 87,Servizi di assistenza sociale residenziale                  ,0,0,0,0,0,2024
SIC,CL,Q 88,Assistenza sociale non residenziale                         ,0,0,0,0,0,2024
SIC,CL,R   ,"Attività artistiche, sportive, di intrattenimento e diver...",3,0,0,0,3,2024
SIC,CL,R 90,"Attività creative, artistiche e di intrattenimento          ",1,0,0,0,1,2024
SIC,CL,R 91,"Attività di biblioteche, archivi, musei ed altre attività...",0,0,0,0,0,2024
SIC,CL,R 92,"Attività riguardanti le lotterie, le scommesse, le case d...",0,0,0,0,0,2024
SIC,CL,R 93,"Attività sportive, di intrattenimento e di divertimento     ",2,0,0,0,2,2024
SIC,CL,S   ,Altre attività di servizi                                   ,0,0,0,0,0,2024
SIC,CL,S 94,Attività di organizzazioni associative                      ,0,0,0,0,0,2024
SIC,CL,S 95,Riparazione di computer e di beni per uso personale e per...,0,0,0,0,0,2024
SIC,CL,S 96,Altre attività di servizi per la persona                    ,0,0,0,0,0,2024
SIC,CL,T   ,Attività di famiglie e convivenze come datori di lavoro p...,0,0,0,0,0,2024
SIC,CL,T 97,Attività di famiglie e convivenze come datori di lavoro p...,0,0,0,0,0,2024
SIC,CL,T 98,Produzione di beni e servizi indifferenziati per uso prop...,0,0,0,0,0,2024
SIC,CL,U   ,Organizzazioni ed organismi extraterritoriali               ,0,0,0,0,0,2024
SIC,CL,U 99,Organizzazioni ed organismi extraterritoriali               ,0,0,0,0,0,2024
SIC,CL,XX  ,Imprese non classificate                                    ,20,0,0,1,21,2024
SIC,CL,TOT ,TOTALE                                                      ,103,0,0,3,106,2024
SIC,EN,A   ,"Agricoltura, silvicoltura pesca                             ",0,0,0,1,1,2024
SIC,EN,A 01,"Coltivazioni agricole e produzione di prodotti animali, c...",0,0,0,1,1,2024
SIC,EN,A 02,Silvicoltura ed utilizzo di aree forestali                  ,0,0,0,0,0,2024
SIC,EN,A 03,Pesca e acquacoltura                                        ,0,0,0,0,0,2024
SIC,EN,B   ,Estrazione di minerali da cave e miniere                    ,0,0,0,0,0,2024
SIC,EN,B 05,Estrazione di carbone (esclusa torba)                       ,0,0,0,0,0,2024
SIC,EN,B 06,Estraz.di petrolio greggio e di gas naturale                ,0,0,0,0,0,2024
SIC,EN,B 07,Estrazione di minerali metalliferi                          ,0,0,0,0,0,2024
SIC,EN,B 08,Altre attività di estrazione di minerali da cave e miniere  ,0,0,0,0,0,2024
SIC,EN,B 09,Attività dei servizi di supporto all'estrazione             ,0,0,0,0,0,2024
SIC,EN,C   ,Attività manifatturiere                                     ,0,0,0,0,0,2024
SIC,EN,C 10,Industrie alimentari                                        ,0,0,0,0,0,2024
SIC,EN,C 11,Industria delle bevande                                     ,0,0,0,0,0,2024
SIC,EN,C 12,Industria del tabacco                                       ,0,0,0,0,0,2024
SIC,EN,C 13,Industrie tessili                                           ,0,0,0,0,0,2024
SIC,EN,C 14,Confezione di articoli di abbigliamento; confezione di ar...,0,0,0,0,0,2024
SIC,EN,C 15,Fabbricazione di articoli in pelle e simili                 ,0,0,0,0,0,2024
SIC,EN,C 16,Industria del legno e dei prodotti in legno e sughero (es...,0,0,0,0,0,2024
SIC,EN,C 17,Fabbricazione di carta e di prodotti di carta               ,0,0,0,0,0,2024
SIC,EN,C 18,Stampa e riproduzione di supporti registrati                ,0,0,0,0,0,2024
SIC,EN,C 19,Fabbricazione di coke e prodotti derivanti dalla raffinaz...,0,0,0,0,0,2024
SIC,EN,C 20,Fabbricazione di prodotti chimici                           ,0,0,0,0,0,2024
SIC,EN,C 21,Fabbricazione di prodotti farmaceutici di base e di prepa...,0,0,0,0,0,2024
SIC,EN,C 22,Fabbricazione di articoli in gomma e materie plastiche      ,0,0,0,0,0,2024
SIC,EN,C 23,Fabbricazione di altri prodotti della lavorazione di miner..,0,0,0,0,0,2024
SIC,EN,C 24,Metallurgia                                                 ,0,0,0,0,0,2024
SIC,EN,C 25,Fabbricazione di prodotti in metallo (esclusi macchinari ...,0,0,0,0,0,2024
SIC,EN,C 26,Fabbricazione di computer e prodotti di elettronica e ott...,0,0,0,0,0,2024
SIC,EN,C 27,Fabbricazione di apparecchiature elettriche ed apparecchi...,0,0,0,0,0,2024
SIC,EN,C 28,Fabbricazione di macchinari ed apparecchiature nca          ,0,0,0,0,0,2024
SIC,EN,C 29,"Fabbricazione di autoveicoli, rimorchi e semirimorchi       ",0,0,0,0,0,2024
SIC,EN,C 30,Fabbricazione di altri mezzi di trasporto                   ,0,0,0,0,0,2024
SIC,EN,C 31,Fabbricazione di mobili                                     ,0,0,0,0,0,2024
SIC,EN,C 32,Altre industrie manifatturiere                              ,0,0,0,0,0,2024
SIC,EN,C 33,"Riparazione, manutenzione ed installazione di macchine ed...",0,0,0,0,0,2024
SIC,EN,D   ,"Fornitura di energia elettrica, gas, vapore e aria condiz...",0,0,0,0,0,2024
SIC,EN,D 35,"Fornitura di energia elettrica, gas, vapore e aria condiz...",0,0,0,0,0,2024
SIC,EN,E   ,"Fornitura di acqua; reti fognarie, attività di gestione d...",0,0,0,0,0,2024
SIC,EN,E 36,"Raccolta, trattamento e fornitura di acqua                  ",0,0,0,0,0,2024
SIC,EN,E 37,Gestione delle reti fognarie                                ,0,0,0,0,0,2024
SIC,EN,E 38,"Attività di raccolta, trattamento e smaltimento dei rifiu...",0,0,0,0,0,2024
SIC,EN,E 39,Attività di risanamento e altri servizi di gestione dei r...,0,0,0,0,0,2024
SIC,EN,F   ,Costruzioni                                                 ,0,0,0,0,0,2024
SIC,EN,F 41,Costruzione di edifici                                      ,0,0,0,0,0,2024
SIC,EN,F 42,Ingegneria civile                                           ,0,0,0,0,0,2024
SIC,EN,F 43,Lavori di costruzione specializzati                         ,0,0,0,0,0,2024
SIC,EN,G   ,Commercio all'ingrosso e al dettaglio; riparazione di aut...,0,0,0,0,0,2024
SIC,EN,G 45,Commercio all'ingrosso e al dettaglio e riparazione di au...,0,0,0,0,0,2024
SIC,EN,G 46,Commercio all'ingrosso (escluso quello di autoveicoli e d...,0,0,0,0,0,2024
SIC,EN,G 47,Commercio al dettaglio (escluso quello di autoveicoli e d...,0,0,0,0,0,2024
SIC,EN,H   ,Trasporto e magazzinaggio                                   ,0,0,0,0,0,2024
SIC,EN,H 49,Trasporto terrestre e mediante condotte                     ,0,0,0,0,0,2024
SIC,EN,H 50,Trasporto marittimo e per vie d'acqua                       ,0,0,0,0,0,2024
SIC,EN,H 51,Trasporto aereo                                             ,0,0,0,0,0,2024
SIC,EN,H 52,Magazzinaggio e attività di supporto ai trasporti           ,0,0,0,0,0,2024
SIC,EN,H 53,Servizi postali e attività di corriere                      ,0,0,0,0,0,2024
SIC,EN,I   ,Attività dei servizi alloggio e ristorazione                ,0,0,0,0,0,2024
SIC,EN,I 55,Alloggio                                                    ,0,0,0,0,0,2024
SIC,EN,I 56,Attività dei servizi di ristorazione                        ,0,0,0,0,0,2024
SIC,EN,J   ,Servizi di informazione e comunicazione                     ,0,0,0,1,1,2024
SIC,EN,J 58,Attività editoriali                                         ,0,0,0,0,0,2024
SIC,EN,J 59,"Attività di produzione cinematografica, di video e di pro...",0,0,0,0,0,2024
SIC,EN,J 60,Attività di programmazione e trasmissione                   ,0,0,0,0,0,2024
SIC,EN,J 61,Telecomunicazioni                                           ,0,0,0,0,0,2024
SIC,EN,J 62,"Produzione di software, consulenza informatica e attività...",0,0,0,0,0,2024
SIC,EN,J 63,Attività dei servizi d'informazione e altri servizi infor...,0,0,0,1,1,2024
SIC,EN,K   ,Attività finanziarie e assicurative                         ,0,0,0,0,0,2024
SIC,EN,K 64,Attività di servizi finanziari (escluse le assicurazioni ...,0,0,0,0,0,2024
SIC,EN,K 65,"Assicurazioni, riassicurazioni e fondi pensione (escluse ...",0,0,0,0,0,2024
SIC,EN,K 66,Attività ausiliarie dei servizi finanziari e delle attivi...,0,0,0,0,0,2024
SIC,EN,L   ,Attivita' immobiliari                                       ,0,0,0,0,0,2024
SIC,EN,L 68,Attivita' immobiliari                                       ,0,0,0,0,0,2024
SIC,EN,M   ,"Attività professionali, scientifiche e tecniche             ",0,0,0,0,0,2024
SIC,EN,M 69,Attività legali e contabilità                               ,0,0,0,0,0,2024
SIC,EN,M 70,Attività di direzione aziendale e di consulenza gestional...,0,0,0,0,0,2024
SIC,EN,M 71,Attività degli studi di architettura e d'ingegneria; coll...,0,0,0,0,0,2024
SIC,EN,M 72,Ricerca scientifica e sviluppo                              ,0,0,0,0,0,2024
SIC,EN,M 73,Pubblicità e ricerche di mercato                            ,0,0,0,0,0,2024
SIC,EN,M 74,"Altre attività professionali, scientifiche e tecniche       ",0,0,0,0,0,2024
SIC,EN,M 75,Servizi veterinari                                          ,0,0,0,0,0,2024
SIC,EN,N   ,"Noleggio, agenzie di viaggio, servizi di supporto alle im...",0,0,0,0,0,2024
SIC,EN,N 77,Attività di noleggio e leasing operativo                    ,0,0,0,0,0,2024
SIC,EN,N 78,"Attività di ricerca, selezione, fornitura di personale      ",0,0,0,0,0,2024
SIC,EN,N 79,"Attività dei servizi delle agenzie di viaggio, dei tour o...",0,0,0,0,0,2024
SIC,EN,N 80,Servizi di vigilanza e investigazione                       ,0,0,0,0,0,2024
SIC,EN,N 81,Attività di servizi per edifici e paesaggio                 ,0,0,0,0,0,2024
SIC,EN,N 82,Attività di supporto per le funzioni d'ufficio e altri se...,0,0,0,0,0,2024
SIC,EN,O   ,Amministrazione pubblica e difesa; assicurazione sociale ...,0,0,0,0,0,2024
SIC,EN,O 84,Amministrazione pubblica e difesa; assicurazione sociale ...,0,0,0,0,0,2024
SIC,EN,P   ,Istruzione                                                  ,0,0,0,0,0,2024
SIC,EN,P 85,Istruzione                                                  ,0,0,0,0,0,2024
SIC,EN,Q   ,Sanita' e assistenza sociale                                ,0,0,0,0,0,2024
SIC,EN,Q 86,Assistenza sanitaria                                        ,0,0,0,0,0,2024
SIC,EN,Q 87,Servizi di assistenza sociale residenziale                  ,0,0,0,0,0,2024
SIC,EN,Q 88,Assistenza sociale non residenziale                         ,0,0,0,0,0,2024
SIC,EN,R   ,"Attività artistiche, sportive, di intrattenimento e diver...",0,0,0,0,0,2024
SIC,EN,R 90,"Attività creative, artistiche e di intrattenimento          ",0,0,0,0,0,2024
SIC,EN,R 91,"Attività di biblioteche, archivi, musei ed altre attività...",0,0,0,0,0,2024
SIC,EN,R 92,"Attività riguardanti le lotterie, le scommesse, le case d...",0,0,0,0,0,2024
SIC,EN,R 93,"Attività sportive, di intrattenimento e di divertimento     ",0,0,0,0,0,2024
SIC,EN,S   ,Altre attività di servizi                                   ,0,0,0,0,0,2024
SIC,EN,S 94,Attività di organizzazioni associative                      ,0,0,0,0,0,2024
SIC,EN,S 95,Riparazione di computer e di beni per uso personale e per...,0,0,0,0,0,2024
SIC,EN,S 96,Altre attività di servizi per la persona                    ,0,0,0,0,0,2024
SIC,EN,T   ,Attività di famiglie e convivenze come datori di lavoro p...,0,0,0,0,0,2024
SIC,EN,T 97,Attività di famiglie e convivenze come datori di lavoro p...,0,0,0,0,0,2024
SIC,EN,T 98,Produzione di beni e servizi indifferenziati per uso prop...,0,0,0,0,0,2024
SIC,EN,U   ,Organizzazioni ed organismi extraterritoriali               ,0,0,0,0,0,2024
SIC,EN,U 99,Organizzazioni ed organismi extraterritoriali               ,0,0,0,0,0,2024
SIC,EN,XX  ,Imprese non classificate                                    ,1,0,0,3,4,2024
SIC,EN,TOT ,TOTALE                                                      ,1,0,0,5,6,2024
SIC,CT,A   ,"Agricoltura, silvicoltura pesca                             ",2,0,667,0,669,2024
SIC,CT,A 01,"Coltivazioni agricole e produzione di prodotti animali, c...",1,0,648,0,649,2024
SIC,CT,A 02,Silvicoltura ed utilizzo di aree forestali                  ,1,0,1,0,2,2024
SIC,CT,A 03,Pesca e acquacoltura                                        ,0,0,18,0,18,2024
SIC,CT,B   ,Estrazione di minerali da cave e miniere                    ,0,0,3,0,3,2024
SIC,CT,B 05,Estrazione di carbone (esclusa torba)                       ,0,0,0,0,0,2024
SIC,CT,B 06,Estraz.di petrolio greggio e di gas naturale                ,0,0,0,0,0,2024
SIC,CT,B 07,Estrazione di minerali metalliferi                          ,0,0,0,0,0,2024
SIC,CT,B 08,Altre attività di estrazione di minerali da cave e miniere  ,0,0,3,0,3,2024
SIC,CT,B 09,Attività dei servizi di supporto all'estrazione             ,0,0,0,0,0,2024
SIC,CT,C   ,Attività manifatturiere                                     ,11,0,356,1,368,2024
SIC,CT,C 10,Industrie alimentari                                        ,2,0,100,0,102,2024
SIC,CT,C 11,Industria delle bevande                                     ,0,0,1,0,1,2024
SIC,CT,C 12,Industria del tabacco                                       ,0,0,0,0,0,2024
SIC,CT,C 13,Industrie tessili                                           ,0,0,3,0,3,2024
SIC,CT,C 14,Confezione di articoli di abbigliamento; confezione di ar...,0,0,30,1,31,2024
SIC,CT,C 15,Fabbricazione di articoli in pelle e simili                 ,1,0,4,0,5,2024
SIC,CT,C 16,Industria del legno e dei prodotti in legno e sughero (es...,0,0,24,0,24,2024
SIC,CT,C 17,Fabbricazione di carta e di prodotti di carta               ,0,0,5,0,5,2024
SIC,CT,C 18,Stampa e riproduzione di supporti registrati                ,1,0,15,0,16,2024
SIC,CT,C 19,Fabbricazione di coke e prodotti derivanti dalla raffinaz...,0,0,0,0,0,2024
SIC,CT,C 20,Fabbricazione di prodotti chimici                           ,0,0,2,0,2,2024
SIC,CT,C 21,Fabbricazione di prodotti farmaceutici di base e di prepa...,0,0,0,0,0,2024
SIC,CT,C 22,Fabbricazione di articoli in gomma e materie plastiche      ,1,0,3,0,4,2024
SIC,CT,C 23,Fabbricazione di altri prodotti della lavorazione di miner..,1,0,30,0,31,2024
SIC,CT,C 24,Metallurgia                                                 ,0,0,0,0,0,2024
SIC,CT,C 25,Fabbricazione di prodotti in metallo (esclusi macchinari ...,2,0,66,0,68,2024
SIC,CT,C 26,Fabbricazione di computer e prodotti di elettronica e ott...,1,0,4,0,5,2024
SIC,CT,C 27,Fabbricazione di apparecchiature elettriche ed apparecchi...,0,0,8,0,8,2024
SIC,CT,C 28,Fabbricazione di macchinari ed apparecchiature nca          ,0,0,4,0,4,2024
SIC,CT,C 29,"Fabbricazione di autoveicoli, rimorchi e semirimorchi       ",0,0,3,0,3,2024
SIC,CT,C 30,Fabbricazione di altri mezzi di trasporto                   ,0,0,0,0,0,2024
SIC,CT,C 31,Fabbricazione di mobili                                     ,0,0,19,0,19,2024
SIC,CT,C 32,Altre industrie manifatturiere                              ,1,0,22,0,23,2024
SIC,CT,C 33,"Riparazione, manutenzione ed installazione di macchine ed...",1,0,13,0,14,2024
SIC,CT,D   ,"Fornitura di energia elettrica, gas, vapore e aria condiz...",0,0,1,0,1,2024
SIC,CT,D 35,"Fornitura di energia elettrica, gas, vapore e aria condiz...",0,0,1,0,1,2024
SIC,CT,E   ,"Fornitura di acqua; reti fognarie, attività di gestione d...",0,0,9,0,9,2024
SIC,CT,E 36,"Raccolta, trattamento e fornitura di acqua                  ",0,0,0,0,0,2024
SIC,CT,E 37,Gestione delle reti fognarie                                ,0,0,0,0,0,2024
SIC,CT,E 38,"Attività di raccolta, trattamento e smaltimento dei rifiu...",0,0,9,0,9,2024
SIC,CT,E 39,Attività di risanamento e altri servizi di gestione dei r...,0,0,0,0,0,2024
SIC,CT,F   ,Costruzioni                                                 ,20,0,614,2,636,2024
SIC,CT,F 41,Costruzione di edifici                                      ,12,0,246,2,260,2024
SIC,CT,F 42,Ingegneria civile                                           ,0,0,8,0,8,2024
SIC,CT,F 43,Lavori di costruzione specializzati                         ,8,0,360,0,368,2024
SIC,CT,G   ,Commercio all'ingrosso e al dettaglio; riparazione di aut...,51,0,2020,0,2071,2024
SIC,CT,G 45,Commercio all'ingrosso e al dettaglio e riparazione di au...,5,0,163,0,168,2024
SIC,CT,G 46,Commercio all'ingrosso (escluso quello di autoveicoli e d...,18,0,436,0,454,2024
SIC,CT,G 47,Commercio al dettaglio (escluso quello di autoveicoli e d...,28,0,1421,0,1449,2024
SIC,CT,H   ,Trasporto e magazzinaggio                                   ,5,0,202,0,207,2024
SIC,CT,H 49,Trasporto terrestre e mediante condotte                     ,4,0,184,0,188,2024
SIC,CT,H 50,Trasporto marittimo e per vie d'acqua                       ,0,0,0,0,0,2024
SIC,CT,H 51,Trasporto aereo                                             ,0,0,0,0,0,2024
SIC,CT,H 52,Magazzinaggio e attività di supporto ai trasporti           ,1,0,14,0,15,2024
SIC,CT,H 53,Servizi postali e attività di corriere                      ,0,0,4,0,4,2024
SIC,CT,I   ,Attività dei servizi alloggio e ristorazione                ,20,0,311,0,331,2024
SIC,CT,I 55,Alloggio                                                    ,1,0,6,0,7,2024
SIC,CT,I 56,Attività dei servizi di ristorazione                        ,19,0,305,0,324,2024
SIC,CT,J   ,Servizi di informazione e comunicazione                     ,8,0,85,0,93,2024
SIC,CT,J 58,Attività editoriali                                         ,1,0,7,0,8,2024
SIC,CT,J 59,"Attività di produzione cinematografica, di video e di pro...",1,0,8,0,9,2024
SIC,CT,J 60,Attività di programmazione e trasmissione                   ,0,0,1,0,1,2024
SIC,CT,J 61,Telecomunicazioni                                           ,0,0,15,0,15,2024
SIC,CT,J 62,"Produzione di software, consulenza informatica e attività...",2,0,21,0,23,2024
SIC,CT,J 63,Attività dei servizi d'informazione e altri servizi infor...,4,0,33,0,37,2024
SIC,CT,K   ,Attività finanziarie e assicurative                         ,2,0,48,0,50,2024
SIC,CT,K 64,Attività di servizi finanziari (escluse le assicurazioni ...,0,0,0,0,0,2024
SIC,CT,K 65,"Assicurazioni, riassicurazioni e fondi pensione (escluse ...",0,0,0,0,0,2024
SIC,CT,K 66,Attività ausiliarie dei servizi finanziari e delle attivi...,2,0,48,0,50,2024
SIC,CT,L   ,Attivita' immobiliari                                       ,2,0,11,0,13,2024
SIC,CT,L 68,Attivita' immobiliari                                       ,2,0,11,0,13,2024
SIC,CT,M   ,"Attività professionali, scientifiche e tecniche             ",12,0,53,0,65,2024
SIC,CT,M 69,Attività legali e contabilità                               ,1,0,4,0,5,2024
SIC,CT,M 70,Attività di direzione aziendale e di consulenza gestional...,3,0,2,0,5,2024
SIC,CT,M 71,Attività degli studi di architettura e d'ingegneria; coll...,3,0,2,0,5,2024
SIC,CT,M 72,Ricerca scientifica e sviluppo                              ,1,0,0,0,1,2024
SIC,CT,M 73,Pubblicità e ricerche di mercato                            ,2,0,17,0,19,2024
SIC,CT,M 74,"Altre attività professionali, scientifiche e tecniche       ",2,0,28,0,30,2024
SIC,CT,M 75,Servizi veterinari                                          ,0,0,0,0,0,2024
SIC,CT,N   ,"Noleggio, agenzie di viaggio, servizi di supporto alle im...",7,0,103,1,111,2024
SIC,CT,N 77,Attività di noleggio e leasing operativo                    ,2,0,31,0,33,2024
SIC,CT,N 78,"Attività di ricerca, selezione, fornitura di personale      ",0,0,1,0,1,2024
SIC,CT,N 79,"Attività dei servizi delle agenzie di viaggio, dei tour o...",1,0,6,0,7,2024
SIC,CT,N 80,Servizi di vigilanza e investigazione                       ,0,0,7,0,7,2024
SIC,CT,N 81,Attività di servizi per edifici e paesaggio                 ,1,0,26,1,28,2024
SIC,CT,N 82,Attività di supporto per le funzioni d'ufficio e altri se...,3,0,32,0,35,2024
SIC,CT,O   ,Amministrazione pubblica e difesa; assicurazione sociale ...,0,0,0,0,0,2024
SIC,CT,O 84,Amministrazione pubblica e difesa; assicurazione sociale ...,0,0,0,0,0,2024
SIC,CT,P   ,Istruzione                                                  ,0,0,1,2,3,2024
SIC,CT,P 85,Istruzione                                                  ,0,0,1,2,3,2024
SIC,CT,Q   ,Sanita' e assistenza sociale                                ,2,0,12,0,14,2024
SIC,CT,Q 86,Assistenza sanitaria                                        ,2,0,3,0,5,2024
SIC,CT,Q 87,Servizi di assistenza sociale residenziale                  ,0,0,6,0,6,2024
SIC,CT,Q 88,Assistenza sociale non residenziale                         ,0,0,3,0,3,2024
SIC,CT,R   ,"Attività artistiche, sportive, di intrattenimento e diver...",2,0,54,0,56,2024
SIC,CT,R 90,"Attività creative, artistiche e di intrattenimento          ",1,0,14,0,15,2024
SIC,CT,R 91,"Attività di biblioteche, archivi, musei ed altre attività...",0,0,0,0,0,2024
SIC,CT,R 92,"Attività riguardanti le lotterie, le scommesse, le case d...",0,0,6,0,6,2024
SIC,CT,R 93,"Attività sportive, di intrattenimento e di divertimento     ",1,0,34,0,35,2024
SIC,CT,S   ,Altre attività di servizi                                   ,4,0,141,0,145,2024
SIC,CT,S 94,Attività di organizzazioni associative                      ,0,0,0,0,0,2024
SIC,CT,S 95,Riparazione di computer e di beni per uso personale e per...,0,0,46,0,46,2024
SIC,CT,S 96,Altre attività di servizi per la persona                    ,4,0,95,0,99,2024
SIC,CT,T   ,Attività di famiglie e convivenze come datori di lavoro p...,0,0,0,0,0,2024
SIC,CT,T 97,Attività di famiglie e convivenze come datori di lavoro p...,0,0,0,0,0,2024
SIC,CT,T 98,Produzione di beni e servizi indifferenziati per uso prop...,0,0,0,0,0,2024
SIC,CT,U   ,Organizzazioni ed organismi extraterritoriali               ,0,0,0,0,0,2024
SIC,CT,U 99,Organizzazioni ed organismi extraterritoriali               ,0,0,0,0,0,2024
SIC,CT,XX  ,Imprese non classificate                                    ,51,0,1095,3,1149,2024
SIC,CT,TOT ,TOTALE                                                      ,199,0,5786,9,5994,2024
SIC,RG,A   ,"Agricoltura, silvicoltura pesca                             ",2,1,407,2,412,2024
SIC,RG,A 01,"Coltivazioni agricole e produzione di prodotti animali, c...",2,1,393,2,398,2024
SIC,RG,A 02,Silvicoltura ed utilizzo di aree forestali                  ,0,0,2,0,2,2024
SIC,RG,A 03,Pesca e acquacoltura                                        ,0,0,12,0,12,2024
SIC,RG,B   ,Estrazione di minerali da cave e miniere                    ,0,1,0,0,1,2024
SIC,RG,B 05,Estrazione di carbone (esclusa torba)                       ,0,0,0,0,0,2024
SIC,RG,B 06,Estraz.di petrolio greggio e di gas naturale                ,0,0,0,0,0,2024
SIC,RG,B 07,Estrazione di minerali metalliferi                          ,0,0,0,0,0,2024
SIC,RG,B 08,Altre attività di estrazione di minerali da cave e miniere  ,0,1,0,0,1,2024
SIC,RG,B 09,Attività dei servizi di supporto all'estrazione             ,0,0,0,0,0,2024
SIC,RG,C   ,Attività manifatturiere                                     ,5,3,155,0,163,2024
SIC,RG,C 10,Industrie alimentari                                        ,1,0,36,0,37,2024
SIC,RG,C 11,Industria delle bevande                                     ,0,0,1,0,1,2024
SIC,RG,C 12,Industria del tabacco                                       ,0,0,0,0,0,2024
SIC,RG,C 13,Industrie tessili                                           ,0,0,5,0,5,2024
SIC,RG,C 14,Confezione di articoli di abbigliamento; confezione di ar...,0,0,4,0,4,2024
SIC,RG,C 15,Fabbricazione di articoli in pelle e simili                 ,0,0,3,0,3,2024
SIC,RG,C 16,Industria del legno e dei prodotti in legno e sughero (es...,1,0,28,0,29,2024
SIC,RG,C 17,Fabbricazione di carta e di prodotti di carta               ,1,0,3,0,4,2024
SIC,RG,C 18,Stampa e riproduzione di supporti registrati                ,0,0,1,0,1,2024
SIC,RG,C 19,Fabbricazione di coke e prodotti derivanti dalla raffinaz...,0,0,0,0,0,2024
SIC,RG,C 20,Fabbricazione di prodotti chimici                           ,0,0,3,0,3,2024
SIC,RG,C 21,Fabbricazione di prodotti farmaceutici di base e di prepa...,0,0,0,0,0,2024
SIC,RG,C 22,Fabbricazione di articoli in gomma e materie plastiche      ,1,0,1,0,2,2024
SIC,RG,C 23,Fabbricazione di altri prodotti della lavorazione di miner..,0,2,15,0,17,2024
SIC,RG,C 24,Metallurgia                                                 ,0,0,2,0,2,2024
SIC,RG,C 25,Fabbricazione di prodotti in metallo (esclusi macchinari ...,1,0,26,0,27,2024
SIC,RG,C 26,Fabbricazione di computer e prodotti di elettronica e ott...,0,0,1,0,1,2024
SIC,RG,C 27,Fabbricazione di apparecchiature elettriche ed apparecchi...,0,0,1,0,1,2024
SIC,RG,C 28,Fabbricazione di macchinari ed apparecchiature nca          ,0,1,3,0,4,2024
SIC,RG,C 29,"Fabbricazione di autoveicoli, rimorchi e semirimorchi       ",0,0,1,0,1,2024
SIC,RG,C 30,Fabbricazione di altri mezzi di trasporto                   ,0,0,3,0,3,2024
SIC,RG,C 31,Fabbricazione di mobili                                     ,0,0,3,0,3,2024
SIC,RG,C 32,Altre industrie manifatturiere                              ,0,0,8,0,8,2024
SIC,RG,C 33,"Riparazione, manutenzione ed installazione di macchine ed...",0,0,7,0,7,2024
SIC,RG,D   ,"Fornitura di energia elettrica, gas, vapore e aria condiz...",0,0,0,0,0,2024
SIC,RG,D 35,"Fornitura di energia elettrica, gas, vapore e aria condiz...",0,0,0,0,0,2024
SIC,RG,E   ,"Fornitura di acqua; reti fognarie, attività di gestione d...",0,0,5,1,6,2024
SIC,RG,E 36,"Raccolta, trattamento e fornitura di acqua                  ",0,0,1,0,1,2024
SIC,RG,E 37,Gestione delle reti fognarie                                ,0,0,0,0,0,2024
SIC,RG,E 38,"Attività di raccolta, trattamento e smaltimento dei rifiu...",0,0,3,1,4,2024
SIC,RG,E 39,Attività di risanamento e altri servizi di gestione dei r...,0,0,1,0,1,2024
SIC,RG,F   ,Costruzioni                                                 ,3,6,311,1,321,2024
SIC,RG,F 41,Costruzione di edifici                                      ,1,3,192,1,197,2024
SIC,RG,F 42,Ingegneria civile                                           ,0,0,2,0,2,2024
SIC,RG,F 43,Lavori di costruzione specializzati                         ,2,3,117,0,122,2024
SIC,RG,G   ,Commercio all'ingrosso e al dettaglio; riparazione di aut...,17,13,809,1,840,2024
SIC,RG,G 45,Commercio all'ingrosso e al dettaglio e riparazione di au...,2,0,66,0,68,2024
SIC,RG,G 46,Commercio all'ingrosso (escluso quello di autoveicoli e d...,7,11,137,1,156,2024
SIC,RG,G 47,Commercio al dettaglio (escluso quello di autoveicoli e d...,8,2,606,0,616,2024
SIC,RG,H   ,Trasporto e magazzinaggio                                   ,3,2,61,0,66,2024
SIC,RG,H 49,Trasporto terrestre e mediante condotte                     ,2,2,55,0,59,2024
SIC,RG,H 50,Trasporto marittimo e per vie d'acqua                       ,0,0,0,0,0,2024
SIC,RG,H 51,Trasporto aereo                                             ,0,0,0,0,0,2024
SIC,RG,H 52,Magazzinaggio e attività di supporto ai trasporti           ,1,0,3,0,4,2024
SIC,RG,H 53,Servizi postali e attività di corriere                      ,0,0,3,0,3,2024
SIC,RG,I   ,Attività dei servizi alloggio e ristorazione                ,4,3,127,0,134,2024
SIC,RG,I 55,Alloggio                                                    ,0,0,3,0,3,2024
SIC,RG,I 56,Attività dei servizi di ristorazione                        ,4,3,124,0,131,2024
SIC,RG,J   ,Servizi di informazione e comunicazione                     ,2,0,23,0,25,2024
SIC,RG,J 58,Attività editoriali                                         ,0,0,1,0,1,2024
SIC,RG,J 59,"Attività di produzione cinematografica, di video e di pro...",0,0,0,0,0,2024
SIC,RG,J 60,Attività di programmazione e trasmissione                   ,0,0,3,0,3,2024
SIC,RG,J 61,Telecomunicazioni                                           ,1,0,6,0,7,2024
SIC,RG,J 62,"Produzione di software, consulenza informatica e attività...",0,0,5,0,5,2024
SIC,RG,J 63,Attività dei servizi d'informazione e altri servizi infor...,1,0,8,0,9,2024
SIC,RG,K   ,Attività finanziarie e assicurative                         ,0,0,12,0,12,2024
SIC,RG,K 64,Attività di servizi finanziari (escluse le assicurazioni ...,0,0,0,0,0,2024
SIC,RG,K 65,"Assicurazioni, riassicurazioni e fondi pensione (escluse ...",0,0,0,0,0,2024
SIC,RG,K 66,Attività ausiliarie dei servizi finanziari e delle attivi...,0,0,12,0,12,2024
SIC,RG,L   ,Attivita' immobiliari                                       ,2,0,8,0,10,2024
SIC,RG,L 68,Attivita' immobiliari                                       ,2,0,8,0,10,2024
SIC,RG,M   ,"Attività professionali, scientifiche e tecniche             ",2,0,33,0,35,2024
SIC,RG,M 69,Attività legali e contabilità                               ,0,0,0,0,0,2024
SIC,RG,M 70,Attività di direzione aziendale e di consulenza gestional...,0,0,3,0,3,2024
SIC,RG,M 71,Attività degli studi di architettura e d'ingegneria; coll...,1,0,0,0,1,2024
SIC,RG,M 72,Ricerca scientifica e sviluppo                              ,0,0,0,0,0,2024
SIC,RG,M 73,Pubblicità e ricerche di mercato                            ,1,0,12,0,13,2024
SIC,RG,M 74,"Altre attività professionali, scientifiche e tecniche       ",0,0,17,0,17,2024
SIC,RG,M 75,Servizi veterinari                                          ,0,0,1,0,1,2024
SIC,RG,N   ,"Noleggio, agenzie di viaggio, servizi di supporto alle im...",1,0,81,2,84,2024
SIC,RG,N 77,Attività di noleggio e leasing operativo                    ,0,0,3,0,3,2024
SIC,RG,N 78,"Attività di ricerca, selezione, fornitura di personale      ",0,0,0,0,0,2024
SIC,RG,N 79,"Attività dei servizi delle agenzie di viaggio, dei tour o...",0,0,2,0,2,2024
SIC,RG,N 80,Servizi di vigilanza e investigazione                       ,0,0,0,0,0,2024
SIC,RG,N 81,Attività di servizi per edifici e paesaggio                 ,0,0,55,2,57,2024
SIC,RG,N 82,Attività di supporto per le funzioni d'ufficio e altri se...,1,0,21,0,22,2024
SIC,RG,O   ,Amministrazione pubblica e difesa; assicurazione sociale ...,0,0,0,0,0,2024
SIC,RG,O 84,Amministrazione pubblica e difesa; assicurazione sociale ...,0,0,0,0,0,2024
SIC,RG,P   ,Istruzione                                                  ,0,0,1,0,1,2024
SIC,RG,P 85,Istruzione                                                  ,0,0,1,0,1,2024
SIC,RG,Q   ,Sanita' e assistenza sociale                                ,0,0,5,0,5,2024
SIC,RG,Q 86,Assistenza sanitaria                                        ,0,0,0,0,0,2024
SIC,RG,Q 87,Servizi di assistenza sociale residenziale                  ,0,0,1,0,1,2024
SIC,RG,Q 88,Assistenza sociale non residenziale                         ,0,0,4,0,4,2024
SIC,RG,R   ,"Attività artistiche, sportive, di intrattenimento e diver...",1,0,19,0,20,2024
SIC,RG,R 90,"Attività creative, artistiche e di intrattenimento          ",0,0,3,0,3,2024
SIC,RG,R 91,"Attività di biblioteche, archivi, musei ed altre attività...",0,0,0,0,0,2024
SIC,RG,R 92,"Attività riguardanti le lotterie, le scommesse, le case d...",0,0,2,0,2,2024
SIC,RG,R 93,"Attività sportive, di intrattenimento e di divertimento     ",1,0,14,0,15,2024
SIC,RG,S   ,Altre attività di servizi                                   ,1,0,72,0,73,2024
SIC,RG,S 94,Attività di organizzazioni associative                      ,0,0,0,0,0,2024
SIC,RG,S 95,Riparazione di computer e di beni per uso personale e per...,0,0,22,0,22,2024
SIC,RG,S 96,Altre attività di servizi per la persona                    ,1,0,50,0,51,2024
SIC,RG,T   ,Attività di famiglie e convivenze come datori di lavoro p...,0,0,0,0,0,2024
SIC,RG,T 97,Attività di famiglie e convivenze come datori di lavoro p...,0,0,0,0,0,2024
SIC,RG,T 98,Produzione di beni e servizi indifferenziati per uso prop...,0,0,0,0,0,2024
SIC,RG,U   ,Organizzazioni ed organismi extraterritoriali               ,0,0,0,0,0,2024
SIC,RG,U 99,Organizzazioni ed organismi extraterritoriali               ,0,0,0,0,0,2024
SIC,RG,XX  ,Imprese non classificate                                    ,9,9,186,4,208,2024
SIC,RG,TOT ,TOTALE                                                      ,52,38,2315,11,2416,2024
SIC,SR,A   ,"Agricoltura, silvicoltura pesca                             ",2,0,342,1,345,2024
SIC,SR,A 01,"Coltivazioni agricole e produzione di prodotti animali, c...",2,0,317,1,320,2024
SIC,SR,A 02,Silvicoltura ed utilizzo di aree forestali                  ,0,0,0,0,0,2024
SIC,SR,A 03,Pesca e acquacoltura                                        ,0,0,25,0,25,2024
SIC,SR,B   ,Estrazione di minerali da cave e miniere                    ,0,0,0,0,0,2024
SIC,SR,B 05,Estrazione di carbone (esclusa torba)                       ,0,0,0,0,0,2024
SIC,SR,B 06,Estraz.di petrolio greggio e di gas naturale                ,0,0,0,0,0,2024
SIC,SR,B 07,Estrazione di minerali metalliferi                          ,0,0,0,0,0,2024
SIC,SR,B 08,Altre attività di estrazione di minerali da cave e miniere  ,0,0,0,0,0,2024
SIC,SR,B 09,Attività dei servizi di supporto all'estrazione             ,0,0,0,0,0,2024
SIC,SR,C   ,Attività manifatturiere                                     ,5,0,187,1,193,2024
SIC,SR,C 10,Industrie alimentari                                        ,0,0,37,0,37,2024
SIC,SR,C 11,Industria delle bevande                                     ,0,0,1,0,1,2024
SIC,SR,C 12,Industria del tabacco                                       ,0,0,0,0,0,2024
SIC,SR,C 13,Industrie tessili                                           ,0,0,4,0,4,2024
SIC,SR,C 14,Confezione di articoli di abbigliamento; confezione di ar...,0,0,7,0,7,2024
SIC,SR,C 15,Fabbricazione di articoli in pelle e simili                 ,0,0,1,0,1,2024
SIC,SR,C 16,Industria del legno e dei prodotti in legno e sughero (es...,0,0,22,0,22,2024
SIC,SR,C 17,Fabbricazione di carta e di prodotti di carta               ,0,0,0,0,0,2024
SIC,SR,C 18,Stampa e riproduzione di supporti registrati                ,0,0,7,1,8,2024
SIC,SR,C 19,Fabbricazione di coke e prodotti derivanti dalla raffinaz...,0,0,0,0,0,2024
SIC,SR,C 20,Fabbricazione di prodotti chimici                           ,0,0,1,0,1,2024
SIC,SR,C 21,Fabbricazione di prodotti farmaceutici di base e di prepa...,0,0,0,0,0,2024
SIC,SR,C 22,Fabbricazione di articoli in gomma e materie plastiche      ,0,0,4,0,4,2024
SIC,SR,C 23,Fabbricazione di altri prodotti della lavorazione di miner..,1,0,12,0,13,2024
SIC,SR,C 24,Metallurgia                                                 ,0,0,1,0,1,2024
SIC,SR,C 25,Fabbricazione di prodotti in metallo (esclusi macchinari ...,2,0,41,0,43,2024
SIC,SR,C 26,Fabbricazione di computer e prodotti di elettronica e ott...,0,0,3,0,3,2024
SIC,SR,C 27,Fabbricazione di apparecchiature elettriche ed apparecchi...,0,0,2,0,2,2024
SIC,SR,C 28,Fabbricazione di macchinari ed apparecchiature nca          ,0,0,3,0,3,2024
SIC,SR,C 29,"Fabbricazione di autoveicoli, rimorchi e semirimorchi       ",0,0,0,0,0,2024
SIC,SR,C 30,Fabbricazione di altri mezzi di trasporto                   ,0,0,8,0,8,2024
SIC,SR,C 31,Fabbricazione di mobili                                     ,0,0,6,0,6,2024
SIC,SR,C 32,Altre industrie manifatturiere                              ,0,0,13,0,13,2024
SIC,SR,C 33,"Riparazione, manutenzione ed installazione di macchine ed...",2,0,14,0,16,2024
SIC,SR,D   ,"Fornitura di energia elettrica, gas, vapore e aria condiz...",0,0,0,0,0,2024
SIC,SR,D 35,"Fornitura di energia elettrica, gas, vapore e aria condiz...",0,0,0,0,0,2024
SIC,SR,E   ,"Fornitura di acqua; reti fognarie, attività di gestione d...",0,0,5,0,5,2024
SIC,SR,E 36,"Raccolta, trattamento e fornitura di acqua                  ",0,0,0,0,0,2024
SIC,SR,E 37,Gestione delle reti fognarie                                ,0,0,1,0,1,2024
SIC,SR,E 38,"Attività di raccolta, trattamento e smaltimento dei rifiu...",0,0,3,0,3,2024
SIC,SR,E 39,Attività di risanamento e altri servizi di gestione dei r...,0,0,1,0,1,2024
SIC,SR,F   ,Costruzioni                                                 ,12,0,409,1,422,2024
SIC,SR,F 41,Costruzione di edifici                                      ,7,0,213,1,221,2024
SIC,SR,F 42,Ingegneria civile                                           ,0,0,8,0,8,2024
SIC,SR,F 43,Lavori di costruzione specializzati                         ,5,0,188,0,193,2024
SIC,SR,G   ,Commercio all'ingrosso e al dettaglio; riparazione di aut...,10,0,763,1,774,2024
SIC,SR,G 45,Commercio all'ingrosso e al dettaglio e riparazione di au...,1,0,87,0,88,2024
SIC,SR,G 46,Commercio all'ingrosso (escluso quello di autoveicoli e d...,1,0,98,1,100,2024
SIC,SR,G 47,Commercio al dettaglio (escluso quello di autoveicoli e d...,8,0,578,0,586,2024
SIC,SR,H   ,Trasporto e magazzinaggio                                   ,0,0,60,0,60,2024
SIC,SR,H 49,Trasporto terrestre e mediante condotte                     ,0,0,53,0,53,2024
SIC,SR,H 50,Trasporto marittimo e per vie d'acqua                       ,0,0,0,0,0,2024
SIC,SR,H 51,Trasporto aereo                                             ,0,0,0,0,0,2024
SIC,SR,H 52,Magazzinaggio e attività di supporto ai trasporti           ,0,0,7,0,7,2024
SIC,SR,H 53,Servizi postali e attività di corriere                      ,0,0,0,0,0,2024
SIC,SR,I   ,Attività dei servizi alloggio e ristorazione                ,8,0,185,1,194,2024
SIC,SR,I 55,Alloggio                                                    ,0,0,7,0,7,2024
SIC,SR,I 56,Attività dei servizi di ristorazione                        ,8,0,178,1,187,2024
SIC,SR,J   ,Servizi di informazione e comunicazione                     ,8,0,39,2,49,2024
SIC,SR,J 58,Attività editoriali                                         ,1,0,4,0,5,2024
SIC,SR,J 59,"Attività di produzione cinematografica, di video e di pro...",2,0,3,0,5,2024
SIC,SR,J 60,Attività di programmazione e trasmissione                   ,0,0,0,0,0,2024
SIC,SR,J 61,Telecomunicazioni                                           ,1,0,14,0,15,2024
SIC,SR,J 62,"Produzione di software, consulenza informatica e attività...",1,0,2,0,3,2024
SIC,SR,J 63,Attività dei servizi d'informazione e altri servizi infor...,3,0,16,2,21,2024
SIC,SR,K   ,Attività finanziarie e assicurative                         ,3,0,30,0,33,2024
SIC,SR,K 64,Attività di servizi finanziari (escluse le assicurazioni ...,0,0,0,0,0,2024
SIC,SR,K 65,"Assicurazioni, riassicurazioni e fondi pensione (escluse ...",0,0,0,0,0,2024
SIC,SR,K 66,Attività ausiliarie dei servizi finanziari e delle attivi...,3,0,30,0,33,2024
SIC,SR,L   ,Attivita' immobiliari                                       ,0,0,8,0,8,2024
SIC,SR,L 68,Attivita' immobiliari                                       ,0,0,8,0,8,2024
SIC,SR,M   ,"Attività professionali, scientifiche e tecniche             ",2,0,37,0,39,2024
SIC,SR,M 69,Attività legali e contabilità                               ,0,0,1,0,1,2024
SIC,SR,M 70,Attività di direzione aziendale e di consulenza gestional...,0,0,5,0,5,2024
SIC,SR,M 71,Attività degli studi di architettura e d'ingegneria; coll...,0,0,5,0,5,2024
SIC,SR,M 72,Ricerca scientifica e sviluppo                              ,0,0,0,0,0,2024
SIC,SR,M 73,Pubblicità e ricerche di mercato                            ,1,0,7,0,8,2024
SIC,SR,M 74,"Altre attività professionali, scientifiche e tecniche       ",1,0,19,0,20,2024
SIC,SR,M 75,Servizi veterinari                                          ,0,0,0,0,0,2024
SIC,SR,N   ,"Noleggio, agenzie di viaggio, servizi di supporto alle im...",2,0,77,0,79,2024
SIC,SR,N 77,Attività di noleggio e leasing operativo                    ,0,0,16,0,16,2024
SIC,SR,N 78,"Attività di ricerca, selezione, fornitura di personale      ",0,0,0,0,0,2024
SIC,SR,N 79,"Attività dei servizi delle agenzie di viaggio, dei tour o...",0,0,6,0,6,2024
SIC,SR,N 80,Servizi di vigilanza e investigazione                       ,0,0,1,0,1,2024
SIC,SR,N 81,Attività di servizi per edifici e paesaggio                 ,0,0,33,0,33,2024
SIC,SR,N 82,Attività di supporto per le funzioni d'ufficio e altri se...,2,0,21,0,23,2024
SIC,SR,O   ,Amministrazione pubblica e difesa; assicurazione sociale ...,0,0,0,0,0,2024
SIC,SR,O 84,Amministrazione pubblica e difesa; assicurazione sociale ...,0,0,0,0,0,2024
SIC,SR,P   ,Istruzione                                                  ,0,0,2,0,2,2024
SIC,SR,P 85,Istruzione                                                  ,0,0,2,0,2,2024
SIC,SR,Q   ,Sanita' e assistenza sociale                                ,0,0,3,0,3,2024
SIC,SR,Q 86,Assistenza sanitaria                                        ,0,0,1,0,1,2024
SIC,SR,Q 87,Servizi di assistenza sociale residenziale                  ,0,0,2,0,2,2024
SIC,SR,Q 88,Assistenza sociale non residenziale                         ,0,0,0,0,0,2024
SIC,SR,R   ,"Attività artistiche, sportive, di intrattenimento e diver...",0,0,31,0,31,2024
SIC,SR,R 90,"Attività creative, artistiche e di intrattenimento          ",0,0,8,0,8,2024
SIC,SR,R 91,"Attività di biblioteche, archivi, musei ed altre attività...",0,0,0,0,0,2024
SIC,SR,R 92,"Attività riguardanti le lotterie, le scommesse, le case d...",0,0,1,0,1,2024
SIC,SR,R 93,"Attività sportive, di intrattenimento e di divertimento     ",0,0,22,0,22,2024
SIC,SR,S   ,Altre attività di servizi                                   ,0,0,75,0,75,2024
SIC,SR,S 94,Attività di organizzazioni associative                      ,0,0,0,0,0,2024
SIC,SR,S 95,Riparazione di computer e di beni per uso personale e per...,0,0,21,0,21,2024
SIC,SR,S 96,Altre attività di servizi per la persona                    ,0,0,54,0,54,2024
SIC,SR,T   ,Attività di famiglie e convivenze come datori di lavoro p...,0,0,0,0,0,2024
SIC,SR,T 97,Attività di famiglie e convivenze come datori di lavoro p...,0,0,0,0,0,2024
SIC,SR,T 98,Produzione di beni e servizi indifferenziati per uso prop...,0,0,0,0,0,2024
SIC,SR,U   ,Organizzazioni ed organismi extraterritoriali               ,0,0,0,0,0,2024
SIC,SR,U 99,Organizzazioni ed organismi extraterritoriali               ,0,0,0,0,0,2024
SIC,SR,XX  ,Imprese non classificate                                    ,16,0,265,4,285,2024
SIC,SR,TOT ,TOTALE                                                      ,68,0,2518,11,2597,2024
SAR,  ,A   ,"Agricoltura, silvicoltura pesca                             ",16,34,126,89,265,2024
SAR,  ,A 01,"Coltivazioni agricole e produzione di prodotti animali, c...",9,23,121,59,212,2024
SAR,  ,A 02,Silvicoltura ed utilizzo di aree forestali                  ,5,0,2,10,17,2024
SAR,  ,A 03,Pesca e acquacoltura                                        ,2,11,3,20,36,2024
SAR,  ,B   ,Estrazione di minerali da cave e miniere                    ,9,7,0,1,17,2024
SAR,  ,B 05,Estrazione di carbone (esclusa torba)                       ,0,0,0,0,0,2024
SAR,  ,B 06,Estraz.di petrolio greggio e di gas naturale                ,0,0,0,0,0,2024
SAR,  ,B 07,Estrazione di minerali metalliferi                          ,1,0,0,0,1,2024
SAR,  ,B 08,Altre attività di estrazione di minerali da cave e miniere  ,8,7,0,1,16,2024
SAR,  ,B 09,Attività dei servizi di supporto all'estrazione             ,0,0,0,0,0,2024
SAR,  ,C   ,Attività manifatturiere                                     ,96,88,91,45,320,2024
SAR,  ,C 10,Industrie alimentari                                        ,9,21,7,18,55,2024
SAR,  ,C 11,Industria delle bevande                                     ,2,1,0,0,3,2024
SAR,  ,C 12,Industria del tabacco                                       ,0,0,0,0,0,2024
SAR,  ,C 13,Industrie tessili                                           ,2,1,2,5,10,2024
SAR,  ,C 14,Confezione di articoli di abbigliamento; confezione di ar...,3,0,4,3,10,2024
SAR,  ,C 15,Fabbricazione di articoli in pelle e simili                 ,1,0,1,0,2,2024
SAR,  ,C 16,Industria del legno e dei prodotti in legno e sughero (es...,12,9,17,4,42,2024
SAR,  ,C 17,Fabbricazione di carta e di prodotti di carta               ,1,0,0,0,1,2024
SAR,  ,C 18,Stampa e riproduzione di supporti registrati                ,3,5,4,1,13,2024
SAR,  ,C 19,Fabbricazione di coke e prodotti derivanti dalla raffinaz...,0,0,0,0,0,2024
SAR,  ,C 20,Fabbricazione di prodotti chimici                           ,3,1,0,0,4,2024
SAR,  ,C 21,Fabbricazione di prodotti farmaceutici di base e di prepa...,0,0,0,0,0,2024
SAR,  ,C 22,Fabbricazione di articoli in gomma e materie plastiche      ,4,1,0,1,6,2024
SAR,  ,C 23,Fabbricazione di altri prodotti della lavorazione di miner..,9,7,5,4,25,2024
SAR,  ,C 24,Metallurgia                                                 ,2,0,1,0,3,2024
SAR,  ,C 25,Fabbricazione di prodotti in metallo (esclusi macchinari ...,16,11,25,2,54,2024
SAR,  ,C 26,Fabbricazione di computer e prodotti di elettronica e ott...,8,4,1,0,13,2024
SAR,  ,C 27,Fabbricazione di apparecchiature elettriche ed apparecchi...,1,1,1,0,3,2024
SAR,  ,C 28,Fabbricazione di macchinari ed apparecchiature nca          ,5,7,4,0,16,2024
SAR,  ,C 29,"Fabbricazione di autoveicoli, rimorchi e semirimorchi       ",1,1,0,0,2,2024
SAR,  ,C 30,Fabbricazione di altri mezzi di trasporto                   ,5,3,2,1,11,2024
SAR,  ,C 31,Fabbricazione di mobili                                     ,4,5,2,3,14,2024
SAR,  ,C 32,Altre industrie manifatturiere                              ,3,7,9,0,19,2024
SAR,  ,C 33,"Riparazione, manutenzione ed installazione di macchine ed...",2,3,6,3,14,2024
SAR,  ,D   ,"Fornitura di energia elettrica, gas, vapore e aria condiz...",1,0,0,1,2,2024
SAR,  ,D 35,"Fornitura di energia elettrica, gas, vapore e aria condiz...",1,0,0,1,2,2024
SAR,  ,E   ,"Fornitura di acqua; reti fognarie, attività di gestione d...",3,4,1,6,14,2024
SAR,  ,E 36,"Raccolta, trattamento e fornitura di acqua                  ",2,0,0,1,3,2024
SAR,  ,E 37,Gestione delle reti fognarie                                ,0,0,0,0,0,2024
SAR,  ,E 38,"Attività di raccolta, trattamento e smaltimento dei rifiu...",1,4,1,3,9,2024
SAR,  ,E 39,Attività di risanamento e altri servizi di gestione dei r...,0,0,0,2,2,2024
SAR,  ,F   ,Costruzioni                                                 ,174,140,199,132,645,2024
SAR,  ,F 41,Costruzione di edifici                                      ,146,90,77,88,401,2024
SAR,  ,F 42,Ingegneria civile                                           ,8,3,2,7,20,2024
SAR,  ,F 43,Lavori di costruzione specializzati                         ,20,47,120,37,224,2024
SAR,  ,G   ,Commercio all'ingrosso e al dettaglio; riparazione di aut...,182,281,474,60,997,2024
SAR,  ,G 45,Commercio all'ingrosso e al dettaglio e riparazione di au...,22,22,40,3,87,2024
SAR,  ,G 46,Commercio all'ingrosso (escluso quello di autoveicoli e d...,82,74,61,24,241,2024
SAR,  ,G 47,Commercio al dettaglio (escluso quello di autoveicoli e d...,78,185,373,33,669,2024
SAR,  ,H   ,Trasporto e magazzinaggio                                   ,25,32,51,53,161,2024
SAR,  ,H 49,Trasporto terrestre e mediante condotte                     ,13,27,46,16,102,2024
SAR,  ,H 50,Trasporto marittimo e per vie d'acqua                       ,3,2,0,2,7,2024
SAR,  ,H 51,Trasporto aereo                                             ,0,0,0,0,0,2024
SAR,  ,H 52,Magazzinaggio e attività di supporto ai trasporti           ,9,3,3,29,44,2024
SAR,  ,H 53,Servizi postali e attività di corriere                      ,0,0,2,6,8,2024
SAR,  ,I   ,Attività dei servizi alloggio e ristorazione                ,59,256,94,64,473,2024
SAR,  ,I 55,Alloggio                                                    ,9,4,1,6,20,2024
SAR,  ,I 56,Attività dei servizi di ristorazione                        ,50,252,93,58,453,2024
SAR,  ,J   ,Servizi di informazione e comunicazione                     ,33,18,16,16,83,2024
SAR,  ,J 58,Attività editoriali                                         ,3,2,5,3,13,2024
SAR,  ,J 59,"Attività di produzione cinematografica, di video e di pro...",1,2,0,0,3,2024
SAR,  ,J 60,Attività di programmazione e trasmissione                   ,2,0,0,0,2,2024
SAR,  ,J 61,Telecomunicazioni                                           ,0,0,3,0,3,2024
SAR,  ,J 62,"Produzione di software, consulenza informatica e attività...",17,1,1,3,22,2024
SAR,  ,J 63,Attività dei servizi d'informazione e altri servizi infor...,10,13,7,10,40,2024
SAR,  ,K   ,Attività finanziarie e assicurative                         ,9,9,14,2,34,2024
SAR,  ,K 64,Attività di servizi finanziari (escluse le assicurazioni ...,4,3,0,1,8,2024
SAR,  ,K 65,"Assicurazioni, riassicurazioni e fondi pensione (escluse ...",0,0,0,0,0,2024
SAR,  ,K 66,Attività ausiliarie dei servizi finanziari e delle attivi...,5,6,14,1,26,2024
SAR,  ,L   ,Attivita' immobiliari                                       ,29,16,2,1,48,2024
SAR,  ,L 68,Attivita' immobiliari                                       ,29,16,2,1,48,2024
SAR,  ,M   ,"Attività professionali, scientifiche e tecniche             ",37,17,15,20,89,2024
SAR,  ,M 69,Attività legali e contabilità                               ,1,0,0,0,1,2024
SAR,  ,M 70,Attività di direzione aziendale e di consulenza gestional...,12,0,0,1,13,2024
SAR,  ,M 71,Attività degli studi di architettura e d'ingegneria; coll...,3,2,2,1,8,2024
SAR,  ,M 72,Ricerca scientifica e sviluppo                              ,0,0,0,3,3,2024
SAR,  ,M 73,Pubblicità e ricerche di mercato                            ,11,5,1,4,21,2024
SAR,  ,M 74,"Altre attività professionali, scientifiche e tecniche       ",10,10,12,11,43,2024
SAR,  ,M 75,Servizi veterinari                                          ,0,0,0,0,0,2024
SAR,  ,N   ,"Noleggio, agenzie di viaggio, servizi di supporto alle im...",23,19,29,84,155,2024
SAR,  ,N 77,Attività di noleggio e leasing operativo                    ,9,4,5,7,25,2024
SAR,  ,N 78,"Attività di ricerca, selezione, fornitura di personale      ",0,0,0,0,0,2024
SAR,  ,N 79,"Attività dei servizi delle agenzie di viaggio, dei tour o...",4,5,2,5,16,2024
SAR,  ,N 80,Servizi di vigilanza e investigazione                       ,2,0,0,4,6,2024
SAR,  ,N 81,Attività di servizi per edifici e paesaggio                 ,2,9,14,52,77,2024
SAR,  ,N 82,Attività di supporto per le funzioni d'ufficio e altri se...,6,1,8,16,31,2024
SAR,  ,O   ,Amministrazione pubblica e difesa; assicurazione sociale ...,0,0,0,0,0,2024
SAR,  ,O 84,Amministrazione pubblica e difesa; assicurazione sociale ...,0,0,0,0,0,2024
SAR,  ,P   ,Istruzione                                                  ,3,5,2,8,18,2024
SAR,  ,P 85,Istruzione                                                  ,3,5,2,8,18,2024
SAR,  ,Q   ,Sanita' e assistenza sociale                                ,5,5,0,52,62,2024
SAR,  ,Q 86,Assistenza sanitaria                                        ,4,3,0,13,20,2024
SAR,  ,Q 87,Servizi di assistenza sociale residenziale                  ,1,0,0,7,8,2024
SAR,  ,Q 88,Assistenza sociale non residenziale                         ,0,2,0,32,34,2024
SAR,  ,R   ,"Attività artistiche, sportive, di intrattenimento e diver...",11,24,5,30,70,2024
SAR,  ,R 90,"Attività creative, artistiche e di intrattenimento          ",3,10,1,10,24,2024
SAR,  ,R 91,"Attività di biblioteche, archivi, musei ed altre attività...",1,0,0,9,10,2024
SAR,  ,R 92,"Attività riguardanti le lotterie, le scommesse, le case d...",0,0,0,0,0,2024
SAR,  ,R 93,"Attività sportive, di intrattenimento e di divertimento     ",7,14,4,11,36,2024
SAR,  ,S   ,Altre attività di servizi                                   ,5,22,43,20,90,2024
SAR,  ,S 94,Attività di organizzazioni associative                      ,0,0,0,0,0,2024
SAR,  ,S 95,Riparazione di computer e di beni per uso personale e per...,2,8,9,4,23,2024
SAR,  ,S 96,Altre attività di servizi per la persona                    ,3,14,34,16,67,2024
SAR,  ,T   ,Attività di famiglie e convivenze come datori di lavoro p...,0,0,0,1,1,2024
SAR,  ,T 97,Attività di famiglie e convivenze come datori di lavoro p...,0,0,0,1,1,2024
SAR,  ,T 98,Produzione di beni e servizi indifferenziati per uso prop...,0,0,0,0,0,2024
SAR,  ,U   ,Organizzazioni ed organismi extraterritoriali               ,0,0,0,0,0,2024
SAR,  ,U 99,Organizzazioni ed organismi extraterritoriali               ,0,0,0,0,0,2024
SAR,  ,XX  ,Imprese non classificate                                    ,934,104,163,166,1367,2024
SAR,  ,TOT ,TOTALE                                                      ,1654,1081,1325,851,4911,2024
SAR,SS,A   ,"Agricoltura, silvicoltura pesca                             ",8,24,14,28,74,2024
SAR,SS,A 01,"Coltivazioni agricole e produzione di prodotti animali, c...",5,13,13,14,45,2024
SAR,SS,A 02,Silvicoltura ed utilizzo di aree forestali                  ,3,0,1,5,9,2024
SAR,SS,A 03,Pesca e acquacoltura                                        ,0,11,0,9,20,2024
SAR,SS,B   ,Estrazione di minerali da cave e miniere                    ,6,7,0,0,13,2024
SAR,SS,B 05,Estrazione di carbone (esclusa torba)                       ,0,0,0,0,0,2024
SAR,SS,B 06,Estraz.di petrolio greggio e di gas naturale                ,0,0,0,0,0,2024
SAR,SS,B 07,Estrazione di minerali metalliferi                          ,0,0,0,0,0,2024
SAR,SS,B 08,Altre attività di estrazione di minerali da cave e miniere  ,6,7,0,0,13,2024
SAR,SS,B 09,Attività dei servizi di supporto all'estrazione             ,0,0,0,0,0,2024
SAR,SS,C   ,Attività manifatturiere                                     ,60,74,13,18,165,2024
SAR,SS,C 10,Industrie alimentari                                        ,5,18,2,2,27,2024
SAR,SS,C 11,Industria delle bevande                                     ,1,1,0,0,2,2024
SAR,SS,C 12,Industria del tabacco                                       ,0,0,0,0,0,2024
SAR,SS,C 13,Industrie tessili                                           ,1,1,0,5,7,2024
SAR,SS,C 14,Confezione di articoli di abbigliamento; confezione di ar...,2,0,1,0,3,2024
SAR,SS,C 15,Fabbricazione di articoli in pelle e simili                 ,0,0,0,0,0,2024
SAR,SS,C 16,Industria del legno e dei prodotti in legno e sughero (es...,9,8,4,4,25,2024
SAR,SS,C 17,Fabbricazione di carta e di prodotti di carta               ,0,0,0,0,0,2024
SAR,SS,C 18,Stampa e riproduzione di supporti registrati                ,2,5,0,1,8,2024
SAR,SS,C 19,Fabbricazione di coke e prodotti derivanti dalla raffinaz...,0,0,0,0,0,2024
SAR,SS,C 20,Fabbricazione di prodotti chimici                           ,2,1,0,0,3,2024
SAR,SS,C 21,Fabbricazione di prodotti farmaceutici di base e di prepa...,0,0,0,0,0,2024
SAR,SS,C 22,Fabbricazione di articoli in gomma e materie plastiche      ,3,1,0,0,4,2024
SAR,SS,C 23,Fabbricazione di altri prodotti della lavorazione di miner..,9,5,0,2,16,2024
SAR,SS,C 24,Metallurgia                                                 ,0,0,0,0,0,2024
SAR,SS,C 25,Fabbricazione di prodotti in metallo (esclusi macchinari ...,11,9,2,2,24,2024
SAR,SS,C 26,Fabbricazione di computer e prodotti di elettronica e ott...,5,3,0,0,8,2024
SAR,SS,C 27,Fabbricazione di apparecchiature elettriche ed apparecchi...,0,1,0,0,1,2024
SAR,SS,C 28,Fabbricazione di macchinari ed apparecchiature nca          ,1,5,1,0,7,2024
SAR,SS,C 29,"Fabbricazione di autoveicoli, rimorchi e semirimorchi       ",0,1,0,0,1,2024
SAR,SS,C 30,Fabbricazione di altri mezzi di trasporto                   ,3,3,0,0,6,2024
SAR,SS,C 31,Fabbricazione di mobili                                     ,3,4,1,0,8,2024
SAR,SS,C 32,Altre industrie manifatturiere                              ,2,6,0,0,8,2024
SAR,SS,C 33,"Riparazione, manutenzione ed installazione di macchine ed...",1,2,2,2,7,2024
SAR,SS,D   ,"Fornitura di energia elettrica, gas, vapore e aria condiz...",1,0,0,1,2,2024
SAR,SS,D 35,"Fornitura di energia elettrica, gas, vapore e aria condiz...",1,0,0,1,2,2024
SAR,SS,E   ,"Fornitura di acqua; reti fognarie, attività di gestione d...",0,4,0,5,9,2024
SAR,SS,E 36,"Raccolta, trattamento e fornitura di acqua                  ",0,0,0,1,1,2024
SAR,SS,E 37,Gestione delle reti fognarie                                ,0,0,0,0,0,2024
SAR,SS,E 38,"Attività di raccolta, trattamento e smaltimento dei rifiu...",0,4,0,2,6,2024
SAR,SS,E 39,Attività di risanamento e altri servizi di gestione dei r...,0,0,0,2,2,2024
SAR,SS,F   ,Costruzioni                                                 ,114,110,58,65,347,2024
SAR,SS,F 41,Costruzione di edifici                                      ,98,74,24,49,245,2024
SAR,SS,F 42,Ingegneria civile                                           ,6,3,1,4,14,2024
SAR,SS,F 43,Lavori di costruzione specializzati                         ,10,33,33,12,88,2024
SAR,SS,G   ,Commercio all'ingrosso e al dettaglio; riparazione di aut...,94,229,102,23,448,2024
SAR,SS,G 45,Commercio all'ingrosso e al dettaglio e riparazione di au...,10,17,14,0,41,2024
SAR,SS,G 46,Commercio all'ingrosso (escluso quello di autoveicoli e d...,36,63,8,9,116,2024
SAR,SS,G 47,Commercio al dettaglio (escluso quello di autoveicoli e d...,48,149,80,14,291,2024
SAR,SS,H   ,Trasporto e magazzinaggio                                   ,14,31,9,18,72,2024
SAR,SS,H 49,Trasporto terrestre e mediante condotte                     ,7,26,7,5,45,2024
SAR,SS,H 50,Trasporto marittimo e per vie d'acqua                       ,3,2,0,1,6,2024
SAR,SS,H 51,Trasporto aereo                                             ,0,0,0,0,0,2024
SAR,SS,H 52,Magazzinaggio e attività di supporto ai trasporti           ,4,3,1,11,19,2024
SAR,SS,H 53,Servizi postali e attività di corriere                      ,0,0,1,1,2,2024
SAR,SS,I   ,Attività dei servizi alloggio e ristorazione                ,48,209,17,25,299,2024
SAR,SS,I 55,Alloggio                                                    ,5,4,0,0,9,2024
SAR,SS,I 56,Attività dei servizi di ristorazione                        ,43,205,17,25,290,2024
SAR,SS,J   ,Servizi di informazione e comunicazione                     ,14,14,3,7,38,2024
SAR,SS,J 58,Attività editoriali                                         ,3,1,0,2,6,2024
SAR,SS,J 59,"Attività di produzione cinematografica, di video e di pro...",1,2,0,0,3,2024
SAR,SS,J 60,Attività di programmazione e trasmissione                   ,1,0,0,0,1,2024
SAR,SS,J 61,Telecomunicazioni                                           ,0,0,1,0,1,2024
SAR,SS,J 62,"Produzione di software, consulenza informatica e attività...",7,1,0,2,10,2024
SAR,SS,J 63,Attività dei servizi d'informazione e altri servizi infor...,2,10,2,3,17,2024
SAR,SS,K   ,Attività finanziarie e assicurative                         ,5,8,1,1,15,2024
SAR,SS,K 64,Attività di servizi finanziari (escluse le assicurazioni ...,1,3,0,1,5,2024
SAR,SS,K 65,"Assicurazioni, riassicurazioni e fondi pensione (escluse ...",0,0,0,0,0,2024
SAR,SS,K 66,Attività ausiliarie dei servizi finanziari e delle attivi...,4,5,1,0,10,2024
SAR,SS,L   ,Attivita' immobiliari                                       ,20,15,0,0,35,2024
SAR,SS,L 68,Attivita' immobiliari                                       ,20,15,0,0,35,2024
SAR,SS,M   ,"Attività professionali, scientifiche e tecniche             ",15,12,3,11,41,2024
SAR,SS,M 69,Attività legali e contabilità                               ,1,0,0,0,1,2024
SAR,SS,M 70,Attività di direzione aziendale e di consulenza gestional...,1,0,0,0,1,2024
SAR,SS,M 71,Attività degli studi di architettura e d'ingegneria; coll...,2,1,1,1,5,2024
SAR,SS,M 72,Ricerca scientifica e sviluppo                              ,0,0,0,2,2,2024
SAR,SS,M 73,Pubblicità e ricerche di mercato                            ,3,4,0,0,7,2024
SAR,SS,M 74,"Altre attività professionali, scientifiche e tecniche       ",8,7,2,8,25,2024
SAR,SS,M 75,Servizi veterinari                                          ,0,0,0,0,0,2024
SAR,SS,N   ,"Noleggio, agenzie di viaggio, servizi di supporto alle im...",14,11,3,28,56,2024
SAR,SS,N 77,Attività di noleggio e leasing operativo                    ,7,2,0,4,13,2024
SAR,SS,N 78,"Attività di ricerca, selezione, fornitura di personale      ",0,0,0,0,0,2024
SAR,SS,N 79,"Attività dei servizi delle agenzie di viaggio, dei tour o...",1,2,0,1,4,2024
SAR,SS,N 80,Servizi di vigilanza e investigazione                       ,0,0,0,1,1,2024
SAR,SS,N 81,Attività di servizi per edifici e paesaggio                 ,1,7,3,16,27,2024
SAR,SS,N 82,Attività di supporto per le funzioni d'ufficio e altri se...,5,0,0,6,11,2024
SAR,SS,O   ,Amministrazione pubblica e difesa; assicurazione sociale ...,0,0,0,0,0,2024
SAR,SS,O 84,Amministrazione pubblica e difesa; assicurazione sociale ...,0,0,0,0,0,2024
SAR,SS,P   ,Istruzione                                                  ,3,4,0,1,8,2024
SAR,SS,P 85,Istruzione                                                  ,3,4,0,1,8,2024
SAR,SS,Q   ,Sanita' e assistenza sociale                                ,3,4,0,16,23,2024
SAR,SS,Q 86,Assistenza sanitaria                                        ,2,2,0,6,10,2024
SAR,SS,Q 87,Servizi di assistenza sociale residenziale                  ,1,0,0,4,5,2024
SAR,SS,Q 88,Assistenza sociale non residenziale                         ,0,2,0,6,8,2024
SAR,SS,R   ,"Attività artistiche, sportive, di intrattenimento e diver...",7,24,3,13,47,2024
SAR,SS,R 90,"Attività creative, artistiche e di intrattenimento          ",3,10,1,4,18,2024
SAR,SS,R 91,"Attività di biblioteche, archivi, musei ed altre attività...",0,0,0,4,4,2024
SAR,SS,R 92,"Attività riguardanti le lotterie, le scommesse, le case d...",0,0,0,0,0,2024
SAR,SS,R 93,"Attività sportive, di intrattenimento e di divertimento     ",4,14,2,5,25,2024
SAR,SS,S   ,Altre attività di servizi                                   ,4,14,12,9,39,2024
SAR,SS,S 94,Attività di organizzazioni associative                      ,0,0,0,0,0,2024
SAR,SS,S 95,Riparazione di computer e di beni per uso personale e per...,1,7,2,1,11,2024
SAR,SS,S 96,Altre attività di servizi per la persona                    ,3,7,10,8,28,2024
SAR,SS,T   ,Attività di famiglie e convivenze come datori di lavoro p...,0,0,0,1,1,2024
SAR,SS,T 97,Attività di famiglie e convivenze come datori di lavoro p...,0,0,0,1,1,2024
SAR,SS,T 98,Produzione di beni e servizi indifferenziati per uso prop...,0,0,0,0,0,2024
SAR,SS,U   ,Organizzazioni ed organismi extraterritoriali               ,0,0,0,0,0,2024
SAR,SS,U 99,Organizzazioni ed organismi extraterritoriali               ,0,0,0,0,0,2024
SAR,SS,XX  ,Imprese non classificate                                    ,102,49,23,50,224,2024
SAR,SS,TOT ,TOTALE                                                      ,532,843,261,320,1956,2024
SAR,NU,A   ,"Agricoltura, silvicoltura pesca                             ",0,0,0,17,17,2024
SAR,NU,A 01,"Coltivazioni agricole e produzione di prodotti animali, c...",0,0,0,12,12,2024
SAR,NU,A 02,Silvicoltura ed utilizzo di aree forestali                  ,0,0,0,3,3,2024
SAR,NU,A 03,Pesca e acquacoltura                                        ,0,0,0,2,2,2024
SAR,NU,B   ,Estrazione di minerali da cave e miniere                    ,0,0,0,1,1,2024
SAR,NU,B 05,Estrazione di carbone (esclusa torba)                       ,0,0,0,0,0,2024
SAR,NU,B 06,Estraz.di petrolio greggio e di gas naturale                ,0,0,0,0,0,2024
SAR,NU,B 07,Estrazione di minerali metalliferi                          ,0,0,0,0,0,2024
SAR,NU,B 08,Altre attività di estrazione di minerali da cave e miniere  ,0,0,0,1,1,2024
SAR,NU,B 09,Attività dei servizi di supporto all'estrazione             ,0,0,0,0,0,2024
SAR,NU,C   ,Attività manifatturiere                                     ,0,0,0,5,5,2024
SAR,NU,C 10,Industrie alimentari                                        ,0,0,0,4,4,2024
SAR,NU,C 11,Industria delle bevande                                     ,0,0,0,0,0,2024
SAR,NU,C 12,Industria del tabacco                                       ,0,0,0,0,0,2024
SAR,NU,C 13,Industrie tessili                                           ,0,0,0,0,0,2024
SAR,NU,C 14,Confezione di articoli di abbigliamento; confezione di ar...,0,0,0,1,1,2024
SAR,NU,C 15,Fabbricazione di articoli in pelle e simili                 ,0,0,0,0,0,2024
SAR,NU,C 16,Industria del legno e dei prodotti in legno e sughero (es...,0,0,0,0,0,2024
SAR,NU,C 17,Fabbricazione di carta e di prodotti di carta               ,0,0,0,0,0,2024
SAR,NU,C 18,Stampa e riproduzione di supporti registrati                ,0,0,0,0,0,2024
SAR,NU,C 19,Fabbricazione di coke e prodotti derivanti dalla raffinaz...,0,0,0,0,0,2024
SAR,NU,C 20,Fabbricazione di prodotti chimici                           ,0,0,0,0,0,2024
SAR,NU,C 21,Fabbricazione di prodotti farmaceutici di base e di prepa...,0,0,0,0,0,2024
SAR,NU,C 22,Fabbricazione di articoli in gomma e materie plastiche      ,0,0,0,0,0,2024
SAR,NU,C 23,Fabbricazione di altri prodotti della lavorazione di miner..,0,0,0,0,0,2024
SAR,NU,C 24,Metallurgia                                                 ,0,0,0,0,0,2024
SAR,NU,C 25,Fabbricazione di prodotti in metallo (esclusi macchinari ...,0,0,0,0,0,2024
SAR,NU,C 26,Fabbricazione di computer e prodotti di elettronica e ott...,0,0,0,0,0,2024
SAR,NU,C 27,Fabbricazione di apparecchiature elettriche ed apparecchi...,0,0,0,0,0,2024
SAR,NU,C 28,Fabbricazione di macchinari ed apparecchiature nca          ,0,0,0,0,0,2024
SAR,NU,C 29,"Fabbricazione di autoveicoli, rimorchi e semirimorchi       ",0,0,0,0,0,2024
SAR,NU,C 30,Fabbricazione di altri mezzi di trasporto                   ,0,0,0,0,0,2024
SAR,NU,C 31,Fabbricazione di mobili                                     ,0,0,0,0,0,2024
SAR,NU,C 32,Altre industrie manifatturiere                              ,0,0,0,0,0,2024
SAR,NU,C 33,"Riparazione, manutenzione ed installazione di macchine ed...",0,0,0,0,0,2024
SAR,NU,D   ,"Fornitura di energia elettrica, gas, vapore e aria condiz...",0,0,0,0,0,2024
SAR,NU,D 35,"Fornitura di energia elettrica, gas, vapore e aria condiz...",0,0,0,0,0,2024
SAR,NU,E   ,"Fornitura di acqua; reti fognarie, attività di gestione d...",0,0,0,1,1,2024
SAR,NU,E 36,"Raccolta, trattamento e fornitura di acqua                  ",0,0,0,0,0,2024
SAR,NU,E 37,Gestione delle reti fognarie                                ,0,0,0,0,0,2024
SAR,NU,E 38,"Attività di raccolta, trattamento e smaltimento dei rifiu...",0,0,0,1,1,2024
SAR,NU,E 39,Attività di risanamento e altri servizi di gestione dei r...,0,0,0,0,0,2024
SAR,NU,F   ,Costruzioni                                                 ,0,0,0,15,15,2024
SAR,NU,F 41,Costruzione di edifici                                      ,0,0,0,12,12,2024
SAR,NU,F 42,Ingegneria civile                                           ,0,0,0,0,0,2024
SAR,NU,F 43,Lavori di costruzione specializzati                         ,0,0,0,3,3,2024
SAR,NU,G   ,Commercio all'ingrosso e al dettaglio; riparazione di aut...,0,0,0,6,6,2024
SAR,NU,G 45,Commercio all'ingrosso e al dettaglio e riparazione di au...,0,0,0,0,0,2024
SAR,NU,G 46,Commercio all'ingrosso (escluso quello di autoveicoli e d...,0,0,0,3,3,2024
SAR,NU,G 47,Commercio al dettaglio (escluso quello di autoveicoli e d...,0,0,0,3,3,2024
SAR,NU,H   ,Trasporto e magazzinaggio                                   ,0,0,0,4,4,2024
SAR,NU,H 49,Trasporto terrestre e mediante condotte                     ,0,0,0,0,0,2024
SAR,NU,H 50,Trasporto marittimo e per vie d'acqua                       ,0,0,0,1,1,2024
SAR,NU,H 51,Trasporto aereo                                             ,0,0,0,0,0,2024
SAR,NU,H 52,Magazzinaggio e attività di supporto ai trasporti           ,0,0,0,3,3,2024
SAR,NU,H 53,Servizi postali e attività di corriere                      ,0,0,0,0,0,2024
SAR,NU,I   ,Attività dei servizi alloggio e ristorazione                ,0,0,0,13,13,2024
SAR,NU,I 55,Alloggio                                                    ,0,0,0,3,3,2024
SAR,NU,I 56,Attività dei servizi di ristorazione                        ,0,0,0,10,10,2024
SAR,NU,J   ,Servizi di informazione e comunicazione                     ,0,0,0,2,2,2024
SAR,NU,J 58,Attività editoriali                                         ,0,0,0,0,0,2024
SAR,NU,J 59,"Attività di produzione cinematografica, di video e di pro...",0,0,0,0,0,2024
SAR,NU,J 60,Attività di programmazione e trasmissione                   ,0,0,0,0,0,2024
SAR,NU,J 61,Telecomunicazioni                                           ,0,0,0,0,0,2024
SAR,NU,J 62,"Produzione di software, consulenza informatica e attività...",0,0,0,0,0,2024
SAR,NU,J 63,Attività dei servizi d'informazione e altri servizi infor...,0,0,0,2,2,2024
SAR,NU,K   ,Attività finanziarie e assicurative                         ,0,0,0,1,1,2024
SAR,NU,K 64,Attività di servizi finanziari (escluse le assicurazioni ...,0,0,0,0,0,2024
SAR,NU,K 65,"Assicurazioni, riassicurazioni e fondi pensione (escluse ...",0,0,0,0,0,2024
SAR,NU,K 66,Attività ausiliarie dei servizi finanziari e delle attivi...,0,0,0,1,1,2024
SAR,NU,L   ,Attivita' immobiliari                                       ,0,0,0,1,1,2024
SAR,NU,L 68,Attivita' immobiliari                                       ,0,0,0,1,1,2024
SAR,NU,M   ,"Attività professionali, scientifiche e tecniche             ",0,0,0,2,2,2024
SAR,NU,M 69,Attività legali e contabilità                               ,0,0,0,0,0,2024
SAR,NU,M 70,Attività di direzione aziendale e di consulenza gestional...,0,0,0,0,0,2024
SAR,NU,M 71,Attività degli studi di architettura e d'ingegneria; coll...,0,0,0,0,0,2024
SAR,NU,M 72,Ricerca scientifica e sviluppo                              ,0,0,0,0,0,2024
SAR,NU,M 73,Pubblicità e ricerche di mercato                            ,0,0,0,0,0,2024
SAR,NU,M 74,"Altre attività professionali, scientifiche e tecniche       ",0,0,0,2,2,2024
SAR,NU,M 75,Servizi veterinari                                          ,0,0,0,0,0,2024
SAR,NU,N   ,"Noleggio, agenzie di viaggio, servizi di supporto alle im...",0,0,0,6,6,2024
SAR,NU,N 77,Attività di noleggio e leasing operativo                    ,0,0,0,1,1,2024
SAR,NU,N 78,"Attività di ricerca, selezione, fornitura di personale      ",0,0,0,0,0,2024
SAR,NU,N 79,"Attività dei servizi delle agenzie di viaggio, dei tour o...",0,0,0,1,1,2024
SAR,NU,N 80,Servizi di vigilanza e investigazione                       ,0,0,0,1,1,2024
SAR,NU,N 81,Attività di servizi per edifici e paesaggio                 ,0,0,0,3,3,2024
SAR,NU,N 82,Attività di supporto per le funzioni d'ufficio e altri se...,0,0,0,0,0,2024
SAR,NU,O   ,Amministrazione pubblica e difesa; assicurazione sociale ...,0,0,0,0,0,2024
SAR,NU,O 84,Amministrazione pubblica e difesa; assicurazione sociale ...,0,0,0,0,0,2024
SAR,NU,P   ,Istruzione                                                  ,0,0,0,1,1,2024
SAR,NU,P 85,Istruzione                                                  ,0,0,0,1,1,2024
SAR,NU,Q   ,Sanita' e assistenza sociale                                ,0,0,0,15,15,2024
SAR,NU,Q 86,Assistenza sanitaria                                        ,0,0,0,2,2,2024
SAR,NU,Q 87,Servizi di assistenza sociale residenziale                  ,0,0,0,1,1,2024
SAR,NU,Q 88,Assistenza sociale non residenziale                         ,0,0,0,12,12,2024
SAR,NU,R   ,"Attività artistiche, sportive, di intrattenimento e diver...",0,0,0,2,2,2024
SAR,NU,R 90,"Attività creative, artistiche e di intrattenimento          ",0,0,0,0,0,2024
SAR,NU,R 91,"Attività di biblioteche, archivi, musei ed altre attività...",0,0,0,2,2,2024
SAR,NU,R 92,"Attività riguardanti le lotterie, le scommesse, le case d...",0,0,0,0,0,2024
SAR,NU,R 93,"Attività sportive, di intrattenimento e di divertimento     ",0,0,0,0,0,2024
SAR,NU,S   ,Altre attività di servizi                                   ,0,0,0,2,2,2024
SAR,NU,S 94,Attività di organizzazioni associative                      ,0,0,0,0,0,2024
SAR,NU,S 95,Riparazione di computer e di beni per uso personale e per...,0,0,0,2,2,2024
SAR,NU,S 96,Altre attività di servizi per la persona                    ,0,0,0,0,0,2024
SAR,NU,T   ,Attività di famiglie e convivenze come datori di lavoro p...,0,0,0,0,0,2024
SAR,NU,T 97,Attività di famiglie e convivenze come datori di lavoro p...,0,0,0,0,0,2024
SAR,NU,T 98,Produzione di beni e servizi indifferenziati per uso prop...,0,0,0,0,0,2024
SAR,NU,U   ,Organizzazioni ed organismi extraterritoriali               ,0,0,0,0,0,2024
SAR,NU,U 99,Organizzazioni ed organismi extraterritoriali               ,0,0,0,0,0,2024
SAR,NU,XX  ,Imprese non classificate                                    ,0,0,0,21,21,2024
SAR,NU,TOT ,TOTALE                                                      ,0,0,0,115,115,2024
SAR,CA,A   ,"Agricoltura, silvicoltura pesca                             ",8,7,59,27,101,2024
SAR,CA,A 01,"Coltivazioni agricole e produzione di prodotti animali, c...",4,7,56,18,85,2024
SAR,CA,A 02,Silvicoltura ed utilizzo di aree forestali                  ,2,0,0,2,4,2024
SAR,CA,A 03,Pesca e acquacoltura                                        ,2,0,3,7,12,2024
SAR,CA,B   ,Estrazione di minerali da cave e miniere                    ,3,0,0,0,3,2024
SAR,CA,B 05,Estrazione di carbone (esclusa torba)                       ,0,0,0,0,0,2024
SAR,CA,B 06,Estraz.di petrolio greggio e di gas naturale                ,0,0,0,0,0,2024
SAR,CA,B 07,Estrazione di minerali metalliferi                          ,1,0,0,0,1,2024
SAR,CA,B 08,Altre attività di estrazione di minerali da cave e miniere  ,2,0,0,0,2,2024
SAR,CA,B 09,Attività dei servizi di supporto all'estrazione             ,0,0,0,0,0,2024
SAR,CA,C   ,Attività manifatturiere                                     ,27,12,45,13,97,2024
SAR,CA,C 10,Industrie alimentari                                        ,2,2,4,5,13,2024
SAR,CA,C 11,Industria delle bevande                                     ,1,0,0,0,1,2024
SAR,CA,C 12,Industria del tabacco                                       ,0,0,0,0,0,2024
SAR,CA,C 13,Industrie tessili                                           ,0,0,1,0,1,2024
SAR,CA,C 14,Confezione di articoli di abbigliamento; confezione di ar...,1,0,2,1,4,2024
SAR,CA,C 15,Fabbricazione di articoli in pelle e simili                 ,1,0,0,0,1,2024
SAR,CA,C 16,Industria del legno e dei prodotti in legno e sughero (es...,1,0,5,0,6,2024
SAR,CA,C 17,Fabbricazione di carta e di prodotti di carta               ,0,0,0,0,0,2024
SAR,CA,C 18,Stampa e riproduzione di supporti registrati                ,1,0,3,0,4,2024
SAR,CA,C 19,Fabbricazione di coke e prodotti derivanti dalla raffinaz...,0,0,0,0,0,2024
SAR,CA,C 20,Fabbricazione di prodotti chimici                           ,1,0,0,0,1,2024
SAR,CA,C 21,Fabbricazione di prodotti farmaceutici di base e di prepa...,0,0,0,0,0,2024
SAR,CA,C 22,Fabbricazione di articoli in gomma e materie plastiche      ,1,0,0,1,2,2024
SAR,CA,C 23,Fabbricazione di altri prodotti della lavorazione di miner..,0,2,2,2,6,2024
SAR,CA,C 24,Metallurgia                                                 ,2,0,1,0,3,2024
SAR,CA,C 25,Fabbricazione di prodotti in metallo (esclusi macchinari ...,4,2,11,0,17,2024
SAR,CA,C 26,Fabbricazione di computer e prodotti di elettronica e ott...,3,1,1,0,5,2024
SAR,CA,C 27,Fabbricazione di apparecchiature elettriche ed apparecchi...,0,0,0,0,0,2024
SAR,CA,C 28,Fabbricazione di macchinari ed apparecchiature nca          ,3,2,1,0,6,2024
SAR,CA,C 29,"Fabbricazione di autoveicoli, rimorchi e semirimorchi       ",1,0,0,0,1,2024
SAR,CA,C 30,Fabbricazione di altri mezzi di trasporto                   ,2,0,1,1,4,2024
SAR,CA,C 31,Fabbricazione di mobili                                     ,1,1,1,2,5,2024
SAR,CA,C 32,Altre industrie manifatturiere                              ,1,1,8,0,10,2024
SAR,CA,C 33,"Riparazione, manutenzione ed installazione di macchine ed...",1,1,4,1,7,2024
SAR,CA,D   ,"Fornitura di energia elettrica, gas, vapore e aria condiz...",0,0,0,0,0,2024
SAR,CA,D 35,"Fornitura di energia elettrica, gas, vapore e aria condiz...",0,0,0,0,0,2024
SAR,CA,E   ,"Fornitura di acqua; reti fognarie, attività di gestione d...",1,0,0,0,1,2024
SAR,CA,E 36,"Raccolta, trattamento e fornitura di acqua                  ",1,0,0,0,1,2024
SAR,CA,E 37,Gestione delle reti fognarie                                ,0,0,0,0,0,2024
SAR,CA,E 38,"Attività di raccolta, trattamento e smaltimento dei rifiu...",0,0,0,0,0,2024
SAR,CA,E 39,Attività di risanamento e altri servizi di gestione dei r...,0,0,0,0,0,2024
SAR,CA,F   ,Costruzioni                                                 ,44,26,94,42,206,2024
SAR,CA,F 41,Costruzione di edifici                                      ,35,14,43,20,112,2024
SAR,CA,F 42,Ingegneria civile                                           ,2,0,1,1,4,2024
SAR,CA,F 43,Lavori di costruzione specializzati                         ,7,12,50,21,90,2024
SAR,CA,G   ,Commercio all'ingrosso e al dettaglio; riparazione di aut...,56,45,290,19,410,2024
SAR,CA,G 45,Commercio all'ingrosso e al dettaglio e riparazione di au...,8,5,22,1,36,2024
SAR,CA,G 46,Commercio all'ingrosso (escluso quello di autoveicoli e d...,26,9,42,9,86,2024
SAR,CA,G 47,Commercio al dettaglio (escluso quello di autoveicoli e d...,22,31,226,9,288,2024
SAR,CA,H   ,Trasporto e magazzinaggio                                   ,9,1,26,26,62,2024
SAR,CA,H 49,Trasporto terrestre e mediante condotte                     ,5,1,25,7,38,2024
SAR,CA,H 50,Trasporto marittimo e per vie d'acqua                       ,0,0,0,0,0,2024
SAR,CA,H 51,Trasporto aereo                                             ,0,0,0,0,0,2024
SAR,CA,H 52,Magazzinaggio e attività di supporto ai trasporti           ,4,0,1,14,19,2024
SAR,CA,H 53,Servizi postali e attività di corriere                      ,0,0,0,5,5,2024
SAR,CA,I   ,Attività dei servizi alloggio e ristorazione                ,9,39,67,16,131,2024
SAR,CA,I 55,Alloggio                                                    ,3,0,1,2,6,2024
SAR,CA,I 56,Attività dei servizi di ristorazione                        ,6,39,66,14,125,2024
SAR,CA,J   ,Servizi di informazione e comunicazione                     ,15,3,11,5,34,2024
SAR,CA,J 58,Attività editoriali                                         ,0,1,5,1,7,2024
SAR,CA,J 59,"Attività di produzione cinematografica, di video e di pro...",0,0,0,0,0,2024
SAR,CA,J 60,Attività di programmazione e trasmissione                   ,0,0,0,0,0,2024
SAR,CA,J 61,Telecomunicazioni                                           ,0,0,1,0,1,2024
SAR,CA,J 62,"Produzione di software, consulenza informatica e attività...",8,0,1,1,10,2024
SAR,CA,J 63,Attività dei servizi d'informazione e altri servizi infor...,7,2,4,3,16,2024
SAR,CA,K   ,Attività finanziarie e assicurative                         ,4,1,12,0,17,2024
SAR,CA,K 64,Attività di servizi finanziari (escluse le assicurazioni ...,3,0,0,0,3,2024
SAR,CA,K 65,"Assicurazioni, riassicurazioni e fondi pensione (escluse ...",0,0,0,0,0,2024
SAR,CA,K 66,Attività ausiliarie dei servizi finanziari e delle attivi...,1,1,12,0,14,2024
SAR,CA,L   ,Attivita' immobiliari                                       ,8,1,2,0,11,2024
SAR,CA,L 68,Attivita' immobiliari                                       ,8,1,2,0,11,2024
SAR,CA,M   ,"Attività professionali, scientifiche e tecniche             ",22,3,9,6,40,2024
SAR,CA,M 69,Attività legali e contabilità                               ,0,0,0,0,0,2024
SAR,CA,M 70,Attività di direzione aziendale e di consulenza gestional...,11,0,0,1,12,2024
SAR,CA,M 71,Attività degli studi di architettura e d'ingegneria; coll...,1,0,0,0,1,2024
SAR,CA,M 72,Ricerca scientifica e sviluppo                              ,0,0,0,1,1,2024
SAR,CA,M 73,Pubblicità e ricerche di mercato                            ,8,1,1,3,13,2024
SAR,CA,M 74,"Altre attività professionali, scientifiche e tecniche       ",2,2,8,1,13,2024
SAR,CA,M 75,Servizi veterinari                                          ,0,0,0,0,0,2024
SAR,CA,N   ,"Noleggio, agenzie di viaggio, servizi di supporto alle im...",8,8,19,34,69,2024
SAR,CA,N 77,Attività di noleggio e leasing operativo                    ,2,2,3,1,8,2024
SAR,CA,N 78,"Attività di ricerca, selezione, fornitura di personale      ",0,0,0,0,0,2024
SAR,CA,N 79,"Attività dei servizi delle agenzie di viaggio, dei tour o...",2,3,1,2,8,2024
SAR,CA,N 80,Servizi di vigilanza e investigazione                       ,2,0,0,0,2,2024
SAR,CA,N 81,Attività di servizi per edifici e paesaggio                 ,1,2,8,23,34,2024
SAR,CA,N 82,Attività di supporto per le funzioni d'ufficio e altri se...,1,1,7,8,17,2024
SAR,CA,O   ,Amministrazione pubblica e difesa; assicurazione sociale ...,0,0,0,0,0,2024
SAR,CA,O 84,Amministrazione pubblica e difesa; assicurazione sociale ...,0,0,0,0,0,2024
SAR,CA,P   ,Istruzione                                                  ,0,1,2,6,9,2024
SAR,CA,P 85,Istruzione                                                  ,0,1,2,6,9,2024
SAR,CA,Q   ,Sanita' e assistenza sociale                                ,2,0,0,17,19,2024
SAR,CA,Q 86,Assistenza sanitaria                                        ,2,0,0,3,5,2024
SAR,CA,Q 87,Servizi di assistenza sociale residenziale                  ,0,0,0,2,2,2024
SAR,CA,Q 88,Assistenza sociale non residenziale                         ,0,0,0,12,12,2024
SAR,CA,R   ,"Attività artistiche, sportive, di intrattenimento e diver...",3,0,1,8,12,2024
SAR,CA,R 90,"Attività creative, artistiche e di intrattenimento          ",0,0,0,4,4,2024
SAR,CA,R 91,"Attività di biblioteche, archivi, musei ed altre attività...",1,0,0,1,2,2024
SAR,CA,R 92,"Attività riguardanti le lotterie, le scommesse, le case d...",0,0,0,0,0,2024
SAR,CA,R 93,"Attività sportive, di intrattenimento e di divertimento     ",2,0,1,3,6,2024
SAR,CA,S   ,Altre attività di servizi                                   ,0,8,25,9,42,2024
SAR,CA,S 94,Attività di organizzazioni associative                      ,0,0,0,0,0,2024
SAR,CA,S 95,Riparazione di computer e di beni per uso personale e per...,0,1,5,1,7,2024
SAR,CA,S 96,Altre attività di servizi per la persona                    ,0,7,20,8,35,2024
SAR,CA,T   ,Attività di famiglie e convivenze come datori di lavoro p...,0,0,0,0,0,2024
SAR,CA,T 97,Attività di famiglie e convivenze come datori di lavoro p...,0,0,0,0,0,2024
SAR,CA,T 98,Produzione di beni e servizi indifferenziati per uso prop...,0,0,0,0,0,2024
SAR,CA,U   ,Organizzazioni ed organismi extraterritoriali               ,0,0,0,0,0,2024
SAR,CA,U 99,Organizzazioni ed organismi extraterritoriali               ,0,0,0,0,0,2024
SAR,CA,XX  ,Imprese non classificate                                    ,801,51,122,61,1035,2024
SAR,CA,TOT ,TOTALE                                                      ,1020,206,784,289,2299,2024
SAR,OR,A   ,"Agricoltura, silvicoltura pesca                             ",0,3,53,17,73,2024
SAR,OR,A 01,"Coltivazioni agricole e produzione di prodotti animali, c...",0,3,52,15,70,2024
SAR,OR,A 02,Silvicoltura ed utilizzo di aree forestali                  ,0,0,1,0,1,2024
SAR,OR,A 03,Pesca e acquacoltura                                        ,0,0,0,2,2,2024
SAR,OR,B   ,Estrazione di minerali da cave e miniere                    ,0,0,0,0,0,2024
SAR,OR,B 05,Estrazione di carbone (esclusa torba)                       ,0,0,0,0,0,2024
SAR,OR,B 06,Estraz.di petrolio greggio e di gas naturale                ,0,0,0,0,0,2024
SAR,OR,B 07,Estrazione di minerali metalliferi                          ,0,0,0,0,0,2024
SAR,OR,B 08,Altre attività di estrazione di minerali da cave e miniere  ,0,0,0,0,0,2024
SAR,OR,B 09,Attività dei servizi di supporto all'estrazione             ,0,0,0,0,0,2024
SAR,OR,C   ,Attività manifatturiere                                     ,9,2,33,9,53,2024
SAR,OR,C 10,Industrie alimentari                                        ,2,1,1,7,11,2024
SAR,OR,C 11,Industria delle bevande                                     ,0,0,0,0,0,2024
SAR,OR,C 12,Industria del tabacco                                       ,0,0,0,0,0,2024
SAR,OR,C 13,Industrie tessili                                           ,1,0,1,0,2,2024
SAR,OR,C 14,Confezione di articoli di abbigliamento; confezione di ar...,0,0,1,1,2,2024
SAR,OR,C 15,Fabbricazione di articoli in pelle e simili                 ,0,0,1,0,1,2024
SAR,OR,C 16,Industria del legno e dei prodotti in legno e sughero (es...,2,1,8,0,11,2024
SAR,OR,C 17,Fabbricazione di carta e di prodotti di carta               ,1,0,0,0,1,2024
SAR,OR,C 18,Stampa e riproduzione di supporti registrati                ,0,0,1,0,1,2024
SAR,OR,C 19,Fabbricazione di coke e prodotti derivanti dalla raffinaz...,0,0,0,0,0,2024
SAR,OR,C 20,Fabbricazione di prodotti chimici                           ,0,0,0,0,0,2024
SAR,OR,C 21,Fabbricazione di prodotti farmaceutici di base e di prepa...,0,0,0,0,0,2024
SAR,OR,C 22,Fabbricazione di articoli in gomma e materie plastiche      ,0,0,0,0,0,2024
SAR,OR,C 23,Fabbricazione di altri prodotti della lavorazione di miner..,0,0,3,0,3,2024
SAR,OR,C 24,Metallurgia                                                 ,0,0,0,0,0,2024
SAR,OR,C 25,Fabbricazione di prodotti in metallo (esclusi macchinari ...,1,0,12,0,13,2024
SAR,OR,C 26,Fabbricazione di computer e prodotti di elettronica e ott...,0,0,0,0,0,2024
SAR,OR,C 27,Fabbricazione di apparecchiature elettriche ed apparecchi...,1,0,1,0,2,2024
SAR,OR,C 28,Fabbricazione di macchinari ed apparecchiature nca          ,1,0,2,0,3,2024
SAR,OR,C 29,"Fabbricazione di autoveicoli, rimorchi e semirimorchi       ",0,0,0,0,0,2024
SAR,OR,C 30,Fabbricazione di altri mezzi di trasporto                   ,0,0,1,0,1,2024
SAR,OR,C 31,Fabbricazione di mobili                                     ,0,0,0,1,1,2024
SAR,OR,C 32,Altre industrie manifatturiere                              ,0,0,1,0,1,2024
SAR,OR,C 33,"Riparazione, manutenzione ed installazione di macchine ed...",0,0,0,0,0,2024
SAR,OR,D   ,"Fornitura di energia elettrica, gas, vapore e aria condiz...",0,0,0,0,0,2024
SAR,OR,D 35,"Fornitura di energia elettrica, gas, vapore e aria condiz...",0,0,0,0,0,2024
SAR,OR,E   ,"Fornitura di acqua; reti fognarie, attività di gestione d...",2,0,1,0,3,2024
SAR,OR,E 36,"Raccolta, trattamento e fornitura di acqua                  ",1,0,0,0,1,2024
SAR,OR,E 37,Gestione delle reti fognarie                                ,0,0,0,0,0,2024
SAR,OR,E 38,"Attività di raccolta, trattamento e smaltimento dei rifiu...",1,0,1,0,2,2024
SAR,OR,E 39,Attività di risanamento e altri servizi di gestione dei r...,0,0,0,0,0,2024
SAR,OR,F   ,Costruzioni                                                 ,16,4,47,10,77,2024
SAR,OR,F 41,Costruzione di edifici                                      ,13,2,10,7,32,2024
SAR,OR,F 42,Ingegneria civile                                           ,0,0,0,2,2,2024
SAR,OR,F 43,Lavori di costruzione specializzati                         ,3,2,37,1,43,2024
SAR,OR,G   ,Commercio all'ingrosso e al dettaglio; riparazione di aut...,32,7,82,12,133,2024
SAR,OR,G 45,Commercio all'ingrosso e al dettaglio e riparazione di au...,4,0,4,2,10,2024
SAR,OR,G 46,Commercio all'ingrosso (escluso quello di autoveicoli e d...,20,2,11,3,36,2024
SAR,OR,G 47,Commercio al dettaglio (escluso quello di autoveicoli e d...,8,5,67,7,87,2024
SAR,OR,H   ,Trasporto e magazzinaggio                                   ,2,0,16,5,23,2024
SAR,OR,H 49,Trasporto terrestre e mediante condotte                     ,1,0,14,4,19,2024
SAR,OR,H 50,Trasporto marittimo e per vie d'acqua                       ,0,0,0,0,0,2024
SAR,OR,H 51,Trasporto aereo                                             ,0,0,0,0,0,2024
SAR,OR,H 52,Magazzinaggio e attività di supporto ai trasporti           ,1,0,1,1,3,2024
SAR,OR,H 53,Servizi postali e attività di corriere                      ,0,0,1,0,1,2024
SAR,OR,I   ,Attività dei servizi alloggio e ristorazione                ,2,8,10,10,30,2024
SAR,OR,I 55,Alloggio                                                    ,1,0,0,1,2,2024
SAR,OR,I 56,Attività dei servizi di ristorazione                        ,1,8,10,9,28,2024
SAR,OR,J   ,Servizi di informazione e comunicazione                     ,4,1,2,2,9,2024
SAR,OR,J 58,Attività editoriali                                         ,0,0,0,0,0,2024
SAR,OR,J 59,"Attività di produzione cinematografica, di video e di pro...",0,0,0,0,0,2024
SAR,OR,J 60,Attività di programmazione e trasmissione                   ,1,0,0,0,1,2024
SAR,OR,J 61,Telecomunicazioni                                           ,0,0,1,0,1,2024
SAR,OR,J 62,"Produzione di software, consulenza informatica e attività...",2,0,0,0,2,2024
SAR,OR,J 63,Attività dei servizi d'informazione e altri servizi infor...,1,1,1,2,5,2024
SAR,OR,K   ,Attività finanziarie e assicurative                         ,0,0,1,0,1,2024
SAR,OR,K 64,Attività di servizi finanziari (escluse le assicurazioni ...,0,0,0,0,0,2024
SAR,OR,K 65,"Assicurazioni, riassicurazioni e fondi pensione (escluse ...",0,0,0,0,0,2024
SAR,OR,K 66,Attività ausiliarie dei servizi finanziari e delle attivi...,0,0,1,0,1,2024
SAR,OR,L   ,Attivita' immobiliari                                       ,1,0,0,0,1,2024
SAR,OR,L 68,Attivita' immobiliari                                       ,1,0,0,0,1,2024
SAR,OR,M   ,"Attività professionali, scientifiche e tecniche             ",0,2,3,1,6,2024
SAR,OR,M 69,Attività legali e contabilità                               ,0,0,0,0,0,2024
SAR,OR,M 70,Attività di direzione aziendale e di consulenza gestional...,0,0,0,0,0,2024
SAR,OR,M 71,Attività degli studi di architettura e d'ingegneria; coll...,0,1,1,0,2,2024
SAR,OR,M 72,Ricerca scientifica e sviluppo                              ,0,0,0,0,0,2024
SAR,OR,M 73,Pubblicità e ricerche di mercato                            ,0,0,0,1,1,2024
SAR,OR,M 74,"Altre attività professionali, scientifiche e tecniche       ",0,1,2,0,3,2024
SAR,OR,M 75,Servizi veterinari                                          ,0,0,0,0,0,2024
SAR,OR,N   ,"Noleggio, agenzie di viaggio, servizi di supporto alle im...",1,0,7,16,24,2024
SAR,OR,N 77,Attività di noleggio e leasing operativo                    ,0,0,2,1,3,2024
SAR,OR,N 78,"Attività di ricerca, selezione, fornitura di personale      ",0,0,0,0,0,2024
SAR,OR,N 79,"Attività dei servizi delle agenzie di viaggio, dei tour o...",1,0,1,1,3,2024
SAR,OR,N 80,Servizi di vigilanza e investigazione                       ,0,0,0,2,2,2024
SAR,OR,N 81,Attività di servizi per edifici e paesaggio                 ,0,0,3,10,13,2024
SAR,OR,N 82,Attività di supporto per le funzioni d'ufficio e altri se...,0,0,1,2,3,2024
SAR,OR,O   ,Amministrazione pubblica e difesa; assicurazione sociale ...,0,0,0,0,0,2024
SAR,OR,O 84,Amministrazione pubblica e difesa; assicurazione sociale ...,0,0,0,0,0,2024
SAR,OR,P   ,Istruzione                                                  ,0,0,0,0,0,2024
SAR,OR,P 85,Istruzione                                                  ,0,0,0,0,0,2024
SAR,OR,Q   ,Sanita' e assistenza sociale                                ,0,1,0,4,5,2024
SAR,OR,Q 86,Assistenza sanitaria                                        ,0,1,0,2,3,2024
SAR,OR,Q 87,Servizi di assistenza sociale residenziale                  ,0,0,0,0,0,2024
SAR,OR,Q 88,Assistenza sociale non residenziale                         ,0,0,0,2,2,2024
SAR,OR,R   ,"Attività artistiche, sportive, di intrattenimento e diver...",1,0,1,7,9,2024
SAR,OR,R 90,"Attività creative, artistiche e di intrattenimento          ",0,0,0,2,2,2024
SAR,OR,R 91,"Attività di biblioteche, archivi, musei ed altre attività...",0,0,0,2,2,2024
SAR,OR,R 92,"Attività riguardanti le lotterie, le scommesse, le case d...",0,0,0,0,0,2024
SAR,OR,R 93,"Attività sportive, di intrattenimento e di divertimento     ",1,0,1,3,5,2024
SAR,OR,S   ,Altre attività di servizi                                   ,1,0,6,0,7,2024
SAR,OR,S 94,Attività di organizzazioni associative                      ,0,0,0,0,0,2024
SAR,OR,S 95,Riparazione di computer e di beni per uso personale e per...,1,0,2,0,3,2024
SAR,OR,S 96,Altre attività di servizi per la persona                    ,0,0,4,0,4,2024
SAR,OR,T   ,Attività di famiglie e convivenze come datori di lavoro p...,0,0,0,0,0,2024
SAR,OR,T 97,Attività di famiglie e convivenze come datori di lavoro p...,0,0,0,0,0,2024
SAR,OR,T 98,Produzione di beni e servizi indifferenziati per uso prop...,0,0,0,0,0,2024
SAR,OR,U   ,Organizzazioni ed organismi extraterritoriali               ,0,0,0,0,0,2024
SAR,OR,U 99,Organizzazioni ed organismi extraterritoriali               ,0,0,0,0,0,2024
SAR,OR,XX  ,Imprese non classificate                                    ,31,4,18,34,87,2024
SAR,OR,TOT ,TOTALE                                                      ,102,32,280,127,541,2024
