REG,PROV,CODAT,DESC,CESSUFFSC,CESSUFFSP,CESSUFFDI,CESSUFFAF,CESSUFFTOT,Anno
PIE,  ,A   ,"Agricoltura, silvicoltura pesca                             ",0,23,362,10,395,2023
PIE,  ,A 01,"Coltivazioni agricole e produzione di prodotti animali, c...",0,23,354,10,387,2023
PIE,  ,A 02,Silvicoltura ed utilizzo di aree forestali                  ,0,0,8,0,8,2023
PIE,  ,A 03,Pesca e acquacoltura                                        ,0,0,0,0,0,2023
PIE,  ,B   ,Estrazione di minerali da cave e miniere                    ,0,0,0,0,0,2023
PIE,  ,B 05,Estrazione di carbone (esclusa torba)                       ,0,0,0,0,0,2023
PIE,  ,B 06,Estraz.di petrolio greggio e di gas naturale                ,0,0,0,0,0,2023
PIE,  ,B 07,Estrazione di minerali metalliferi                          ,0,0,0,0,0,2023
PIE,  ,B 08,Altre attività di estrazione di minerali da cave e miniere  ,0,0,0,0,0,2023
PIE,  ,B 09,Attività dei servizi di supporto all'estrazione             ,0,0,0,0,0,2023
PIE,  ,C   ,Attività manifatturiere                                     ,71,192,126,11,400,2023
PIE,  ,C 10,Industrie alimentari                                        ,4,22,4,1,31,2023
PIE,  ,C 11,Industria delle bevande                                     ,0,1,0,0,1,2023
PIE,  ,C 12,Industria del tabacco                                       ,0,0,0,0,0,2023
PIE,  ,C 13,Industrie tessili                                           ,2,25,1,0,28,2023
PIE,  ,C 14,Confezione di articoli di abbigliamento; confezione di ar...,2,8,17,1,28,2023
PIE,  ,C 15,Fabbricazione di articoli in pelle e simili                 ,0,0,2,0,2,2023
PIE,  ,C 16,Industria del legno e dei prodotti in legno e sughero (es...,1,5,13,1,20,2023
PIE,  ,C 17,Fabbricazione di carta e di prodotti di carta               ,1,0,0,0,1,2023
PIE,  ,C 18,Stampa e riproduzione di supporti registrati                ,2,8,3,0,13,2023
PIE,  ,C 19,Fabbricazione di coke e prodotti derivanti dalla raffinaz...,0,0,0,0,0,2023
PIE,  ,C 20,Fabbricazione di prodotti chimici                           ,1,1,0,0,2,2023
PIE,  ,C 21,Fabbricazione di prodotti farmaceutici di base e di prepa...,0,0,0,0,0,2023
PIE,  ,C 22,Fabbricazione di articoli in gomma e materie plastiche      ,5,6,1,2,14,2023
PIE,  ,C 23,Fabbricazione di altri prodotti della lavorazione di miner..,5,1,4,0,10,2023
PIE,  ,C 24,Metallurgia                                                 ,0,3,0,0,3,2023
PIE,  ,C 25,Fabbricazione di prodotti in metallo (esclusi macchinari ...,16,53,46,1,116,2023
PIE,  ,C 26,Fabbricazione di computer e prodotti di elettronica e ott...,5,2,0,0,7,2023
PIE,  ,C 27,Fabbricazione di apparecchiature elettriche ed apparecchi...,5,4,2,0,11,2023
PIE,  ,C 28,Fabbricazione di macchinari ed apparecchiature nca          ,12,16,4,3,35,2023
PIE,  ,C 29,"Fabbricazione di autoveicoli, rimorchi e semirimorchi       ",3,4,1,0,8,2023
PIE,  ,C 30,Fabbricazione di altri mezzi di trasporto                   ,3,1,0,0,4,2023
PIE,  ,C 31,Fabbricazione di mobili                                     ,0,8,5,0,13,2023
PIE,  ,C 32,Altre industrie manifatturiere                              ,2,18,12,1,33,2023
PIE,  ,C 33,"Riparazione, manutenzione ed installazione di macchine ed...",2,6,11,1,20,2023
PIE,  ,D   ,"Fornitura di energia elettrica, gas, vapore e aria condiz...",1,0,3,1,5,2023
PIE,  ,D 35,"Fornitura di energia elettrica, gas, vapore e aria condiz...",1,0,3,1,5,2023
PIE,  ,E   ,"Fornitura di acqua; reti fognarie, attività di gestione d...",0,1,1,1,3,2023
PIE,  ,E 36,"Raccolta, trattamento e fornitura di acqua                  ",0,0,0,1,1,2023
PIE,  ,E 37,Gestione delle reti fognarie                                ,0,1,0,0,1,2023
PIE,  ,E 38,"Attività di raccolta, trattamento e smaltimento dei rifiu...",0,0,1,0,1,2023
PIE,  ,E 39,Attività di risanamento e altri servizi di gestione dei r...,0,0,0,0,0,2023
PIE,  ,F   ,Costruzioni                                                 ,83,112,325,37,557,2023
PIE,  ,F 41,Costruzione di edifici                                      ,50,52,68,26,196,2023
PIE,  ,F 42,Ingegneria civile                                           ,2,2,1,1,6,2023
PIE,  ,F 43,Lavori di costruzione specializzati                         ,31,58,256,10,355,2023
PIE,  ,G   ,Commercio all'ingrosso e al dettaglio; riparazione di aut...,105,324,402,38,869,2023
PIE,  ,G 45,Commercio all'ingrosso e al dettaglio e riparazione di au...,21,28,44,0,93,2023
PIE,  ,G 46,Commercio all'ingrosso (escluso quello di autoveicoli e d...,48,112,132,23,315,2023
PIE,  ,G 47,Commercio al dettaglio (escluso quello di autoveicoli e d...,36,184,226,15,461,2023
PIE,  ,H   ,Trasporto e magazzinaggio                                   ,8,30,55,12,105,2023
PIE,  ,H 49,Trasporto terrestre e mediante condotte                     ,5,26,42,4,77,2023
PIE,  ,H 50,Trasporto marittimo e per vie d'acqua                       ,0,0,0,0,0,2023
PIE,  ,H 51,Trasporto aereo                                             ,0,0,0,0,0,2023
PIE,  ,H 52,Magazzinaggio e attività di supporto ai trasporti           ,3,4,2,8,17,2023
PIE,  ,H 53,Servizi postali e attività di corriere                      ,0,0,11,0,11,2023
PIE,  ,I   ,Attività dei servizi alloggio e ristorazione                ,33,241,68,7,349,2023
PIE,  ,I 55,Alloggio                                                    ,5,4,7,0,16,2023
PIE,  ,I 56,Attività dei servizi di ristorazione                        ,28,237,61,7,333,2023
PIE,  ,J   ,Servizi di informazione e comunicazione                     ,18,20,28,5,71,2023
PIE,  ,J 58,Attività editoriali                                         ,2,2,4,0,8,2023
PIE,  ,J 59,"Attività di produzione cinematografica, di video e di pro...",0,3,0,1,4,2023
PIE,  ,J 60,Attività di programmazione e trasmissione                   ,0,0,1,1,2,2023
PIE,  ,J 61,Telecomunicazioni                                           ,1,1,11,0,13,2023
PIE,  ,J 62,"Produzione di software, consulenza informatica e attività...",8,5,9,0,22,2023
PIE,  ,J 63,Attività dei servizi d'informazione e altri servizi infor...,7,9,3,3,22,2023
PIE,  ,K   ,Attività finanziarie e assicurative                         ,11,9,36,3,59,2023
PIE,  ,K 64,Attività di servizi finanziari (escluse le assicurazioni ...,4,2,0,2,8,2023
PIE,  ,K 65,"Assicurazioni, riassicurazioni e fondi pensione (escluse ...",0,1,0,1,2,2023
PIE,  ,K 66,Attività ausiliarie dei servizi finanziari e delle attivi...,7,6,36,0,49,2023
PIE,  ,L   ,Attivita' immobiliari                                       ,38,59,12,97,206,2023
PIE,  ,L 68,Attivita' immobiliari                                       ,38,59,12,97,206,2023
PIE,  ,M   ,"Attività professionali, scientifiche e tecniche             ",46,31,37,4,118,2023
PIE,  ,M 69,Attività legali e contabilità                               ,4,4,1,1,10,2023
PIE,  ,M 70,Attività di direzione aziendale e di consulenza gestional...,16,3,9,1,29,2023
PIE,  ,M 71,Attività degli studi di architettura e d'ingegneria; coll...,9,7,10,0,26,2023
PIE,  ,M 72,Ricerca scientifica e sviluppo                              ,2,0,0,0,2,2023
PIE,  ,M 73,Pubblicità e ricerche di mercato                            ,8,5,8,0,21,2023
PIE,  ,M 74,"Altre attività professionali, scientifiche e tecniche       ",7,12,9,2,30,2023
PIE,  ,M 75,Servizi veterinari                                          ,0,0,0,0,0,2023
PIE,  ,N   ,"Noleggio, agenzie di viaggio, servizi di supporto alle im...",27,21,34,15,97,2023
PIE,  ,N 77,Attività di noleggio e leasing operativo                    ,3,5,2,0,10,2023
PIE,  ,N 78,"Attività di ricerca, selezione, fornitura di personale      ",0,0,0,0,0,2023
PIE,  ,N 79,"Attività dei servizi delle agenzie di viaggio, dei tour o...",4,2,0,0,6,2023
PIE,  ,N 80,Servizi di vigilanza e investigazione                       ,1,0,1,0,2,2023
PIE,  ,N 81,Attività di servizi per edifici e paesaggio                 ,8,6,17,11,42,2023
PIE,  ,N 82,Attività di supporto per le funzioni d'ufficio e altri se...,11,8,14,4,37,2023
PIE,  ,O   ,Amministrazione pubblica e difesa; assicurazione sociale ...,0,0,0,0,0,2023
PIE,  ,O 84,Amministrazione pubblica e difesa; assicurazione sociale ...,0,0,0,0,0,2023
PIE,  ,P   ,Istruzione                                                  ,3,4,3,4,14,2023
PIE,  ,P 85,Istruzione                                                  ,3,4,3,4,14,2023
PIE,  ,Q   ,Sanita' e assistenza sociale                                ,3,1,6,14,24,2023
PIE,  ,Q 86,Assistenza sanitaria                                        ,2,0,1,3,6,2023
PIE,  ,Q 87,Servizi di assistenza sociale residenziale                  ,1,0,0,2,3,2023
PIE,  ,Q 88,Assistenza sociale non residenziale                         ,0,1,5,9,15,2023
PIE,  ,R   ,"Attività artistiche, sportive, di intrattenimento e diver...",15,18,10,3,46,2023
PIE,  ,R 90,"Attività creative, artistiche e di intrattenimento          ",1,2,1,1,5,2023
PIE,  ,R 91,"Attività di biblioteche, archivi, musei ed altre attività...",0,0,0,0,0,2023
PIE,  ,R 92,"Attività riguardanti le lotterie, le scommesse, le case d...",1,0,1,0,2,2023
PIE,  ,R 93,"Attività sportive, di intrattenimento e di divertimento     ",13,16,8,2,39,2023
PIE,  ,S   ,Altre attività di servizi                                   ,5,19,44,2,70,2023
PIE,  ,S 94,Attività di organizzazioni associative                      ,0,0,0,1,1,2023
PIE,  ,S 95,Riparazione di computer e di beni per uso personale e per...,0,4,17,0,21,2023
PIE,  ,S 96,Altre attività di servizi per la persona                    ,5,15,27,1,48,2023
PIE,  ,T   ,Attività di famiglie e convivenze come datori di lavoro p...,0,0,0,0,0,2023
PIE,  ,T 97,Attività di famiglie e convivenze come datori di lavoro p...,0,0,0,0,0,2023
PIE,  ,T 98,Produzione di beni e servizi indifferenziati per uso prop...,0,0,0,0,0,2023
PIE,  ,U   ,Organizzazioni ed organismi extraterritoriali               ,0,0,0,0,0,2023
PIE,  ,U 99,Organizzazioni ed organismi extraterritoriali               ,0,0,0,0,0,2023
PIE,  ,XX  ,Imprese non classificate                                    ,93,116,15,26,250,2023
PIE,  ,TOT ,TOTALE                                                      ,560,1221,1567,290,3638,2023
PIE,TO,A   ,"Agricoltura, silvicoltura pesca                             ",0,0,56,2,58,2023
PIE,TO,A 01,"Coltivazioni agricole e produzione di prodotti animali, c...",0,0,55,2,57,2023
PIE,TO,A 02,Silvicoltura ed utilizzo di aree forestali                  ,0,0,1,0,1,2023
PIE,TO,A 03,Pesca e acquacoltura                                        ,0,0,0,0,0,2023
PIE,TO,B   ,Estrazione di minerali da cave e miniere                    ,0,0,0,0,0,2023
PIE,TO,B 05,Estrazione di carbone (esclusa torba)                       ,0,0,0,0,0,2023
PIE,TO,B 06,Estraz.di petrolio greggio e di gas naturale                ,0,0,0,0,0,2023
PIE,TO,B 07,Estrazione di minerali metalliferi                          ,0,0,0,0,0,2023
PIE,TO,B 08,Altre attività di estrazione di minerali da cave e miniere  ,0,0,0,0,0,2023
PIE,TO,B 09,Attività dei servizi di supporto all'estrazione             ,0,0,0,0,0,2023
PIE,TO,C   ,Attività manifatturiere                                     ,70,85,20,4,179,2023
PIE,TO,C 10,Industrie alimentari                                        ,4,8,0,0,12,2023
PIE,TO,C 11,Industria delle bevande                                     ,0,0,0,0,0,2023
PIE,TO,C 12,Industria del tabacco                                       ,0,0,0,0,0,2023
PIE,TO,C 13,Industrie tessili                                           ,2,0,0,0,2,2023
PIE,TO,C 14,Confezione di articoli di abbigliamento; confezione di ar...,2,3,1,1,7,2023
PIE,TO,C 15,Fabbricazione di articoli in pelle e simili                 ,0,0,1,0,1,2023
PIE,TO,C 16,Industria del legno e dei prodotti in legno e sughero (es...,1,2,1,0,4,2023
PIE,TO,C 17,Fabbricazione di carta e di prodotti di carta               ,1,0,0,0,1,2023
PIE,TO,C 18,Stampa e riproduzione di supporti registrati                ,2,5,2,0,9,2023
PIE,TO,C 19,Fabbricazione di coke e prodotti derivanti dalla raffinaz...,0,0,0,0,0,2023
PIE,TO,C 20,Fabbricazione di prodotti chimici                           ,1,1,0,0,2,2023
PIE,TO,C 21,Fabbricazione di prodotti farmaceutici di base e di prepa...,0,0,0,0,0,2023
PIE,TO,C 22,Fabbricazione di articoli in gomma e materie plastiche      ,5,3,0,1,9,2023
PIE,TO,C 23,Fabbricazione di altri prodotti della lavorazione di miner..,5,0,1,0,6,2023
PIE,TO,C 24,Metallurgia                                                 ,0,3,0,0,3,2023
PIE,TO,C 25,Fabbricazione di prodotti in metallo (esclusi macchinari ...,16,39,11,1,67,2023
PIE,TO,C 26,Fabbricazione di computer e prodotti di elettronica e ott...,5,1,0,0,6,2023
PIE,TO,C 27,Fabbricazione di apparecchiature elettriche ed apparecchi...,5,2,0,0,7,2023
PIE,TO,C 28,Fabbricazione di macchinari ed apparecchiature nca          ,11,4,1,1,17,2023
PIE,TO,C 29,"Fabbricazione di autoveicoli, rimorchi e semirimorchi       ",3,4,0,0,7,2023
PIE,TO,C 30,Fabbricazione di altri mezzi di trasporto                   ,3,1,0,0,4,2023
PIE,TO,C 31,Fabbricazione di mobili                                     ,0,6,0,0,6,2023
PIE,TO,C 32,Altre industrie manifatturiere                              ,2,0,0,0,2,2023
PIE,TO,C 33,"Riparazione, manutenzione ed installazione di macchine ed...",2,3,2,0,7,2023
PIE,TO,D   ,"Fornitura di energia elettrica, gas, vapore e aria condiz...",0,0,1,0,1,2023
PIE,TO,D 35,"Fornitura di energia elettrica, gas, vapore e aria condiz...",0,0,1,0,1,2023
PIE,TO,E   ,"Fornitura di acqua; reti fognarie, attività di gestione d...",0,1,1,0,2,2023
PIE,TO,E 36,"Raccolta, trattamento e fornitura di acqua                  ",0,0,0,0,0,2023
PIE,TO,E 37,Gestione delle reti fognarie                                ,0,1,0,0,1,2023
PIE,TO,E 38,"Attività di raccolta, trattamento e smaltimento dei rifiu...",0,0,1,0,1,2023
PIE,TO,E 39,Attività di risanamento e altri servizi di gestione dei r...,0,0,0,0,0,2023
PIE,TO,F   ,Costruzioni                                                 ,82,24,55,15,176,2023
PIE,TO,F 41,Costruzione di edifici                                      ,49,14,13,13,89,2023
PIE,TO,F 42,Ingegneria civile                                           ,2,0,0,1,3,2023
PIE,TO,F 43,Lavori di costruzione specializzati                         ,31,10,42,1,84,2023
PIE,TO,G   ,Commercio all'ingrosso e al dettaglio; riparazione di aut...,103,112,192,26,433,2023
PIE,TO,G 45,Commercio all'ingrosso e al dettaglio e riparazione di au...,20,4,21,0,45,2023
PIE,TO,G 46,Commercio all'ingrosso (escluso quello di autoveicoli e d...,47,57,48,20,172,2023
PIE,TO,G 47,Commercio al dettaglio (escluso quello di autoveicoli e d...,36,51,123,6,216,2023
PIE,TO,H   ,Trasporto e magazzinaggio                                   ,8,10,22,11,51,2023
PIE,TO,H 49,Trasporto terrestre e mediante condotte                     ,5,9,10,3,27,2023
PIE,TO,H 50,Trasporto marittimo e per vie d'acqua                       ,0,0,0,0,0,2023
PIE,TO,H 51,Trasporto aereo                                             ,0,0,0,0,0,2023
PIE,TO,H 52,Magazzinaggio e attività di supporto ai trasporti           ,3,1,1,8,13,2023
PIE,TO,H 53,Servizi postali e attività di corriere                      ,0,0,11,0,11,2023
PIE,TO,I   ,Attività dei servizi alloggio e ristorazione                ,33,48,22,2,105,2023
PIE,TO,I 55,Alloggio                                                    ,5,2,2,0,9,2023
PIE,TO,I 56,Attività dei servizi di ristorazione                        ,28,46,20,2,96,2023
PIE,TO,J   ,Servizi di informazione e comunicazione                     ,18,3,20,3,44,2023
PIE,TO,J 58,Attività editoriali                                         ,2,0,2,0,4,2023
PIE,TO,J 59,"Attività di produzione cinematografica, di video e di pro...",0,1,0,1,2,2023
PIE,TO,J 60,Attività di programmazione e trasmissione                   ,0,0,0,0,0,2023
PIE,TO,J 61,Telecomunicazioni                                           ,1,0,11,0,12,2023
PIE,TO,J 62,"Produzione di software, consulenza informatica e attività...",8,1,6,0,15,2023
PIE,TO,J 63,Attività dei servizi d'informazione e altri servizi infor...,7,1,1,2,11,2023
PIE,TO,K   ,Attività finanziarie e assicurative                         ,11,0,6,2,19,2023
PIE,TO,K 64,Attività di servizi finanziari (escluse le assicurazioni ...,4,0,0,2,6,2023
PIE,TO,K 65,"Assicurazioni, riassicurazioni e fondi pensione (escluse ...",0,0,0,0,0,2023
PIE,TO,K 66,Attività ausiliarie dei servizi finanziari e delle attivi...,7,0,6,0,13,2023
PIE,TO,L   ,Attivita' immobiliari                                       ,38,12,6,94,150,2023
PIE,TO,L 68,Attivita' immobiliari                                       ,38,12,6,94,150,2023
PIE,TO,M   ,"Attività professionali, scientifiche e tecniche             ",46,14,20,1,81,2023
PIE,TO,M 69,Attività legali e contabilità                               ,4,2,1,0,7,2023
PIE,TO,M 70,Attività di direzione aziendale e di consulenza gestional...,16,2,5,1,24,2023
PIE,TO,M 71,Attività degli studi di architettura e d'ingegneria; coll...,9,3,5,0,17,2023
PIE,TO,M 72,Ricerca scientifica e sviluppo                              ,2,0,0,0,2,2023
PIE,TO,M 73,Pubblicità e ricerche di mercato                            ,8,2,4,0,14,2023
PIE,TO,M 74,"Altre attività professionali, scientifiche e tecniche       ",7,5,5,0,17,2023
PIE,TO,M 75,Servizi veterinari                                          ,0,0,0,0,0,2023
PIE,TO,N   ,"Noleggio, agenzie di viaggio, servizi di supporto alle im...",27,6,16,7,56,2023
PIE,TO,N 77,Attività di noleggio e leasing operativo                    ,3,0,0,0,3,2023
PIE,TO,N 78,"Attività di ricerca, selezione, fornitura di personale      ",0,0,0,0,0,2023
PIE,TO,N 79,"Attività dei servizi delle agenzie di viaggio, dei tour o...",4,1,0,0,5,2023
PIE,TO,N 80,Servizi di vigilanza e investigazione                       ,1,0,0,0,1,2023
PIE,TO,N 81,Attività di servizi per edifici e paesaggio                 ,8,0,6,4,18,2023
PIE,TO,N 82,Attività di supporto per le funzioni d'ufficio e altri se...,11,5,10,3,29,2023
PIE,TO,O   ,Amministrazione pubblica e difesa; assicurazione sociale ...,0,0,0,0,0,2023
PIE,TO,O 84,Amministrazione pubblica e difesa; assicurazione sociale ...,0,0,0,0,0,2023
PIE,TO,P   ,Istruzione                                                  ,3,2,1,1,7,2023
PIE,TO,P 85,Istruzione                                                  ,3,2,1,1,7,2023
PIE,TO,Q   ,Sanita' e assistenza sociale                                ,3,0,3,3,9,2023
PIE,TO,Q 86,Assistenza sanitaria                                        ,2,0,0,1,3,2023
PIE,TO,Q 87,Servizi di assistenza sociale residenziale                  ,1,0,0,0,1,2023
PIE,TO,Q 88,Assistenza sociale non residenziale                         ,0,0,3,2,5,2023
PIE,TO,R   ,"Attività artistiche, sportive, di intrattenimento e diver...",14,5,5,2,26,2023
PIE,TO,R 90,"Attività creative, artistiche e di intrattenimento          ",1,1,1,1,4,2023
PIE,TO,R 91,"Attività di biblioteche, archivi, musei ed altre attività...",0,0,0,0,0,2023
PIE,TO,R 92,"Attività riguardanti le lotterie, le scommesse, le case d...",1,0,0,0,1,2023
PIE,TO,R 93,"Attività sportive, di intrattenimento e di divertimento     ",12,4,4,1,21,2023
PIE,TO,S   ,Altre attività di servizi                                   ,5,3,8,1,17,2023
PIE,TO,S 94,Attività di organizzazioni associative                      ,0,0,0,1,1,2023
PIE,TO,S 95,Riparazione di computer e di beni per uso personale e per...,0,1,2,0,3,2023
PIE,TO,S 96,Altre attività di servizi per la persona                    ,5,2,6,0,13,2023
PIE,TO,T   ,Attività di famiglie e convivenze come datori di lavoro p...,0,0,0,0,0,2023
PIE,TO,T 97,Attività di famiglie e convivenze come datori di lavoro p...,0,0,0,0,0,2023
PIE,TO,T 98,Produzione di beni e servizi indifferenziati per uso prop...,0,0,0,0,0,2023
PIE,TO,U   ,Organizzazioni ed organismi extraterritoriali               ,0,0,0,0,0,2023
PIE,TO,U 99,Organizzazioni ed organismi extraterritoriali               ,0,0,0,0,0,2023
PIE,TO,XX  ,Imprese non classificate                                    ,92,13,1,3,109,2023
PIE,TO,TOT ,TOTALE                                                      ,553,338,455,177,1523,2023
PIE,VC,A   ,"Agricoltura, silvicoltura pesca                             ",0,2,0,1,3,2023
PIE,VC,A 01,"Coltivazioni agricole e produzione di prodotti animali, c...",0,2,0,1,3,2023
PIE,VC,A 02,Silvicoltura ed utilizzo di aree forestali                  ,0,0,0,0,0,2023
PIE,VC,A 03,Pesca e acquacoltura                                        ,0,0,0,0,0,2023
PIE,VC,B   ,Estrazione di minerali da cave e miniere                    ,0,0,0,0,0,2023
PIE,VC,B 05,Estrazione di carbone (esclusa torba)                       ,0,0,0,0,0,2023
PIE,VC,B 06,Estraz.di petrolio greggio e di gas naturale                ,0,0,0,0,0,2023
PIE,VC,B 07,Estrazione di minerali metalliferi                          ,0,0,0,0,0,2023
PIE,VC,B 08,Altre attività di estrazione di minerali da cave e miniere  ,0,0,0,0,0,2023
PIE,VC,B 09,Attività dei servizi di supporto all'estrazione             ,0,0,0,0,0,2023
PIE,VC,C   ,Attività manifatturiere                                     ,0,15,0,1,16,2023
PIE,VC,C 10,Industrie alimentari                                        ,0,0,0,0,0,2023
PIE,VC,C 11,Industria delle bevande                                     ,0,0,0,0,0,2023
PIE,VC,C 12,Industria del tabacco                                       ,0,0,0,0,0,2023
PIE,VC,C 13,Industrie tessili                                           ,0,2,0,0,2,2023
PIE,VC,C 14,Confezione di articoli di abbigliamento; confezione di ar...,0,0,0,0,0,2023
PIE,VC,C 15,Fabbricazione di articoli in pelle e simili                 ,0,0,0,0,0,2023
PIE,VC,C 16,Industria del legno e dei prodotti in legno e sughero (es...,0,1,0,0,1,2023
PIE,VC,C 17,Fabbricazione di carta e di prodotti di carta               ,0,0,0,0,0,2023
PIE,VC,C 18,Stampa e riproduzione di supporti registrati                ,0,1,0,0,1,2023
PIE,VC,C 19,Fabbricazione di coke e prodotti derivanti dalla raffinaz...,0,0,0,0,0,2023
PIE,VC,C 20,Fabbricazione di prodotti chimici                           ,0,0,0,0,0,2023
PIE,VC,C 21,Fabbricazione di prodotti farmaceutici di base e di prepa...,0,0,0,0,0,2023
PIE,VC,C 22,Fabbricazione di articoli in gomma e materie plastiche      ,0,1,0,0,1,2023
PIE,VC,C 23,Fabbricazione di altri prodotti della lavorazione di miner..,0,0,0,0,0,2023
PIE,VC,C 24,Metallurgia                                                 ,0,0,0,0,0,2023
PIE,VC,C 25,Fabbricazione di prodotti in metallo (esclusi macchinari ...,0,3,0,0,3,2023
PIE,VC,C 26,Fabbricazione di computer e prodotti di elettronica e ott...,0,0,0,0,0,2023
PIE,VC,C 27,Fabbricazione di apparecchiature elettriche ed apparecchi...,0,0,0,0,0,2023
PIE,VC,C 28,Fabbricazione di macchinari ed apparecchiature nca          ,0,4,0,0,4,2023
PIE,VC,C 29,"Fabbricazione di autoveicoli, rimorchi e semirimorchi       ",0,0,0,0,0,2023
PIE,VC,C 30,Fabbricazione di altri mezzi di trasporto                   ,0,0,0,0,0,2023
PIE,VC,C 31,Fabbricazione di mobili                                     ,0,0,0,0,0,2023
PIE,VC,C 32,Altre industrie manifatturiere                              ,0,3,0,1,4,2023
PIE,VC,C 33,"Riparazione, manutenzione ed installazione di macchine ed...",0,0,0,0,0,2023
PIE,VC,D   ,"Fornitura di energia elettrica, gas, vapore e aria condiz...",0,0,0,0,0,2023
PIE,VC,D 35,"Fornitura di energia elettrica, gas, vapore e aria condiz...",0,0,0,0,0,2023
PIE,VC,E   ,"Fornitura di acqua; reti fognarie, attività di gestione d...",0,0,0,0,0,2023
PIE,VC,E 36,"Raccolta, trattamento e fornitura di acqua                  ",0,0,0,0,0,2023
PIE,VC,E 37,Gestione delle reti fognarie                                ,0,0,0,0,0,2023
PIE,VC,E 38,"Attività di raccolta, trattamento e smaltimento dei rifiu...",0,0,0,0,0,2023
PIE,VC,E 39,Attività di risanamento e altri servizi di gestione dei r...,0,0,0,0,0,2023
PIE,VC,F   ,Costruzioni                                                 ,0,13,0,7,20,2023
PIE,VC,F 41,Costruzione di edifici                                      ,0,5,0,5,10,2023
PIE,VC,F 42,Ingegneria civile                                           ,0,0,0,0,0,2023
PIE,VC,F 43,Lavori di costruzione specializzati                         ,0,8,0,2,10,2023
PIE,VC,G   ,Commercio all'ingrosso e al dettaglio; riparazione di aut...,0,32,0,1,33,2023
PIE,VC,G 45,Commercio all'ingrosso e al dettaglio e riparazione di au...,0,3,0,0,3,2023
PIE,VC,G 46,Commercio all'ingrosso (escluso quello di autoveicoli e d...,0,5,0,0,5,2023
PIE,VC,G 47,Commercio al dettaglio (escluso quello di autoveicoli e d...,0,24,0,1,25,2023
PIE,VC,H   ,Trasporto e magazzinaggio                                   ,0,3,0,0,3,2023
PIE,VC,H 49,Trasporto terrestre e mediante condotte                     ,0,2,0,0,2,2023
PIE,VC,H 50,Trasporto marittimo e per vie d'acqua                       ,0,0,0,0,0,2023
PIE,VC,H 51,Trasporto aereo                                             ,0,0,0,0,0,2023
PIE,VC,H 52,Magazzinaggio e attività di supporto ai trasporti           ,0,1,0,0,1,2023
PIE,VC,H 53,Servizi postali e attività di corriere                      ,0,0,0,0,0,2023
PIE,VC,I   ,Attività dei servizi alloggio e ristorazione                ,0,20,0,0,20,2023
PIE,VC,I 55,Alloggio                                                    ,0,1,0,0,1,2023
PIE,VC,I 56,Attività dei servizi di ristorazione                        ,0,19,0,0,19,2023
PIE,VC,J   ,Servizi di informazione e comunicazione                     ,0,2,0,0,2,2023
PIE,VC,J 58,Attività editoriali                                         ,0,1,0,0,1,2023
PIE,VC,J 59,"Attività di produzione cinematografica, di video e di pro...",0,0,0,0,0,2023
PIE,VC,J 60,Attività di programmazione e trasmissione                   ,0,0,0,0,0,2023
PIE,VC,J 61,Telecomunicazioni                                           ,0,0,0,0,0,2023
PIE,VC,J 62,"Produzione di software, consulenza informatica e attività...",0,0,0,0,0,2023
PIE,VC,J 63,Attività dei servizi d'informazione e altri servizi infor...,0,1,0,0,1,2023
PIE,VC,K   ,Attività finanziarie e assicurative                         ,0,2,0,0,2,2023
PIE,VC,K 64,Attività di servizi finanziari (escluse le assicurazioni ...,0,1,0,0,1,2023
PIE,VC,K 65,"Assicurazioni, riassicurazioni e fondi pensione (escluse ...",0,0,0,0,0,2023
PIE,VC,K 66,Attività ausiliarie dei servizi finanziari e delle attivi...,0,1,0,0,1,2023
PIE,VC,L   ,Attivita' immobiliari                                       ,0,2,0,0,2,2023
PIE,VC,L 68,Attivita' immobiliari                                       ,0,2,0,0,2,2023
PIE,VC,M   ,"Attività professionali, scientifiche e tecniche             ",0,1,0,0,1,2023
PIE,VC,M 69,Attività legali e contabilità                               ,0,0,0,0,0,2023
PIE,VC,M 70,Attività di direzione aziendale e di consulenza gestional...,0,0,0,0,0,2023
PIE,VC,M 71,Attività degli studi di architettura e d'ingegneria; coll...,0,0,0,0,0,2023
PIE,VC,M 72,Ricerca scientifica e sviluppo                              ,0,0,0,0,0,2023
PIE,VC,M 73,Pubblicità e ricerche di mercato                            ,0,1,0,0,1,2023
PIE,VC,M 74,"Altre attività professionali, scientifiche e tecniche       ",0,0,0,0,0,2023
PIE,VC,M 75,Servizi veterinari                                          ,0,0,0,0,0,2023
PIE,VC,N   ,"Noleggio, agenzie di viaggio, servizi di supporto alle im...",0,2,0,1,3,2023
PIE,VC,N 77,Attività di noleggio e leasing operativo                    ,0,1,0,0,1,2023
PIE,VC,N 78,"Attività di ricerca, selezione, fornitura di personale      ",0,0,0,0,0,2023
PIE,VC,N 79,"Attività dei servizi delle agenzie di viaggio, dei tour o...",0,0,0,0,0,2023
PIE,VC,N 80,Servizi di vigilanza e investigazione                       ,0,0,0,0,0,2023
PIE,VC,N 81,Attività di servizi per edifici e paesaggio                 ,0,1,0,1,2,2023
PIE,VC,N 82,Attività di supporto per le funzioni d'ufficio e altri se...,0,0,0,0,0,2023
PIE,VC,O   ,Amministrazione pubblica e difesa; assicurazione sociale ...,0,0,0,0,0,2023
PIE,VC,O 84,Amministrazione pubblica e difesa; assicurazione sociale ...,0,0,0,0,0,2023
PIE,VC,P   ,Istruzione                                                  ,0,0,0,0,0,2023
PIE,VC,P 85,Istruzione                                                  ,0,0,0,0,0,2023
PIE,VC,Q   ,Sanita' e assistenza sociale                                ,0,0,0,0,0,2023
PIE,VC,Q 86,Assistenza sanitaria                                        ,0,0,0,0,0,2023
PIE,VC,Q 87,Servizi di assistenza sociale residenziale                  ,0,0,0,0,0,2023
PIE,VC,Q 88,Assistenza sociale non residenziale                         ,0,0,0,0,0,2023
PIE,VC,R   ,"Attività artistiche, sportive, di intrattenimento e diver...",0,1,0,1,2,2023
PIE,VC,R 90,"Attività creative, artistiche e di intrattenimento          ",0,0,0,0,0,2023
PIE,VC,R 91,"Attività di biblioteche, archivi, musei ed altre attività...",0,0,0,0,0,2023
PIE,VC,R 92,"Attività riguardanti le lotterie, le scommesse, le case d...",0,0,0,0,0,2023
PIE,VC,R 93,"Attività sportive, di intrattenimento e di divertimento     ",0,1,0,1,2,2023
PIE,VC,S   ,Altre attività di servizi                                   ,0,2,0,1,3,2023
PIE,VC,S 94,Attività di organizzazioni associative                      ,0,0,0,0,0,2023
PIE,VC,S 95,Riparazione di computer e di beni per uso personale e per...,0,0,0,0,0,2023
PIE,VC,S 96,Altre attività di servizi per la persona                    ,0,2,0,1,3,2023
PIE,VC,T   ,Attività di famiglie e convivenze come datori di lavoro p...,0,0,0,0,0,2023
PIE,VC,T 97,Attività di famiglie e convivenze come datori di lavoro p...,0,0,0,0,0,2023
PIE,VC,T 98,Produzione di beni e servizi indifferenziati per uso prop...,0,0,0,0,0,2023
PIE,VC,U   ,Organizzazioni ed organismi extraterritoriali               ,0,0,0,0,0,2023
PIE,VC,U 99,Organizzazioni ed organismi extraterritoriali               ,0,0,0,0,0,2023
PIE,VC,XX  ,Imprese non classificate                                    ,0,23,0,6,29,2023
PIE,VC,TOT ,TOTALE                                                      ,0,120,0,19,139,2023
PIE,NO,A   ,"Agricoltura, silvicoltura pesca                             ",0,0,0,0,0,2023
PIE,NO,A 01,"Coltivazioni agricole e produzione di prodotti animali, c...",0,0,0,0,0,2023
PIE,NO,A 02,Silvicoltura ed utilizzo di aree forestali                  ,0,0,0,0,0,2023
PIE,NO,A 03,Pesca e acquacoltura                                        ,0,0,0,0,0,2023
PIE,NO,B   ,Estrazione di minerali da cave e miniere                    ,0,0,0,0,0,2023
PIE,NO,B 05,Estrazione di carbone (esclusa torba)                       ,0,0,0,0,0,2023
PIE,NO,B 06,Estraz.di petrolio greggio e di gas naturale                ,0,0,0,0,0,2023
PIE,NO,B 07,Estrazione di minerali metalliferi                          ,0,0,0,0,0,2023
PIE,NO,B 08,Altre attività di estrazione di minerali da cave e miniere  ,0,0,0,0,0,2023
PIE,NO,B 09,Attività dei servizi di supporto all'estrazione             ,0,0,0,0,0,2023
PIE,NO,C   ,Attività manifatturiere                                     ,0,1,0,2,3,2023
PIE,NO,C 10,Industrie alimentari                                        ,0,1,0,0,1,2023
PIE,NO,C 11,Industria delle bevande                                     ,0,0,0,0,0,2023
PIE,NO,C 12,Industria del tabacco                                       ,0,0,0,0,0,2023
PIE,NO,C 13,Industrie tessili                                           ,0,0,0,0,0,2023
PIE,NO,C 14,Confezione di articoli di abbigliamento; confezione di ar...,0,0,0,0,0,2023
PIE,NO,C 15,Fabbricazione di articoli in pelle e simili                 ,0,0,0,0,0,2023
PIE,NO,C 16,Industria del legno e dei prodotti in legno e sughero (es...,0,0,0,0,0,2023
PIE,NO,C 17,Fabbricazione di carta e di prodotti di carta               ,0,0,0,0,0,2023
PIE,NO,C 18,Stampa e riproduzione di supporti registrati                ,0,0,0,0,0,2023
PIE,NO,C 19,Fabbricazione di coke e prodotti derivanti dalla raffinaz...,0,0,0,0,0,2023
PIE,NO,C 20,Fabbricazione di prodotti chimici                           ,0,0,0,0,0,2023
PIE,NO,C 21,Fabbricazione di prodotti farmaceutici di base e di prepa...,0,0,0,0,0,2023
PIE,NO,C 22,Fabbricazione di articoli in gomma e materie plastiche      ,0,0,0,0,0,2023
PIE,NO,C 23,Fabbricazione di altri prodotti della lavorazione di miner..,0,0,0,0,0,2023
PIE,NO,C 24,Metallurgia                                                 ,0,0,0,0,0,2023
PIE,NO,C 25,Fabbricazione di prodotti in metallo (esclusi macchinari ...,0,0,0,0,0,2023
PIE,NO,C 26,Fabbricazione di computer e prodotti di elettronica e ott...,0,0,0,0,0,2023
PIE,NO,C 27,Fabbricazione di apparecchiature elettriche ed apparecchi...,0,0,0,0,0,2023
PIE,NO,C 28,Fabbricazione di macchinari ed apparecchiature nca          ,0,0,0,2,2,2023
PIE,NO,C 29,"Fabbricazione di autoveicoli, rimorchi e semirimorchi       ",0,0,0,0,0,2023
PIE,NO,C 30,Fabbricazione di altri mezzi di trasporto                   ,0,0,0,0,0,2023
PIE,NO,C 31,Fabbricazione di mobili                                     ,0,0,0,0,0,2023
PIE,NO,C 32,Altre industrie manifatturiere                              ,0,0,0,0,0,2023
PIE,NO,C 33,"Riparazione, manutenzione ed installazione di macchine ed...",0,0,0,0,0,2023
PIE,NO,D   ,"Fornitura di energia elettrica, gas, vapore e aria condiz...",0,0,0,0,0,2023
PIE,NO,D 35,"Fornitura di energia elettrica, gas, vapore e aria condiz...",0,0,0,0,0,2023
PIE,NO,E   ,"Fornitura di acqua; reti fognarie, attività di gestione d...",0,0,0,0,0,2023
PIE,NO,E 36,"Raccolta, trattamento e fornitura di acqua                  ",0,0,0,0,0,2023
PIE,NO,E 37,Gestione delle reti fognarie                                ,0,0,0,0,0,2023
PIE,NO,E 38,"Attività di raccolta, trattamento e smaltimento dei rifiu...",0,0,0,0,0,2023
PIE,NO,E 39,Attività di risanamento e altri servizi di gestione dei r...,0,0,0,0,0,2023
PIE,NO,F   ,Costruzioni                                                 ,0,0,0,4,4,2023
PIE,NO,F 41,Costruzione di edifici                                      ,0,0,0,2,2,2023
PIE,NO,F 42,Ingegneria civile                                           ,0,0,0,0,0,2023
PIE,NO,F 43,Lavori di costruzione specializzati                         ,0,0,0,2,2,2023
PIE,NO,G   ,Commercio all'ingrosso e al dettaglio; riparazione di aut...,0,7,0,4,11,2023
PIE,NO,G 45,Commercio all'ingrosso e al dettaglio e riparazione di au...,0,1,0,0,1,2023
PIE,NO,G 46,Commercio all'ingrosso (escluso quello di autoveicoli e d...,0,2,0,1,3,2023
PIE,NO,G 47,Commercio al dettaglio (escluso quello di autoveicoli e d...,0,4,0,3,7,2023
PIE,NO,H   ,Trasporto e magazzinaggio                                   ,0,0,0,1,1,2023
PIE,NO,H 49,Trasporto terrestre e mediante condotte                     ,0,0,0,1,1,2023
PIE,NO,H 50,Trasporto marittimo e per vie d'acqua                       ,0,0,0,0,0,2023
PIE,NO,H 51,Trasporto aereo                                             ,0,0,0,0,0,2023
PIE,NO,H 52,Magazzinaggio e attività di supporto ai trasporti           ,0,0,0,0,0,2023
PIE,NO,H 53,Servizi postali e attività di corriere                      ,0,0,0,0,0,2023
PIE,NO,I   ,Attività dei servizi alloggio e ristorazione                ,0,13,0,0,13,2023
PIE,NO,I 55,Alloggio                                                    ,0,0,0,0,0,2023
PIE,NO,I 56,Attività dei servizi di ristorazione                        ,0,13,0,0,13,2023
PIE,NO,J   ,Servizi di informazione e comunicazione                     ,0,0,0,1,1,2023
PIE,NO,J 58,Attività editoriali                                         ,0,0,0,0,0,2023
PIE,NO,J 59,"Attività di produzione cinematografica, di video e di pro...",0,0,0,0,0,2023
PIE,NO,J 60,Attività di programmazione e trasmissione                   ,0,0,0,0,0,2023
PIE,NO,J 61,Telecomunicazioni                                           ,0,0,0,0,0,2023
PIE,NO,J 62,"Produzione di software, consulenza informatica e attività...",0,0,0,0,0,2023
PIE,NO,J 63,Attività dei servizi d'informazione e altri servizi infor...,0,0,0,1,1,2023
PIE,NO,K   ,Attività finanziarie e assicurative                         ,0,0,0,0,0,2023
PIE,NO,K 64,Attività di servizi finanziari (escluse le assicurazioni ...,0,0,0,0,0,2023
PIE,NO,K 65,"Assicurazioni, riassicurazioni e fondi pensione (escluse ...",0,0,0,0,0,2023
PIE,NO,K 66,Attività ausiliarie dei servizi finanziari e delle attivi...,0,0,0,0,0,2023
PIE,NO,L   ,Attivita' immobiliari                                       ,0,0,0,1,1,2023
PIE,NO,L 68,Attivita' immobiliari                                       ,0,0,0,1,1,2023
PIE,NO,M   ,"Attività professionali, scientifiche e tecniche             ",0,0,0,1,1,2023
PIE,NO,M 69,Attività legali e contabilità                               ,0,0,0,0,0,2023
PIE,NO,M 70,Attività di direzione aziendale e di consulenza gestional...,0,0,0,0,0,2023
PIE,NO,M 71,Attività degli studi di architettura e d'ingegneria; coll...,0,0,0,0,0,2023
PIE,NO,M 72,Ricerca scientifica e sviluppo                              ,0,0,0,0,0,2023
PIE,NO,M 73,Pubblicità e ricerche di mercato                            ,0,0,0,0,0,2023
PIE,NO,M 74,"Altre attività professionali, scientifiche e tecniche       ",0,0,0,1,1,2023
PIE,NO,M 75,Servizi veterinari                                          ,0,0,0,0,0,2023
PIE,NO,N   ,"Noleggio, agenzie di viaggio, servizi di supporto alle im...",0,1,0,2,3,2023
PIE,NO,N 77,Attività di noleggio e leasing operativo                    ,0,0,0,0,0,2023
PIE,NO,N 78,"Attività di ricerca, selezione, fornitura di personale      ",0,0,0,0,0,2023
PIE,NO,N 79,"Attività dei servizi delle agenzie di viaggio, dei tour o...",0,0,0,0,0,2023
PIE,NO,N 80,Servizi di vigilanza e investigazione                       ,0,0,0,0,0,2023
PIE,NO,N 81,Attività di servizi per edifici e paesaggio                 ,0,1,0,2,3,2023
PIE,NO,N 82,Attività di supporto per le funzioni d'ufficio e altri se...,0,0,0,0,0,2023
PIE,NO,O   ,Amministrazione pubblica e difesa; assicurazione sociale ...,0,0,0,0,0,2023
PIE,NO,O 84,Amministrazione pubblica e difesa; assicurazione sociale ...,0,0,0,0,0,2023
PIE,NO,P   ,Istruzione                                                  ,0,0,0,2,2,2023
PIE,NO,P 85,Istruzione                                                  ,0,0,0,2,2,2023
PIE,NO,Q   ,Sanita' e assistenza sociale                                ,0,0,0,5,5,2023
PIE,NO,Q 86,Assistenza sanitaria                                        ,0,0,0,2,2,2023
PIE,NO,Q 87,Servizi di assistenza sociale residenziale                  ,0,0,0,0,0,2023
PIE,NO,Q 88,Assistenza sociale non residenziale                         ,0,0,0,3,3,2023
PIE,NO,R   ,"Attività artistiche, sportive, di intrattenimento e diver...",0,0,0,0,0,2023
PIE,NO,R 90,"Attività creative, artistiche e di intrattenimento          ",0,0,0,0,0,2023
PIE,NO,R 91,"Attività di biblioteche, archivi, musei ed altre attività...",0,0,0,0,0,2023
PIE,NO,R 92,"Attività riguardanti le lotterie, le scommesse, le case d...",0,0,0,0,0,2023
PIE,NO,R 93,"Attività sportive, di intrattenimento e di divertimento     ",0,0,0,0,0,2023
PIE,NO,S   ,Altre attività di servizi                                   ,0,1,0,0,1,2023
PIE,NO,S 94,Attività di organizzazioni associative                      ,0,0,0,0,0,2023
PIE,NO,S 95,Riparazione di computer e di beni per uso personale e per...,0,0,0,0,0,2023
PIE,NO,S 96,Altre attività di servizi per la persona                    ,0,1,0,0,1,2023
PIE,NO,T   ,Attività di famiglie e convivenze come datori di lavoro p...,0,0,0,0,0,2023
PIE,NO,T 97,Attività di famiglie e convivenze come datori di lavoro p...,0,0,0,0,0,2023
PIE,NO,T 98,Produzione di beni e servizi indifferenziati per uso prop...,0,0,0,0,0,2023
PIE,NO,U   ,Organizzazioni ed organismi extraterritoriali               ,0,0,0,0,0,2023
PIE,NO,U 99,Organizzazioni ed organismi extraterritoriali               ,0,0,0,0,0,2023
PIE,NO,XX  ,Imprese non classificate                                    ,0,7,0,4,11,2023
PIE,NO,TOT ,TOTALE                                                      ,0,30,0,27,57,2023
PIE,CN,A   ,"Agricoltura, silvicoltura pesca                             ",0,5,59,3,67,2023
PIE,CN,A 01,"Coltivazioni agricole e produzione di prodotti animali, c...",0,5,57,3,65,2023
PIE,CN,A 02,Silvicoltura ed utilizzo di aree forestali                  ,0,0,2,0,2,2023
PIE,CN,A 03,Pesca e acquacoltura                                        ,0,0,0,0,0,2023
PIE,CN,B   ,Estrazione di minerali da cave e miniere                    ,0,0,0,0,0,2023
PIE,CN,B 05,Estrazione di carbone (esclusa torba)                       ,0,0,0,0,0,2023
PIE,CN,B 06,Estraz.di petrolio greggio e di gas naturale                ,0,0,0,0,0,2023
PIE,CN,B 07,Estrazione di minerali metalliferi                          ,0,0,0,0,0,2023
PIE,CN,B 08,Altre attività di estrazione di minerali da cave e miniere  ,0,0,0,0,0,2023
PIE,CN,B 09,Attività dei servizi di supporto all'estrazione             ,0,0,0,0,0,2023
PIE,CN,C   ,Attività manifatturiere                                     ,1,7,28,2,38,2023
PIE,CN,C 10,Industrie alimentari                                        ,0,1,3,1,5,2023
PIE,CN,C 11,Industria delle bevande                                     ,0,0,0,0,0,2023
PIE,CN,C 12,Industria del tabacco                                       ,0,0,0,0,0,2023
PIE,CN,C 13,Industrie tessili                                           ,0,0,0,0,0,2023
PIE,CN,C 14,Confezione di articoli di abbigliamento; confezione di ar...,0,0,5,0,5,2023
PIE,CN,C 15,Fabbricazione di articoli in pelle e simili                 ,0,0,1,0,1,2023
PIE,CN,C 16,Industria del legno e dei prodotti in legno e sughero (es...,0,1,1,0,2,2023
PIE,CN,C 17,Fabbricazione di carta e di prodotti di carta               ,0,0,0,0,0,2023
PIE,CN,C 18,Stampa e riproduzione di supporti registrati                ,0,0,0,0,0,2023
PIE,CN,C 19,Fabbricazione di coke e prodotti derivanti dalla raffinaz...,0,0,0,0,0,2023
PIE,CN,C 20,Fabbricazione di prodotti chimici                           ,0,0,0,0,0,2023
PIE,CN,C 21,Fabbricazione di prodotti farmaceutici di base e di prepa...,0,0,0,0,0,2023
PIE,CN,C 22,Fabbricazione di articoli in gomma e materie plastiche      ,0,1,1,0,2,2023
PIE,CN,C 23,Fabbricazione di altri prodotti della lavorazione di miner..,0,0,1,0,1,2023
PIE,CN,C 24,Metallurgia                                                 ,0,0,0,0,0,2023
PIE,CN,C 25,Fabbricazione di prodotti in metallo (esclusi macchinari ...,0,0,11,0,11,2023
PIE,CN,C 26,Fabbricazione di computer e prodotti di elettronica e ott...,0,0,0,0,0,2023
PIE,CN,C 27,Fabbricazione di apparecchiature elettriche ed apparecchi...,0,0,0,0,0,2023
PIE,CN,C 28,Fabbricazione di macchinari ed apparecchiature nca          ,1,1,1,0,3,2023
PIE,CN,C 29,"Fabbricazione di autoveicoli, rimorchi e semirimorchi       ",0,0,0,0,0,2023
PIE,CN,C 30,Fabbricazione di altri mezzi di trasporto                   ,0,0,0,0,0,2023
PIE,CN,C 31,Fabbricazione di mobili                                     ,0,2,0,0,2,2023
PIE,CN,C 32,Altre industrie manifatturiere                              ,0,0,0,0,0,2023
PIE,CN,C 33,"Riparazione, manutenzione ed installazione di macchine ed...",0,1,4,1,6,2023
PIE,CN,D   ,"Fornitura di energia elettrica, gas, vapore e aria condiz...",1,0,1,0,2,2023
PIE,CN,D 35,"Fornitura di energia elettrica, gas, vapore e aria condiz...",1,0,1,0,2,2023
PIE,CN,E   ,"Fornitura di acqua; reti fognarie, attività di gestione d...",0,0,0,0,0,2023
PIE,CN,E 36,"Raccolta, trattamento e fornitura di acqua                  ",0,0,0,0,0,2023
PIE,CN,E 37,Gestione delle reti fognarie                                ,0,0,0,0,0,2023
PIE,CN,E 38,"Attività di raccolta, trattamento e smaltimento dei rifiu...",0,0,0,0,0,2023
PIE,CN,E 39,Attività di risanamento e altri servizi di gestione dei r...,0,0,0,0,0,2023
PIE,CN,F   ,Costruzioni                                                 ,1,8,65,1,75,2023
PIE,CN,F 41,Costruzione di edifici                                      ,1,3,9,0,13,2023
PIE,CN,F 42,Ingegneria civile                                           ,0,0,0,0,0,2023
PIE,CN,F 43,Lavori di costruzione specializzati                         ,0,5,56,1,62,2023
PIE,CN,G   ,Commercio all'ingrosso e al dettaglio; riparazione di aut...,2,23,48,0,73,2023
PIE,CN,G 45,Commercio all'ingrosso e al dettaglio e riparazione di au...,1,4,1,0,6,2023
PIE,CN,G 46,Commercio all'ingrosso (escluso quello di autoveicoli e d...,1,4,21,0,26,2023
PIE,CN,G 47,Commercio al dettaglio (escluso quello di autoveicoli e d...,0,15,26,0,41,2023
PIE,CN,H   ,Trasporto e magazzinaggio                                   ,0,2,3,0,5,2023
PIE,CN,H 49,Trasporto terrestre e mediante condotte                     ,0,2,3,0,5,2023
PIE,CN,H 50,Trasporto marittimo e per vie d'acqua                       ,0,0,0,0,0,2023
PIE,CN,H 51,Trasporto aereo                                             ,0,0,0,0,0,2023
PIE,CN,H 52,Magazzinaggio e attività di supporto ai trasporti           ,0,0,0,0,0,2023
PIE,CN,H 53,Servizi postali e attività di corriere                      ,0,0,0,0,0,2023
PIE,CN,I   ,Attività dei servizi alloggio e ristorazione                ,0,21,14,1,36,2023
PIE,CN,I 55,Alloggio                                                    ,0,0,3,0,3,2023
PIE,CN,I 56,Attività dei servizi di ristorazione                        ,0,21,11,1,33,2023
PIE,CN,J   ,Servizi di informazione e comunicazione                     ,0,2,0,0,2,2023
PIE,CN,J 58,Attività editoriali                                         ,0,0,0,0,0,2023
PIE,CN,J 59,"Attività di produzione cinematografica, di video e di pro...",0,0,0,0,0,2023
PIE,CN,J 60,Attività di programmazione e trasmissione                   ,0,0,0,0,0,2023
PIE,CN,J 61,Telecomunicazioni                                           ,0,1,0,0,1,2023
PIE,CN,J 62,"Produzione di software, consulenza informatica e attività...",0,1,0,0,1,2023
PIE,CN,J 63,Attività dei servizi d'informazione e altri servizi infor...,0,0,0,0,0,2023
PIE,CN,K   ,Attività finanziarie e assicurative                         ,0,1,0,0,1,2023
PIE,CN,K 64,Attività di servizi finanziari (escluse le assicurazioni ...,0,0,0,0,0,2023
PIE,CN,K 65,"Assicurazioni, riassicurazioni e fondi pensione (escluse ...",0,0,0,0,0,2023
PIE,CN,K 66,Attività ausiliarie dei servizi finanziari e delle attivi...,0,1,0,0,1,2023
PIE,CN,L   ,Attivita' immobiliari                                       ,0,3,2,0,5,2023
PIE,CN,L 68,Attivita' immobiliari                                       ,0,3,2,0,5,2023
PIE,CN,M   ,"Attività professionali, scientifiche e tecniche             ",0,2,5,1,8,2023
PIE,CN,M 69,Attività legali e contabilità                               ,0,0,0,0,0,2023
PIE,CN,M 70,Attività di direzione aziendale e di consulenza gestional...,0,0,3,0,3,2023
PIE,CN,M 71,Attività degli studi di architettura e d'ingegneria; coll...,0,0,1,0,1,2023
PIE,CN,M 72,Ricerca scientifica e sviluppo                              ,0,0,0,0,0,2023
PIE,CN,M 73,Pubblicità e ricerche di mercato                            ,0,0,0,0,0,2023
PIE,CN,M 74,"Altre attività professionali, scientifiche e tecniche       ",0,2,1,1,4,2023
PIE,CN,M 75,Servizi veterinari                                          ,0,0,0,0,0,2023
PIE,CN,N   ,"Noleggio, agenzie di viaggio, servizi di supporto alle im...",0,2,5,0,7,2023
PIE,CN,N 77,Attività di noleggio e leasing operativo                    ,0,1,0,0,1,2023
PIE,CN,N 78,"Attività di ricerca, selezione, fornitura di personale      ",0,0,0,0,0,2023
PIE,CN,N 79,"Attività dei servizi delle agenzie di viaggio, dei tour o...",0,0,0,0,0,2023
PIE,CN,N 80,Servizi di vigilanza e investigazione                       ,0,0,0,0,0,2023
PIE,CN,N 81,Attività di servizi per edifici e paesaggio                 ,0,1,2,0,3,2023
PIE,CN,N 82,Attività di supporto per le funzioni d'ufficio e altri se...,0,0,3,0,3,2023
PIE,CN,O   ,Amministrazione pubblica e difesa; assicurazione sociale ...,0,0,0,0,0,2023
PIE,CN,O 84,Amministrazione pubblica e difesa; assicurazione sociale ...,0,0,0,0,0,2023
PIE,CN,P   ,Istruzione                                                  ,0,1,0,0,1,2023
PIE,CN,P 85,Istruzione                                                  ,0,1,0,0,1,2023
PIE,CN,Q   ,Sanita' e assistenza sociale                                ,0,0,2,1,3,2023
PIE,CN,Q 86,Assistenza sanitaria                                        ,0,0,0,0,0,2023
PIE,CN,Q 87,Servizi di assistenza sociale residenziale                  ,0,0,0,0,0,2023
PIE,CN,Q 88,Assistenza sociale non residenziale                         ,0,0,2,1,3,2023
PIE,CN,R   ,"Attività artistiche, sportive, di intrattenimento e diver...",1,3,2,0,6,2023
PIE,CN,R 90,"Attività creative, artistiche e di intrattenimento          ",0,0,0,0,0,2023
PIE,CN,R 91,"Attività di biblioteche, archivi, musei ed altre attività...",0,0,0,0,0,2023
PIE,CN,R 92,"Attività riguardanti le lotterie, le scommesse, le case d...",0,0,1,0,1,2023
PIE,CN,R 93,"Attività sportive, di intrattenimento e di divertimento     ",1,3,1,0,5,2023
PIE,CN,S   ,Altre attività di servizi                                   ,0,3,3,0,6,2023
PIE,CN,S 94,Attività di organizzazioni associative                      ,0,0,0,0,0,2023
PIE,CN,S 95,Riparazione di computer e di beni per uso personale e per...,0,2,1,0,3,2023
PIE,CN,S 96,Altre attività di servizi per la persona                    ,0,1,2,0,3,2023
PIE,CN,T   ,Attività di famiglie e convivenze come datori di lavoro p...,0,0,0,0,0,2023
PIE,CN,T 97,Attività di famiglie e convivenze come datori di lavoro p...,0,0,0,0,0,2023
PIE,CN,T 98,Produzione di beni e servizi indifferenziati per uso prop...,0,0,0,0,0,2023
PIE,CN,U   ,Organizzazioni ed organismi extraterritoriali               ,0,0,0,0,0,2023
PIE,CN,U 99,Organizzazioni ed organismi extraterritoriali               ,0,0,0,0,0,2023
PIE,CN,XX  ,Imprese non classificate                                    ,0,3,4,3,10,2023
PIE,CN,TOT ,TOTALE                                                      ,6,86,241,12,345,2023
PIE,AT,A   ,"Agricoltura, silvicoltura pesca                             ",0,9,88,4,101,2023
PIE,AT,A 01,"Coltivazioni agricole e produzione di prodotti animali, c...",0,9,87,4,100,2023
PIE,AT,A 02,Silvicoltura ed utilizzo di aree forestali                  ,0,0,1,0,1,2023
PIE,AT,A 03,Pesca e acquacoltura                                        ,0,0,0,0,0,2023
PIE,AT,B   ,Estrazione di minerali da cave e miniere                    ,0,0,0,0,0,2023
PIE,AT,B 05,Estrazione di carbone (esclusa torba)                       ,0,0,0,0,0,2023
PIE,AT,B 06,Estraz.di petrolio greggio e di gas naturale                ,0,0,0,0,0,2023
PIE,AT,B 07,Estrazione di minerali metalliferi                          ,0,0,0,0,0,2023
PIE,AT,B 08,Altre attività di estrazione di minerali da cave e miniere  ,0,0,0,0,0,2023
PIE,AT,B 09,Attività dei servizi di supporto all'estrazione             ,0,0,0,0,0,2023
PIE,AT,C   ,Attività manifatturiere                                     ,0,12,22,0,34,2023
PIE,AT,C 10,Industrie alimentari                                        ,0,4,0,0,4,2023
PIE,AT,C 11,Industria delle bevande                                     ,0,1,0,0,1,2023
PIE,AT,C 12,Industria del tabacco                                       ,0,0,0,0,0,2023
PIE,AT,C 13,Industrie tessili                                           ,0,0,0,0,0,2023
PIE,AT,C 14,Confezione di articoli di abbigliamento; confezione di ar...,0,0,3,0,3,2023
PIE,AT,C 15,Fabbricazione di articoli in pelle e simili                 ,0,0,0,0,0,2023
PIE,AT,C 16,Industria del legno e dei prodotti in legno e sughero (es...,0,0,5,0,5,2023
PIE,AT,C 17,Fabbricazione di carta e di prodotti di carta               ,0,0,0,0,0,2023
PIE,AT,C 18,Stampa e riproduzione di supporti registrati                ,0,1,1,0,2,2023
PIE,AT,C 19,Fabbricazione di coke e prodotti derivanti dalla raffinaz...,0,0,0,0,0,2023
PIE,AT,C 20,Fabbricazione di prodotti chimici                           ,0,0,0,0,0,2023
PIE,AT,C 21,Fabbricazione di prodotti farmaceutici di base e di prepa...,0,0,0,0,0,2023
PIE,AT,C 22,Fabbricazione di articoli in gomma e materie plastiche      ,0,1,0,0,1,2023
PIE,AT,C 23,Fabbricazione di altri prodotti della lavorazione di miner..,0,0,0,0,0,2023
PIE,AT,C 24,Metallurgia                                                 ,0,0,0,0,0,2023
PIE,AT,C 25,Fabbricazione di prodotti in metallo (esclusi macchinari ...,0,3,9,0,12,2023
PIE,AT,C 26,Fabbricazione di computer e prodotti di elettronica e ott...,0,0,0,0,0,2023
PIE,AT,C 27,Fabbricazione di apparecchiature elettriche ed apparecchi...,0,0,0,0,0,2023
PIE,AT,C 28,Fabbricazione di macchinari ed apparecchiature nca          ,0,1,0,0,1,2023
PIE,AT,C 29,"Fabbricazione di autoveicoli, rimorchi e semirimorchi       ",0,0,0,0,0,2023
PIE,AT,C 30,Fabbricazione di altri mezzi di trasporto                   ,0,0,0,0,0,2023
PIE,AT,C 31,Fabbricazione di mobili                                     ,0,0,3,0,3,2023
PIE,AT,C 32,Altre industrie manifatturiere                              ,0,0,1,0,1,2023
PIE,AT,C 33,"Riparazione, manutenzione ed installazione di macchine ed...",0,1,0,0,1,2023
PIE,AT,D   ,"Fornitura di energia elettrica, gas, vapore e aria condiz...",0,0,1,0,1,2023
PIE,AT,D 35,"Fornitura di energia elettrica, gas, vapore e aria condiz...",0,0,1,0,1,2023
PIE,AT,E   ,"Fornitura di acqua; reti fognarie, attività di gestione d...",0,0,0,0,0,2023
PIE,AT,E 36,"Raccolta, trattamento e fornitura di acqua                  ",0,0,0,0,0,2023
PIE,AT,E 37,Gestione delle reti fognarie                                ,0,0,0,0,0,2023
PIE,AT,E 38,"Attività di raccolta, trattamento e smaltimento dei rifiu...",0,0,0,0,0,2023
PIE,AT,E 39,Attività di risanamento e altri servizi di gestione dei r...,0,0,0,0,0,2023
PIE,AT,F   ,Costruzioni                                                 ,0,21,47,0,68,2023
PIE,AT,F 41,Costruzione di edifici                                      ,0,9,8,0,17,2023
PIE,AT,F 42,Ingegneria civile                                           ,0,0,1,0,1,2023
PIE,AT,F 43,Lavori di costruzione specializzati                         ,0,12,38,0,50,2023
PIE,AT,G   ,Commercio all'ingrosso e al dettaglio; riparazione di aut...,0,35,45,0,80,2023
PIE,AT,G 45,Commercio all'ingrosso e al dettaglio e riparazione di au...,0,6,6,0,12,2023
PIE,AT,G 46,Commercio all'ingrosso (escluso quello di autoveicoli e d...,0,5,21,0,26,2023
PIE,AT,G 47,Commercio al dettaglio (escluso quello di autoveicoli e d...,0,24,18,0,42,2023
PIE,AT,H   ,Trasporto e magazzinaggio                                   ,0,5,2,0,7,2023
PIE,AT,H 49,Trasporto terrestre e mediante condotte                     ,0,5,2,0,7,2023
PIE,AT,H 50,Trasporto marittimo e per vie d'acqua                       ,0,0,0,0,0,2023
PIE,AT,H 51,Trasporto aereo                                             ,0,0,0,0,0,2023
PIE,AT,H 52,Magazzinaggio e attività di supporto ai trasporti           ,0,0,0,0,0,2023
PIE,AT,H 53,Servizi postali e attività di corriere                      ,0,0,0,0,0,2023
PIE,AT,I   ,Attività dei servizi alloggio e ristorazione                ,0,23,10,0,33,2023
PIE,AT,I 55,Alloggio                                                    ,0,0,2,0,2,2023
PIE,AT,I 56,Attività dei servizi di ristorazione                        ,0,23,8,0,31,2023
PIE,AT,J   ,Servizi di informazione e comunicazione                     ,0,1,2,0,3,2023
PIE,AT,J 58,Attività editoriali                                         ,0,0,1,0,1,2023
PIE,AT,J 59,"Attività di produzione cinematografica, di video e di pro...",0,1,0,0,1,2023
PIE,AT,J 60,Attività di programmazione e trasmissione                   ,0,0,0,0,0,2023
PIE,AT,J 61,Telecomunicazioni                                           ,0,0,0,0,0,2023
PIE,AT,J 62,"Produzione di software, consulenza informatica e attività...",0,0,1,0,1,2023
PIE,AT,J 63,Attività dei servizi d'informazione e altri servizi infor...,0,0,0,0,0,2023
PIE,AT,K   ,Attività finanziarie e assicurative                         ,0,2,6,1,9,2023
PIE,AT,K 64,Attività di servizi finanziari (escluse le assicurazioni ...,0,0,0,0,0,2023
PIE,AT,K 65,"Assicurazioni, riassicurazioni e fondi pensione (escluse ...",0,0,0,1,1,2023
PIE,AT,K 66,Attività ausiliarie dei servizi finanziari e delle attivi...,0,2,6,0,8,2023
PIE,AT,L   ,Attivita' immobiliari                                       ,0,10,1,0,11,2023
PIE,AT,L 68,Attivita' immobiliari                                       ,0,10,1,0,11,2023
PIE,AT,M   ,"Attività professionali, scientifiche e tecniche             ",0,2,2,0,4,2023
PIE,AT,M 69,Attività legali e contabilità                               ,0,1,0,0,1,2023
PIE,AT,M 70,Attività di direzione aziendale e di consulenza gestional...,0,0,0,0,0,2023
PIE,AT,M 71,Attività degli studi di architettura e d'ingegneria; coll...,0,0,1,0,1,2023
PIE,AT,M 72,Ricerca scientifica e sviluppo                              ,0,0,0,0,0,2023
PIE,AT,M 73,Pubblicità e ricerche di mercato                            ,0,1,1,0,2,2023
PIE,AT,M 74,"Altre attività professionali, scientifiche e tecniche       ",0,0,0,0,0,2023
PIE,AT,M 75,Servizi veterinari                                          ,0,0,0,0,0,2023
PIE,AT,N   ,"Noleggio, agenzie di viaggio, servizi di supporto alle im...",0,4,3,0,7,2023
PIE,AT,N 77,Attività di noleggio e leasing operativo                    ,0,1,0,0,1,2023
PIE,AT,N 78,"Attività di ricerca, selezione, fornitura di personale      ",0,0,0,0,0,2023
PIE,AT,N 79,"Attività dei servizi delle agenzie di viaggio, dei tour o...",0,0,0,0,0,2023
PIE,AT,N 80,Servizi di vigilanza e investigazione                       ,0,0,0,0,0,2023
PIE,AT,N 81,Attività di servizi per edifici e paesaggio                 ,0,2,2,0,4,2023
PIE,AT,N 82,Attività di supporto per le funzioni d'ufficio e altri se...,0,1,1,0,2,2023
PIE,AT,O   ,Amministrazione pubblica e difesa; assicurazione sociale ...,0,0,0,0,0,2023
PIE,AT,O 84,Amministrazione pubblica e difesa; assicurazione sociale ...,0,0,0,0,0,2023
PIE,AT,P   ,Istruzione                                                  ,0,0,1,1,2,2023
PIE,AT,P 85,Istruzione                                                  ,0,0,1,1,2,2023
PIE,AT,Q   ,Sanita' e assistenza sociale                                ,0,0,1,2,3,2023
PIE,AT,Q 86,Assistenza sanitaria                                        ,0,0,1,0,1,2023
PIE,AT,Q 87,Servizi di assistenza sociale residenziale                  ,0,0,0,1,1,2023
PIE,AT,Q 88,Assistenza sociale non residenziale                         ,0,0,0,1,1,2023
PIE,AT,R   ,"Attività artistiche, sportive, di intrattenimento e diver...",0,3,1,0,4,2023
PIE,AT,R 90,"Attività creative, artistiche e di intrattenimento          ",0,0,0,0,0,2023
PIE,AT,R 91,"Attività di biblioteche, archivi, musei ed altre attività...",0,0,0,0,0,2023
PIE,AT,R 92,"Attività riguardanti le lotterie, le scommesse, le case d...",0,0,0,0,0,2023
PIE,AT,R 93,"Attività sportive, di intrattenimento e di divertimento     ",0,3,1,0,4,2023
PIE,AT,S   ,Altre attività di servizi                                   ,0,3,6,0,9,2023
PIE,AT,S 94,Attività di organizzazioni associative                      ,0,0,0,0,0,2023
PIE,AT,S 95,Riparazione di computer e di beni per uso personale e per...,0,1,4,0,5,2023
PIE,AT,S 96,Altre attività di servizi per la persona                    ,0,2,2,0,4,2023
PIE,AT,T   ,Attività di famiglie e convivenze come datori di lavoro p...,0,0,0,0,0,2023
PIE,AT,T 97,Attività di famiglie e convivenze come datori di lavoro p...,0,0,0,0,0,2023
PIE,AT,T 98,Produzione di beni e servizi indifferenziati per uso prop...,0,0,0,0,0,2023
PIE,AT,U   ,Organizzazioni ed organismi extraterritoriali               ,0,0,0,0,0,2023
PIE,AT,U 99,Organizzazioni ed organismi extraterritoriali               ,0,0,0,0,0,2023
PIE,AT,XX  ,Imprese non classificate                                    ,1,6,1,0,8,2023
PIE,AT,TOT ,TOTALE                                                      ,1,136,239,8,384,2023
PIE,AL,A   ,"Agricoltura, silvicoltura pesca                             ",0,7,159,0,166,2023
PIE,AL,A 01,"Coltivazioni agricole e produzione di prodotti animali, c...",0,7,155,0,162,2023
PIE,AL,A 02,Silvicoltura ed utilizzo di aree forestali                  ,0,0,4,0,4,2023
PIE,AL,A 03,Pesca e acquacoltura                                        ,0,0,0,0,0,2023
PIE,AL,B   ,Estrazione di minerali da cave e miniere                    ,0,0,0,0,0,2023
PIE,AL,B 05,Estrazione di carbone (esclusa torba)                       ,0,0,0,0,0,2023
PIE,AL,B 06,Estraz.di petrolio greggio e di gas naturale                ,0,0,0,0,0,2023
PIE,AL,B 07,Estrazione di minerali metalliferi                          ,0,0,0,0,0,2023
PIE,AL,B 08,Altre attività di estrazione di minerali da cave e miniere  ,0,0,0,0,0,2023
PIE,AL,B 09,Attività dei servizi di supporto all'estrazione             ,0,0,0,0,0,2023
PIE,AL,C   ,Attività manifatturiere                                     ,0,36,56,1,93,2023
PIE,AL,C 10,Industrie alimentari                                        ,0,4,1,0,5,2023
PIE,AL,C 11,Industria delle bevande                                     ,0,0,0,0,0,2023
PIE,AL,C 12,Industria del tabacco                                       ,0,0,0,0,0,2023
PIE,AL,C 13,Industrie tessili                                           ,0,0,1,0,1,2023
PIE,AL,C 14,Confezione di articoli di abbigliamento; confezione di ar...,0,3,8,0,11,2023
PIE,AL,C 15,Fabbricazione di articoli in pelle e simili                 ,0,0,0,0,0,2023
PIE,AL,C 16,Industria del legno e dei prodotti in legno e sughero (es...,0,1,6,0,7,2023
PIE,AL,C 17,Fabbricazione di carta e di prodotti di carta               ,0,0,0,0,0,2023
PIE,AL,C 18,Stampa e riproduzione di supporti registrati                ,0,0,0,0,0,2023
PIE,AL,C 19,Fabbricazione di coke e prodotti derivanti dalla raffinaz...,0,0,0,0,0,2023
PIE,AL,C 20,Fabbricazione di prodotti chimici                           ,0,0,0,0,0,2023
PIE,AL,C 21,Fabbricazione di prodotti farmaceutici di base e di prepa...,0,0,0,0,0,2023
PIE,AL,C 22,Fabbricazione di articoli in gomma e materie plastiche      ,0,0,0,1,1,2023
PIE,AL,C 23,Fabbricazione di altri prodotti della lavorazione di miner..,0,1,2,0,3,2023
PIE,AL,C 24,Metallurgia                                                 ,0,0,0,0,0,2023
PIE,AL,C 25,Fabbricazione di prodotti in metallo (esclusi macchinari ...,0,6,15,0,21,2023
PIE,AL,C 26,Fabbricazione di computer e prodotti di elettronica e ott...,0,0,0,0,0,2023
PIE,AL,C 27,Fabbricazione di apparecchiature elettriche ed apparecchi...,0,0,2,0,2,2023
PIE,AL,C 28,Fabbricazione di macchinari ed apparecchiature nca          ,0,5,2,0,7,2023
PIE,AL,C 29,"Fabbricazione di autoveicoli, rimorchi e semirimorchi       ",0,0,1,0,1,2023
PIE,AL,C 30,Fabbricazione di altri mezzi di trasporto                   ,0,0,0,0,0,2023
PIE,AL,C 31,Fabbricazione di mobili                                     ,0,0,2,0,2,2023
PIE,AL,C 32,Altre industrie manifatturiere                              ,0,15,11,0,26,2023
PIE,AL,C 33,"Riparazione, manutenzione ed installazione di macchine ed...",0,1,5,0,6,2023
PIE,AL,D   ,"Fornitura di energia elettrica, gas, vapore e aria condiz...",0,0,0,0,0,2023
PIE,AL,D 35,"Fornitura di energia elettrica, gas, vapore e aria condiz...",0,0,0,0,0,2023
PIE,AL,E   ,"Fornitura di acqua; reti fognarie, attività di gestione d...",0,0,0,0,0,2023
PIE,AL,E 36,"Raccolta, trattamento e fornitura di acqua                  ",0,0,0,0,0,2023
PIE,AL,E 37,Gestione delle reti fognarie                                ,0,0,0,0,0,2023
PIE,AL,E 38,"Attività di raccolta, trattamento e smaltimento dei rifiu...",0,0,0,0,0,2023
PIE,AL,E 39,Attività di risanamento e altri servizi di gestione dei r...,0,0,0,0,0,2023
PIE,AL,F   ,Costruzioni                                                 ,0,32,157,5,194,2023
PIE,AL,F 41,Costruzione di edifici                                      ,0,15,38,1,54,2023
PIE,AL,F 42,Ingegneria civile                                           ,0,2,0,0,2,2023
PIE,AL,F 43,Lavori di costruzione specializzati                         ,0,15,119,4,138,2023
PIE,AL,G   ,Commercio all'ingrosso e al dettaglio; riparazione di aut...,0,71,117,1,189,2023
PIE,AL,G 45,Commercio all'ingrosso e al dettaglio e riparazione di au...,0,7,16,0,23,2023
PIE,AL,G 46,Commercio all'ingrosso (escluso quello di autoveicoli e d...,0,23,42,0,65,2023
PIE,AL,G 47,Commercio al dettaglio (escluso quello di autoveicoli e d...,0,41,59,1,101,2023
PIE,AL,H   ,Trasporto e magazzinaggio                                   ,0,7,28,0,35,2023
PIE,AL,H 49,Trasporto terrestre e mediante condotte                     ,0,5,27,0,32,2023
PIE,AL,H 50,Trasporto marittimo e per vie d'acqua                       ,0,0,0,0,0,2023
PIE,AL,H 51,Trasporto aereo                                             ,0,0,0,0,0,2023
PIE,AL,H 52,Magazzinaggio e attività di supporto ai trasporti           ,0,2,1,0,3,2023
PIE,AL,H 53,Servizi postali e attività di corriere                      ,0,0,0,0,0,2023
PIE,AL,I   ,Attività dei servizi alloggio e ristorazione                ,0,60,22,2,84,2023
PIE,AL,I 55,Alloggio                                                    ,0,1,0,0,1,2023
PIE,AL,I 56,Attività dei servizi di ristorazione                        ,0,59,22,2,83,2023
PIE,AL,J   ,Servizi di informazione e comunicazione                     ,0,4,6,0,10,2023
PIE,AL,J 58,Attività editoriali                                         ,0,0,1,0,1,2023
PIE,AL,J 59,"Attività di produzione cinematografica, di video e di pro...",0,1,0,0,1,2023
PIE,AL,J 60,Attività di programmazione e trasmissione                   ,0,0,1,0,1,2023
PIE,AL,J 61,Telecomunicazioni                                           ,0,0,0,0,0,2023
PIE,AL,J 62,"Produzione di software, consulenza informatica e attività...",0,1,2,0,3,2023
PIE,AL,J 63,Attività dei servizi d'informazione e altri servizi infor...,0,2,2,0,4,2023
PIE,AL,K   ,Attività finanziarie e assicurative                         ,0,3,24,0,27,2023
PIE,AL,K 64,Attività di servizi finanziari (escluse le assicurazioni ...,0,1,0,0,1,2023
PIE,AL,K 65,"Assicurazioni, riassicurazioni e fondi pensione (escluse ...",0,1,0,0,1,2023
PIE,AL,K 66,Attività ausiliarie dei servizi finanziari e delle attivi...,0,1,24,0,25,2023
PIE,AL,L   ,Attivita' immobiliari                                       ,0,18,3,0,21,2023
PIE,AL,L 68,Attivita' immobiliari                                       ,0,18,3,0,21,2023
PIE,AL,M   ,"Attività professionali, scientifiche e tecniche             ",0,9,10,0,19,2023
PIE,AL,M 69,Attività legali e contabilità                               ,0,1,0,0,1,2023
PIE,AL,M 70,Attività di direzione aziendale e di consulenza gestional...,0,0,1,0,1,2023
PIE,AL,M 71,Attività degli studi di architettura e d'ingegneria; coll...,0,4,3,0,7,2023
PIE,AL,M 72,Ricerca scientifica e sviluppo                              ,0,0,0,0,0,2023
PIE,AL,M 73,Pubblicità e ricerche di mercato                            ,0,1,3,0,4,2023
PIE,AL,M 74,"Altre attività professionali, scientifiche e tecniche       ",0,3,3,0,6,2023
PIE,AL,M 75,Servizi veterinari                                          ,0,0,0,0,0,2023
PIE,AL,N   ,"Noleggio, agenzie di viaggio, servizi di supporto alle im...",0,2,10,2,14,2023
PIE,AL,N 77,Attività di noleggio e leasing operativo                    ,0,1,2,0,3,2023
PIE,AL,N 78,"Attività di ricerca, selezione, fornitura di personale      ",0,0,0,0,0,2023
PIE,AL,N 79,"Attività dei servizi delle agenzie di viaggio, dei tour o...",0,0,0,0,0,2023
PIE,AL,N 80,Servizi di vigilanza e investigazione                       ,0,0,1,0,1,2023
PIE,AL,N 81,Attività di servizi per edifici e paesaggio                 ,0,0,7,2,9,2023
PIE,AL,N 82,Attività di supporto per le funzioni d'ufficio e altri se...,0,1,0,0,1,2023
PIE,AL,O   ,Amministrazione pubblica e difesa; assicurazione sociale ...,0,0,0,0,0,2023
PIE,AL,O 84,Amministrazione pubblica e difesa; assicurazione sociale ...,0,0,0,0,0,2023
PIE,AL,P   ,Istruzione                                                  ,0,0,1,0,1,2023
PIE,AL,P 85,Istruzione                                                  ,0,0,1,0,1,2023
PIE,AL,Q   ,Sanita' e assistenza sociale                                ,0,1,0,0,1,2023
PIE,AL,Q 86,Assistenza sanitaria                                        ,0,0,0,0,0,2023
PIE,AL,Q 87,Servizi di assistenza sociale residenziale                  ,0,0,0,0,0,2023
PIE,AL,Q 88,Assistenza sociale non residenziale                         ,0,1,0,0,1,2023
PIE,AL,R   ,"Attività artistiche, sportive, di intrattenimento e diver...",0,4,2,0,6,2023
PIE,AL,R 90,"Attività creative, artistiche e di intrattenimento          ",0,1,0,0,1,2023
PIE,AL,R 91,"Attività di biblioteche, archivi, musei ed altre attività...",0,0,0,0,0,2023
PIE,AL,R 92,"Attività riguardanti le lotterie, le scommesse, le case d...",0,0,0,0,0,2023
PIE,AL,R 93,"Attività sportive, di intrattenimento e di divertimento     ",0,3,2,0,5,2023
PIE,AL,S   ,Altre attività di servizi                                   ,0,4,27,0,31,2023
PIE,AL,S 94,Attività di organizzazioni associative                      ,0,0,0,0,0,2023
PIE,AL,S 95,Riparazione di computer e di beni per uso personale e per...,0,0,10,0,10,2023
PIE,AL,S 96,Altre attività di servizi per la persona                    ,0,4,17,0,21,2023
PIE,AL,T   ,Attività di famiglie e convivenze come datori di lavoro p...,0,0,0,0,0,2023
PIE,AL,T 97,Attività di famiglie e convivenze come datori di lavoro p...,0,0,0,0,0,2023
PIE,AL,T 98,Produzione di beni e servizi indifferenziati per uso prop...,0,0,0,0,0,2023
PIE,AL,U   ,Organizzazioni ed organismi extraterritoriali               ,0,0,0,0,0,2023
PIE,AL,U 99,Organizzazioni ed organismi extraterritoriali               ,0,0,0,0,0,2023
PIE,AL,XX  ,Imprese non classificate                                    ,0,18,9,1,28,2023
PIE,AL,TOT ,TOTALE                                                      ,0,276,631,12,919,2023
PIE,BI,A   ,"Agricoltura, silvicoltura pesca                             ",0,0,0,0,0,2023
PIE,BI,A 01,"Coltivazioni agricole e produzione di prodotti animali, c...",0,0,0,0,0,2023
PIE,BI,A 02,Silvicoltura ed utilizzo di aree forestali                  ,0,0,0,0,0,2023
PIE,BI,A 03,Pesca e acquacoltura                                        ,0,0,0,0,0,2023
PIE,BI,B   ,Estrazione di minerali da cave e miniere                    ,0,0,0,0,0,2023
PIE,BI,B 05,Estrazione di carbone (esclusa torba)                       ,0,0,0,0,0,2023
PIE,BI,B 06,Estraz.di petrolio greggio e di gas naturale                ,0,0,0,0,0,2023
PIE,BI,B 07,Estrazione di minerali metalliferi                          ,0,0,0,0,0,2023
PIE,BI,B 08,Altre attività di estrazione di minerali da cave e miniere  ,0,0,0,0,0,2023
PIE,BI,B 09,Attività dei servizi di supporto all'estrazione             ,0,0,0,0,0,2023
PIE,BI,C   ,Attività manifatturiere                                     ,0,34,0,1,35,2023
PIE,BI,C 10,Industrie alimentari                                        ,0,3,0,0,3,2023
PIE,BI,C 11,Industria delle bevande                                     ,0,0,0,0,0,2023
PIE,BI,C 12,Industria del tabacco                                       ,0,0,0,0,0,2023
PIE,BI,C 13,Industrie tessili                                           ,0,23,0,0,23,2023
PIE,BI,C 14,Confezione di articoli di abbigliamento; confezione di ar...,0,2,0,0,2,2023
PIE,BI,C 15,Fabbricazione di articoli in pelle e simili                 ,0,0,0,0,0,2023
PIE,BI,C 16,Industria del legno e dei prodotti in legno e sughero (es...,0,0,0,1,1,2023
PIE,BI,C 17,Fabbricazione di carta e di prodotti di carta               ,0,0,0,0,0,2023
PIE,BI,C 18,Stampa e riproduzione di supporti registrati                ,0,1,0,0,1,2023
PIE,BI,C 19,Fabbricazione di coke e prodotti derivanti dalla raffinaz...,0,0,0,0,0,2023
PIE,BI,C 20,Fabbricazione di prodotti chimici                           ,0,0,0,0,0,2023
PIE,BI,C 21,Fabbricazione di prodotti farmaceutici di base e di prepa...,0,0,0,0,0,2023
PIE,BI,C 22,Fabbricazione di articoli in gomma e materie plastiche      ,0,0,0,0,0,2023
PIE,BI,C 23,Fabbricazione di altri prodotti della lavorazione di miner..,0,0,0,0,0,2023
PIE,BI,C 24,Metallurgia                                                 ,0,0,0,0,0,2023
PIE,BI,C 25,Fabbricazione di prodotti in metallo (esclusi macchinari ...,0,1,0,0,1,2023
PIE,BI,C 26,Fabbricazione di computer e prodotti di elettronica e ott...,0,1,0,0,1,2023
PIE,BI,C 27,Fabbricazione di apparecchiature elettriche ed apparecchi...,0,2,0,0,2,2023
PIE,BI,C 28,Fabbricazione di macchinari ed apparecchiature nca          ,0,1,0,0,1,2023
PIE,BI,C 29,"Fabbricazione di autoveicoli, rimorchi e semirimorchi       ",0,0,0,0,0,2023
PIE,BI,C 30,Fabbricazione di altri mezzi di trasporto                   ,0,0,0,0,0,2023
PIE,BI,C 31,Fabbricazione di mobili                                     ,0,0,0,0,0,2023
PIE,BI,C 32,Altre industrie manifatturiere                              ,0,0,0,0,0,2023
PIE,BI,C 33,"Riparazione, manutenzione ed installazione di macchine ed...",0,0,0,0,0,2023
PIE,BI,D   ,"Fornitura di energia elettrica, gas, vapore e aria condiz...",0,0,0,1,1,2023
PIE,BI,D 35,"Fornitura di energia elettrica, gas, vapore e aria condiz...",0,0,0,1,1,2023
PIE,BI,E   ,"Fornitura di acqua; reti fognarie, attività di gestione d...",0,0,0,1,1,2023
PIE,BI,E 36,"Raccolta, trattamento e fornitura di acqua                  ",0,0,0,1,1,2023
PIE,BI,E 37,Gestione delle reti fognarie                                ,0,0,0,0,0,2023
PIE,BI,E 38,"Attività di raccolta, trattamento e smaltimento dei rifiu...",0,0,0,0,0,2023
PIE,BI,E 39,Attività di risanamento e altri servizi di gestione dei r...,0,0,0,0,0,2023
PIE,BI,F   ,Costruzioni                                                 ,0,13,1,5,19,2023
PIE,BI,F 41,Costruzione di edifici                                      ,0,6,0,5,11,2023
PIE,BI,F 42,Ingegneria civile                                           ,0,0,0,0,0,2023
PIE,BI,F 43,Lavori di costruzione specializzati                         ,0,7,1,0,8,2023
PIE,BI,G   ,Commercio all'ingrosso e al dettaglio; riparazione di aut...,0,35,0,6,41,2023
PIE,BI,G 45,Commercio all'ingrosso e al dettaglio e riparazione di au...,0,2,0,0,2,2023
PIE,BI,G 46,Commercio all'ingrosso (escluso quello di autoveicoli e d...,0,14,0,2,16,2023
PIE,BI,G 47,Commercio al dettaglio (escluso quello di autoveicoli e d...,0,19,0,4,23,2023
PIE,BI,H   ,Trasporto e magazzinaggio                                   ,0,1,0,0,1,2023
PIE,BI,H 49,Trasporto terrestre e mediante condotte                     ,0,1,0,0,1,2023
PIE,BI,H 50,Trasporto marittimo e per vie d'acqua                       ,0,0,0,0,0,2023
PIE,BI,H 51,Trasporto aereo                                             ,0,0,0,0,0,2023
PIE,BI,H 52,Magazzinaggio e attività di supporto ai trasporti           ,0,0,0,0,0,2023
PIE,BI,H 53,Servizi postali e attività di corriere                      ,0,0,0,0,0,2023
PIE,BI,I   ,Attività dei servizi alloggio e ristorazione                ,0,37,0,1,38,2023
PIE,BI,I 55,Alloggio                                                    ,0,0,0,0,0,2023
PIE,BI,I 56,Attività dei servizi di ristorazione                        ,0,37,0,1,38,2023
PIE,BI,J   ,Servizi di informazione e comunicazione                     ,0,8,0,1,9,2023
PIE,BI,J 58,Attività editoriali                                         ,0,1,0,0,1,2023
PIE,BI,J 59,"Attività di produzione cinematografica, di video e di pro...",0,0,0,0,0,2023
PIE,BI,J 60,Attività di programmazione e trasmissione                   ,0,0,0,1,1,2023
PIE,BI,J 61,Telecomunicazioni                                           ,0,0,0,0,0,2023
PIE,BI,J 62,"Produzione di software, consulenza informatica e attività...",0,2,0,0,2,2023
PIE,BI,J 63,Attività dei servizi d'informazione e altri servizi infor...,0,5,0,0,5,2023
PIE,BI,K   ,Attività finanziarie e assicurative                         ,0,1,0,0,1,2023
PIE,BI,K 64,Attività di servizi finanziari (escluse le assicurazioni ...,0,0,0,0,0,2023
PIE,BI,K 65,"Assicurazioni, riassicurazioni e fondi pensione (escluse ...",0,0,0,0,0,2023
PIE,BI,K 66,Attività ausiliarie dei servizi finanziari e delle attivi...,0,1,0,0,1,2023
PIE,BI,L   ,Attivita' immobiliari                                       ,0,14,0,2,16,2023
PIE,BI,L 68,Attivita' immobiliari                                       ,0,14,0,2,16,2023
PIE,BI,M   ,"Attività professionali, scientifiche e tecniche             ",0,2,0,0,2,2023
PIE,BI,M 69,Attività legali e contabilità                               ,0,0,0,0,0,2023
PIE,BI,M 70,Attività di direzione aziendale e di consulenza gestional...,0,1,0,0,1,2023
PIE,BI,M 71,Attività degli studi di architettura e d'ingegneria; coll...,0,0,0,0,0,2023
PIE,BI,M 72,Ricerca scientifica e sviluppo                              ,0,0,0,0,0,2023
PIE,BI,M 73,Pubblicità e ricerche di mercato                            ,0,0,0,0,0,2023
PIE,BI,M 74,"Altre attività professionali, scientifiche e tecniche       ",0,1,0,0,1,2023
PIE,BI,M 75,Servizi veterinari                                          ,0,0,0,0,0,2023
PIE,BI,N   ,"Noleggio, agenzie di viaggio, servizi di supporto alle im...",0,4,0,2,6,2023
PIE,BI,N 77,Attività di noleggio e leasing operativo                    ,0,1,0,0,1,2023
PIE,BI,N 78,"Attività di ricerca, selezione, fornitura di personale      ",0,0,0,0,0,2023
PIE,BI,N 79,"Attività dei servizi delle agenzie di viaggio, dei tour o...",0,1,0,0,1,2023
PIE,BI,N 80,Servizi di vigilanza e investigazione                       ,0,0,0,0,0,2023
PIE,BI,N 81,Attività di servizi per edifici e paesaggio                 ,0,1,0,1,2,2023
PIE,BI,N 82,Attività di supporto per le funzioni d'ufficio e altri se...,0,1,0,1,2,2023
PIE,BI,O   ,Amministrazione pubblica e difesa; assicurazione sociale ...,0,0,0,0,0,2023
PIE,BI,O 84,Amministrazione pubblica e difesa; assicurazione sociale ...,0,0,0,0,0,2023
PIE,BI,P   ,Istruzione                                                  ,0,1,0,0,1,2023
PIE,BI,P 85,Istruzione                                                  ,0,1,0,0,1,2023
PIE,BI,Q   ,Sanita' e assistenza sociale                                ,0,0,0,0,0,2023
PIE,BI,Q 86,Assistenza sanitaria                                        ,0,0,0,0,0,2023
PIE,BI,Q 87,Servizi di assistenza sociale residenziale                  ,0,0,0,0,0,2023
PIE,BI,Q 88,Assistenza sociale non residenziale                         ,0,0,0,0,0,2023
PIE,BI,R   ,"Attività artistiche, sportive, di intrattenimento e diver...",0,1,0,0,1,2023
PIE,BI,R 90,"Attività creative, artistiche e di intrattenimento          ",0,0,0,0,0,2023
PIE,BI,R 91,"Attività di biblioteche, archivi, musei ed altre attività...",0,0,0,0,0,2023
PIE,BI,R 92,"Attività riguardanti le lotterie, le scommesse, le case d...",0,0,0,0,0,2023
PIE,BI,R 93,"Attività sportive, di intrattenimento e di divertimento     ",0,1,0,0,1,2023
PIE,BI,S   ,Altre attività di servizi                                   ,0,3,0,0,3,2023
PIE,BI,S 94,Attività di organizzazioni associative                      ,0,0,0,0,0,2023
PIE,BI,S 95,Riparazione di computer e di beni per uso personale e per...,0,0,0,0,0,2023
PIE,BI,S 96,Altre attività di servizi per la persona                    ,0,3,0,0,3,2023
PIE,BI,T   ,Attività di famiglie e convivenze come datori di lavoro p...,0,0,0,0,0,2023
PIE,BI,T 97,Attività di famiglie e convivenze come datori di lavoro p...,0,0,0,0,0,2023
PIE,BI,T 98,Produzione di beni e servizi indifferenziati per uso prop...,0,0,0,0,0,2023
PIE,BI,U   ,Organizzazioni ed organismi extraterritoriali               ,0,0,0,0,0,2023
PIE,BI,U 99,Organizzazioni ed organismi extraterritoriali               ,0,0,0,0,0,2023
PIE,BI,XX  ,Imprese non classificate                                    ,0,39,0,9,48,2023
PIE,BI,TOT ,TOTALE                                                      ,0,193,1,29,223,2023
PIE,VB,A   ,"Agricoltura, silvicoltura pesca                             ",0,0,0,0,0,2023
PIE,VB,A 01,"Coltivazioni agricole e produzione di prodotti animali, c...",0,0,0,0,0,2023
PIE,VB,A 02,Silvicoltura ed utilizzo di aree forestali                  ,0,0,0,0,0,2023
PIE,VB,A 03,Pesca e acquacoltura                                        ,0,0,0,0,0,2023
PIE,VB,B   ,Estrazione di minerali da cave e miniere                    ,0,0,0,0,0,2023
PIE,VB,B 05,Estrazione di carbone (esclusa torba)                       ,0,0,0,0,0,2023
PIE,VB,B 06,Estraz.di petrolio greggio e di gas naturale                ,0,0,0,0,0,2023
PIE,VB,B 07,Estrazione di minerali metalliferi                          ,0,0,0,0,0,2023
PIE,VB,B 08,Altre attività di estrazione di minerali da cave e miniere  ,0,0,0,0,0,2023
PIE,VB,B 09,Attività dei servizi di supporto all'estrazione             ,0,0,0,0,0,2023
PIE,VB,C   ,Attività manifatturiere                                     ,0,2,0,0,2,2023
PIE,VB,C 10,Industrie alimentari                                        ,0,1,0,0,1,2023
PIE,VB,C 11,Industria delle bevande                                     ,0,0,0,0,0,2023
PIE,VB,C 12,Industria del tabacco                                       ,0,0,0,0,0,2023
PIE,VB,C 13,Industrie tessili                                           ,0,0,0,0,0,2023
PIE,VB,C 14,Confezione di articoli di abbigliamento; confezione di ar...,0,0,0,0,0,2023
PIE,VB,C 15,Fabbricazione di articoli in pelle e simili                 ,0,0,0,0,0,2023
PIE,VB,C 16,Industria del legno e dei prodotti in legno e sughero (es...,0,0,0,0,0,2023
PIE,VB,C 17,Fabbricazione di carta e di prodotti di carta               ,0,0,0,0,0,2023
PIE,VB,C 18,Stampa e riproduzione di supporti registrati                ,0,0,0,0,0,2023
PIE,VB,C 19,Fabbricazione di coke e prodotti derivanti dalla raffinaz...,0,0,0,0,0,2023
PIE,VB,C 20,Fabbricazione di prodotti chimici                           ,0,0,0,0,0,2023
PIE,VB,C 21,Fabbricazione di prodotti farmaceutici di base e di prepa...,0,0,0,0,0,2023
PIE,VB,C 22,Fabbricazione di articoli in gomma e materie plastiche      ,0,0,0,0,0,2023
PIE,VB,C 23,Fabbricazione di altri prodotti della lavorazione di miner..,0,0,0,0,0,2023
PIE,VB,C 24,Metallurgia                                                 ,0,0,0,0,0,2023
PIE,VB,C 25,Fabbricazione di prodotti in metallo (esclusi macchinari ...,0,1,0,0,1,2023
PIE,VB,C 26,Fabbricazione di computer e prodotti di elettronica e ott...,0,0,0,0,0,2023
PIE,VB,C 27,Fabbricazione di apparecchiature elettriche ed apparecchi...,0,0,0,0,0,2023
PIE,VB,C 28,Fabbricazione di macchinari ed apparecchiature nca          ,0,0,0,0,0,2023
PIE,VB,C 29,"Fabbricazione di autoveicoli, rimorchi e semirimorchi       ",0,0,0,0,0,2023
PIE,VB,C 30,Fabbricazione di altri mezzi di trasporto                   ,0,0,0,0,0,2023
PIE,VB,C 31,Fabbricazione di mobili                                     ,0,0,0,0,0,2023
PIE,VB,C 32,Altre industrie manifatturiere                              ,0,0,0,0,0,2023
PIE,VB,C 33,"Riparazione, manutenzione ed installazione di macchine ed...",0,0,0,0,0,2023
PIE,VB,D   ,"Fornitura di energia elettrica, gas, vapore e aria condiz...",0,0,0,0,0,2023
PIE,VB,D 35,"Fornitura di energia elettrica, gas, vapore e aria condiz...",0,0,0,0,0,2023
PIE,VB,E   ,"Fornitura di acqua; reti fognarie, attività di gestione d...",0,0,0,0,0,2023
PIE,VB,E 36,"Raccolta, trattamento e fornitura di acqua                  ",0,0,0,0,0,2023
PIE,VB,E 37,Gestione delle reti fognarie                                ,0,0,0,0,0,2023
PIE,VB,E 38,"Attività di raccolta, trattamento e smaltimento dei rifiu...",0,0,0,0,0,2023
PIE,VB,E 39,Attività di risanamento e altri servizi di gestione dei r...,0,0,0,0,0,2023
PIE,VB,F   ,Costruzioni                                                 ,0,1,0,0,1,2023
PIE,VB,F 41,Costruzione di edifici                                      ,0,0,0,0,0,2023
PIE,VB,F 42,Ingegneria civile                                           ,0,0,0,0,0,2023
PIE,VB,F 43,Lavori di costruzione specializzati                         ,0,1,0,0,1,2023
PIE,VB,G   ,Commercio all'ingrosso e al dettaglio; riparazione di aut...,0,9,0,0,9,2023
PIE,VB,G 45,Commercio all'ingrosso e al dettaglio e riparazione di au...,0,1,0,0,1,2023
PIE,VB,G 46,Commercio all'ingrosso (escluso quello di autoveicoli e d...,0,2,0,0,2,2023
PIE,VB,G 47,Commercio al dettaglio (escluso quello di autoveicoli e d...,0,6,0,0,6,2023
PIE,VB,H   ,Trasporto e magazzinaggio                                   ,0,2,0,0,2,2023
PIE,VB,H 49,Trasporto terrestre e mediante condotte                     ,0,2,0,0,2,2023
PIE,VB,H 50,Trasporto marittimo e per vie d'acqua                       ,0,0,0,0,0,2023
PIE,VB,H 51,Trasporto aereo                                             ,0,0,0,0,0,2023
PIE,VB,H 52,Magazzinaggio e attività di supporto ai trasporti           ,0,0,0,0,0,2023
PIE,VB,H 53,Servizi postali e attività di corriere                      ,0,0,0,0,0,2023
PIE,VB,I   ,Attività dei servizi alloggio e ristorazione                ,0,19,0,1,20,2023
PIE,VB,I 55,Alloggio                                                    ,0,0,0,0,0,2023
PIE,VB,I 56,Attività dei servizi di ristorazione                        ,0,19,0,1,20,2023
PIE,VB,J   ,Servizi di informazione e comunicazione                     ,0,0,0,0,0,2023
PIE,VB,J 58,Attività editoriali                                         ,0,0,0,0,0,2023
PIE,VB,J 59,"Attività di produzione cinematografica, di video e di pro...",0,0,0,0,0,2023
PIE,VB,J 60,Attività di programmazione e trasmissione                   ,0,0,0,0,0,2023
PIE,VB,J 61,Telecomunicazioni                                           ,0,0,0,0,0,2023
PIE,VB,J 62,"Produzione di software, consulenza informatica e attività...",0,0,0,0,0,2023
PIE,VB,J 63,Attività dei servizi d'informazione e altri servizi infor...,0,0,0,0,0,2023
PIE,VB,K   ,Attività finanziarie e assicurative                         ,0,0,0,0,0,2023
PIE,VB,K 64,Attività di servizi finanziari (escluse le assicurazioni ...,0,0,0,0,0,2023
PIE,VB,K 65,"Assicurazioni, riassicurazioni e fondi pensione (escluse ...",0,0,0,0,0,2023
PIE,VB,K 66,Attività ausiliarie dei servizi finanziari e delle attivi...,0,0,0,0,0,2023
PIE,VB,L   ,Attivita' immobiliari                                       ,0,0,0,0,0,2023
PIE,VB,L 68,Attivita' immobiliari                                       ,0,0,0,0,0,2023
PIE,VB,M   ,"Attività professionali, scientifiche e tecniche             ",0,1,0,1,2,2023
PIE,VB,M 69,Attività legali e contabilità                               ,0,0,0,1,1,2023
PIE,VB,M 70,Attività di direzione aziendale e di consulenza gestional...,0,0,0,0,0,2023
PIE,VB,M 71,Attività degli studi di architettura e d'ingegneria; coll...,0,0,0,0,0,2023
PIE,VB,M 72,Ricerca scientifica e sviluppo                              ,0,0,0,0,0,2023
PIE,VB,M 73,Pubblicità e ricerche di mercato                            ,0,0,0,0,0,2023
PIE,VB,M 74,"Altre attività professionali, scientifiche e tecniche       ",0,1,0,0,1,2023
PIE,VB,M 75,Servizi veterinari                                          ,0,0,0,0,0,2023
PIE,VB,N   ,"Noleggio, agenzie di viaggio, servizi di supporto alle im...",0,0,0,1,1,2023
PIE,VB,N 77,Attività di noleggio e leasing operativo                    ,0,0,0,0,0,2023
PIE,VB,N 78,"Attività di ricerca, selezione, fornitura di personale      ",0,0,0,0,0,2023
PIE,VB,N 79,"Attività dei servizi delle agenzie di viaggio, dei tour o...",0,0,0,0,0,2023
PIE,VB,N 80,Servizi di vigilanza e investigazione                       ,0,0,0,0,0,2023
PIE,VB,N 81,Attività di servizi per edifici e paesaggio                 ,0,0,0,1,1,2023
PIE,VB,N 82,Attività di supporto per le funzioni d'ufficio e altri se...,0,0,0,0,0,2023
PIE,VB,O   ,Amministrazione pubblica e difesa; assicurazione sociale ...,0,0,0,0,0,2023
PIE,VB,O 84,Amministrazione pubblica e difesa; assicurazione sociale ...,0,0,0,0,0,2023
PIE,VB,P   ,Istruzione                                                  ,0,0,0,0,0,2023
PIE,VB,P 85,Istruzione                                                  ,0,0,0,0,0,2023
PIE,VB,Q   ,Sanita' e assistenza sociale                                ,0,0,0,3,3,2023
PIE,VB,Q 86,Assistenza sanitaria                                        ,0,0,0,0,0,2023
PIE,VB,Q 87,Servizi di assistenza sociale residenziale                  ,0,0,0,1,1,2023
PIE,VB,Q 88,Assistenza sociale non residenziale                         ,0,0,0,2,2,2023
PIE,VB,R   ,"Attività artistiche, sportive, di intrattenimento e diver...",0,1,0,0,1,2023
PIE,VB,R 90,"Attività creative, artistiche e di intrattenimento          ",0,0,0,0,0,2023
PIE,VB,R 91,"Attività di biblioteche, archivi, musei ed altre attività...",0,0,0,0,0,2023
PIE,VB,R 92,"Attività riguardanti le lotterie, le scommesse, le case d...",0,0,0,0,0,2023
PIE,VB,R 93,"Attività sportive, di intrattenimento e di divertimento     ",0,1,0,0,1,2023
PIE,VB,S   ,Altre attività di servizi                                   ,0,0,0,0,0,2023
PIE,VB,S 94,Attività di organizzazioni associative                      ,0,0,0,0,0,2023
PIE,VB,S 95,Riparazione di computer e di beni per uso personale e per...,0,0,0,0,0,2023
PIE,VB,S 96,Altre attività di servizi per la persona                    ,0,0,0,0,0,2023
PIE,VB,T   ,Attività di famiglie e convivenze come datori di lavoro p...,0,0,0,0,0,2023
PIE,VB,T 97,Attività di famiglie e convivenze come datori di lavoro p...,0,0,0,0,0,2023
PIE,VB,T 98,Produzione di beni e servizi indifferenziati per uso prop...,0,0,0,0,0,2023
PIE,VB,U   ,Organizzazioni ed organismi extraterritoriali               ,0,0,0,0,0,2023
PIE,VB,U 99,Organizzazioni ed organismi extraterritoriali               ,0,0,0,0,0,2023
PIE,VB,XX  ,Imprese non classificate                                    ,0,7,0,0,7,2023
PIE,VB,TOT ,TOTALE                                                      ,0,42,0,6,48,2023
VAO,  ,A   ,"Agricoltura, silvicoltura pesca                             ",0,0,0,0,0,2023
VAO,  ,A 01,"Coltivazioni agricole e produzione di prodotti animali, c...",0,0,0,0,0,2023
VAO,  ,A 02,Silvicoltura ed utilizzo di aree forestali                  ,0,0,0,0,0,2023
VAO,  ,A 03,Pesca e acquacoltura                                        ,0,0,0,0,0,2023
VAO,  ,B   ,Estrazione di minerali da cave e miniere                    ,0,0,0,0,0,2023
VAO,  ,B 05,Estrazione di carbone (esclusa torba)                       ,0,0,0,0,0,2023
VAO,  ,B 06,Estraz.di petrolio greggio e di gas naturale                ,0,0,0,0,0,2023
VAO,  ,B 07,Estrazione di minerali metalliferi                          ,0,0,0,0,0,2023
VAO,  ,B 08,Altre attività di estrazione di minerali da cave e miniere  ,0,0,0,0,0,2023
VAO,  ,B 09,Attività dei servizi di supporto all'estrazione             ,0,0,0,0,0,2023
VAO,  ,C   ,Attività manifatturiere                                     ,0,0,0,0,0,2023
VAO,  ,C 10,Industrie alimentari                                        ,0,0,0,0,0,2023
VAO,  ,C 11,Industria delle bevande                                     ,0,0,0,0,0,2023
VAO,  ,C 12,Industria del tabacco                                       ,0,0,0,0,0,2023
VAO,  ,C 13,Industrie tessili                                           ,0,0,0,0,0,2023
VAO,  ,C 14,Confezione di articoli di abbigliamento; confezione di ar...,0,0,0,0,0,2023
VAO,  ,C 15,Fabbricazione di articoli in pelle e simili                 ,0,0,0,0,0,2023
VAO,  ,C 16,Industria del legno e dei prodotti in legno e sughero (es...,0,0,0,0,0,2023
VAO,  ,C 17,Fabbricazione di carta e di prodotti di carta               ,0,0,0,0,0,2023
VAO,  ,C 18,Stampa e riproduzione di supporti registrati                ,0,0,0,0,0,2023
VAO,  ,C 19,Fabbricazione di coke e prodotti derivanti dalla raffinaz...,0,0,0,0,0,2023
VAO,  ,C 20,Fabbricazione di prodotti chimici                           ,0,0,0,0,0,2023
VAO,  ,C 21,Fabbricazione di prodotti farmaceutici di base e di prepa...,0,0,0,0,0,2023
VAO,  ,C 22,Fabbricazione di articoli in gomma e materie plastiche      ,0,0,0,0,0,2023
VAO,  ,C 23,Fabbricazione di altri prodotti della lavorazione di miner..,0,0,0,0,0,2023
VAO,  ,C 24,Metallurgia                                                 ,0,0,0,0,0,2023
VAO,  ,C 25,Fabbricazione di prodotti in metallo (esclusi macchinari ...,0,0,0,0,0,2023
VAO,  ,C 26,Fabbricazione di computer e prodotti di elettronica e ott...,0,0,0,0,0,2023
VAO,  ,C 27,Fabbricazione di apparecchiature elettriche ed apparecchi...,0,0,0,0,0,2023
VAO,  ,C 28,Fabbricazione di macchinari ed apparecchiature nca          ,0,0,0,0,0,2023
VAO,  ,C 29,"Fabbricazione di autoveicoli, rimorchi e semirimorchi       ",0,0,0,0,0,2023
VAO,  ,C 30,Fabbricazione di altri mezzi di trasporto                   ,0,0,0,0,0,2023
VAO,  ,C 31,Fabbricazione di mobili                                     ,0,0,0,0,0,2023
VAO,  ,C 32,Altre industrie manifatturiere                              ,0,0,0,0,0,2023
VAO,  ,C 33,"Riparazione, manutenzione ed installazione di macchine ed...",0,0,0,0,0,2023
VAO,  ,D   ,"Fornitura di energia elettrica, gas, vapore e aria condiz...",0,0,0,0,0,2023
VAO,  ,D 35,"Fornitura di energia elettrica, gas, vapore e aria condiz...",0,0,0,0,0,2023
VAO,  ,E   ,"Fornitura di acqua; reti fognarie, attività di gestione d...",0,0,0,0,0,2023
VAO,  ,E 36,"Raccolta, trattamento e fornitura di acqua                  ",0,0,0,0,0,2023
VAO,  ,E 37,Gestione delle reti fognarie                                ,0,0,0,0,0,2023
VAO,  ,E 38,"Attività di raccolta, trattamento e smaltimento dei rifiu...",0,0,0,0,0,2023
VAO,  ,E 39,Attività di risanamento e altri servizi di gestione dei r...,0,0,0,0,0,2023
VAO,  ,F   ,Costruzioni                                                 ,0,0,0,1,1,2023
VAO,  ,F 41,Costruzione di edifici                                      ,0,0,0,1,1,2023
VAO,  ,F 42,Ingegneria civile                                           ,0,0,0,0,0,2023
VAO,  ,F 43,Lavori di costruzione specializzati                         ,0,0,0,0,0,2023
VAO,  ,G   ,Commercio all'ingrosso e al dettaglio; riparazione di aut...,0,0,0,0,0,2023
VAO,  ,G 45,Commercio all'ingrosso e al dettaglio e riparazione di au...,0,0,0,0,0,2023
VAO,  ,G 46,Commercio all'ingrosso (escluso quello di autoveicoli e d...,0,0,0,0,0,2023
VAO,  ,G 47,Commercio al dettaglio (escluso quello di autoveicoli e d...,0,0,0,0,0,2023
VAO,  ,H   ,Trasporto e magazzinaggio                                   ,0,0,0,0,0,2023
VAO,  ,H 49,Trasporto terrestre e mediante condotte                     ,0,0,0,0,0,2023
VAO,  ,H 50,Trasporto marittimo e per vie d'acqua                       ,0,0,0,0,0,2023
VAO,  ,H 51,Trasporto aereo                                             ,0,0,0,0,0,2023
VAO,  ,H 52,Magazzinaggio e attività di supporto ai trasporti           ,0,0,0,0,0,2023
VAO,  ,H 53,Servizi postali e attività di corriere                      ,0,0,0,0,0,2023
VAO,  ,I   ,Attività dei servizi alloggio e ristorazione                ,0,0,0,0,0,2023
VAO,  ,I 55,Alloggio                                                    ,0,0,0,0,0,2023
VAO,  ,I 56,Attività dei servizi di ristorazione                        ,0,0,0,0,0,2023
VAO,  ,J   ,Servizi di informazione e comunicazione                     ,0,0,0,0,0,2023
VAO,  ,J 58,Attività editoriali                                         ,0,0,0,0,0,2023
VAO,  ,J 59,"Attività di produzione cinematografica, di video e di pro...",0,0,0,0,0,2023
VAO,  ,J 60,Attività di programmazione e trasmissione                   ,0,0,0,0,0,2023
VAO,  ,J 61,Telecomunicazioni                                           ,0,0,0,0,0,2023
VAO,  ,J 62,"Produzione di software, consulenza informatica e attività...",0,0,0,0,0,2023
VAO,  ,J 63,Attività dei servizi d'informazione e altri servizi infor...,0,0,0,0,0,2023
VAO,  ,K   ,Attività finanziarie e assicurative                         ,0,0,0,0,0,2023
VAO,  ,K 64,Attività di servizi finanziari (escluse le assicurazioni ...,0,0,0,0,0,2023
VAO,  ,K 65,"Assicurazioni, riassicurazioni e fondi pensione (escluse ...",0,0,0,0,0,2023
VAO,  ,K 66,Attività ausiliarie dei servizi finanziari e delle attivi...,0,0,0,0,0,2023
VAO,  ,L   ,Attivita' immobiliari                                       ,0,0,0,0,0,2023
VAO,  ,L 68,Attivita' immobiliari                                       ,0,0,0,0,0,2023
VAO,  ,M   ,"Attività professionali, scientifiche e tecniche             ",0,0,0,0,0,2023
VAO,  ,M 69,Attività legali e contabilità                               ,0,0,0,0,0,2023
VAO,  ,M 70,Attività di direzione aziendale e di consulenza gestional...,0,0,0,0,0,2023
VAO,  ,M 71,Attività degli studi di architettura e d'ingegneria; coll...,0,0,0,0,0,2023
VAO,  ,M 72,Ricerca scientifica e sviluppo                              ,0,0,0,0,0,2023
VAO,  ,M 73,Pubblicità e ricerche di mercato                            ,0,0,0,0,0,2023
VAO,  ,M 74,"Altre attività professionali, scientifiche e tecniche       ",0,0,0,0,0,2023
VAO,  ,M 75,Servizi veterinari                                          ,0,0,0,0,0,2023
VAO,  ,N   ,"Noleggio, agenzie di viaggio, servizi di supporto alle im...",0,0,0,1,1,2023
VAO,  ,N 77,Attività di noleggio e leasing operativo                    ,0,0,0,0,0,2023
VAO,  ,N 78,"Attività di ricerca, selezione, fornitura di personale      ",0,0,0,0,0,2023
VAO,  ,N 79,"Attività dei servizi delle agenzie di viaggio, dei tour o...",0,0,0,0,0,2023
VAO,  ,N 80,Servizi di vigilanza e investigazione                       ,0,0,0,0,0,2023
VAO,  ,N 81,Attività di servizi per edifici e paesaggio                 ,0,0,0,1,1,2023
VAO,  ,N 82,Attività di supporto per le funzioni d'ufficio e altri se...,0,0,0,0,0,2023
VAO,  ,O   ,Amministrazione pubblica e difesa; assicurazione sociale ...,0,0,0,0,0,2023
VAO,  ,O 84,Amministrazione pubblica e difesa; assicurazione sociale ...,0,0,0,0,0,2023
VAO,  ,P   ,Istruzione                                                  ,0,0,0,0,0,2023
VAO,  ,P 85,Istruzione                                                  ,0,0,0,0,0,2023
VAO,  ,Q   ,Sanita' e assistenza sociale                                ,0,0,0,0,0,2023
VAO,  ,Q 86,Assistenza sanitaria                                        ,0,0,0,0,0,2023
VAO,  ,Q 87,Servizi di assistenza sociale residenziale                  ,0,0,0,0,0,2023
VAO,  ,Q 88,Assistenza sociale non residenziale                         ,0,0,0,0,0,2023
VAO,  ,R   ,"Attività artistiche, sportive, di intrattenimento e diver...",0,0,0,0,0,2023
VAO,  ,R 90,"Attività creative, artistiche e di intrattenimento          ",0,0,0,0,0,2023
VAO,  ,R 91,"Attività di biblioteche, archivi, musei ed altre attività...",0,0,0,0,0,2023
VAO,  ,R 92,"Attività riguardanti le lotterie, le scommesse, le case d...",0,0,0,0,0,2023
VAO,  ,R 93,"Attività sportive, di intrattenimento e di divertimento     ",0,0,0,0,0,2023
VAO,  ,S   ,Altre attività di servizi                                   ,0,0,0,0,0,2023
VAO,  ,S 94,Attività di organizzazioni associative                      ,0,0,0,0,0,2023
VAO,  ,S 95,Riparazione di computer e di beni per uso personale e per...,0,0,0,0,0,2023
VAO,  ,S 96,Altre attività di servizi per la persona                    ,0,0,0,0,0,2023
VAO,  ,T   ,Attività di famiglie e convivenze come datori di lavoro p...,0,0,0,0,0,2023
VAO,  ,T 97,Attività di famiglie e convivenze come datori di lavoro p...,0,0,0,0,0,2023
VAO,  ,T 98,Produzione di beni e servizi indifferenziati per uso prop...,0,0,0,0,0,2023
VAO,  ,U   ,Organizzazioni ed organismi extraterritoriali               ,0,0,0,0,0,2023
VAO,  ,U 99,Organizzazioni ed organismi extraterritoriali               ,0,0,0,0,0,2023
VAO,  ,XX  ,Imprese non classificate                                    ,0,0,0,0,0,2023
VAO,  ,TOT ,TOTALE                                                      ,0,0,0,2,2,2023
VAO,AO,A   ,"Agricoltura, silvicoltura pesca                             ",0,0,0,0,0,2023
VAO,AO,A 01,"Coltivazioni agricole e produzione di prodotti animali, c...",0,0,0,0,0,2023
VAO,AO,A 02,Silvicoltura ed utilizzo di aree forestali                  ,0,0,0,0,0,2023
VAO,AO,A 03,Pesca e acquacoltura                                        ,0,0,0,0,0,2023
VAO,AO,B   ,Estrazione di minerali da cave e miniere                    ,0,0,0,0,0,2023
VAO,AO,B 05,Estrazione di carbone (esclusa torba)                       ,0,0,0,0,0,2023
VAO,AO,B 06,Estraz.di petrolio greggio e di gas naturale                ,0,0,0,0,0,2023
VAO,AO,B 07,Estrazione di minerali metalliferi                          ,0,0,0,0,0,2023
VAO,AO,B 08,Altre attività di estrazione di minerali da cave e miniere  ,0,0,0,0,0,2023
VAO,AO,B 09,Attività dei servizi di supporto all'estrazione             ,0,0,0,0,0,2023
VAO,AO,C   ,Attività manifatturiere                                     ,0,0,0,0,0,2023
VAO,AO,C 10,Industrie alimentari                                        ,0,0,0,0,0,2023
VAO,AO,C 11,Industria delle bevande                                     ,0,0,0,0,0,2023
VAO,AO,C 12,Industria del tabacco                                       ,0,0,0,0,0,2023
VAO,AO,C 13,Industrie tessili                                           ,0,0,0,0,0,2023
VAO,AO,C 14,Confezione di articoli di abbigliamento; confezione di ar...,0,0,0,0,0,2023
VAO,AO,C 15,Fabbricazione di articoli in pelle e simili                 ,0,0,0,0,0,2023
VAO,AO,C 16,Industria del legno e dei prodotti in legno e sughero (es...,0,0,0,0,0,2023
VAO,AO,C 17,Fabbricazione di carta e di prodotti di carta               ,0,0,0,0,0,2023
VAO,AO,C 18,Stampa e riproduzione di supporti registrati                ,0,0,0,0,0,2023
VAO,AO,C 19,Fabbricazione di coke e prodotti derivanti dalla raffinaz...,0,0,0,0,0,2023
VAO,AO,C 20,Fabbricazione di prodotti chimici                           ,0,0,0,0,0,2023
VAO,AO,C 21,Fabbricazione di prodotti farmaceutici di base e di prepa...,0,0,0,0,0,2023
VAO,AO,C 22,Fabbricazione di articoli in gomma e materie plastiche      ,0,0,0,0,0,2023
VAO,AO,C 23,Fabbricazione di altri prodotti della lavorazione di miner..,0,0,0,0,0,2023
VAO,AO,C 24,Metallurgia                                                 ,0,0,0,0,0,2023
VAO,AO,C 25,Fabbricazione di prodotti in metallo (esclusi macchinari ...,0,0,0,0,0,2023
VAO,AO,C 26,Fabbricazione di computer e prodotti di elettronica e ott...,0,0,0,0,0,2023
VAO,AO,C 27,Fabbricazione di apparecchiature elettriche ed apparecchi...,0,0,0,0,0,2023
VAO,AO,C 28,Fabbricazione di macchinari ed apparecchiature nca          ,0,0,0,0,0,2023
VAO,AO,C 29,"Fabbricazione di autoveicoli, rimorchi e semirimorchi       ",0,0,0,0,0,2023
VAO,AO,C 30,Fabbricazione di altri mezzi di trasporto                   ,0,0,0,0,0,2023
VAO,AO,C 31,Fabbricazione di mobili                                     ,0,0,0,0,0,2023
VAO,AO,C 32,Altre industrie manifatturiere                              ,0,0,0,0,0,2023
VAO,AO,C 33,"Riparazione, manutenzione ed installazione di macchine ed...",0,0,0,0,0,2023
VAO,AO,D   ,"Fornitura di energia elettrica, gas, vapore e aria condiz...",0,0,0,0,0,2023
VAO,AO,D 35,"Fornitura di energia elettrica, gas, vapore e aria condiz...",0,0,0,0,0,2023
VAO,AO,E   ,"Fornitura di acqua; reti fognarie, attività di gestione d...",0,0,0,0,0,2023
VAO,AO,E 36,"Raccolta, trattamento e fornitura di acqua                  ",0,0,0,0,0,2023
VAO,AO,E 37,Gestione delle reti fognarie                                ,0,0,0,0,0,2023
VAO,AO,E 38,"Attività di raccolta, trattamento e smaltimento dei rifiu...",0,0,0,0,0,2023
VAO,AO,E 39,Attività di risanamento e altri servizi di gestione dei r...,0,0,0,0,0,2023
VAO,AO,F   ,Costruzioni                                                 ,0,0,0,1,1,2023
VAO,AO,F 41,Costruzione di edifici                                      ,0,0,0,1,1,2023
VAO,AO,F 42,Ingegneria civile                                           ,0,0,0,0,0,2023
VAO,AO,F 43,Lavori di costruzione specializzati                         ,0,0,0,0,0,2023
VAO,AO,G   ,Commercio all'ingrosso e al dettaglio; riparazione di aut...,0,0,0,0,0,2023
VAO,AO,G 45,Commercio all'ingrosso e al dettaglio e riparazione di au...,0,0,0,0,0,2023
VAO,AO,G 46,Commercio all'ingrosso (escluso quello di autoveicoli e d...,0,0,0,0,0,2023
VAO,AO,G 47,Commercio al dettaglio (escluso quello di autoveicoli e d...,0,0,0,0,0,2023
VAO,AO,H   ,Trasporto e magazzinaggio                                   ,0,0,0,0,0,2023
VAO,AO,H 49,Trasporto terrestre e mediante condotte                     ,0,0,0,0,0,2023
VAO,AO,H 50,Trasporto marittimo e per vie d'acqua                       ,0,0,0,0,0,2023
VAO,AO,H 51,Trasporto aereo                                             ,0,0,0,0,0,2023
VAO,AO,H 52,Magazzinaggio e attività di supporto ai trasporti           ,0,0,0,0,0,2023
VAO,AO,H 53,Servizi postali e attività di corriere                      ,0,0,0,0,0,2023
VAO,AO,I   ,Attività dei servizi alloggio e ristorazione                ,0,0,0,0,0,2023
VAO,AO,I 55,Alloggio                                                    ,0,0,0,0,0,2023
VAO,AO,I 56,Attività dei servizi di ristorazione                        ,0,0,0,0,0,2023
VAO,AO,J   ,Servizi di informazione e comunicazione                     ,0,0,0,0,0,2023
VAO,AO,J 58,Attività editoriali                                         ,0,0,0,0,0,2023
VAO,AO,J 59,"Attività di produzione cinematografica, di video e di pro...",0,0,0,0,0,2023
VAO,AO,J 60,Attività di programmazione e trasmissione                   ,0,0,0,0,0,2023
VAO,AO,J 61,Telecomunicazioni                                           ,0,0,0,0,0,2023
VAO,AO,J 62,"Produzione di software, consulenza informatica e attività...",0,0,0,0,0,2023
VAO,AO,J 63,Attività dei servizi d'informazione e altri servizi infor...,0,0,0,0,0,2023
VAO,AO,K   ,Attività finanziarie e assicurative                         ,0,0,0,0,0,2023
VAO,AO,K 64,Attività di servizi finanziari (escluse le assicurazioni ...,0,0,0,0,0,2023
VAO,AO,K 65,"Assicurazioni, riassicurazioni e fondi pensione (escluse ...",0,0,0,0,0,2023
VAO,AO,K 66,Attività ausiliarie dei servizi finanziari e delle attivi...,0,0,0,0,0,2023
VAO,AO,L   ,Attivita' immobiliari                                       ,0,0,0,0,0,2023
VAO,AO,L 68,Attivita' immobiliari                                       ,0,0,0,0,0,2023
VAO,AO,M   ,"Attività professionali, scientifiche e tecniche             ",0,0,0,0,0,2023
VAO,AO,M 69,Attività legali e contabilità                               ,0,0,0,0,0,2023
VAO,AO,M 70,Attività di direzione aziendale e di consulenza gestional...,0,0,0,0,0,2023
VAO,AO,M 71,Attività degli studi di architettura e d'ingegneria; coll...,0,0,0,0,0,2023
VAO,AO,M 72,Ricerca scientifica e sviluppo                              ,0,0,0,0,0,2023
VAO,AO,M 73,Pubblicità e ricerche di mercato                            ,0,0,0,0,0,2023
VAO,AO,M 74,"Altre attività professionali, scientifiche e tecniche       ",0,0,0,0,0,2023
VAO,AO,M 75,Servizi veterinari                                          ,0,0,0,0,0,2023
VAO,AO,N   ,"Noleggio, agenzie di viaggio, servizi di supporto alle im...",0,0,0,1,1,2023
VAO,AO,N 77,Attività di noleggio e leasing operativo                    ,0,0,0,0,0,2023
VAO,AO,N 78,"Attività di ricerca, selezione, fornitura di personale      ",0,0,0,0,0,2023
VAO,AO,N 79,"Attività dei servizi delle agenzie di viaggio, dei tour o...",0,0,0,0,0,2023
VAO,AO,N 80,Servizi di vigilanza e investigazione                       ,0,0,0,0,0,2023
VAO,AO,N 81,Attività di servizi per edifici e paesaggio                 ,0,0,0,1,1,2023
VAO,AO,N 82,Attività di supporto per le funzioni d'ufficio e altri se...,0,0,0,0,0,2023
VAO,AO,O   ,Amministrazione pubblica e difesa; assicurazione sociale ...,0,0,0,0,0,2023
VAO,AO,O 84,Amministrazione pubblica e difesa; assicurazione sociale ...,0,0,0,0,0,2023
VAO,AO,P   ,Istruzione                                                  ,0,0,0,0,0,2023
VAO,AO,P 85,Istruzione                                                  ,0,0,0,0,0,2023
VAO,AO,Q   ,Sanita' e assistenza sociale                                ,0,0,0,0,0,2023
VAO,AO,Q 86,Assistenza sanitaria                                        ,0,0,0,0,0,2023
VAO,AO,Q 87,Servizi di assistenza sociale residenziale                  ,0,0,0,0,0,2023
VAO,AO,Q 88,Assistenza sociale non residenziale                         ,0,0,0,0,0,2023
VAO,AO,R   ,"Attività artistiche, sportive, di intrattenimento e diver...",0,0,0,0,0,2023
VAO,AO,R 90,"Attività creative, artistiche e di intrattenimento          ",0,0,0,0,0,2023
VAO,AO,R 91,"Attività di biblioteche, archivi, musei ed altre attività...",0,0,0,0,0,2023
VAO,AO,R 92,"Attività riguardanti le lotterie, le scommesse, le case d...",0,0,0,0,0,2023
VAO,AO,R 93,"Attività sportive, di intrattenimento e di divertimento     ",0,0,0,0,0,2023
VAO,AO,S   ,Altre attività di servizi                                   ,0,0,0,0,0,2023
VAO,AO,S 94,Attività di organizzazioni associative                      ,0,0,0,0,0,2023
VAO,AO,S 95,Riparazione di computer e di beni per uso personale e per...,0,0,0,0,0,2023
VAO,AO,S 96,Altre attività di servizi per la persona                    ,0,0,0,0,0,2023
VAO,AO,T   ,Attività di famiglie e convivenze come datori di lavoro p...,0,0,0,0,0,2023
VAO,AO,T 97,Attività di famiglie e convivenze come datori di lavoro p...,0,0,0,0,0,2023
VAO,AO,T 98,Produzione di beni e servizi indifferenziati per uso prop...,0,0,0,0,0,2023
VAO,AO,U   ,Organizzazioni ed organismi extraterritoriali               ,0,0,0,0,0,2023
VAO,AO,U 99,Organizzazioni ed organismi extraterritoriali               ,0,0,0,0,0,2023
VAO,AO,XX  ,Imprese non classificate                                    ,0,0,0,0,0,2023
VAO,AO,TOT ,TOTALE                                                      ,0,0,0,2,2,2023
LOM,  ,A   ,"Agricoltura, silvicoltura pesca                             ",24,39,221,1,285,2023
LOM,  ,A 01,"Coltivazioni agricole e produzione di prodotti animali, c...",24,38,212,0,274,2023
LOM,  ,A 02,Silvicoltura ed utilizzo di aree forestali                  ,0,1,8,0,9,2023
LOM,  ,A 03,Pesca e acquacoltura                                        ,0,0,1,1,2,2023
LOM,  ,B   ,Estrazione di minerali da cave e miniere                    ,3,1,1,0,5,2023
LOM,  ,B 05,Estrazione di carbone (esclusa torba)                       ,0,0,0,0,0,2023
LOM,  ,B 06,Estraz.di petrolio greggio e di gas naturale                ,0,0,0,0,0,2023
LOM,  ,B 07,Estrazione di minerali metalliferi                          ,0,0,0,0,0,2023
LOM,  ,B 08,Altre attività di estrazione di minerali da cave e miniere  ,3,1,1,0,5,2023
LOM,  ,B 09,Attività dei servizi di supporto all'estrazione             ,0,0,0,0,0,2023
LOM,  ,C   ,Attività manifatturiere                                     ,364,367,529,21,1281,2023
LOM,  ,C 10,Industrie alimentari                                        ,13,25,25,4,67,2023
LOM,  ,C 11,Industria delle bevande                                     ,0,3,2,0,5,2023
LOM,  ,C 12,Industria del tabacco                                       ,0,0,0,0,0,2023
LOM,  ,C 13,Industrie tessili                                           ,34,30,19,1,84,2023
LOM,  ,C 14,Confezione di articoli di abbigliamento; confezione di ar...,49,49,122,1,221,2023
LOM,  ,C 15,Fabbricazione di articoli in pelle e simili                 ,5,5,17,1,28,2023
LOM,  ,C 16,Industria del legno e dei prodotti in legno e sughero (es...,13,18,22,0,53,2023
LOM,  ,C 17,Fabbricazione di carta e di prodotti di carta               ,6,4,3,0,13,2023
LOM,  ,C 18,Stampa e riproduzione di supporti registrati                ,10,14,9,3,36,2023
LOM,  ,C 19,Fabbricazione di coke e prodotti derivanti dalla raffinaz...,0,0,0,0,0,2023
LOM,  ,C 20,Fabbricazione di prodotti chimici                           ,9,4,2,1,16,2023
LOM,  ,C 21,Fabbricazione di prodotti farmaceutici di base e di prepa...,2,1,0,0,3,2023
LOM,  ,C 22,Fabbricazione di articoli in gomma e materie plastiche      ,18,17,19,1,55,2023
LOM,  ,C 23,Fabbricazione di altri prodotti della lavorazione di miner..,12,7,14,1,34,2023
LOM,  ,C 24,Metallurgia                                                 ,9,5,3,0,17,2023
LOM,  ,C 25,Fabbricazione di prodotti in metallo (esclusi macchinari ...,73,90,174,5,342,2023
LOM,  ,C 26,Fabbricazione di computer e prodotti di elettronica e ott...,12,6,4,0,22,2023
LOM,  ,C 27,Fabbricazione di apparecchiature elettriche ed apparecchi...,13,15,11,0,39,2023
LOM,  ,C 28,Fabbricazione di macchinari ed apparecchiature nca          ,37,22,19,0,78,2023
LOM,  ,C 29,"Fabbricazione di autoveicoli, rimorchi e semirimorchi       ",8,7,1,0,16,2023
LOM,  ,C 30,Fabbricazione di altri mezzi di trasporto                   ,3,3,2,1,9,2023
LOM,  ,C 31,Fabbricazione di mobili                                     ,14,14,15,0,43,2023
LOM,  ,C 32,Altre industrie manifatturiere                              ,15,13,14,0,42,2023
LOM,  ,C 33,"Riparazione, manutenzione ed installazione di macchine ed...",9,15,32,2,58,2023
LOM,  ,D   ,"Fornitura di energia elettrica, gas, vapore e aria condiz...",3,0,2,0,5,2023
LOM,  ,D 35,"Fornitura di energia elettrica, gas, vapore e aria condiz...",3,0,2,0,5,2023
LOM,  ,E   ,"Fornitura di acqua; reti fognarie, attività di gestione d...",5,3,5,1,14,2023
LOM,  ,E 36,"Raccolta, trattamento e fornitura di acqua                  ",0,0,0,0,0,2023
LOM,  ,E 37,Gestione delle reti fognarie                                ,1,1,1,0,3,2023
LOM,  ,E 38,"Attività di raccolta, trattamento e smaltimento dei rifiu...",4,2,4,1,11,2023
LOM,  ,E 39,Attività di risanamento e altri servizi di gestione dei r...,0,0,0,0,0,2023
LOM,  ,F   ,Costruzioni                                                 ,297,249,1186,65,1797,2023
LOM,  ,F 41,Costruzione di edifici                                      ,195,125,229,49,598,2023
LOM,  ,F 42,Ingegneria civile                                           ,6,2,2,2,12,2023
LOM,  ,F 43,Lavori di costruzione specializzati                         ,96,122,955,14,1187,2023
LOM,  ,G   ,Commercio all'ingrosso e al dettaglio; riparazione di aut...,515,532,1331,14,2392,2023
LOM,  ,G 45,Commercio all'ingrosso e al dettaglio e riparazione di au...,48,61,165,0,274,2023
LOM,  ,G 46,Commercio all'ingrosso (escluso quello di autoveicoli e d...,325,130,384,4,843,2023
LOM,  ,G 47,Commercio al dettaglio (escluso quello di autoveicoli e d...,142,341,782,10,1275,2023
LOM,  ,H   ,Trasporto e magazzinaggio                                   ,38,53,203,75,369,2023
LOM,  ,H 49,Trasporto terrestre e mediante condotte                     ,19,44,176,15,254,2023
LOM,  ,H 50,Trasporto marittimo e per vie d'acqua                       ,0,0,0,0,0,2023
LOM,  ,H 51,Trasporto aereo                                             ,1,0,0,0,1,2023
LOM,  ,H 52,Magazzinaggio e attività di supporto ai trasporti           ,17,7,16,59,99,2023
LOM,  ,H 53,Servizi postali e attività di corriere                      ,1,2,11,1,15,2023
LOM,  ,I   ,Attività dei servizi alloggio e ristorazione                ,147,707,359,6,1219,2023
LOM,  ,I 55,Alloggio                                                    ,8,14,10,0,32,2023
LOM,  ,I 56,Attività dei servizi di ristorazione                        ,139,693,349,6,1187,2023
LOM,  ,J   ,Servizi di informazione e comunicazione                     ,110,64,62,5,241,2023
LOM,  ,J 58,Attività editoriali                                         ,12,0,5,2,19,2023
LOM,  ,J 59,"Attività di produzione cinematografica, di video e di pro...",6,7,8,2,23,2023
LOM,  ,J 60,Attività di programmazione e trasmissione                   ,3,0,0,0,3,2023
LOM,  ,J 61,Telecomunicazioni                                           ,9,11,18,0,38,2023
LOM,  ,J 62,"Produzione di software, consulenza informatica e attività...",46,17,14,0,77,2023
LOM,  ,J 63,Attività dei servizi d'informazione e altri servizi infor...,34,29,17,1,81,2023
LOM,  ,K   ,Attività finanziarie e assicurative                         ,33,26,64,0,123,2023
LOM,  ,K 64,Attività di servizi finanziari (escluse le assicurazioni ...,20,4,4,0,28,2023
LOM,  ,K 65,"Assicurazioni, riassicurazioni e fondi pensione (escluse ...",0,0,0,0,0,2023
LOM,  ,K 66,Attività ausiliarie dei servizi finanziari e delle attivi...,13,22,60,0,95,2023
LOM,  ,L   ,Attivita' immobiliari                                       ,256,118,30,31,435,2023
LOM,  ,L 68,Attivita' immobiliari                                       ,256,118,30,31,435,2023
LOM,  ,M   ,"Attività professionali, scientifiche e tecniche             ",159,75,141,10,385,2023
LOM,  ,M 69,Attività legali e contabilità                               ,9,7,5,0,21,2023
LOM,  ,M 70,Attività di direzione aziendale e di consulenza gestional...,65,12,35,5,117,2023
LOM,  ,M 71,Attività degli studi di architettura e d'ingegneria; coll...,20,9,7,0,36,2023
LOM,  ,M 72,Ricerca scientifica e sviluppo                              ,3,0,0,0,3,2023
LOM,  ,M 73,Pubblicità e ricerche di mercato                            ,32,17,45,2,96,2023
LOM,  ,M 74,"Altre attività professionali, scientifiche e tecniche       ",30,30,49,3,112,2023
LOM,  ,M 75,Servizi veterinari                                          ,0,0,0,0,0,2023
LOM,  ,N   ,"Noleggio, agenzie di viaggio, servizi di supporto alle im...",86,78,219,46,429,2023
LOM,  ,N 77,Attività di noleggio e leasing operativo                    ,15,10,4,1,30,2023
LOM,  ,N 78,"Attività di ricerca, selezione, fornitura di personale      ",4,2,0,0,6,2023
LOM,  ,N 79,"Attività dei servizi delle agenzie di viaggio, dei tour o...",15,14,4,0,33,2023
LOM,  ,N 80,Servizi di vigilanza e investigazione                       ,5,3,2,0,10,2023
LOM,  ,N 81,Attività di servizi per edifici e paesaggio                 ,19,26,78,17,140,2023
LOM,  ,N 82,Attività di supporto per le funzioni d'ufficio e altri se...,28,23,131,28,210,2023
LOM,  ,O   ,Amministrazione pubblica e difesa; assicurazione sociale ...,1,0,0,0,1,2023
LOM,  ,O 84,Amministrazione pubblica e difesa; assicurazione sociale ...,1,0,0,0,1,2023
LOM,  ,P   ,Istruzione                                                  ,7,6,7,2,22,2023
LOM,  ,P 85,Istruzione                                                  ,7,6,7,2,22,2023
LOM,  ,Q   ,Sanita' e assistenza sociale                                ,7,10,6,17,40,2023
LOM,  ,Q 86,Assistenza sanitaria                                        ,5,7,1,4,17,2023
LOM,  ,Q 87,Servizi di assistenza sociale residenziale                  ,0,0,1,2,3,2023
LOM,  ,Q 88,Assistenza sociale non residenziale                         ,2,3,4,11,20,2023
LOM,  ,R   ,"Attività artistiche, sportive, di intrattenimento e diver...",71,23,32,4,130,2023
LOM,  ,R 90,"Attività creative, artistiche e di intrattenimento          ",12,2,13,2,29,2023
LOM,  ,R 91,"Attività di biblioteche, archivi, musei ed altre attività...",0,0,0,0,0,2023
LOM,  ,R 92,"Attività riguardanti le lotterie, le scommesse, le case d...",10,3,7,0,20,2023
LOM,  ,R 93,"Attività sportive, di intrattenimento e di divertimento     ",49,18,12,2,81,2023
LOM,  ,S   ,Altre attività di servizi                                   ,29,94,159,3,285,2023
LOM,  ,S 94,Attività di organizzazioni associative                      ,0,0,0,0,0,2023
LOM,  ,S 95,Riparazione di computer e di beni per uso personale e per...,6,8,38,0,52,2023
LOM,  ,S 96,Altre attività di servizi per la persona                    ,23,86,121,3,233,2023
LOM,  ,T   ,Attività di famiglie e convivenze come datori di lavoro p...,0,0,0,0,0,2023
LOM,  ,T 97,Attività di famiglie e convivenze come datori di lavoro p...,0,0,0,0,0,2023
LOM,  ,T 98,Produzione di beni e servizi indifferenziati per uso prop...,0,0,0,0,0,2023
LOM,  ,U   ,Organizzazioni ed organismi extraterritoriali               ,0,0,0,0,0,2023
LOM,  ,U 99,Organizzazioni ed organismi extraterritoriali               ,0,0,0,0,0,2023
LOM,  ,XX  ,Imprese non classificate                                    ,383,305,338,33,1059,2023
LOM,  ,TOT ,TOTALE                                                      ,2538,2750,4895,334,10517,2023
LOM,VA,A   ,"Agricoltura, silvicoltura pesca                             ",0,9,0,1,10,2023
LOM,VA,A 01,"Coltivazioni agricole e produzione di prodotti animali, c...",0,9,0,0,9,2023
LOM,VA,A 02,Silvicoltura ed utilizzo di aree forestali                  ,0,0,0,0,0,2023
LOM,VA,A 03,Pesca e acquacoltura                                        ,0,0,0,1,1,2023
LOM,VA,B   ,Estrazione di minerali da cave e miniere                    ,0,0,0,0,0,2023
LOM,VA,B 05,Estrazione di carbone (esclusa torba)                       ,0,0,0,0,0,2023
LOM,VA,B 06,Estraz.di petrolio greggio e di gas naturale                ,0,0,0,0,0,2023
LOM,VA,B 07,Estrazione di minerali metalliferi                          ,0,0,0,0,0,2023
LOM,VA,B 08,Altre attività di estrazione di minerali da cave e miniere  ,0,0,0,0,0,2023
LOM,VA,B 09,Attività dei servizi di supporto all'estrazione             ,0,0,0,0,0,2023
LOM,VA,C   ,Attività manifatturiere                                     ,0,163,0,7,170,2023
LOM,VA,C 10,Industrie alimentari                                        ,0,10,0,2,12,2023
LOM,VA,C 11,Industria delle bevande                                     ,0,1,0,0,1,2023
LOM,VA,C 12,Industria del tabacco                                       ,0,0,0,0,0,2023
LOM,VA,C 13,Industrie tessili                                           ,0,19,0,0,19,2023
LOM,VA,C 14,Confezione di articoli di abbigliamento; confezione di ar...,0,32,0,0,32,2023
LOM,VA,C 15,Fabbricazione di articoli in pelle e simili                 ,0,4,0,1,5,2023
LOM,VA,C 16,Industria del legno e dei prodotti in legno e sughero (es...,0,5,0,0,5,2023
LOM,VA,C 17,Fabbricazione di carta e di prodotti di carta               ,0,1,0,0,1,2023
LOM,VA,C 18,Stampa e riproduzione di supporti registrati                ,0,7,0,2,9,2023
LOM,VA,C 19,Fabbricazione di coke e prodotti derivanti dalla raffinaz...,0,0,0,0,0,2023
LOM,VA,C 20,Fabbricazione di prodotti chimici                           ,0,1,0,0,1,2023
LOM,VA,C 21,Fabbricazione di prodotti farmaceutici di base e di prepa...,0,0,0,0,0,2023
LOM,VA,C 22,Fabbricazione di articoli in gomma e materie plastiche      ,0,9,0,0,9,2023
LOM,VA,C 23,Fabbricazione di altri prodotti della lavorazione di miner..,0,4,0,0,4,2023
LOM,VA,C 24,Metallurgia                                                 ,0,2,0,0,2,2023
LOM,VA,C 25,Fabbricazione di prodotti in metallo (esclusi macchinari ...,0,29,0,2,31,2023
LOM,VA,C 26,Fabbricazione di computer e prodotti di elettronica e ott...,0,4,0,0,4,2023
LOM,VA,C 27,Fabbricazione di apparecchiature elettriche ed apparecchi...,0,8,0,0,8,2023
LOM,VA,C 28,Fabbricazione di macchinari ed apparecchiature nca          ,0,11,0,0,11,2023
LOM,VA,C 29,"Fabbricazione di autoveicoli, rimorchi e semirimorchi       ",0,2,0,0,2,2023
LOM,VA,C 30,Fabbricazione di altri mezzi di trasporto                   ,0,1,0,0,1,2023
LOM,VA,C 31,Fabbricazione di mobili                                     ,0,4,0,0,4,2023
LOM,VA,C 32,Altre industrie manifatturiere                              ,0,3,0,0,3,2023
LOM,VA,C 33,"Riparazione, manutenzione ed installazione di macchine ed...",0,6,0,0,6,2023
LOM,VA,D   ,"Fornitura di energia elettrica, gas, vapore e aria condiz...",0,0,0,0,0,2023
LOM,VA,D 35,"Fornitura di energia elettrica, gas, vapore e aria condiz...",0,0,0,0,0,2023
LOM,VA,E   ,"Fornitura di acqua; reti fognarie, attività di gestione d...",0,2,0,0,2,2023
LOM,VA,E 36,"Raccolta, trattamento e fornitura di acqua                  ",0,0,0,0,0,2023
LOM,VA,E 37,Gestione delle reti fognarie                                ,0,1,0,0,1,2023
LOM,VA,E 38,"Attività di raccolta, trattamento e smaltimento dei rifiu...",0,1,0,0,1,2023
LOM,VA,E 39,Attività di risanamento e altri servizi di gestione dei r...,0,0,0,0,0,2023
LOM,VA,F   ,Costruzioni                                                 ,0,68,0,0,68,2023
LOM,VA,F 41,Costruzione di edifici                                      ,0,36,0,0,36,2023
LOM,VA,F 42,Ingegneria civile                                           ,0,0,0,0,0,2023
LOM,VA,F 43,Lavori di costruzione specializzati                         ,0,32,0,0,32,2023
LOM,VA,G   ,Commercio all'ingrosso e al dettaglio; riparazione di aut...,0,194,0,6,200,2023
LOM,VA,G 45,Commercio all'ingrosso e al dettaglio e riparazione di au...,0,32,0,0,32,2023
LOM,VA,G 46,Commercio all'ingrosso (escluso quello di autoveicoli e d...,0,47,0,2,49,2023
LOM,VA,G 47,Commercio al dettaglio (escluso quello di autoveicoli e d...,0,115,0,4,119,2023
LOM,VA,H   ,Trasporto e magazzinaggio                                   ,0,16,0,2,18,2023
LOM,VA,H 49,Trasporto terrestre e mediante condotte                     ,0,12,0,1,13,2023
LOM,VA,H 50,Trasporto marittimo e per vie d'acqua                       ,0,0,0,0,0,2023
LOM,VA,H 51,Trasporto aereo                                             ,0,0,0,0,0,2023
LOM,VA,H 52,Magazzinaggio e attività di supporto ai trasporti           ,0,3,0,1,4,2023
LOM,VA,H 53,Servizi postali e attività di corriere                      ,0,1,0,0,1,2023
LOM,VA,I   ,Attività dei servizi alloggio e ristorazione                ,0,241,0,4,245,2023
LOM,VA,I 55,Alloggio                                                    ,0,6,0,0,6,2023
LOM,VA,I 56,Attività dei servizi di ristorazione                        ,0,235,0,4,239,2023
LOM,VA,J   ,Servizi di informazione e comunicazione                     ,0,24,0,0,24,2023
LOM,VA,J 58,Attività editoriali                                         ,0,0,0,0,0,2023
LOM,VA,J 59,"Attività di produzione cinematografica, di video e di pro...",0,4,0,0,4,2023
LOM,VA,J 60,Attività di programmazione e trasmissione                   ,0,0,0,0,0,2023
LOM,VA,J 61,Telecomunicazioni                                           ,0,0,0,0,0,2023
LOM,VA,J 62,"Produzione di software, consulenza informatica e attività...",0,6,0,0,6,2023
LOM,VA,J 63,Attività dei servizi d'informazione e altri servizi infor...,0,14,0,0,14,2023
LOM,VA,K   ,Attività finanziarie e assicurative                         ,0,9,0,0,9,2023
LOM,VA,K 64,Attività di servizi finanziari (escluse le assicurazioni ...,0,1,0,0,1,2023
LOM,VA,K 65,"Assicurazioni, riassicurazioni e fondi pensione (escluse ...",0,0,0,0,0,2023
LOM,VA,K 66,Attività ausiliarie dei servizi finanziari e delle attivi...,0,8,0,0,8,2023
LOM,VA,L   ,Attivita' immobiliari                                       ,0,39,0,18,57,2023
LOM,VA,L 68,Attivita' immobiliari                                       ,0,39,0,18,57,2023
LOM,VA,M   ,"Attività professionali, scientifiche e tecniche             ",0,18,0,1,19,2023
LOM,VA,M 69,Attività legali e contabilità                               ,0,0,0,0,0,2023
LOM,VA,M 70,Attività di direzione aziendale e di consulenza gestional...,0,5,0,0,5,2023
LOM,VA,M 71,Attività degli studi di architettura e d'ingegneria; coll...,0,1,0,0,1,2023
LOM,VA,M 72,Ricerca scientifica e sviluppo                              ,0,0,0,0,0,2023
LOM,VA,M 73,Pubblicità e ricerche di mercato                            ,0,5,0,0,5,2023
LOM,VA,M 74,"Altre attività professionali, scientifiche e tecniche       ",0,7,0,1,8,2023
LOM,VA,M 75,Servizi veterinari                                          ,0,0,0,0,0,2023
LOM,VA,N   ,"Noleggio, agenzie di viaggio, servizi di supporto alle im...",0,20,0,1,21,2023
LOM,VA,N 77,Attività di noleggio e leasing operativo                    ,0,3,0,0,3,2023
LOM,VA,N 78,"Attività di ricerca, selezione, fornitura di personale      ",0,0,0,0,0,2023
LOM,VA,N 79,"Attività dei servizi delle agenzie di viaggio, dei tour o...",0,5,0,0,5,2023
LOM,VA,N 80,Servizi di vigilanza e investigazione                       ,0,1,0,0,1,2023
LOM,VA,N 81,Attività di servizi per edifici e paesaggio                 ,0,5,0,0,5,2023
LOM,VA,N 82,Attività di supporto per le funzioni d'ufficio e altri se...,0,6,0,1,7,2023
LOM,VA,O   ,Amministrazione pubblica e difesa; assicurazione sociale ...,0,0,0,0,0,2023
LOM,VA,O 84,Amministrazione pubblica e difesa; assicurazione sociale ...,0,0,0,0,0,2023
LOM,VA,P   ,Istruzione                                                  ,0,1,0,1,2,2023
LOM,VA,P 85,Istruzione                                                  ,0,1,0,1,2,2023
LOM,VA,Q   ,Sanita' e assistenza sociale                                ,0,2,0,2,4,2023
LOM,VA,Q 86,Assistenza sanitaria                                        ,0,2,0,0,2,2023
LOM,VA,Q 87,Servizi di assistenza sociale residenziale                  ,0,0,0,0,0,2023
LOM,VA,Q 88,Assistenza sociale non residenziale                         ,0,0,0,2,2,2023
LOM,VA,R   ,"Attività artistiche, sportive, di intrattenimento e diver...",0,9,0,1,10,2023
LOM,VA,R 90,"Attività creative, artistiche e di intrattenimento          ",0,1,0,1,2,2023
LOM,VA,R 91,"Attività di biblioteche, archivi, musei ed altre attività...",0,0,0,0,0,2023
LOM,VA,R 92,"Attività riguardanti le lotterie, le scommesse, le case d...",0,2,0,0,2,2023
LOM,VA,R 93,"Attività sportive, di intrattenimento e di divertimento     ",0,6,0,0,6,2023
LOM,VA,S   ,Altre attività di servizi                                   ,0,26,0,1,27,2023
LOM,VA,S 94,Attività di organizzazioni associative                      ,0,0,0,0,0,2023
LOM,VA,S 95,Riparazione di computer e di beni per uso personale e per...,0,0,0,0,0,2023
LOM,VA,S 96,Altre attività di servizi per la persona                    ,0,26,0,1,27,2023
LOM,VA,T   ,Attività di famiglie e convivenze come datori di lavoro p...,0,0,0,0,0,2023
LOM,VA,T 97,Attività di famiglie e convivenze come datori di lavoro p...,0,0,0,0,0,2023
LOM,VA,T 98,Produzione di beni e servizi indifferenziati per uso prop...,0,0,0,0,0,2023
LOM,VA,U   ,Organizzazioni ed organismi extraterritoriali               ,0,0,0,0,0,2023
LOM,VA,U 99,Organizzazioni ed organismi extraterritoriali               ,0,0,0,0,0,2023
LOM,VA,XX  ,Imprese non classificate                                    ,0,70,0,3,73,2023
LOM,VA,TOT ,TOTALE                                                      ,0,911,0,48,959,2023
LOM,CO,A   ,"Agricoltura, silvicoltura pesca                             ",2,14,12,0,28,2023
LOM,CO,A 01,"Coltivazioni agricole e produzione di prodotti animali, c...",2,13,11,0,26,2023
LOM,CO,A 02,Silvicoltura ed utilizzo di aree forestali                  ,0,1,0,0,1,2023
LOM,CO,A 03,Pesca e acquacoltura                                        ,0,0,1,0,1,2023
LOM,CO,B   ,Estrazione di minerali da cave e miniere                    ,0,0,0,0,0,2023
LOM,CO,B 05,Estrazione di carbone (esclusa torba)                       ,0,0,0,0,0,2023
LOM,CO,B 06,Estraz.di petrolio greggio e di gas naturale                ,0,0,0,0,0,2023
LOM,CO,B 07,Estrazione di minerali metalliferi                          ,0,0,0,0,0,2023
LOM,CO,B 08,Altre attività di estrazione di minerali da cave e miniere  ,0,0,0,0,0,2023
LOM,CO,B 09,Attività dei servizi di supporto all'estrazione             ,0,0,0,0,0,2023
LOM,CO,C   ,Attività manifatturiere                                     ,14,41,16,3,74,2023
LOM,CO,C 10,Industrie alimentari                                        ,0,2,2,1,5,2023
LOM,CO,C 11,Industria delle bevande                                     ,0,0,0,0,0,2023
LOM,CO,C 12,Industria del tabacco                                       ,0,0,0,0,0,2023
LOM,CO,C 13,Industrie tessili                                           ,5,4,2,1,12,2023
LOM,CO,C 14,Confezione di articoli di abbigliamento; confezione di ar...,2,6,2,0,10,2023
LOM,CO,C 15,Fabbricazione di articoli in pelle e simili                 ,0,1,0,0,1,2023
LOM,CO,C 16,Industria del legno e dei prodotti in legno e sughero (es...,0,3,0,0,3,2023
LOM,CO,C 17,Fabbricazione di carta e di prodotti di carta               ,0,0,0,0,0,2023
LOM,CO,C 18,Stampa e riproduzione di supporti registrati                ,0,1,0,0,1,2023
LOM,CO,C 19,Fabbricazione di coke e prodotti derivanti dalla raffinaz...,0,0,0,0,0,2023
LOM,CO,C 20,Fabbricazione di prodotti chimici                           ,0,1,0,0,1,2023
LOM,CO,C 21,Fabbricazione di prodotti farmaceutici di base e di prepa...,0,0,0,0,0,2023
LOM,CO,C 22,Fabbricazione di articoli in gomma e materie plastiche      ,0,2,0,0,2,2023
LOM,CO,C 23,Fabbricazione di altri prodotti della lavorazione di miner..,0,1,0,0,1,2023
LOM,CO,C 24,Metallurgia                                                 ,3,0,2,0,5,2023
LOM,CO,C 25,Fabbricazione di prodotti in metallo (esclusi macchinari ...,2,6,3,0,11,2023
LOM,CO,C 26,Fabbricazione di computer e prodotti di elettronica e ott...,0,0,0,0,0,2023
LOM,CO,C 27,Fabbricazione di apparecchiature elettriche ed apparecchi...,0,0,0,0,0,2023
LOM,CO,C 28,Fabbricazione di macchinari ed apparecchiature nca          ,0,1,1,0,2,2023
LOM,CO,C 29,"Fabbricazione di autoveicoli, rimorchi e semirimorchi       ",0,2,0,0,2,2023
LOM,CO,C 30,Fabbricazione di altri mezzi di trasporto                   ,0,0,0,0,0,2023
LOM,CO,C 31,Fabbricazione di mobili                                     ,1,3,4,0,8,2023
LOM,CO,C 32,Altre industrie manifatturiere                              ,0,5,0,0,5,2023
LOM,CO,C 33,"Riparazione, manutenzione ed installazione di macchine ed...",1,3,0,1,5,2023
LOM,CO,D   ,"Fornitura di energia elettrica, gas, vapore e aria condiz...",0,0,1,0,1,2023
LOM,CO,D 35,"Fornitura di energia elettrica, gas, vapore e aria condiz...",0,0,1,0,1,2023
LOM,CO,E   ,"Fornitura di acqua; reti fognarie, attività di gestione d...",0,0,0,0,0,2023
LOM,CO,E 36,"Raccolta, trattamento e fornitura di acqua                  ",0,0,0,0,0,2023
LOM,CO,E 37,Gestione delle reti fognarie                                ,0,0,0,0,0,2023
LOM,CO,E 38,"Attività di raccolta, trattamento e smaltimento dei rifiu...",0,0,0,0,0,2023
LOM,CO,E 39,Attività di risanamento e altri servizi di gestione dei r...,0,0,0,0,0,2023
LOM,CO,F   ,Costruzioni                                                 ,11,67,12,1,91,2023
LOM,CO,F 41,Costruzione di edifici                                      ,8,32,9,1,50,2023
LOM,CO,F 42,Ingegneria civile                                           ,0,1,0,0,1,2023
LOM,CO,F 43,Lavori di costruzione specializzati                         ,3,34,3,0,40,2023
LOM,CO,G   ,Commercio all'ingrosso e al dettaglio; riparazione di aut...,21,96,18,1,136,2023
LOM,CO,G 45,Commercio all'ingrosso e al dettaglio e riparazione di au...,3,8,4,0,15,2023
LOM,CO,G 46,Commercio all'ingrosso (escluso quello di autoveicoli e d...,12,16,5,0,33,2023
LOM,CO,G 47,Commercio al dettaglio (escluso quello di autoveicoli e d...,6,72,9,1,88,2023
LOM,CO,H   ,Trasporto e magazzinaggio                                   ,1,17,2,4,24,2023
LOM,CO,H 49,Trasporto terrestre e mediante condotte                     ,1,17,2,3,23,2023
LOM,CO,H 50,Trasporto marittimo e per vie d'acqua                       ,0,0,0,0,0,2023
LOM,CO,H 51,Trasporto aereo                                             ,0,0,0,0,0,2023
LOM,CO,H 52,Magazzinaggio e attività di supporto ai trasporti           ,0,0,0,1,1,2023
LOM,CO,H 53,Servizi postali e attività di corriere                      ,0,0,0,0,0,2023
LOM,CO,I   ,Attività dei servizi alloggio e ristorazione                ,6,172,7,0,185,2023
LOM,CO,I 55,Alloggio                                                    ,0,1,1,0,2,2023
LOM,CO,I 56,Attività dei servizi di ristorazione                        ,6,171,6,0,183,2023
LOM,CO,J   ,Servizi di informazione e comunicazione                     ,7,7,0,1,15,2023
LOM,CO,J 58,Attività editoriali                                         ,0,0,0,0,0,2023
LOM,CO,J 59,"Attività di produzione cinematografica, di video e di pro...",0,0,0,0,0,2023
LOM,CO,J 60,Attività di programmazione e trasmissione                   ,0,0,0,0,0,2023
LOM,CO,J 61,Telecomunicazioni                                           ,0,0,0,0,0,2023
LOM,CO,J 62,"Produzione di software, consulenza informatica e attività...",4,5,0,0,9,2023
LOM,CO,J 63,Attività dei servizi d'informazione e altri servizi infor...,3,2,0,1,6,2023
LOM,CO,K   ,Attività finanziarie e assicurative                         ,3,5,1,0,9,2023
LOM,CO,K 64,Attività di servizi finanziari (escluse le assicurazioni ...,3,1,1,0,5,2023
LOM,CO,K 65,"Assicurazioni, riassicurazioni e fondi pensione (escluse ...",0,0,0,0,0,2023
LOM,CO,K 66,Attività ausiliarie dei servizi finanziari e delle attivi...,0,4,0,0,4,2023
LOM,CO,L   ,Attivita' immobiliari                                       ,6,21,0,2,29,2023
LOM,CO,L 68,Attivita' immobiliari                                       ,6,21,0,2,29,2023
LOM,CO,M   ,"Attività professionali, scientifiche e tecniche             ",2,15,6,0,23,2023
LOM,CO,M 69,Attività legali e contabilità                               ,0,0,0,0,0,2023
LOM,CO,M 70,Attività di direzione aziendale e di consulenza gestional...,1,4,0,0,5,2023
LOM,CO,M 71,Attività degli studi di architettura e d'ingegneria; coll...,1,2,3,0,6,2023
LOM,CO,M 72,Ricerca scientifica e sviluppo                              ,0,0,0,0,0,2023
LOM,CO,M 73,Pubblicità e ricerche di mercato                            ,0,1,0,0,1,2023
LOM,CO,M 74,"Altre attività professionali, scientifiche e tecniche       ",0,8,3,0,11,2023
LOM,CO,M 75,Servizi veterinari                                          ,0,0,0,0,0,2023
LOM,CO,N   ,"Noleggio, agenzie di viaggio, servizi di supporto alle im...",2,21,1,4,28,2023
LOM,CO,N 77,Attività di noleggio e leasing operativo                    ,0,3,0,0,3,2023
LOM,CO,N 78,"Attività di ricerca, selezione, fornitura di personale      ",0,1,0,0,1,2023
LOM,CO,N 79,"Attività dei servizi delle agenzie di viaggio, dei tour o...",0,3,0,0,3,2023
LOM,CO,N 80,Servizi di vigilanza e investigazione                       ,0,2,0,0,2,2023
LOM,CO,N 81,Attività di servizi per edifici e paesaggio                 ,0,8,0,1,9,2023
LOM,CO,N 82,Attività di supporto per le funzioni d'ufficio e altri se...,2,4,1,3,10,2023
LOM,CO,O   ,Amministrazione pubblica e difesa; assicurazione sociale ...,0,0,0,0,0,2023
LOM,CO,O 84,Amministrazione pubblica e difesa; assicurazione sociale ...,0,0,0,0,0,2023
LOM,CO,P   ,Istruzione                                                  ,1,1,0,0,2,2023
LOM,CO,P 85,Istruzione                                                  ,1,1,0,0,2,2023
LOM,CO,Q   ,Sanita' e assistenza sociale                                ,0,6,0,1,7,2023
LOM,CO,Q 86,Assistenza sanitaria                                        ,0,4,0,0,4,2023
LOM,CO,Q 87,Servizi di assistenza sociale residenziale                  ,0,0,0,0,0,2023
LOM,CO,Q 88,Assistenza sociale non residenziale                         ,0,2,0,1,3,2023
LOM,CO,R   ,"Attività artistiche, sportive, di intrattenimento e diver...",3,6,2,0,11,2023
LOM,CO,R 90,"Attività creative, artistiche e di intrattenimento          ",1,0,1,0,2,2023
LOM,CO,R 91,"Attività di biblioteche, archivi, musei ed altre attività...",0,0,0,0,0,2023
LOM,CO,R 92,"Attività riguardanti le lotterie, le scommesse, le case d...",0,1,0,0,1,2023
LOM,CO,R 93,"Attività sportive, di intrattenimento e di divertimento     ",2,5,1,0,8,2023
LOM,CO,S   ,Altre attività di servizi                                   ,0,24,1,1,26,2023
LOM,CO,S 94,Attività di organizzazioni associative                      ,0,0,0,0,0,2023
LOM,CO,S 95,Riparazione di computer e di beni per uso personale e per...,0,2,0,0,2,2023
LOM,CO,S 96,Altre attività di servizi per la persona                    ,0,22,1,1,24,2023
LOM,CO,T   ,Attività di famiglie e convivenze come datori di lavoro p...,0,0,0,0,0,2023
LOM,CO,T 97,Attività di famiglie e convivenze come datori di lavoro p...,0,0,0,0,0,2023
LOM,CO,T 98,Produzione di beni e servizi indifferenziati per uso prop...,0,0,0,0,0,2023
LOM,CO,U   ,Organizzazioni ed organismi extraterritoriali               ,0,0,0,0,0,2023
LOM,CO,U 99,Organizzazioni ed organismi extraterritoriali               ,0,0,0,0,0,2023
LOM,CO,XX  ,Imprese non classificate                                    ,10,69,0,0,79,2023
LOM,CO,TOT ,TOTALE                                                      ,89,582,79,18,768,2023
LOM,SO,A   ,"Agricoltura, silvicoltura pesca                             ",0,0,0,0,0,2023
LOM,SO,A 01,"Coltivazioni agricole e produzione di prodotti animali, c...",0,0,0,0,0,2023
LOM,SO,A 02,Silvicoltura ed utilizzo di aree forestali                  ,0,0,0,0,0,2023
LOM,SO,A 03,Pesca e acquacoltura                                        ,0,0,0,0,0,2023
LOM,SO,B   ,Estrazione di minerali da cave e miniere                    ,1,0,0,0,1,2023
LOM,SO,B 05,Estrazione di carbone (esclusa torba)                       ,0,0,0,0,0,2023
LOM,SO,B 06,Estraz.di petrolio greggio e di gas naturale                ,0,0,0,0,0,2023
LOM,SO,B 07,Estrazione di minerali metalliferi                          ,0,0,0,0,0,2023
LOM,SO,B 08,Altre attività di estrazione di minerali da cave e miniere  ,1,0,0,0,1,2023
LOM,SO,B 09,Attività dei servizi di supporto all'estrazione             ,0,0,0,0,0,2023
LOM,SO,C   ,Attività manifatturiere                                     ,7,0,0,0,7,2023
LOM,SO,C 10,Industrie alimentari                                        ,0,0,0,0,0,2023
LOM,SO,C 11,Industria delle bevande                                     ,0,0,0,0,0,2023
LOM,SO,C 12,Industria del tabacco                                       ,0,0,0,0,0,2023
LOM,SO,C 13,Industrie tessili                                           ,1,0,0,0,1,2023
LOM,SO,C 14,Confezione di articoli di abbigliamento; confezione di ar...,0,0,0,0,0,2023
LOM,SO,C 15,Fabbricazione di articoli in pelle e simili                 ,1,0,0,0,1,2023
LOM,SO,C 16,Industria del legno e dei prodotti in legno e sughero (es...,0,0,0,0,0,2023
LOM,SO,C 17,Fabbricazione di carta e di prodotti di carta               ,0,0,0,0,0,2023
LOM,SO,C 18,Stampa e riproduzione di supporti registrati                ,0,0,0,0,0,2023
LOM,SO,C 19,Fabbricazione di coke e prodotti derivanti dalla raffinaz...,0,0,0,0,0,2023
LOM,SO,C 20,Fabbricazione di prodotti chimici                           ,0,0,0,0,0,2023
LOM,SO,C 21,Fabbricazione di prodotti farmaceutici di base e di prepa...,0,0,0,0,0,2023
LOM,SO,C 22,Fabbricazione di articoli in gomma e materie plastiche      ,0,0,0,0,0,2023
LOM,SO,C 23,Fabbricazione di altri prodotti della lavorazione di miner..,1,0,0,0,1,2023
LOM,SO,C 24,Metallurgia                                                 ,0,0,0,0,0,2023
LOM,SO,C 25,Fabbricazione di prodotti in metallo (esclusi macchinari ...,2,0,0,0,2,2023
LOM,SO,C 26,Fabbricazione di computer e prodotti di elettronica e ott...,0,0,0,0,0,2023
LOM,SO,C 27,Fabbricazione di apparecchiature elettriche ed apparecchi...,0,0,0,0,0,2023
LOM,SO,C 28,Fabbricazione di macchinari ed apparecchiature nca          ,1,0,0,0,1,2023
LOM,SO,C 29,"Fabbricazione di autoveicoli, rimorchi e semirimorchi       ",0,0,0,0,0,2023
LOM,SO,C 30,Fabbricazione di altri mezzi di trasporto                   ,0,0,0,0,0,2023
LOM,SO,C 31,Fabbricazione di mobili                                     ,0,0,0,0,0,2023
LOM,SO,C 32,Altre industrie manifatturiere                              ,1,0,0,0,1,2023
LOM,SO,C 33,"Riparazione, manutenzione ed installazione di macchine ed...",0,0,0,0,0,2023
LOM,SO,D   ,"Fornitura di energia elettrica, gas, vapore e aria condiz...",0,0,0,0,0,2023
LOM,SO,D 35,"Fornitura di energia elettrica, gas, vapore e aria condiz...",0,0,0,0,0,2023
LOM,SO,E   ,"Fornitura di acqua; reti fognarie, attività di gestione d...",0,0,0,0,0,2023
LOM,SO,E 36,"Raccolta, trattamento e fornitura di acqua                  ",0,0,0,0,0,2023
LOM,SO,E 37,Gestione delle reti fognarie                                ,0,0,0,0,0,2023
LOM,SO,E 38,"Attività di raccolta, trattamento e smaltimento dei rifiu...",0,0,0,0,0,2023
LOM,SO,E 39,Attività di risanamento e altri servizi di gestione dei r...,0,0,0,0,0,2023
LOM,SO,F   ,Costruzioni                                                 ,16,0,0,1,17,2023
LOM,SO,F 41,Costruzione di edifici                                      ,12,0,0,0,12,2023
LOM,SO,F 42,Ingegneria civile                                           ,1,0,0,1,2,2023
LOM,SO,F 43,Lavori di costruzione specializzati                         ,3,0,0,0,3,2023
LOM,SO,G   ,Commercio all'ingrosso e al dettaglio; riparazione di aut...,14,0,1,0,15,2023
LOM,SO,G 45,Commercio all'ingrosso e al dettaglio e riparazione di au...,3,0,0,0,3,2023
LOM,SO,G 46,Commercio all'ingrosso (escluso quello di autoveicoli e d...,5,0,1,0,6,2023
LOM,SO,G 47,Commercio al dettaglio (escluso quello di autoveicoli e d...,6,0,0,0,6,2023
LOM,SO,H   ,Trasporto e magazzinaggio                                   ,2,0,0,0,2,2023
LOM,SO,H 49,Trasporto terrestre e mediante condotte                     ,1,0,0,0,1,2023
LOM,SO,H 50,Trasporto marittimo e per vie d'acqua                       ,0,0,0,0,0,2023
LOM,SO,H 51,Trasporto aereo                                             ,0,0,0,0,0,2023
LOM,SO,H 52,Magazzinaggio e attività di supporto ai trasporti           ,1,0,0,0,1,2023
LOM,SO,H 53,Servizi postali e attività di corriere                      ,0,0,0,0,0,2023
LOM,SO,I   ,Attività dei servizi alloggio e ristorazione                ,6,0,0,0,6,2023
LOM,SO,I 55,Alloggio                                                    ,2,0,0,0,2,2023
LOM,SO,I 56,Attività dei servizi di ristorazione                        ,4,0,0,0,4,2023
LOM,SO,J   ,Servizi di informazione e comunicazione                     ,4,0,0,0,4,2023
LOM,SO,J 58,Attività editoriali                                         ,0,0,0,0,0,2023
LOM,SO,J 59,"Attività di produzione cinematografica, di video e di pro...",1,0,0,0,1,2023
LOM,SO,J 60,Attività di programmazione e trasmissione                   ,1,0,0,0,1,2023
LOM,SO,J 61,Telecomunicazioni                                           ,0,0,0,0,0,2023
LOM,SO,J 62,"Produzione di software, consulenza informatica e attività...",1,0,0,0,1,2023
LOM,SO,J 63,Attività dei servizi d'informazione e altri servizi infor...,1,0,0,0,1,2023
LOM,SO,K   ,Attività finanziarie e assicurative                         ,0,0,0,0,0,2023
LOM,SO,K 64,Attività di servizi finanziari (escluse le assicurazioni ...,0,0,0,0,0,2023
LOM,SO,K 65,"Assicurazioni, riassicurazioni e fondi pensione (escluse ...",0,0,0,0,0,2023
LOM,SO,K 66,Attività ausiliarie dei servizi finanziari e delle attivi...,0,0,0,0,0,2023
LOM,SO,L   ,Attivita' immobiliari                                       ,12,0,0,0,12,2023
LOM,SO,L 68,Attivita' immobiliari                                       ,12,0,0,0,12,2023
LOM,SO,M   ,"Attività professionali, scientifiche e tecniche             ",4,0,0,0,4,2023
LOM,SO,M 69,Attività legali e contabilità                               ,2,0,0,0,2,2023
LOM,SO,M 70,Attività di direzione aziendale e di consulenza gestional...,1,0,0,0,1,2023
LOM,SO,M 71,Attività degli studi di architettura e d'ingegneria; coll...,0,0,0,0,0,2023
LOM,SO,M 72,Ricerca scientifica e sviluppo                              ,0,0,0,0,0,2023
LOM,SO,M 73,Pubblicità e ricerche di mercato                            ,0,0,0,0,0,2023
LOM,SO,M 74,"Altre attività professionali, scientifiche e tecniche       ",1,0,0,0,1,2023
LOM,SO,M 75,Servizi veterinari                                          ,0,0,0,0,0,2023
LOM,SO,N   ,"Noleggio, agenzie di viaggio, servizi di supporto alle im...",3,0,0,0,3,2023
LOM,SO,N 77,Attività di noleggio e leasing operativo                    ,0,0,0,0,0,2023
LOM,SO,N 78,"Attività di ricerca, selezione, fornitura di personale      ",0,0,0,0,0,2023
LOM,SO,N 79,"Attività dei servizi delle agenzie di viaggio, dei tour o...",2,0,0,0,2,2023
LOM,SO,N 80,Servizi di vigilanza e investigazione                       ,0,0,0,0,0,2023
LOM,SO,N 81,Attività di servizi per edifici e paesaggio                 ,0,0,0,0,0,2023
LOM,SO,N 82,Attività di supporto per le funzioni d'ufficio e altri se...,1,0,0,0,1,2023
LOM,SO,O   ,Amministrazione pubblica e difesa; assicurazione sociale ...,0,0,0,0,0,2023
LOM,SO,O 84,Amministrazione pubblica e difesa; assicurazione sociale ...,0,0,0,0,0,2023
LOM,SO,P   ,Istruzione                                                  ,1,0,0,0,1,2023
LOM,SO,P 85,Istruzione                                                  ,1,0,0,0,1,2023
LOM,SO,Q   ,Sanita' e assistenza sociale                                ,2,0,0,2,4,2023
LOM,SO,Q 86,Assistenza sanitaria                                        ,2,0,0,0,2,2023
LOM,SO,Q 87,Servizi di assistenza sociale residenziale                  ,0,0,0,1,1,2023
LOM,SO,Q 88,Assistenza sociale non residenziale                         ,0,0,0,1,1,2023
LOM,SO,R   ,"Attività artistiche, sportive, di intrattenimento e diver...",5,0,0,0,5,2023
LOM,SO,R 90,"Attività creative, artistiche e di intrattenimento          ",1,0,0,0,1,2023
LOM,SO,R 91,"Attività di biblioteche, archivi, musei ed altre attività...",0,0,0,0,0,2023
LOM,SO,R 92,"Attività riguardanti le lotterie, le scommesse, le case d...",1,0,0,0,1,2023
LOM,SO,R 93,"Attività sportive, di intrattenimento e di divertimento     ",3,0,0,0,3,2023
LOM,SO,S   ,Altre attività di servizi                                   ,0,0,0,0,0,2023
LOM,SO,S 94,Attività di organizzazioni associative                      ,0,0,0,0,0,2023
LOM,SO,S 95,Riparazione di computer e di beni per uso personale e per...,0,0,0,0,0,2023
LOM,SO,S 96,Altre attività di servizi per la persona                    ,0,0,0,0,0,2023
LOM,SO,T   ,Attività di famiglie e convivenze come datori di lavoro p...,0,0,0,0,0,2023
LOM,SO,T 97,Attività di famiglie e convivenze come datori di lavoro p...,0,0,0,0,0,2023
LOM,SO,T 98,Produzione di beni e servizi indifferenziati per uso prop...,0,0,0,0,0,2023
LOM,SO,U   ,Organizzazioni ed organismi extraterritoriali               ,0,0,0,0,0,2023
LOM,SO,U 99,Organizzazioni ed organismi extraterritoriali               ,0,0,0,0,0,2023
LOM,SO,XX  ,Imprese non classificate                                    ,18,0,0,2,20,2023
LOM,SO,TOT ,TOTALE                                                      ,95,0,1,5,101,2023
LOM,MI,A   ,"Agricoltura, silvicoltura pesca                             ",1,2,33,0,36,2023
LOM,MI,A 01,"Coltivazioni agricole e produzione di prodotti animali, c...",1,2,32,0,35,2023
LOM,MI,A 02,Silvicoltura ed utilizzo di aree forestali                  ,0,0,1,0,1,2023
LOM,MI,A 03,Pesca e acquacoltura                                        ,0,0,0,0,0,2023
LOM,MI,B   ,Estrazione di minerali da cave e miniere                    ,0,0,0,0,0,2023
LOM,MI,B 05,Estrazione di carbone (esclusa torba)                       ,0,0,0,0,0,2023
LOM,MI,B 06,Estraz.di petrolio greggio e di gas naturale                ,0,0,0,0,0,2023
LOM,MI,B 07,Estrazione di minerali metalliferi                          ,0,0,0,0,0,2023
LOM,MI,B 08,Altre attività di estrazione di minerali da cave e miniere  ,0,0,0,0,0,2023
LOM,MI,B 09,Attività dei servizi di supporto all'estrazione             ,0,0,0,0,0,2023
LOM,MI,C   ,Attività manifatturiere                                     ,43,24,120,5,192,2023
LOM,MI,C 10,Industrie alimentari                                        ,0,2,13,1,16,2023
LOM,MI,C 11,Industria delle bevande                                     ,0,2,0,0,2,2023
LOM,MI,C 12,Industria del tabacco                                       ,0,0,0,0,0,2023
LOM,MI,C 13,Industrie tessili                                           ,4,0,1,0,5,2023
LOM,MI,C 14,Confezione di articoli di abbigliamento; confezione di ar...,4,1,26,1,32,2023
LOM,MI,C 15,Fabbricazione di articoli in pelle e simili                 ,2,0,10,0,12,2023
LOM,MI,C 16,Industria del legno e dei prodotti in legno e sughero (es...,0,1,6,0,7,2023
LOM,MI,C 17,Fabbricazione di carta e di prodotti di carta               ,2,1,2,0,5,2023
LOM,MI,C 18,Stampa e riproduzione di supporti registrati                ,3,2,6,1,12,2023
LOM,MI,C 19,Fabbricazione di coke e prodotti derivanti dalla raffinaz...,0,0,0,0,0,2023
LOM,MI,C 20,Fabbricazione di prodotti chimici                           ,3,0,1,0,4,2023
LOM,MI,C 21,Fabbricazione di prodotti farmaceutici di base e di prepa...,0,0,0,0,0,2023
LOM,MI,C 22,Fabbricazione di articoli in gomma e materie plastiche      ,2,0,9,0,11,2023
LOM,MI,C 23,Fabbricazione di altri prodotti della lavorazione di miner..,2,0,1,1,4,2023
LOM,MI,C 24,Metallurgia                                                 ,0,0,0,0,0,2023
LOM,MI,C 25,Fabbricazione di prodotti in metallo (esclusi macchinari ...,11,7,18,0,36,2023
LOM,MI,C 26,Fabbricazione di computer e prodotti di elettronica e ott...,1,0,1,0,2,2023
LOM,MI,C 27,Fabbricazione di apparecchiature elettriche ed apparecchi...,2,3,2,0,7,2023
LOM,MI,C 28,Fabbricazione di macchinari ed apparecchiature nca          ,3,1,7,0,11,2023
LOM,MI,C 29,"Fabbricazione di autoveicoli, rimorchi e semirimorchi       ",0,2,0,0,2,2023
LOM,MI,C 30,Fabbricazione di altri mezzi di trasporto                   ,0,0,0,1,1,2023
LOM,MI,C 31,Fabbricazione di mobili                                     ,1,1,2,0,4,2023
LOM,MI,C 32,Altre industrie manifatturiere                              ,3,0,6,0,9,2023
LOM,MI,C 33,"Riparazione, manutenzione ed installazione di macchine ed...",0,1,9,0,10,2023
LOM,MI,D   ,"Fornitura di energia elettrica, gas, vapore e aria condiz...",0,0,1,0,1,2023
LOM,MI,D 35,"Fornitura di energia elettrica, gas, vapore e aria condiz...",0,0,1,0,1,2023
LOM,MI,E   ,"Fornitura di acqua; reti fognarie, attività di gestione d...",2,0,1,0,3,2023
LOM,MI,E 36,"Raccolta, trattamento e fornitura di acqua                  ",0,0,0,0,0,2023
LOM,MI,E 37,Gestione delle reti fognarie                                ,1,0,0,0,1,2023
LOM,MI,E 38,"Attività di raccolta, trattamento e smaltimento dei rifiu...",1,0,1,0,2,2023
LOM,MI,E 39,Attività di risanamento e altri servizi di gestione dei r...,0,0,0,0,0,2023
LOM,MI,F   ,Costruzioni                                                 ,36,27,312,36,411,2023
LOM,MI,F 41,Costruzione di edifici                                      ,16,11,32,27,86,2023
LOM,MI,F 42,Ingegneria civile                                           ,0,0,1,0,1,2023
LOM,MI,F 43,Lavori di costruzione specializzati                         ,20,16,279,9,324,2023
LOM,MI,G   ,Commercio all'ingrosso e al dettaglio; riparazione di aut...,74,53,771,0,898,2023
LOM,MI,G 45,Commercio all'ingrosso e al dettaglio e riparazione di au...,4,8,93,0,105,2023
LOM,MI,G 46,Commercio all'ingrosso (escluso quello di autoveicoli e d...,51,12,203,0,266,2023
LOM,MI,G 47,Commercio al dettaglio (escluso quello di autoveicoli e d...,19,33,475,0,527,2023
LOM,MI,H   ,Trasporto e magazzinaggio                                   ,12,9,54,57,132,2023
LOM,MI,H 49,Trasporto terrestre e mediante condotte                     ,5,6,36,8,55,2023
LOM,MI,H 50,Trasporto marittimo e per vie d'acqua                       ,0,0,0,0,0,2023
LOM,MI,H 51,Trasporto aereo                                             ,0,0,0,0,0,2023
LOM,MI,H 52,Magazzinaggio e attività di supporto ai trasporti           ,7,2,10,48,67,2023
LOM,MI,H 53,Servizi postali e attività di corriere                      ,0,1,8,1,10,2023
LOM,MI,I   ,Attività dei servizi alloggio e ristorazione                ,23,51,213,1,288,2023
LOM,MI,I 55,Alloggio                                                    ,2,0,6,0,8,2023
LOM,MI,I 56,Attività dei servizi di ristorazione                        ,21,51,207,1,280,2023
LOM,MI,J   ,Servizi di informazione e comunicazione                     ,29,9,36,4,78,2023
LOM,MI,J 58,Attività editoriali                                         ,4,0,5,2,11,2023
LOM,MI,J 59,"Attività di produzione cinematografica, di video e di pro...",3,1,7,2,13,2023
LOM,MI,J 60,Attività di programmazione e trasmissione                   ,0,0,0,0,0,2023
LOM,MI,J 61,Telecomunicazioni                                           ,2,2,7,0,11,2023
LOM,MI,J 62,"Produzione di software, consulenza informatica e attività...",13,3,5,0,21,2023
LOM,MI,J 63,Attività dei servizi d'informazione e altri servizi infor...,7,3,12,0,22,2023
LOM,MI,K   ,Attività finanziarie e assicurative                         ,11,0,28,0,39,2023
LOM,MI,K 64,Attività di servizi finanziari (escluse le assicurazioni ...,6,0,3,0,9,2023
LOM,MI,K 65,"Assicurazioni, riassicurazioni e fondi pensione (escluse ...",0,0,0,0,0,2023
LOM,MI,K 66,Attività ausiliarie dei servizi finanziari e delle attivi...,5,0,25,0,30,2023
LOM,MI,L   ,Attivita' immobiliari                                       ,53,17,19,5,94,2023
LOM,MI,L 68,Attivita' immobiliari                                       ,53,17,19,5,94,2023
LOM,MI,M   ,"Attività professionali, scientifiche e tecniche             ",42,20,70,6,138,2023
LOM,MI,M 69,Attività legali e contabilità                               ,1,5,5,0,11,2023
LOM,MI,M 70,Attività di direzione aziendale e di consulenza gestional...,26,1,17,3,47,2023
LOM,MI,M 71,Attività degli studi di architettura e d'ingegneria; coll...,3,4,1,0,8,2023
LOM,MI,M 72,Ricerca scientifica e sviluppo                              ,2,0,0,0,2,2023
LOM,MI,M 73,Pubblicità e ricerche di mercato                            ,3,3,25,2,33,2023
LOM,MI,M 74,"Altre attività professionali, scientifiche e tecniche       ",7,7,22,1,37,2023
LOM,MI,M 75,Servizi veterinari                                          ,0,0,0,0,0,2023
LOM,MI,N   ,"Noleggio, agenzie di viaggio, servizi di supporto alle im...",28,9,102,26,165,2023
LOM,MI,N 77,Attività di noleggio e leasing operativo                    ,3,0,0,1,4,2023
LOM,MI,N 78,"Attività di ricerca, selezione, fornitura di personale      ",3,0,0,0,3,2023
LOM,MI,N 79,"Attività dei servizi delle agenzie di viaggio, dei tour o...",2,2,3,0,7,2023
LOM,MI,N 80,Servizi di vigilanza e investigazione                       ,0,0,2,0,2,2023
LOM,MI,N 81,Attività di servizi per edifici e paesaggio                 ,10,5,51,10,76,2023
LOM,MI,N 82,Attività di supporto per le funzioni d'ufficio e altri se...,10,2,46,15,73,2023
LOM,MI,O   ,Amministrazione pubblica e difesa; assicurazione sociale ...,0,0,0,0,0,2023
LOM,MI,O 84,Amministrazione pubblica e difesa; assicurazione sociale ...,0,0,0,0,0,2023
LOM,MI,P   ,Istruzione                                                  ,1,0,3,0,4,2023
LOM,MI,P 85,Istruzione                                                  ,1,0,3,0,4,2023
LOM,MI,Q   ,Sanita' e assistenza sociale                                ,2,0,5,6,13,2023
LOM,MI,Q 86,Assistenza sanitaria                                        ,2,0,1,1,4,2023
LOM,MI,Q 87,Servizi di assistenza sociale residenziale                  ,0,0,0,0,0,2023
LOM,MI,Q 88,Assistenza sociale non residenziale                         ,0,0,4,5,9,2023
LOM,MI,R   ,"Attività artistiche, sportive, di intrattenimento e diver...",7,2,11,2,22,2023
LOM,MI,R 90,"Attività creative, artistiche e di intrattenimento          ",2,1,3,1,7,2023
LOM,MI,R 91,"Attività di biblioteche, archivi, musei ed altre attività...",0,0,0,0,0,2023
LOM,MI,R 92,"Attività riguardanti le lotterie, le scommesse, le case d...",1,0,3,0,4,2023
LOM,MI,R 93,"Attività sportive, di intrattenimento e di divertimento     ",4,1,5,1,11,2023
LOM,MI,S   ,Altre attività di servizi                                   ,6,13,95,0,114,2023
LOM,MI,S 94,Attività di organizzazioni associative                      ,0,0,0,0,0,2023
LOM,MI,S 95,Riparazione di computer e di beni per uso personale e per...,2,1,13,0,16,2023
LOM,MI,S 96,Altre attività di servizi per la persona                    ,4,12,82,0,98,2023
LOM,MI,T   ,Attività di famiglie e convivenze come datori di lavoro p...,0,0,0,0,0,2023
LOM,MI,T 97,Attività di famiglie e convivenze come datori di lavoro p...,0,0,0,0,0,2023
LOM,MI,T 98,Produzione di beni e servizi indifferenziati per uso prop...,0,0,0,0,0,2023
LOM,MI,U   ,Organizzazioni ed organismi extraterritoriali               ,0,0,0,0,0,2023
LOM,MI,U 99,Organizzazioni ed organismi extraterritoriali               ,0,0,0,0,0,2023
LOM,MI,XX  ,Imprese non classificate                                    ,60,6,253,10,329,2023
LOM,MI,TOT ,TOTALE                                                      ,430,242,2127,158,2957,2023
LOM,BG,A   ,"Agricoltura, silvicoltura pesca                             ",3,1,25,0,29,2023
LOM,BG,A 01,"Coltivazioni agricole e produzione di prodotti animali, c...",3,1,25,0,29,2023
LOM,BG,A 02,Silvicoltura ed utilizzo di aree forestali                  ,0,0,0,0,0,2023
LOM,BG,A 03,Pesca e acquacoltura                                        ,0,0,0,0,0,2023
LOM,BG,B   ,Estrazione di minerali da cave e miniere                    ,1,0,0,0,1,2023
LOM,BG,B 05,Estrazione di carbone (esclusa torba)                       ,0,0,0,0,0,2023
LOM,BG,B 06,Estraz.di petrolio greggio e di gas naturale                ,0,0,0,0,0,2023
LOM,BG,B 07,Estrazione di minerali metalliferi                          ,0,0,0,0,0,2023
LOM,BG,B 08,Altre attività di estrazione di minerali da cave e miniere  ,1,0,0,0,1,2023
LOM,BG,B 09,Attività dei servizi di supporto all'estrazione             ,0,0,0,0,0,2023
LOM,BG,C   ,Attività manifatturiere                                     ,146,19,12,4,181,2023
LOM,BG,C 10,Industrie alimentari                                        ,2,2,1,0,5,2023
LOM,BG,C 11,Industria delle bevande                                     ,0,0,0,0,0,2023
LOM,BG,C 12,Industria del tabacco                                       ,0,0,0,0,0,2023
LOM,BG,C 13,Industrie tessili                                           ,13,2,1,0,16,2023
LOM,BG,C 14,Confezione di articoli di abbigliamento; confezione di ar...,13,1,1,0,15,2023
LOM,BG,C 15,Fabbricazione di articoli in pelle e simili                 ,0,0,0,0,0,2023
LOM,BG,C 16,Industria del legno e dei prodotti in legno e sughero (es...,7,1,1,0,9,2023
LOM,BG,C 17,Fabbricazione di carta e di prodotti di carta               ,1,0,0,0,1,2023
LOM,BG,C 18,Stampa e riproduzione di supporti registrati                ,7,1,0,0,8,2023
LOM,BG,C 19,Fabbricazione di coke e prodotti derivanti dalla raffinaz...,0,0,0,0,0,2023
LOM,BG,C 20,Fabbricazione di prodotti chimici                           ,1,0,0,1,2,2023
LOM,BG,C 21,Fabbricazione di prodotti farmaceutici di base e di prepa...,1,0,0,0,1,2023
LOM,BG,C 22,Fabbricazione di articoli in gomma e materie plastiche      ,14,0,2,1,17,2023
LOM,BG,C 23,Fabbricazione di altri prodotti della lavorazione di miner..,4,1,1,0,6,2023
LOM,BG,C 24,Metallurgia                                                 ,4,0,0,0,4,2023
LOM,BG,C 25,Fabbricazione di prodotti in metallo (esclusi macchinari ...,31,5,4,2,42,2023
LOM,BG,C 26,Fabbricazione di computer e prodotti di elettronica e ott...,5,0,0,0,5,2023
LOM,BG,C 27,Fabbricazione di apparecchiature elettriche ed apparecchi...,4,0,0,0,4,2023
LOM,BG,C 28,Fabbricazione di macchinari ed apparecchiature nca          ,21,1,0,0,22,2023
LOM,BG,C 29,"Fabbricazione di autoveicoli, rimorchi e semirimorchi       ",3,0,0,0,3,2023
LOM,BG,C 30,Fabbricazione di altri mezzi di trasporto                   ,1,1,0,0,2,2023
LOM,BG,C 31,Fabbricazione di mobili                                     ,3,1,0,0,4,2023
LOM,BG,C 32,Altre industrie manifatturiere                              ,5,1,0,0,6,2023
LOM,BG,C 33,"Riparazione, manutenzione ed installazione di macchine ed...",6,2,1,0,9,2023
LOM,BG,D   ,"Fornitura di energia elettrica, gas, vapore e aria condiz...",1,0,0,0,1,2023
LOM,BG,D 35,"Fornitura di energia elettrica, gas, vapore e aria condiz...",1,0,0,0,1,2023
LOM,BG,E   ,"Fornitura di acqua; reti fognarie, attività di gestione d...",0,0,0,0,0,2023
LOM,BG,E 36,"Raccolta, trattamento e fornitura di acqua                  ",0,0,0,0,0,2023
LOM,BG,E 37,Gestione delle reti fognarie                                ,0,0,0,0,0,2023
LOM,BG,E 38,"Attività di raccolta, trattamento e smaltimento dei rifiu...",0,0,0,0,0,2023
LOM,BG,E 39,Attività di risanamento e altri servizi di gestione dei r...,0,0,0,0,0,2023
LOM,BG,F   ,Costruzioni                                                 ,163,21,26,8,218,2023
LOM,BG,F 41,Costruzione di edifici                                      ,111,14,7,5,137,2023
LOM,BG,F 42,Ingegneria civile                                           ,0,0,0,1,1,2023
LOM,BG,F 43,Lavori di costruzione specializzati                         ,52,7,19,2,80,2023
LOM,BG,G   ,Commercio all'ingrosso e al dettaglio; riparazione di aut...,185,45,48,0,278,2023
LOM,BG,G 45,Commercio all'ingrosso e al dettaglio e riparazione di au...,22,4,8,0,34,2023
LOM,BG,G 46,Commercio all'ingrosso (escluso quello di autoveicoli e d...,107,6,14,0,127,2023
LOM,BG,G 47,Commercio al dettaglio (escluso quello di autoveicoli e d...,56,35,26,0,117,2023
LOM,BG,H   ,Trasporto e magazzinaggio                                   ,18,0,3,7,28,2023
LOM,BG,H 49,Trasporto terrestre e mediante condotte                     ,10,0,2,2,14,2023
LOM,BG,H 50,Trasporto marittimo e per vie d'acqua                       ,0,0,0,0,0,2023
LOM,BG,H 51,Trasporto aereo                                             ,1,0,0,0,1,2023
LOM,BG,H 52,Magazzinaggio e attività di supporto ai trasporti           ,6,0,0,5,11,2023
LOM,BG,H 53,Servizi postali e attività di corriere                      ,1,0,1,0,2,2023
LOM,BG,I   ,Attività dei servizi alloggio e ristorazione                ,51,58,15,0,124,2023
LOM,BG,I 55,Alloggio                                                    ,2,1,1,0,4,2023
LOM,BG,I 56,Attività dei servizi di ristorazione                        ,49,57,14,0,120,2023
LOM,BG,J   ,Servizi di informazione e comunicazione                     ,37,6,2,0,45,2023
LOM,BG,J 58,Attività editoriali                                         ,2,0,0,0,2,2023
LOM,BG,J 59,"Attività di produzione cinematografica, di video e di pro...",2,0,0,0,2,2023
LOM,BG,J 60,Attività di programmazione e trasmissione                   ,1,0,0,0,1,2023
LOM,BG,J 61,Telecomunicazioni                                           ,1,3,1,0,5,2023
LOM,BG,J 62,"Produzione di software, consulenza informatica e attività...",17,0,0,0,17,2023
LOM,BG,J 63,Attività dei servizi d'informazione e altri servizi infor...,14,3,1,0,18,2023
LOM,BG,K   ,Attività finanziarie e assicurative                         ,13,0,3,0,16,2023
LOM,BG,K 64,Attività di servizi finanziari (escluse le assicurazioni ...,9,0,0,0,9,2023
LOM,BG,K 65,"Assicurazioni, riassicurazioni e fondi pensione (escluse ...",0,0,0,0,0,2023
LOM,BG,K 66,Attività ausiliarie dei servizi finanziari e delle attivi...,4,0,3,0,7,2023
LOM,BG,L   ,Attivita' immobiliari                                       ,98,7,0,0,105,2023
LOM,BG,L 68,Attivita' immobiliari                                       ,98,7,0,0,105,2023
LOM,BG,M   ,"Attività professionali, scientifiche e tecniche             ",57,1,4,2,64,2023
LOM,BG,M 69,Attività legali e contabilità                               ,3,0,0,0,3,2023
LOM,BG,M 70,Attività di direzione aziendale e di consulenza gestional...,14,0,2,2,18,2023
LOM,BG,M 71,Attività degli studi di architettura e d'ingegneria; coll...,7,0,0,0,7,2023
LOM,BG,M 72,Ricerca scientifica e sviluppo                              ,1,0,0,0,1,2023
LOM,BG,M 73,Pubblicità e ricerche di mercato                            ,18,0,0,0,18,2023
LOM,BG,M 74,"Altre attività professionali, scientifiche e tecniche       ",14,1,2,0,17,2023
LOM,BG,M 75,Servizi veterinari                                          ,0,0,0,0,0,2023
LOM,BG,N   ,"Noleggio, agenzie di viaggio, servizi di supporto alle im...",29,4,6,1,40,2023
LOM,BG,N 77,Attività di noleggio e leasing operativo                    ,4,2,1,0,7,2023
LOM,BG,N 78,"Attività di ricerca, selezione, fornitura di personale      ",1,0,0,0,1,2023
LOM,BG,N 79,"Attività dei servizi delle agenzie di viaggio, dei tour o...",3,1,0,0,4,2023
LOM,BG,N 80,Servizi di vigilanza e investigazione                       ,4,0,0,0,4,2023
LOM,BG,N 81,Attività di servizi per edifici e paesaggio                 ,7,0,2,1,10,2023
LOM,BG,N 82,Attività di supporto per le funzioni d'ufficio e altri se...,10,1,3,0,14,2023
LOM,BG,O   ,Amministrazione pubblica e difesa; assicurazione sociale ...,0,0,0,0,0,2023
LOM,BG,O 84,Amministrazione pubblica e difesa; assicurazione sociale ...,0,0,0,0,0,2023
LOM,BG,P   ,Istruzione                                                  ,4,1,1,0,6,2023
LOM,BG,P 85,Istruzione                                                  ,4,1,1,0,6,2023
LOM,BG,Q   ,Sanita' e assistenza sociale                                ,0,0,0,0,0,2023
LOM,BG,Q 86,Assistenza sanitaria                                        ,0,0,0,0,0,2023
LOM,BG,Q 87,Servizi di assistenza sociale residenziale                  ,0,0,0,0,0,2023
LOM,BG,Q 88,Assistenza sociale non residenziale                         ,0,0,0,0,0,2023
LOM,BG,R   ,"Attività artistiche, sportive, di intrattenimento e diver...",26,2,2,0,30,2023
LOM,BG,R 90,"Attività creative, artistiche e di intrattenimento          ",1,0,0,0,1,2023
LOM,BG,R 91,"Attività di biblioteche, archivi, musei ed altre attività...",0,0,0,0,0,2023
LOM,BG,R 92,"Attività riguardanti le lotterie, le scommesse, le case d...",2,0,0,0,2,2023
LOM,BG,R 93,"Attività sportive, di intrattenimento e di divertimento     ",23,2,2,0,27,2023
LOM,BG,S   ,Altre attività di servizi                                   ,11,6,3,1,21,2023
LOM,BG,S 94,Attività di organizzazioni associative                      ,0,0,0,0,0,2023
LOM,BG,S 95,Riparazione di computer e di beni per uso personale e per...,2,0,1,0,3,2023
LOM,BG,S 96,Altre attività di servizi per la persona                    ,9,6,2,1,18,2023
LOM,BG,T   ,Attività di famiglie e convivenze come datori di lavoro p...,0,0,0,0,0,2023
LOM,BG,T 97,Attività di famiglie e convivenze come datori di lavoro p...,0,0,0,0,0,2023
LOM,BG,T 98,Produzione di beni e servizi indifferenziati per uso prop...,0,0,0,0,0,2023
LOM,BG,U   ,Organizzazioni ed organismi extraterritoriali               ,0,0,0,0,0,2023
LOM,BG,U 99,Organizzazioni ed organismi extraterritoriali               ,0,0,0,0,0,2023
LOM,BG,XX  ,Imprese non classificate                                    ,206,98,6,4,314,2023
LOM,BG,TOT ,TOTALE                                                      ,1049,269,156,27,1501,2023
LOM,BS,A   ,"Agricoltura, silvicoltura pesca                             ",0,5,79,0,84,2023
LOM,BS,A 01,"Coltivazioni agricole e produzione di prodotti animali, c...",0,5,72,0,77,2023
LOM,BS,A 02,Silvicoltura ed utilizzo di aree forestali                  ,0,0,7,0,7,2023
LOM,BS,A 03,Pesca e acquacoltura                                        ,0,0,0,0,0,2023
LOM,BS,B   ,Estrazione di minerali da cave e miniere                    ,0,0,1,0,1,2023
LOM,BS,B 05,Estrazione di carbone (esclusa torba)                       ,0,0,0,0,0,2023
LOM,BS,B 06,Estraz.di petrolio greggio e di gas naturale                ,0,0,0,0,0,2023
LOM,BS,B 07,Estrazione di minerali metalliferi                          ,0,0,0,0,0,2023
LOM,BS,B 08,Altre attività di estrazione di minerali da cave e miniere  ,0,0,1,0,1,2023
LOM,BS,B 09,Attività dei servizi di supporto all'estrazione             ,0,0,0,0,0,2023
LOM,BS,C   ,Attività manifatturiere                                     ,3,34,291,1,329,2023
LOM,BS,C 10,Industrie alimentari                                        ,1,3,4,0,8,2023
LOM,BS,C 11,Industria delle bevande                                     ,0,0,1,0,1,2023
LOM,BS,C 12,Industria del tabacco                                       ,0,0,0,0,0,2023
LOM,BS,C 13,Industrie tessili                                           ,0,3,10,0,13,2023
LOM,BS,C 14,Confezione di articoli di abbigliamento; confezione di ar...,0,6,63,0,69,2023
LOM,BS,C 15,Fabbricazione di articoli in pelle e simili                 ,0,0,5,0,5,2023
LOM,BS,C 16,Industria del legno e dei prodotti in legno e sughero (es...,0,4,13,0,17,2023
LOM,BS,C 17,Fabbricazione di carta e di prodotti di carta               ,0,1,1,0,2,2023
LOM,BS,C 18,Stampa e riproduzione di supporti registrati                ,0,1,2,0,3,2023
LOM,BS,C 19,Fabbricazione di coke e prodotti derivanti dalla raffinaz...,0,0,0,0,0,2023
LOM,BS,C 20,Fabbricazione di prodotti chimici                           ,0,0,1,0,1,2023
LOM,BS,C 21,Fabbricazione di prodotti farmaceutici di base e di prepa...,0,0,0,0,0,2023
LOM,BS,C 22,Fabbricazione di articoli in gomma e materie plastiche      ,0,2,5,0,7,2023
LOM,BS,C 23,Fabbricazione di altri prodotti della lavorazione di miner..,0,0,8,0,8,2023
LOM,BS,C 24,Metallurgia                                                 ,0,0,1,0,1,2023
LOM,BS,C 25,Fabbricazione di prodotti in metallo (esclusi macchinari ...,0,9,131,1,141,2023
LOM,BS,C 26,Fabbricazione di computer e prodotti di elettronica e ott...,0,0,1,0,1,2023
LOM,BS,C 27,Fabbricazione di apparecchiature elettriche ed apparecchi...,0,2,6,0,8,2023
LOM,BS,C 28,Fabbricazione di macchinari ed apparecchiature nca          ,0,2,9,0,11,2023
LOM,BS,C 29,"Fabbricazione di autoveicoli, rimorchi e semirimorchi       ",0,0,1,0,1,2023
LOM,BS,C 30,Fabbricazione di altri mezzi di trasporto                   ,0,0,2,0,2,2023
LOM,BS,C 31,Fabbricazione di mobili                                     ,2,0,4,0,6,2023
LOM,BS,C 32,Altre industrie manifatturiere                              ,0,1,6,0,7,2023
LOM,BS,C 33,"Riparazione, manutenzione ed installazione di macchine ed...",0,0,17,0,17,2023
LOM,BS,D   ,"Fornitura di energia elettrica, gas, vapore e aria condiz...",0,0,0,0,0,2023
LOM,BS,D 35,"Fornitura di energia elettrica, gas, vapore e aria condiz...",0,0,0,0,0,2023
LOM,BS,E   ,"Fornitura di acqua; reti fognarie, attività di gestione d...",0,0,4,0,4,2023
LOM,BS,E 36,"Raccolta, trattamento e fornitura di acqua                  ",0,0,0,0,0,2023
LOM,BS,E 37,Gestione delle reti fognarie                                ,0,0,1,0,1,2023
LOM,BS,E 38,"Attività di raccolta, trattamento e smaltimento dei rifiu...",0,0,3,0,3,2023
LOM,BS,E 39,Attività di risanamento e altri servizi di gestione dei r...,0,0,0,0,0,2023
LOM,BS,F   ,Costruzioni                                                 ,4,25,670,3,702,2023
LOM,BS,F 41,Costruzione di edifici                                      ,2,12,144,3,161,2023
LOM,BS,F 42,Ingegneria civile                                           ,0,0,1,0,1,2023
LOM,BS,F 43,Lavori di costruzione specializzati                         ,2,13,525,0,540,2023
LOM,BS,G   ,Commercio all'ingrosso e al dettaglio; riparazione di aut...,5,50,303,2,360,2023
LOM,BS,G 45,Commercio all'ingrosso e al dettaglio e riparazione di au...,1,3,35,0,39,2023
LOM,BS,G 46,Commercio all'ingrosso (escluso quello di autoveicoli e d...,4,14,114,2,134,2023
LOM,BS,G 47,Commercio al dettaglio (escluso quello di autoveicoli e d...,0,33,154,0,187,2023
LOM,BS,H   ,Trasporto e magazzinaggio                                   ,0,3,125,0,128,2023
LOM,BS,H 49,Trasporto terrestre e mediante condotte                     ,0,2,118,0,120,2023
LOM,BS,H 50,Trasporto marittimo e per vie d'acqua                       ,0,0,0,0,0,2023
LOM,BS,H 51,Trasporto aereo                                             ,0,0,0,0,0,2023
LOM,BS,H 52,Magazzinaggio e attività di supporto ai trasporti           ,0,1,5,0,6,2023
LOM,BS,H 53,Servizi postali e attività di corriere                      ,0,0,2,0,2,2023
LOM,BS,I   ,Attività dei servizi alloggio e ristorazione                ,1,74,72,1,148,2023
LOM,BS,I 55,Alloggio                                                    ,0,3,2,0,5,2023
LOM,BS,I 56,Attività dei servizi di ristorazione                        ,1,71,70,1,143,2023
LOM,BS,J   ,Servizi di informazione e comunicazione                     ,0,10,14,0,24,2023
LOM,BS,J 58,Attività editoriali                                         ,0,0,0,0,0,2023
LOM,BS,J 59,"Attività di produzione cinematografica, di video e di pro...",0,0,1,0,1,2023
LOM,BS,J 60,Attività di programmazione e trasmissione                   ,0,0,0,0,0,2023
LOM,BS,J 61,Telecomunicazioni                                           ,0,5,5,0,10,2023
LOM,BS,J 62,"Produzione di software, consulenza informatica e attività...",0,0,6,0,6,2023
LOM,BS,J 63,Attività dei servizi d'informazione e altri servizi infor...,0,5,2,0,7,2023
LOM,BS,K   ,Attività finanziarie e assicurative                         ,0,4,24,0,28,2023
LOM,BS,K 64,Attività di servizi finanziari (escluse le assicurazioni ...,0,0,0,0,0,2023
LOM,BS,K 65,"Assicurazioni, riassicurazioni e fondi pensione (escluse ...",0,0,0,0,0,2023
LOM,BS,K 66,Attività ausiliarie dei servizi finanziari e delle attivi...,0,4,24,0,28,2023
LOM,BS,L   ,Attivita' immobiliari                                       ,0,21,7,0,28,2023
LOM,BS,L 68,Attivita' immobiliari                                       ,0,21,7,0,28,2023
LOM,BS,M   ,"Attività professionali, scientifiche e tecniche             ",2,5,37,1,45,2023
LOM,BS,M 69,Attività legali e contabilità                               ,0,1,0,0,1,2023
LOM,BS,M 70,Attività di direzione aziendale e di consulenza gestional...,1,1,10,0,12,2023
LOM,BS,M 71,Attività degli studi di architettura e d'ingegneria; coll...,1,0,1,0,2,2023
LOM,BS,M 72,Ricerca scientifica e sviluppo                              ,0,0,0,0,0,2023
LOM,BS,M 73,Pubblicità e ricerche di mercato                            ,0,3,12,0,15,2023
LOM,BS,M 74,"Altre attività professionali, scientifiche e tecniche       ",0,0,14,1,15,2023
LOM,BS,M 75,Servizi veterinari                                          ,0,0,0,0,0,2023
LOM,BS,N   ,"Noleggio, agenzie di viaggio, servizi di supporto alle im...",0,11,87,0,98,2023
LOM,BS,N 77,Attività di noleggio e leasing operativo                    ,0,0,3,0,3,2023
LOM,BS,N 78,"Attività di ricerca, selezione, fornitura di personale      ",0,1,0,0,1,2023
LOM,BS,N 79,"Attività dei servizi delle agenzie di viaggio, dei tour o...",0,2,1,0,3,2023
LOM,BS,N 80,Servizi di vigilanza e investigazione                       ,0,0,0,0,0,2023
LOM,BS,N 81,Attività di servizi per edifici e paesaggio                 ,0,2,16,0,18,2023
LOM,BS,N 82,Attività di supporto per le funzioni d'ufficio e altri se...,0,6,67,0,73,2023
LOM,BS,O   ,Amministrazione pubblica e difesa; assicurazione sociale ...,0,0,0,0,0,2023
LOM,BS,O 84,Amministrazione pubblica e difesa; assicurazione sociale ...,0,0,0,0,0,2023
LOM,BS,P   ,Istruzione                                                  ,0,0,1,1,2,2023
LOM,BS,P 85,Istruzione                                                  ,0,0,1,1,2,2023
LOM,BS,Q   ,Sanita' e assistenza sociale                                ,0,0,0,1,1,2023
LOM,BS,Q 86,Assistenza sanitaria                                        ,0,0,0,1,1,2023
LOM,BS,Q 87,Servizi di assistenza sociale residenziale                  ,0,0,0,0,0,2023
LOM,BS,Q 88,Assistenza sociale non residenziale                         ,0,0,0,0,0,2023
LOM,BS,R   ,"Attività artistiche, sportive, di intrattenimento e diver...",0,1,14,1,16,2023
LOM,BS,R 90,"Attività creative, artistiche e di intrattenimento          ",0,0,9,0,9,2023
LOM,BS,R 91,"Attività di biblioteche, archivi, musei ed altre attività...",0,0,0,0,0,2023
LOM,BS,R 92,"Attività riguardanti le lotterie, le scommesse, le case d...",0,0,3,0,3,2023
LOM,BS,R 93,"Attività sportive, di intrattenimento e di divertimento     ",0,1,2,1,4,2023
LOM,BS,S   ,Altre attività di servizi                                   ,0,6,41,0,47,2023
LOM,BS,S 94,Attività di organizzazioni associative                      ,0,0,0,0,0,2023
LOM,BS,S 95,Riparazione di computer e di beni per uso personale e per...,0,1,19,0,20,2023
LOM,BS,S 96,Altre attività di servizi per la persona                    ,0,5,22,0,27,2023
LOM,BS,T   ,Attività di famiglie e convivenze come datori di lavoro p...,0,0,0,0,0,2023
LOM,BS,T 97,Attività di famiglie e convivenze come datori di lavoro p...,0,0,0,0,0,2023
LOM,BS,T 98,Produzione di beni e servizi indifferenziati per uso prop...,0,0,0,0,0,2023
LOM,BS,U   ,Organizzazioni ed organismi extraterritoriali               ,0,0,0,0,0,2023
LOM,BS,U 99,Organizzazioni ed organismi extraterritoriali               ,0,0,0,0,0,2023
LOM,BS,XX  ,Imprese non classificate                                    ,2,20,6,6,34,2023
LOM,BS,TOT ,TOTALE                                                      ,17,269,1776,17,2079,2023
LOM,PV,A   ,"Agricoltura, silvicoltura pesca                             ",0,0,41,0,41,2023
LOM,PV,A 01,"Coltivazioni agricole e produzione di prodotti animali, c...",0,0,41,0,41,2023
LOM,PV,A 02,Silvicoltura ed utilizzo di aree forestali                  ,0,0,0,0,0,2023
LOM,PV,A 03,Pesca e acquacoltura                                        ,0,0,0,0,0,2023
LOM,PV,B   ,Estrazione di minerali da cave e miniere                    ,0,0,0,0,0,2023
LOM,PV,B 05,Estrazione di carbone (esclusa torba)                       ,0,0,0,0,0,2023
LOM,PV,B 06,Estraz.di petrolio greggio e di gas naturale                ,0,0,0,0,0,2023
LOM,PV,B 07,Estrazione di minerali metalliferi                          ,0,0,0,0,0,2023
LOM,PV,B 08,Altre attività di estrazione di minerali da cave e miniere  ,0,0,0,0,0,2023
LOM,PV,B 09,Attività dei servizi di supporto all'estrazione             ,0,0,0,0,0,2023
LOM,PV,C   ,Attività manifatturiere                                     ,0,0,19,0,19,2023
LOM,PV,C 10,Industrie alimentari                                        ,0,0,1,0,1,2023
LOM,PV,C 11,Industria delle bevande                                     ,0,0,1,0,1,2023
LOM,PV,C 12,Industria del tabacco                                       ,0,0,0,0,0,2023
LOM,PV,C 13,Industrie tessili                                           ,0,0,0,0,0,2023
LOM,PV,C 14,Confezione di articoli di abbigliamento; confezione di ar...,0,0,2,0,2,2023
LOM,PV,C 15,Fabbricazione di articoli in pelle e simili                 ,0,0,2,0,2,2023
LOM,PV,C 16,Industria del legno e dei prodotti in legno e sughero (es...,0,0,0,0,0,2023
LOM,PV,C 17,Fabbricazione di carta e di prodotti di carta               ,0,0,0,0,0,2023
LOM,PV,C 18,Stampa e riproduzione di supporti registrati                ,0,0,1,0,1,2023
LOM,PV,C 19,Fabbricazione di coke e prodotti derivanti dalla raffinaz...,0,0,0,0,0,2023
LOM,PV,C 20,Fabbricazione di prodotti chimici                           ,0,0,0,0,0,2023
LOM,PV,C 21,Fabbricazione di prodotti farmaceutici di base e di prepa...,0,0,0,0,0,2023
LOM,PV,C 22,Fabbricazione di articoli in gomma e materie plastiche      ,0,0,0,0,0,2023
LOM,PV,C 23,Fabbricazione di altri prodotti della lavorazione di miner..,0,0,2,0,2,2023
LOM,PV,C 24,Metallurgia                                                 ,0,0,0,0,0,2023
LOM,PV,C 25,Fabbricazione di prodotti in metallo (esclusi macchinari ...,0,0,3,0,3,2023
LOM,PV,C 26,Fabbricazione di computer e prodotti di elettronica e ott...,0,0,0,0,0,2023
LOM,PV,C 27,Fabbricazione di apparecchiature elettriche ed apparecchi...,0,0,1,0,1,2023
LOM,PV,C 28,Fabbricazione di macchinari ed apparecchiature nca          ,0,0,1,0,1,2023
LOM,PV,C 29,"Fabbricazione di autoveicoli, rimorchi e semirimorchi       ",0,0,0,0,0,2023
LOM,PV,C 30,Fabbricazione di altri mezzi di trasporto                   ,0,0,0,0,0,2023
LOM,PV,C 31,Fabbricazione di mobili                                     ,0,0,1,0,1,2023
LOM,PV,C 32,Altre industrie manifatturiere                              ,0,0,2,0,2,2023
LOM,PV,C 33,"Riparazione, manutenzione ed installazione di macchine ed...",0,0,2,0,2,2023
LOM,PV,D   ,"Fornitura di energia elettrica, gas, vapore e aria condiz...",0,0,0,0,0,2023
LOM,PV,D 35,"Fornitura di energia elettrica, gas, vapore e aria condiz...",0,0,0,0,0,2023
LOM,PV,E   ,"Fornitura di acqua; reti fognarie, attività di gestione d...",0,0,0,0,0,2023
LOM,PV,E 36,"Raccolta, trattamento e fornitura di acqua                  ",0,0,0,0,0,2023
LOM,PV,E 37,Gestione delle reti fognarie                                ,0,0,0,0,0,2023
LOM,PV,E 38,"Attività di raccolta, trattamento e smaltimento dei rifiu...",0,0,0,0,0,2023
LOM,PV,E 39,Attività di risanamento e altri servizi di gestione dei r...,0,0,0,0,0,2023
LOM,PV,F   ,Costruzioni                                                 ,0,0,19,2,21,2023
LOM,PV,F 41,Costruzione di edifici                                      ,0,0,9,1,10,2023
LOM,PV,F 42,Ingegneria civile                                           ,0,0,0,0,0,2023
LOM,PV,F 43,Lavori di costruzione specializzati                         ,0,0,10,1,11,2023
LOM,PV,G   ,Commercio all'ingrosso e al dettaglio; riparazione di aut...,0,0,9,0,9,2023
LOM,PV,G 45,Commercio all'ingrosso e al dettaglio e riparazione di au...,0,0,2,0,2,2023
LOM,PV,G 46,Commercio all'ingrosso (escluso quello di autoveicoli e d...,0,0,0,0,0,2023
LOM,PV,G 47,Commercio al dettaglio (escluso quello di autoveicoli e d...,0,0,7,0,7,2023
LOM,PV,H   ,Trasporto e magazzinaggio                                   ,0,0,4,0,4,2023
LOM,PV,H 49,Trasporto terrestre e mediante condotte                     ,0,0,4,0,4,2023
LOM,PV,H 50,Trasporto marittimo e per vie d'acqua                       ,0,0,0,0,0,2023
LOM,PV,H 51,Trasporto aereo                                             ,0,0,0,0,0,2023
LOM,PV,H 52,Magazzinaggio e attività di supporto ai trasporti           ,0,0,0,0,0,2023
LOM,PV,H 53,Servizi postali e attività di corriere                      ,0,0,0,0,0,2023
LOM,PV,I   ,Attività dei servizi alloggio e ristorazione                ,0,0,6,0,6,2023
LOM,PV,I 55,Alloggio                                                    ,0,0,0,0,0,2023
LOM,PV,I 56,Attività dei servizi di ristorazione                        ,0,0,6,0,6,2023
LOM,PV,J   ,Servizi di informazione e comunicazione                     ,0,0,0,0,0,2023
LOM,PV,J 58,Attività editoriali                                         ,0,0,0,0,0,2023
LOM,PV,J 59,"Attività di produzione cinematografica, di video e di pro...",0,0,0,0,0,2023
LOM,PV,J 60,Attività di programmazione e trasmissione                   ,0,0,0,0,0,2023
LOM,PV,J 61,Telecomunicazioni                                           ,0,0,0,0,0,2023
LOM,PV,J 62,"Produzione di software, consulenza informatica e attività...",0,0,0,0,0,2023
LOM,PV,J 63,Attività dei servizi d'informazione e altri servizi infor...,0,0,0,0,0,2023
LOM,PV,K   ,Attività finanziarie e assicurative                         ,0,0,0,0,0,2023
LOM,PV,K 64,Attività di servizi finanziari (escluse le assicurazioni ...,0,0,0,0,0,2023
LOM,PV,K 65,"Assicurazioni, riassicurazioni e fondi pensione (escluse ...",0,0,0,0,0,2023
LOM,PV,K 66,Attività ausiliarie dei servizi finanziari e delle attivi...,0,0,0,0,0,2023
LOM,PV,L   ,Attivita' immobiliari                                       ,0,0,0,0,0,2023
LOM,PV,L 68,Attivita' immobiliari                                       ,0,0,0,0,0,2023
LOM,PV,M   ,"Attività professionali, scientifiche e tecniche             ",0,0,1,0,1,2023
LOM,PV,M 69,Attività legali e contabilità                               ,0,0,0,0,0,2023
LOM,PV,M 70,Attività di direzione aziendale e di consulenza gestional...,0,0,0,0,0,2023
LOM,PV,M 71,Attività degli studi di architettura e d'ingegneria; coll...,0,0,0,0,0,2023
LOM,PV,M 72,Ricerca scientifica e sviluppo                              ,0,0,0,0,0,2023
LOM,PV,M 73,Pubblicità e ricerche di mercato                            ,0,0,1,0,1,2023
LOM,PV,M 74,"Altre attività professionali, scientifiche e tecniche       ",0,0,0,0,0,2023
LOM,PV,M 75,Servizi veterinari                                          ,0,0,0,0,0,2023
LOM,PV,N   ,"Noleggio, agenzie di viaggio, servizi di supporto alle im...",0,0,0,1,1,2023
LOM,PV,N 77,Attività di noleggio e leasing operativo                    ,0,0,0,0,0,2023
LOM,PV,N 78,"Attività di ricerca, selezione, fornitura di personale      ",0,0,0,0,0,2023
LOM,PV,N 79,"Attività dei servizi delle agenzie di viaggio, dei tour o...",0,0,0,0,0,2023
LOM,PV,N 80,Servizi di vigilanza e investigazione                       ,0,0,0,0,0,2023
LOM,PV,N 81,Attività di servizi per edifici e paesaggio                 ,0,0,0,0,0,2023
LOM,PV,N 82,Attività di supporto per le funzioni d'ufficio e altri se...,0,0,0,1,1,2023
LOM,PV,O   ,Amministrazione pubblica e difesa; assicurazione sociale ...,0,0,0,0,0,2023
LOM,PV,O 84,Amministrazione pubblica e difesa; assicurazione sociale ...,0,0,0,0,0,2023
LOM,PV,P   ,Istruzione                                                  ,0,0,0,0,0,2023
LOM,PV,P 85,Istruzione                                                  ,0,0,0,0,0,2023
LOM,PV,Q   ,Sanita' e assistenza sociale                                ,0,0,0,1,1,2023
LOM,PV,Q 86,Assistenza sanitaria                                        ,0,0,0,0,0,2023
LOM,PV,Q 87,Servizi di assistenza sociale residenziale                  ,0,0,0,1,1,2023
LOM,PV,Q 88,Assistenza sociale non residenziale                         ,0,0,0,0,0,2023
LOM,PV,R   ,"Attività artistiche, sportive, di intrattenimento e diver...",0,0,0,0,0,2023
LOM,PV,R 90,"Attività creative, artistiche e di intrattenimento          ",0,0,0,0,0,2023
LOM,PV,R 91,"Attività di biblioteche, archivi, musei ed altre attività...",0,0,0,0,0,2023
LOM,PV,R 92,"Attività riguardanti le lotterie, le scommesse, le case d...",0,0,0,0,0,2023
LOM,PV,R 93,"Attività sportive, di intrattenimento e di divertimento     ",0,0,0,0,0,2023
LOM,PV,S   ,Altre attività di servizi                                   ,0,0,4,0,4,2023
LOM,PV,S 94,Attività di organizzazioni associative                      ,0,0,0,0,0,2023
LOM,PV,S 95,Riparazione di computer e di beni per uso personale e per...,0,0,2,0,2,2023
LOM,PV,S 96,Altre attività di servizi per la persona                    ,0,0,2,0,2,2023
LOM,PV,T   ,Attività di famiglie e convivenze come datori di lavoro p...,0,0,0,0,0,2023
LOM,PV,T 97,Attività di famiglie e convivenze come datori di lavoro p...,0,0,0,0,0,2023
LOM,PV,T 98,Produzione di beni e servizi indifferenziati per uso prop...,0,0,0,0,0,2023
LOM,PV,U   ,Organizzazioni ed organismi extraterritoriali               ,0,0,0,0,0,2023
LOM,PV,U 99,Organizzazioni ed organismi extraterritoriali               ,0,0,0,0,0,2023
LOM,PV,XX  ,Imprese non classificate                                    ,0,0,0,2,2,2023
LOM,PV,TOT ,TOTALE                                                      ,0,0,103,6,109,2023
LOM,CR,A   ,"Agricoltura, silvicoltura pesca                             ",2,0,5,0,7,2023
LOM,CR,A 01,"Coltivazioni agricole e produzione di prodotti animali, c...",2,0,5,0,7,2023
LOM,CR,A 02,Silvicoltura ed utilizzo di aree forestali                  ,0,0,0,0,0,2023
LOM,CR,A 03,Pesca e acquacoltura                                        ,0,0,0,0,0,2023
LOM,CR,B   ,Estrazione di minerali da cave e miniere                    ,0,0,0,0,0,2023
LOM,CR,B 05,Estrazione di carbone (esclusa torba)                       ,0,0,0,0,0,2023
LOM,CR,B 06,Estraz.di petrolio greggio e di gas naturale                ,0,0,0,0,0,2023
LOM,CR,B 07,Estrazione di minerali metalliferi                          ,0,0,0,0,0,2023
LOM,CR,B 08,Altre attività di estrazione di minerali da cave e miniere  ,0,0,0,0,0,2023
LOM,CR,B 09,Attività dei servizi di supporto all'estrazione             ,0,0,0,0,0,2023
LOM,CR,C   ,Attività manifatturiere                                     ,42,0,3,0,45,2023
LOM,CR,C 10,Industrie alimentari                                        ,2,0,1,0,3,2023
LOM,CR,C 11,Industria delle bevande                                     ,0,0,0,0,0,2023
LOM,CR,C 12,Industria del tabacco                                       ,0,0,0,0,0,2023
LOM,CR,C 13,Industrie tessili                                           ,1,0,0,0,1,2023
LOM,CR,C 14,Confezione di articoli di abbigliamento; confezione di ar...,8,0,1,0,9,2023
LOM,CR,C 15,Fabbricazione di articoli in pelle e simili                 ,1,0,0,0,1,2023
LOM,CR,C 16,Industria del legno e dei prodotti in legno e sughero (es...,1,0,0,0,1,2023
LOM,CR,C 17,Fabbricazione di carta e di prodotti di carta               ,2,0,0,0,2,2023
LOM,CR,C 18,Stampa e riproduzione di supporti registrati                ,0,0,0,0,0,2023
LOM,CR,C 19,Fabbricazione di coke e prodotti derivanti dalla raffinaz...,0,0,0,0,0,2023
LOM,CR,C 20,Fabbricazione di prodotti chimici                           ,2,0,0,0,2,2023
LOM,CR,C 21,Fabbricazione di prodotti farmaceutici di base e di prepa...,1,0,0,0,1,2023
LOM,CR,C 22,Fabbricazione di articoli in gomma e materie plastiche      ,0,0,0,0,0,2023
LOM,CR,C 23,Fabbricazione di altri prodotti della lavorazione di miner..,1,0,0,0,1,2023
LOM,CR,C 24,Metallurgia                                                 ,1,0,0,0,1,2023
LOM,CR,C 25,Fabbricazione di prodotti in metallo (esclusi macchinari ...,8,0,1,0,9,2023
LOM,CR,C 26,Fabbricazione di computer e prodotti di elettronica e ott...,4,0,0,0,4,2023
LOM,CR,C 27,Fabbricazione di apparecchiature elettriche ed apparecchi...,2,0,0,0,2,2023
LOM,CR,C 28,Fabbricazione di macchinari ed apparecchiature nca          ,5,0,0,0,5,2023
LOM,CR,C 29,"Fabbricazione di autoveicoli, rimorchi e semirimorchi       ",0,0,0,0,0,2023
LOM,CR,C 30,Fabbricazione di altri mezzi di trasporto                   ,0,0,0,0,0,2023
LOM,CR,C 31,Fabbricazione di mobili                                     ,1,0,0,0,1,2023
LOM,CR,C 32,Altre industrie manifatturiere                              ,1,0,0,0,1,2023
LOM,CR,C 33,"Riparazione, manutenzione ed installazione di macchine ed...",1,0,0,0,1,2023
LOM,CR,D   ,"Fornitura di energia elettrica, gas, vapore e aria condiz...",1,0,0,0,1,2023
LOM,CR,D 35,"Fornitura di energia elettrica, gas, vapore e aria condiz...",1,0,0,0,1,2023
LOM,CR,E   ,"Fornitura di acqua; reti fognarie, attività di gestione d...",0,0,0,0,0,2023
LOM,CR,E 36,"Raccolta, trattamento e fornitura di acqua                  ",0,0,0,0,0,2023
LOM,CR,E 37,Gestione delle reti fognarie                                ,0,0,0,0,0,2023
LOM,CR,E 38,"Attività di raccolta, trattamento e smaltimento dei rifiu...",0,0,0,0,0,2023
LOM,CR,E 39,Attività di risanamento e altri servizi di gestione dei r...,0,0,0,0,0,2023
LOM,CR,F   ,Costruzioni                                                 ,20,0,12,0,32,2023
LOM,CR,F 41,Costruzione di edifici                                      ,15,0,1,0,16,2023
LOM,CR,F 42,Ingegneria civile                                           ,1,0,0,0,1,2023
LOM,CR,F 43,Lavori di costruzione specializzati                         ,4,0,11,0,15,2023
LOM,CR,G   ,Commercio all'ingrosso e al dettaglio; riparazione di aut...,47,0,26,0,73,2023
LOM,CR,G 45,Commercio all'ingrosso e al dettaglio e riparazione di au...,1,0,2,0,3,2023
LOM,CR,G 46,Commercio all'ingrosso (escluso quello di autoveicoli e d...,37,0,6,0,43,2023
LOM,CR,G 47,Commercio al dettaglio (escluso quello di autoveicoli e d...,9,0,18,0,27,2023
LOM,CR,H   ,Trasporto e magazzinaggio                                   ,1,0,2,0,3,2023
LOM,CR,H 49,Trasporto terrestre e mediante condotte                     ,0,0,2,0,2,2023
LOM,CR,H 50,Trasporto marittimo e per vie d'acqua                       ,0,0,0,0,0,2023
LOM,CR,H 51,Trasporto aereo                                             ,0,0,0,0,0,2023
LOM,CR,H 52,Magazzinaggio e attività di supporto ai trasporti           ,1,0,0,0,1,2023
LOM,CR,H 53,Servizi postali e attività di corriere                      ,0,0,0,0,0,2023
LOM,CR,I   ,Attività dei servizi alloggio e ristorazione                ,23,0,7,0,30,2023
LOM,CR,I 55,Alloggio                                                    ,0,0,0,0,0,2023
LOM,CR,I 56,Attività dei servizi di ristorazione                        ,23,0,7,0,30,2023
LOM,CR,J   ,Servizi di informazione e comunicazione                     ,10,0,2,0,12,2023
LOM,CR,J 58,Attività editoriali                                         ,1,0,0,0,1,2023
LOM,CR,J 59,"Attività di produzione cinematografica, di video e di pro...",0,0,0,0,0,2023
LOM,CR,J 60,Attività di programmazione e trasmissione                   ,1,0,0,0,1,2023
LOM,CR,J 61,Telecomunicazioni                                           ,3,0,1,0,4,2023
LOM,CR,J 62,"Produzione di software, consulenza informatica e attività...",4,0,1,0,5,2023
LOM,CR,J 63,Attività dei servizi d'informazione e altri servizi infor...,1,0,0,0,1,2023
LOM,CR,K   ,Attività finanziarie e assicurative                         ,2,0,2,0,4,2023
LOM,CR,K 64,Attività di servizi finanziari (escluse le assicurazioni ...,1,0,0,0,1,2023
LOM,CR,K 65,"Assicurazioni, riassicurazioni e fondi pensione (escluse ...",0,0,0,0,0,2023
LOM,CR,K 66,Attività ausiliarie dei servizi finanziari e delle attivi...,1,0,2,0,3,2023
LOM,CR,L   ,Attivita' immobiliari                                       ,29,0,0,0,29,2023
LOM,CR,L 68,Attivita' immobiliari                                       ,29,0,0,0,29,2023
LOM,CR,M   ,"Attività professionali, scientifiche e tecniche             ",16,0,3,0,19,2023
LOM,CR,M 69,Attività legali e contabilità                               ,0,0,0,0,0,2023
LOM,CR,M 70,Attività di direzione aziendale e di consulenza gestional...,5,0,2,0,7,2023
LOM,CR,M 71,Attività degli studi di architettura e d'ingegneria; coll...,3,0,0,0,3,2023
LOM,CR,M 72,Ricerca scientifica e sviluppo                              ,0,0,0,0,0,2023
LOM,CR,M 73,Pubblicità e ricerche di mercato                            ,5,0,0,0,5,2023
LOM,CR,M 74,"Altre attività professionali, scientifiche e tecniche       ",3,0,1,0,4,2023
LOM,CR,M 75,Servizi veterinari                                          ,0,0,0,0,0,2023
LOM,CR,N   ,"Noleggio, agenzie di viaggio, servizi di supporto alle im...",7,0,3,0,10,2023
LOM,CR,N 77,Attività di noleggio e leasing operativo                    ,5,0,0,0,5,2023
LOM,CR,N 78,"Attività di ricerca, selezione, fornitura di personale      ",0,0,0,0,0,2023
LOM,CR,N 79,"Attività dei servizi delle agenzie di viaggio, dei tour o...",1,0,0,0,1,2023
LOM,CR,N 80,Servizi di vigilanza e investigazione                       ,1,0,0,0,1,2023
LOM,CR,N 81,Attività di servizi per edifici e paesaggio                 ,0,0,2,0,2,2023
LOM,CR,N 82,Attività di supporto per le funzioni d'ufficio e altri se...,0,0,1,0,1,2023
LOM,CR,O   ,Amministrazione pubblica e difesa; assicurazione sociale ...,0,0,0,0,0,2023
LOM,CR,O 84,Amministrazione pubblica e difesa; assicurazione sociale ...,0,0,0,0,0,2023
LOM,CR,P   ,Istruzione                                                  ,0,0,1,0,1,2023
LOM,CR,P 85,Istruzione                                                  ,0,0,1,0,1,2023
LOM,CR,Q   ,Sanita' e assistenza sociale                                ,0,0,0,0,0,2023
LOM,CR,Q 86,Assistenza sanitaria                                        ,0,0,0,0,0,2023
LOM,CR,Q 87,Servizi di assistenza sociale residenziale                  ,0,0,0,0,0,2023
LOM,CR,Q 88,Assistenza sociale non residenziale                         ,0,0,0,0,0,2023
LOM,CR,R   ,"Attività artistiche, sportive, di intrattenimento e diver...",4,0,1,0,5,2023
LOM,CR,R 90,"Attività creative, artistiche e di intrattenimento          ",2,0,0,0,2,2023
LOM,CR,R 91,"Attività di biblioteche, archivi, musei ed altre attività...",0,0,0,0,0,2023
LOM,CR,R 92,"Attività riguardanti le lotterie, le scommesse, le case d...",0,0,0,0,0,2023
LOM,CR,R 93,"Attività sportive, di intrattenimento e di divertimento     ",2,0,1,0,3,2023
LOM,CR,S   ,Altre attività di servizi                                   ,1,0,2,0,3,2023
LOM,CR,S 94,Attività di organizzazioni associative                      ,0,0,0,0,0,2023
LOM,CR,S 95,Riparazione di computer e di beni per uso personale e per...,0,0,2,0,2,2023
LOM,CR,S 96,Altre attività di servizi per la persona                    ,1,0,0,0,1,2023
LOM,CR,T   ,Attività di famiglie e convivenze come datori di lavoro p...,0,0,0,0,0,2023
LOM,CR,T 97,Attività di famiglie e convivenze come datori di lavoro p...,0,0,0,0,0,2023
LOM,CR,T 98,Produzione di beni e servizi indifferenziati per uso prop...,0,0,0,0,0,2023
LOM,CR,U   ,Organizzazioni ed organismi extraterritoriali               ,0,0,0,0,0,2023
LOM,CR,U 99,Organizzazioni ed organismi extraterritoriali               ,0,0,0,0,0,2023
LOM,CR,XX  ,Imprese non classificate                                    ,23,0,4,0,27,2023
LOM,CR,TOT ,TOTALE                                                      ,228,0,73,0,301,2023
LOM,MN,A   ,"Agricoltura, silvicoltura pesca                             ",16,0,11,0,27,2023
LOM,MN,A 01,"Coltivazioni agricole e produzione di prodotti animali, c...",16,0,11,0,27,2023
LOM,MN,A 02,Silvicoltura ed utilizzo di aree forestali                  ,0,0,0,0,0,2023
LOM,MN,A 03,Pesca e acquacoltura                                        ,0,0,0,0,0,2023
LOM,MN,B   ,Estrazione di minerali da cave e miniere                    ,1,0,0,0,1,2023
LOM,MN,B 05,Estrazione di carbone (esclusa torba)                       ,0,0,0,0,0,2023
LOM,MN,B 06,Estraz.di petrolio greggio e di gas naturale                ,0,0,0,0,0,2023
LOM,MN,B 07,Estrazione di minerali metalliferi                          ,0,0,0,0,0,2023
LOM,MN,B 08,Altre attività di estrazione di minerali da cave e miniere  ,1,0,0,0,1,2023
LOM,MN,B 09,Attività dei servizi di supporto all'estrazione             ,0,0,0,0,0,2023
LOM,MN,C   ,Attività manifatturiere                                     ,102,0,34,0,136,2023
LOM,MN,C 10,Industrie alimentari                                        ,8,0,0,0,8,2023
LOM,MN,C 11,Industria delle bevande                                     ,0,0,0,0,0,2023
LOM,MN,C 12,Industria del tabacco                                       ,0,0,0,0,0,2023
LOM,MN,C 13,Industrie tessili                                           ,9,0,4,0,13,2023
LOM,MN,C 14,Confezione di articoli di abbigliamento; confezione di ar...,21,0,23,0,44,2023
LOM,MN,C 15,Fabbricazione di articoli in pelle e simili                 ,1,0,0,0,1,2023
LOM,MN,C 16,Industria del legno e dei prodotti in legno e sughero (es...,5,0,0,0,5,2023
LOM,MN,C 17,Fabbricazione di carta e di prodotti di carta               ,1,0,0,0,1,2023
LOM,MN,C 18,Stampa e riproduzione di supporti registrati                ,0,0,0,0,0,2023
LOM,MN,C 19,Fabbricazione di coke e prodotti derivanti dalla raffinaz...,0,0,0,0,0,2023
LOM,MN,C 20,Fabbricazione di prodotti chimici                           ,3,0,0,0,3,2023
LOM,MN,C 21,Fabbricazione di prodotti farmaceutici di base e di prepa...,0,0,0,0,0,2023
LOM,MN,C 22,Fabbricazione di articoli in gomma e materie plastiche      ,1,0,0,0,1,2023
LOM,MN,C 23,Fabbricazione di altri prodotti della lavorazione di miner..,4,0,1,0,5,2023
LOM,MN,C 24,Metallurgia                                                 ,1,0,0,0,1,2023
LOM,MN,C 25,Fabbricazione di prodotti in metallo (esclusi macchinari ...,19,0,6,0,25,2023
LOM,MN,C 26,Fabbricazione di computer e prodotti di elettronica e ott...,1,0,0,0,1,2023
LOM,MN,C 27,Fabbricazione di apparecchiature elettriche ed apparecchi...,4,0,0,0,4,2023
LOM,MN,C 28,Fabbricazione di macchinari ed apparecchiature nca          ,6,0,0,0,6,2023
LOM,MN,C 29,"Fabbricazione di autoveicoli, rimorchi e semirimorchi       ",5,0,0,0,5,2023
LOM,MN,C 30,Fabbricazione di altri mezzi di trasporto                   ,2,0,0,0,2,2023
LOM,MN,C 31,Fabbricazione di mobili                                     ,6,0,0,0,6,2023
LOM,MN,C 32,Altre industrie manifatturiere                              ,4,0,0,0,4,2023
LOM,MN,C 33,"Riparazione, manutenzione ed installazione di macchine ed...",1,0,0,0,1,2023
LOM,MN,D   ,"Fornitura di energia elettrica, gas, vapore e aria condiz...",1,0,0,0,1,2023
LOM,MN,D 35,"Fornitura di energia elettrica, gas, vapore e aria condiz...",1,0,0,0,1,2023
LOM,MN,E   ,"Fornitura di acqua; reti fognarie, attività di gestione d...",3,0,0,0,3,2023
LOM,MN,E 36,"Raccolta, trattamento e fornitura di acqua                  ",0,0,0,0,0,2023
LOM,MN,E 37,Gestione delle reti fognarie                                ,0,0,0,0,0,2023
LOM,MN,E 38,"Attività di raccolta, trattamento e smaltimento dei rifiu...",3,0,0,0,3,2023
LOM,MN,E 39,Attività di risanamento e altri servizi di gestione dei r...,0,0,0,0,0,2023
LOM,MN,F   ,Costruzioni                                                 ,37,0,94,0,131,2023
LOM,MN,F 41,Costruzione di edifici                                      ,23,0,17,0,40,2023
LOM,MN,F 42,Ingegneria civile                                           ,4,0,0,0,4,2023
LOM,MN,F 43,Lavori di costruzione specializzati                         ,10,0,77,0,87,2023
LOM,MN,G   ,Commercio all'ingrosso e al dettaglio; riparazione di aut...,154,0,65,0,219,2023
LOM,MN,G 45,Commercio all'ingrosso e al dettaglio e riparazione di au...,13,0,8,0,21,2023
LOM,MN,G 46,Commercio all'ingrosso (escluso quello di autoveicoli e d...,102,0,17,0,119,2023
LOM,MN,G 47,Commercio al dettaglio (escluso quello di autoveicoli e d...,39,0,40,0,79,2023
LOM,MN,H   ,Trasporto e magazzinaggio                                   ,3,0,8,1,12,2023
LOM,MN,H 49,Trasporto terrestre e mediante condotte                     ,2,0,8,0,10,2023
LOM,MN,H 50,Trasporto marittimo e per vie d'acqua                       ,0,0,0,0,0,2023
LOM,MN,H 51,Trasporto aereo                                             ,0,0,0,0,0,2023
LOM,MN,H 52,Magazzinaggio e attività di supporto ai trasporti           ,1,0,0,1,2,2023
LOM,MN,H 53,Servizi postali e attività di corriere                      ,0,0,0,0,0,2023
LOM,MN,I   ,Attività dei servizi alloggio e ristorazione                ,32,0,13,0,45,2023
LOM,MN,I 55,Alloggio                                                    ,1,0,0,0,1,2023
LOM,MN,I 56,Attività dei servizi di ristorazione                        ,31,0,13,0,44,2023
LOM,MN,J   ,Servizi di informazione e comunicazione                     ,22,0,1,0,23,2023
LOM,MN,J 58,Attività editoriali                                         ,4,0,0,0,4,2023
LOM,MN,J 59,"Attività di produzione cinematografica, di video e di pro...",0,0,0,0,0,2023
LOM,MN,J 60,Attività di programmazione e trasmissione                   ,0,0,0,0,0,2023
LOM,MN,J 61,Telecomunicazioni                                           ,3,0,1,0,4,2023
LOM,MN,J 62,"Produzione di software, consulenza informatica e attività...",7,0,0,0,7,2023
LOM,MN,J 63,Attività dei servizi d'informazione e altri servizi infor...,8,0,0,0,8,2023
LOM,MN,K   ,Attività finanziarie e assicurative                         ,4,0,2,0,6,2023
LOM,MN,K 64,Attività di servizi finanziari (escluse le assicurazioni ...,1,0,0,0,1,2023
LOM,MN,K 65,"Assicurazioni, riassicurazioni e fondi pensione (escluse ...",0,0,0,0,0,2023
LOM,MN,K 66,Attività ausiliarie dei servizi finanziari e delle attivi...,3,0,2,0,5,2023
LOM,MN,L   ,Attivita' immobiliari                                       ,49,0,0,0,49,2023
LOM,MN,L 68,Attivita' immobiliari                                       ,49,0,0,0,49,2023
LOM,MN,M   ,"Attività professionali, scientifiche e tecniche             ",26,0,11,0,37,2023
LOM,MN,M 69,Attività legali e contabilità                               ,2,0,0,0,2,2023
LOM,MN,M 70,Attività di direzione aziendale e di consulenza gestional...,13,0,2,0,15,2023
LOM,MN,M 71,Attività degli studi di architettura e d'ingegneria; coll...,4,0,2,0,6,2023
LOM,MN,M 72,Ricerca scientifica e sviluppo                              ,0,0,0,0,0,2023
LOM,MN,M 73,Pubblicità e ricerche di mercato                            ,5,0,6,0,11,2023
LOM,MN,M 74,"Altre attività professionali, scientifiche e tecniche       ",2,0,1,0,3,2023
LOM,MN,M 75,Servizi veterinari                                          ,0,0,0,0,0,2023
LOM,MN,N   ,"Noleggio, agenzie di viaggio, servizi di supporto alle im...",12,0,11,2,25,2023
LOM,MN,N 77,Attività di noleggio e leasing operativo                    ,2,0,0,0,2,2023
LOM,MN,N 78,"Attività di ricerca, selezione, fornitura di personale      ",0,0,0,0,0,2023
LOM,MN,N 79,"Attività dei servizi delle agenzie di viaggio, dei tour o...",6,0,0,0,6,2023
LOM,MN,N 80,Servizi di vigilanza e investigazione                       ,0,0,0,0,0,2023
LOM,MN,N 81,Attività di servizi per edifici e paesaggio                 ,0,0,2,2,4,2023
LOM,MN,N 82,Attività di supporto per le funzioni d'ufficio e altri se...,4,0,9,0,13,2023
LOM,MN,O   ,Amministrazione pubblica e difesa; assicurazione sociale ...,1,0,0,0,1,2023
LOM,MN,O 84,Amministrazione pubblica e difesa; assicurazione sociale ...,1,0,0,0,1,2023
LOM,MN,P   ,Istruzione                                                  ,0,0,1,0,1,2023
LOM,MN,P 85,Istruzione                                                  ,0,0,1,0,1,2023
LOM,MN,Q   ,Sanita' e assistenza sociale                                ,1,0,0,1,2,2023
LOM,MN,Q 86,Assistenza sanitaria                                        ,1,0,0,0,1,2023
LOM,MN,Q 87,Servizi di assistenza sociale residenziale                  ,0,0,0,0,0,2023
LOM,MN,Q 88,Assistenza sociale non residenziale                         ,0,0,0,1,1,2023
LOM,MN,R   ,"Attività artistiche, sportive, di intrattenimento e diver...",26,0,0,0,26,2023
LOM,MN,R 90,"Attività creative, artistiche e di intrattenimento          ",5,0,0,0,5,2023
LOM,MN,R 91,"Attività di biblioteche, archivi, musei ed altre attività...",0,0,0,0,0,2023
LOM,MN,R 92,"Attività riguardanti le lotterie, le scommesse, le case d...",6,0,0,0,6,2023
LOM,MN,R 93,"Attività sportive, di intrattenimento e di divertimento     ",15,0,0,0,15,2023
LOM,MN,S   ,Altre attività di servizi                                   ,10,0,6,0,16,2023
LOM,MN,S 94,Attività di organizzazioni associative                      ,0,0,0,0,0,2023
LOM,MN,S 95,Riparazione di computer e di beni per uso personale e per...,2,0,0,0,2,2023
LOM,MN,S 96,Altre attività di servizi per la persona                    ,8,0,6,0,14,2023
LOM,MN,T   ,Attività di famiglie e convivenze come datori di lavoro p...,0,0,0,0,0,2023
LOM,MN,T 97,Attività di famiglie e convivenze come datori di lavoro p...,0,0,0,0,0,2023
LOM,MN,T 98,Produzione di beni e servizi indifferenziati per uso prop...,0,0,0,0,0,2023
LOM,MN,U   ,Organizzazioni ed organismi extraterritoriali               ,0,0,0,0,0,2023
LOM,MN,U 99,Organizzazioni ed organismi extraterritoriali               ,0,0,0,0,0,2023
LOM,MN,XX  ,Imprese non classificate                                    ,49,0,7,1,57,2023
LOM,MN,TOT ,TOTALE                                                      ,549,0,264,5,818,2023
LOM,LC,A   ,"Agricoltura, silvicoltura pesca                             ",0,8,3,0,11,2023
LOM,LC,A 01,"Coltivazioni agricole e produzione di prodotti animali, c...",0,8,3,0,11,2023
LOM,LC,A 02,Silvicoltura ed utilizzo di aree forestali                  ,0,0,0,0,0,2023
LOM,LC,A 03,Pesca e acquacoltura                                        ,0,0,0,0,0,2023
LOM,LC,B   ,Estrazione di minerali da cave e miniere                    ,0,1,0,0,1,2023
LOM,LC,B 05,Estrazione di carbone (esclusa torba)                       ,0,0,0,0,0,2023
LOM,LC,B 06,Estraz.di petrolio greggio e di gas naturale                ,0,0,0,0,0,2023
LOM,LC,B 07,Estrazione di minerali metalliferi                          ,0,0,0,0,0,2023
LOM,LC,B 08,Altre attività di estrazione di minerali da cave e miniere  ,0,1,0,0,1,2023
LOM,LC,B 09,Attività dei servizi di supporto all'estrazione             ,0,0,0,0,0,2023
LOM,LC,C   ,Attività manifatturiere                                     ,3,81,10,0,94,2023
LOM,LC,C 10,Industrie alimentari                                        ,0,6,1,0,7,2023
LOM,LC,C 11,Industria delle bevande                                     ,0,0,0,0,0,2023
LOM,LC,C 12,Industria del tabacco                                       ,0,0,0,0,0,2023
LOM,LC,C 13,Industrie tessili                                           ,1,2,1,0,4,2023
LOM,LC,C 14,Confezione di articoli di abbigliamento; confezione di ar...,0,3,3,0,6,2023
LOM,LC,C 15,Fabbricazione di articoli in pelle e simili                 ,0,0,0,0,0,2023
LOM,LC,C 16,Industria del legno e dei prodotti in legno e sughero (es...,0,4,1,0,5,2023
LOM,LC,C 17,Fabbricazione di carta e di prodotti di carta               ,0,1,0,0,1,2023
LOM,LC,C 18,Stampa e riproduzione di supporti registrati                ,0,2,0,0,2,2023
LOM,LC,C 19,Fabbricazione di coke e prodotti derivanti dalla raffinaz...,0,0,0,0,0,2023
LOM,LC,C 20,Fabbricazione di prodotti chimici                           ,0,1,0,0,1,2023
LOM,LC,C 21,Fabbricazione di prodotti farmaceutici di base e di prepa...,0,1,0,0,1,2023
LOM,LC,C 22,Fabbricazione di articoli in gomma e materie plastiche      ,0,4,1,0,5,2023
LOM,LC,C 23,Fabbricazione di altri prodotti della lavorazione di miner..,0,1,0,0,1,2023
LOM,LC,C 24,Metallurgia                                                 ,0,3,0,0,3,2023
LOM,LC,C 25,Fabbricazione di prodotti in metallo (esclusi macchinari ...,0,32,2,0,34,2023
LOM,LC,C 26,Fabbricazione di computer e prodotti di elettronica e ott...,1,2,0,0,3,2023
LOM,LC,C 27,Fabbricazione di apparecchiature elettriche ed apparecchi...,0,1,0,0,1,2023
LOM,LC,C 28,Fabbricazione di macchinari ed apparecchiature nca          ,0,6,0,0,6,2023
LOM,LC,C 29,"Fabbricazione di autoveicoli, rimorchi e semirimorchi       ",0,1,0,0,1,2023
LOM,LC,C 30,Fabbricazione di altri mezzi di trasporto                   ,0,1,0,0,1,2023
LOM,LC,C 31,Fabbricazione di mobili                                     ,0,5,1,0,6,2023
LOM,LC,C 32,Altre industrie manifatturiere                              ,1,3,0,0,4,2023
LOM,LC,C 33,"Riparazione, manutenzione ed installazione di macchine ed...",0,2,0,0,2,2023
LOM,LC,D   ,"Fornitura di energia elettrica, gas, vapore e aria condiz...",0,0,0,0,0,2023
LOM,LC,D 35,"Fornitura di energia elettrica, gas, vapore e aria condiz...",0,0,0,0,0,2023
LOM,LC,E   ,"Fornitura di acqua; reti fognarie, attività di gestione d...",0,1,0,0,1,2023
LOM,LC,E 36,"Raccolta, trattamento e fornitura di acqua                  ",0,0,0,0,0,2023
LOM,LC,E 37,Gestione delle reti fognarie                                ,0,0,0,0,0,2023
LOM,LC,E 38,"Attività di raccolta, trattamento e smaltimento dei rifiu...",0,1,0,0,1,2023
LOM,LC,E 39,Attività di risanamento e altri servizi di gestione dei r...,0,0,0,0,0,2023
LOM,LC,F   ,Costruzioni                                                 ,2,37,0,2,41,2023
LOM,LC,F 41,Costruzione di edifici                                      ,2,17,0,1,20,2023
LOM,LC,F 42,Ingegneria civile                                           ,0,1,0,0,1,2023
LOM,LC,F 43,Lavori di costruzione specializzati                         ,0,19,0,1,20,2023
LOM,LC,G   ,Commercio all'ingrosso e al dettaglio; riparazione di aut...,8,91,9,1,109,2023
LOM,LC,G 45,Commercio all'ingrosso e al dettaglio e riparazione di au...,1,6,0,0,7,2023
LOM,LC,G 46,Commercio all'ingrosso (escluso quello di autoveicoli e d...,6,35,1,0,42,2023
LOM,LC,G 47,Commercio al dettaglio (escluso quello di autoveicoli e d...,1,50,8,1,60,2023
LOM,LC,H   ,Trasporto e magazzinaggio                                   ,0,6,0,0,6,2023
LOM,LC,H 49,Trasporto terrestre e mediante condotte                     ,0,5,0,0,5,2023
LOM,LC,H 50,Trasporto marittimo e per vie d'acqua                       ,0,0,0,0,0,2023
LOM,LC,H 51,Trasporto aereo                                             ,0,0,0,0,0,2023
LOM,LC,H 52,Magazzinaggio e attività di supporto ai trasporti           ,0,1,0,0,1,2023
LOM,LC,H 53,Servizi postali e attività di corriere                      ,0,0,0,0,0,2023
LOM,LC,I   ,Attività dei servizi alloggio e ristorazione                ,2,107,3,0,112,2023
LOM,LC,I 55,Alloggio                                                    ,0,3,0,0,3,2023
LOM,LC,I 56,Attività dei servizi di ristorazione                        ,2,104,3,0,109,2023
LOM,LC,J   ,Servizi di informazione e comunicazione                     ,0,8,0,0,8,2023
LOM,LC,J 58,Attività editoriali                                         ,0,0,0,0,0,2023
LOM,LC,J 59,"Attività di produzione cinematografica, di video e di pro...",0,2,0,0,2,2023
LOM,LC,J 60,Attività di programmazione e trasmissione                   ,0,0,0,0,0,2023
LOM,LC,J 61,Telecomunicazioni                                           ,0,1,0,0,1,2023
LOM,LC,J 62,"Produzione di software, consulenza informatica e attività...",0,3,0,0,3,2023
LOM,LC,J 63,Attività dei servizi d'informazione e altri servizi infor...,0,2,0,0,2,2023
LOM,LC,K   ,Attività finanziarie e assicurative                         ,0,8,0,0,8,2023
LOM,LC,K 64,Attività di servizi finanziari (escluse le assicurazioni ...,0,2,0,0,2,2023
LOM,LC,K 65,"Assicurazioni, riassicurazioni e fondi pensione (escluse ...",0,0,0,0,0,2023
LOM,LC,K 66,Attività ausiliarie dei servizi finanziari e delle attivi...,0,6,0,0,6,2023
LOM,LC,L   ,Attivita' immobiliari                                       ,4,11,0,5,20,2023
LOM,LC,L 68,Attivita' immobiliari                                       ,4,11,0,5,20,2023
LOM,LC,M   ,"Attività professionali, scientifiche e tecniche             ",2,16,1,0,19,2023
LOM,LC,M 69,Attività legali e contabilità                               ,0,1,0,0,1,2023
LOM,LC,M 70,Attività di direzione aziendale e di consulenza gestional...,2,1,1,0,4,2023
LOM,LC,M 71,Attività degli studi di architettura e d'ingegneria; coll...,0,2,0,0,2,2023
LOM,LC,M 72,Ricerca scientifica e sviluppo                              ,0,0,0,0,0,2023
LOM,LC,M 73,Pubblicità e ricerche di mercato                            ,0,5,0,0,5,2023
LOM,LC,M 74,"Altre attività professionali, scientifiche e tecniche       ",0,7,0,0,7,2023
LOM,LC,M 75,Servizi veterinari                                          ,0,0,0,0,0,2023
LOM,LC,N   ,"Noleggio, agenzie di viaggio, servizi di supporto alle im...",3,11,1,1,16,2023
LOM,LC,N 77,Attività di noleggio e leasing operativo                    ,1,2,0,0,3,2023
LOM,LC,N 78,"Attività di ricerca, selezione, fornitura di personale      ",0,0,0,0,0,2023
LOM,LC,N 79,"Attività dei servizi delle agenzie di viaggio, dei tour o...",1,1,0,0,2,2023
LOM,LC,N 80,Servizi di vigilanza e investigazione                       ,0,0,0,0,0,2023
LOM,LC,N 81,Attività di servizi per edifici e paesaggio                 ,1,5,0,0,6,2023
LOM,LC,N 82,Attività di supporto per le funzioni d'ufficio e altri se...,0,3,1,1,5,2023
LOM,LC,O   ,Amministrazione pubblica e difesa; assicurazione sociale ...,0,0,0,0,0,2023
LOM,LC,O 84,Amministrazione pubblica e difesa; assicurazione sociale ...,0,0,0,0,0,2023
LOM,LC,P   ,Istruzione                                                  ,0,3,0,0,3,2023
LOM,LC,P 85,Istruzione                                                  ,0,3,0,0,3,2023
LOM,LC,Q   ,Sanita' e assistenza sociale                                ,1,2,0,0,3,2023
LOM,LC,Q 86,Assistenza sanitaria                                        ,0,1,0,0,1,2023
LOM,LC,Q 87,Servizi di assistenza sociale residenziale                  ,0,0,0,0,0,2023
LOM,LC,Q 88,Assistenza sociale non residenziale                         ,1,1,0,0,2,2023
LOM,LC,R   ,"Attività artistiche, sportive, di intrattenimento e diver...",0,1,0,0,1,2023
LOM,LC,R 90,"Attività creative, artistiche e di intrattenimento          ",0,0,0,0,0,2023
LOM,LC,R 91,"Attività di biblioteche, archivi, musei ed altre attività...",0,0,0,0,0,2023
LOM,LC,R 92,"Attività riguardanti le lotterie, le scommesse, le case d...",0,0,0,0,0,2023
LOM,LC,R 93,"Attività sportive, di intrattenimento e di divertimento     ",0,1,0,0,1,2023
LOM,LC,S   ,Altre attività di servizi                                   ,1,18,1,0,20,2023
LOM,LC,S 94,Attività di organizzazioni associative                      ,0,0,0,0,0,2023
LOM,LC,S 95,Riparazione di computer e di beni per uso personale e per...,0,4,1,0,5,2023
LOM,LC,S 96,Altre attività di servizi per la persona                    ,1,14,0,0,15,2023
LOM,LC,T   ,Attività di famiglie e convivenze come datori di lavoro p...,0,0,0,0,0,2023
LOM,LC,T 97,Attività di famiglie e convivenze come datori di lavoro p...,0,0,0,0,0,2023
LOM,LC,T 98,Produzione di beni e servizi indifferenziati per uso prop...,0,0,0,0,0,2023
LOM,LC,U   ,Organizzazioni ed organismi extraterritoriali               ,0,0,0,0,0,2023
LOM,LC,U 99,Organizzazioni ed organismi extraterritoriali               ,0,0,0,0,0,2023
LOM,LC,XX  ,Imprese non classificate                                    ,12,42,1,0,55,2023
LOM,LC,TOT ,TOTALE                                                      ,38,452,29,9,528,2023
LOM,LO,A   ,"Agricoltura, silvicoltura pesca                             ",0,0,5,0,5,2023
LOM,LO,A 01,"Coltivazioni agricole e produzione di prodotti animali, c...",0,0,5,0,5,2023
LOM,LO,A 02,Silvicoltura ed utilizzo di aree forestali                  ,0,0,0,0,0,2023
LOM,LO,A 03,Pesca e acquacoltura                                        ,0,0,0,0,0,2023
LOM,LO,B   ,Estrazione di minerali da cave e miniere                    ,0,0,0,0,0,2023
LOM,LO,B 05,Estrazione di carbone (esclusa torba)                       ,0,0,0,0,0,2023
LOM,LO,B 06,Estraz.di petrolio greggio e di gas naturale                ,0,0,0,0,0,2023
LOM,LO,B 07,Estrazione di minerali metalliferi                          ,0,0,0,0,0,2023
LOM,LO,B 08,Altre attività di estrazione di minerali da cave e miniere  ,0,0,0,0,0,2023
LOM,LO,B 09,Attività dei servizi di supporto all'estrazione             ,0,0,0,0,0,2023
LOM,LO,C   ,Attività manifatturiere                                     ,0,2,4,1,7,2023
LOM,LO,C 10,Industrie alimentari                                        ,0,0,0,0,0,2023
LOM,LO,C 11,Industria delle bevande                                     ,0,0,0,0,0,2023
LOM,LO,C 12,Industria del tabacco                                       ,0,0,0,0,0,2023
LOM,LO,C 13,Industrie tessili                                           ,0,0,0,0,0,2023
LOM,LO,C 14,Confezione di articoli di abbigliamento; confezione di ar...,0,0,0,0,0,2023
LOM,LO,C 15,Fabbricazione di articoli in pelle e simili                 ,0,0,0,0,0,2023
LOM,LO,C 16,Industria del legno e dei prodotti in legno e sughero (es...,0,0,0,0,0,2023
LOM,LO,C 17,Fabbricazione di carta e di prodotti di carta               ,0,0,0,0,0,2023
LOM,LO,C 18,Stampa e riproduzione di supporti registrati                ,0,0,0,0,0,2023
LOM,LO,C 19,Fabbricazione di coke e prodotti derivanti dalla raffinaz...,0,0,0,0,0,2023
LOM,LO,C 20,Fabbricazione di prodotti chimici                           ,0,1,0,0,1,2023
LOM,LO,C 21,Fabbricazione di prodotti farmaceutici di base e di prepa...,0,0,0,0,0,2023
LOM,LO,C 22,Fabbricazione di articoli in gomma e materie plastiche      ,0,0,0,0,0,2023
LOM,LO,C 23,Fabbricazione di altri prodotti della lavorazione di miner..,0,0,0,0,0,2023
LOM,LO,C 24,Metallurgia                                                 ,0,0,0,0,0,2023
LOM,LO,C 25,Fabbricazione di prodotti in metallo (esclusi macchinari ...,0,1,2,0,3,2023
LOM,LO,C 26,Fabbricazione di computer e prodotti di elettronica e ott...,0,0,0,0,0,2023
LOM,LO,C 27,Fabbricazione di apparecchiature elettriche ed apparecchi...,0,0,1,0,1,2023
LOM,LO,C 28,Fabbricazione di macchinari ed apparecchiature nca          ,0,0,0,0,0,2023
LOM,LO,C 29,"Fabbricazione di autoveicoli, rimorchi e semirimorchi       ",0,0,0,0,0,2023
LOM,LO,C 30,Fabbricazione di altri mezzi di trasporto                   ,0,0,0,0,0,2023
LOM,LO,C 31,Fabbricazione di mobili                                     ,0,0,0,0,0,2023
LOM,LO,C 32,Altre industrie manifatturiere                              ,0,0,0,0,0,2023
LOM,LO,C 33,"Riparazione, manutenzione ed installazione di macchine ed...",0,0,1,1,2,2023
LOM,LO,D   ,"Fornitura di energia elettrica, gas, vapore e aria condiz...",0,0,0,0,0,2023
LOM,LO,D 35,"Fornitura di energia elettrica, gas, vapore e aria condiz...",0,0,0,0,0,2023
LOM,LO,E   ,"Fornitura di acqua; reti fognarie, attività di gestione d...",0,0,0,1,1,2023
LOM,LO,E 36,"Raccolta, trattamento e fornitura di acqua                  ",0,0,0,0,0,2023
LOM,LO,E 37,Gestione delle reti fognarie                                ,0,0,0,0,0,2023
LOM,LO,E 38,"Attività di raccolta, trattamento e smaltimento dei rifiu...",0,0,0,1,1,2023
LOM,LO,E 39,Attività di risanamento e altri servizi di gestione dei r...,0,0,0,0,0,2023
LOM,LO,F   ,Costruzioni                                                 ,2,3,11,8,24,2023
LOM,LO,F 41,Costruzione di edifici                                      ,1,2,3,8,14,2023
LOM,LO,F 42,Ingegneria civile                                           ,0,0,0,0,0,2023
LOM,LO,F 43,Lavori di costruzione specializzati                         ,1,1,8,0,10,2023
LOM,LO,G   ,Commercio all'ingrosso e al dettaglio; riparazione di aut...,0,1,17,4,22,2023
LOM,LO,G 45,Commercio all'ingrosso e al dettaglio e riparazione di au...,0,0,4,0,4,2023
LOM,LO,G 46,Commercio all'ingrosso (escluso quello di autoveicoli e d...,0,0,3,0,3,2023
LOM,LO,G 47,Commercio al dettaglio (escluso quello di autoveicoli e d...,0,1,10,4,15,2023
LOM,LO,H   ,Trasporto e magazzinaggio                                   ,0,1,0,1,2,2023
LOM,LO,H 49,Trasporto terrestre e mediante condotte                     ,0,1,0,1,2,2023
LOM,LO,H 50,Trasporto marittimo e per vie d'acqua                       ,0,0,0,0,0,2023
LOM,LO,H 51,Trasporto aereo                                             ,0,0,0,0,0,2023
LOM,LO,H 52,Magazzinaggio e attività di supporto ai trasporti           ,0,0,0,0,0,2023
LOM,LO,H 53,Servizi postali e attività di corriere                      ,0,0,0,0,0,2023
LOM,LO,I   ,Attività dei servizi alloggio e ristorazione                ,1,1,5,0,7,2023
LOM,LO,I 55,Alloggio                                                    ,0,0,0,0,0,2023
LOM,LO,I 56,Attività dei servizi di ristorazione                        ,1,1,5,0,7,2023
LOM,LO,J   ,Servizi di informazione e comunicazione                     ,0,0,1,0,1,2023
LOM,LO,J 58,Attività editoriali                                         ,0,0,0,0,0,2023
LOM,LO,J 59,"Attività di produzione cinematografica, di video e di pro...",0,0,0,0,0,2023
LOM,LO,J 60,Attività di programmazione e trasmissione                   ,0,0,0,0,0,2023
LOM,LO,J 61,Telecomunicazioni                                           ,0,0,1,0,1,2023
LOM,LO,J 62,"Produzione di software, consulenza informatica e attività...",0,0,0,0,0,2023
LOM,LO,J 63,Attività dei servizi d'informazione e altri servizi infor...,0,0,0,0,0,2023
LOM,LO,K   ,Attività finanziarie e assicurative                         ,0,0,1,0,1,2023
LOM,LO,K 64,Attività di servizi finanziari (escluse le assicurazioni ...,0,0,0,0,0,2023
LOM,LO,K 65,"Assicurazioni, riassicurazioni e fondi pensione (escluse ...",0,0,0,0,0,2023
LOM,LO,K 66,Attività ausiliarie dei servizi finanziari e delle attivi...,0,0,1,0,1,2023
LOM,LO,L   ,Attivita' immobiliari                                       ,0,0,1,1,2,2023
LOM,LO,L 68,Attivita' immobiliari                                       ,0,0,1,1,2,2023
LOM,LO,M   ,"Attività professionali, scientifiche e tecniche             ",1,0,3,0,4,2023
LOM,LO,M 69,Attività legali e contabilità                               ,0,0,0,0,0,2023
LOM,LO,M 70,Attività di direzione aziendale e di consulenza gestional...,0,0,0,0,0,2023
LOM,LO,M 71,Attività degli studi di architettura e d'ingegneria; coll...,1,0,0,0,1,2023
LOM,LO,M 72,Ricerca scientifica e sviluppo                              ,0,0,0,0,0,2023
LOM,LO,M 73,Pubblicità e ricerche di mercato                            ,0,0,1,0,1,2023
LOM,LO,M 74,"Altre attività professionali, scientifiche e tecniche       ",0,0,2,0,2,2023
LOM,LO,M 75,Servizi veterinari                                          ,0,0,0,0,0,2023
LOM,LO,N   ,"Noleggio, agenzie di viaggio, servizi di supporto alle im...",1,0,2,1,4,2023
LOM,LO,N 77,Attività di noleggio e leasing operativo                    ,0,0,0,0,0,2023
LOM,LO,N 78,"Attività di ricerca, selezione, fornitura di personale      ",0,0,0,0,0,2023
LOM,LO,N 79,"Attività dei servizi delle agenzie di viaggio, dei tour o...",0,0,0,0,0,2023
LOM,LO,N 80,Servizi di vigilanza e investigazione                       ,0,0,0,0,0,2023
LOM,LO,N 81,Attività di servizi per edifici e paesaggio                 ,0,0,2,1,3,2023
LOM,LO,N 82,Attività di supporto per le funzioni d'ufficio e altri se...,1,0,0,0,1,2023
LOM,LO,O   ,Amministrazione pubblica e difesa; assicurazione sociale ...,0,0,0,0,0,2023
LOM,LO,O 84,Amministrazione pubblica e difesa; assicurazione sociale ...,0,0,0,0,0,2023
LOM,LO,P   ,Istruzione                                                  ,0,0,0,0,0,2023
LOM,LO,P 85,Istruzione                                                  ,0,0,0,0,0,2023
LOM,LO,Q   ,Sanita' e assistenza sociale                                ,0,0,1,1,2,2023
LOM,LO,Q 86,Assistenza sanitaria                                        ,0,0,0,1,1,2023
LOM,LO,Q 87,Servizi di assistenza sociale residenziale                  ,0,0,1,0,1,2023
LOM,LO,Q 88,Assistenza sociale non residenziale                         ,0,0,0,0,0,2023
LOM,LO,R   ,"Attività artistiche, sportive, di intrattenimento e diver...",0,1,0,0,1,2023
LOM,LO,R 90,"Attività creative, artistiche e di intrattenimento          ",0,0,0,0,0,2023
LOM,LO,R 91,"Attività di biblioteche, archivi, musei ed altre attività...",0,0,0,0,0,2023
LOM,LO,R 92,"Attività riguardanti le lotterie, le scommesse, le case d...",0,0,0,0,0,2023
LOM,LO,R 93,"Attività sportive, di intrattenimento e di divertimento     ",0,1,0,0,1,2023
LOM,LO,S   ,Altre attività di servizi                                   ,0,0,1,0,1,2023
LOM,LO,S 94,Attività di organizzazioni associative                      ,0,0,0,0,0,2023
LOM,LO,S 95,Riparazione di computer e di beni per uso personale e per...,0,0,0,0,0,2023
LOM,LO,S 96,Altre attività di servizi per la persona                    ,0,0,1,0,1,2023
LOM,LO,T   ,Attività di famiglie e convivenze come datori di lavoro p...,0,0,0,0,0,2023
LOM,LO,T 97,Attività di famiglie e convivenze come datori di lavoro p...,0,0,0,0,0,2023
LOM,LO,T 98,Produzione di beni e servizi indifferenziati per uso prop...,0,0,0,0,0,2023
LOM,LO,U   ,Organizzazioni ed organismi extraterritoriali               ,0,0,0,0,0,2023
LOM,LO,U 99,Organizzazioni ed organismi extraterritoriali               ,0,0,0,0,0,2023
LOM,LO,XX  ,Imprese non classificate                                    ,0,0,5,2,7,2023
LOM,LO,TOT ,TOTALE                                                      ,5,9,57,20,91,2023
LOM,MB,A   ,"Agricoltura, silvicoltura pesca                             ",0,0,7,0,7,2023
LOM,MB,A 01,"Coltivazioni agricole e produzione di prodotti animali, c...",0,0,7,0,7,2023
LOM,MB,A 02,Silvicoltura ed utilizzo di aree forestali                  ,0,0,0,0,0,2023
LOM,MB,A 03,Pesca e acquacoltura                                        ,0,0,0,0,0,2023
LOM,MB,B   ,Estrazione di minerali da cave e miniere                    ,0,0,0,0,0,2023
LOM,MB,B 05,Estrazione di carbone (esclusa torba)                       ,0,0,0,0,0,2023
LOM,MB,B 06,Estraz.di petrolio greggio e di gas naturale                ,0,0,0,0,0,2023
LOM,MB,B 07,Estrazione di minerali metalliferi                          ,0,0,0,0,0,2023
LOM,MB,B 08,Altre attività di estrazione di minerali da cave e miniere  ,0,0,0,0,0,2023
LOM,MB,B 09,Attività dei servizi di supporto all'estrazione             ,0,0,0,0,0,2023
LOM,MB,C   ,Attività manifatturiere                                     ,4,3,20,0,27,2023
LOM,MB,C 10,Industrie alimentari                                        ,0,0,2,0,2,2023
LOM,MB,C 11,Industria delle bevande                                     ,0,0,0,0,0,2023
LOM,MB,C 12,Industria del tabacco                                       ,0,0,0,0,0,2023
LOM,MB,C 13,Industrie tessili                                           ,0,0,0,0,0,2023
LOM,MB,C 14,Confezione di articoli di abbigliamento; confezione di ar...,1,0,1,0,2,2023
LOM,MB,C 15,Fabbricazione di articoli in pelle e simili                 ,0,0,0,0,0,2023
LOM,MB,C 16,Industria del legno e dei prodotti in legno e sughero (es...,0,0,1,0,1,2023
LOM,MB,C 17,Fabbricazione di carta e di prodotti di carta               ,0,0,0,0,0,2023
LOM,MB,C 18,Stampa e riproduzione di supporti registrati                ,0,0,0,0,0,2023
LOM,MB,C 19,Fabbricazione di coke e prodotti derivanti dalla raffinaz...,0,0,0,0,0,2023
LOM,MB,C 20,Fabbricazione di prodotti chimici                           ,0,0,0,0,0,2023
LOM,MB,C 21,Fabbricazione di prodotti farmaceutici di base e di prepa...,0,0,0,0,0,2023
LOM,MB,C 22,Fabbricazione di articoli in gomma e materie plastiche      ,1,0,2,0,3,2023
LOM,MB,C 23,Fabbricazione di altri prodotti della lavorazione di miner..,0,0,1,0,1,2023
LOM,MB,C 24,Metallurgia                                                 ,0,0,0,0,0,2023
LOM,MB,C 25,Fabbricazione di prodotti in metallo (esclusi macchinari ...,0,1,4,0,5,2023
LOM,MB,C 26,Fabbricazione di computer e prodotti di elettronica e ott...,0,0,2,0,2,2023
LOM,MB,C 27,Fabbricazione di apparecchiature elettriche ed apparecchi...,1,1,1,0,3,2023
LOM,MB,C 28,Fabbricazione di macchinari ed apparecchiature nca          ,1,0,1,0,2,2023
LOM,MB,C 29,"Fabbricazione di autoveicoli, rimorchi e semirimorchi       ",0,0,0,0,0,2023
LOM,MB,C 30,Fabbricazione di altri mezzi di trasporto                   ,0,0,0,0,0,2023
LOM,MB,C 31,Fabbricazione di mobili                                     ,0,0,3,0,3,2023
LOM,MB,C 32,Altre industrie manifatturiere                              ,0,0,0,0,0,2023
LOM,MB,C 33,"Riparazione, manutenzione ed installazione di macchine ed...",0,1,2,0,3,2023
LOM,MB,D   ,"Fornitura di energia elettrica, gas, vapore e aria condiz...",0,0,0,0,0,2023
LOM,MB,D 35,"Fornitura di energia elettrica, gas, vapore e aria condiz...",0,0,0,0,0,2023
LOM,MB,E   ,"Fornitura di acqua; reti fognarie, attività di gestione d...",0,0,0,0,0,2023
LOM,MB,E 36,"Raccolta, trattamento e fornitura di acqua                  ",0,0,0,0,0,2023
LOM,MB,E 37,Gestione delle reti fognarie                                ,0,0,0,0,0,2023
LOM,MB,E 38,"Attività di raccolta, trattamento e smaltimento dei rifiu...",0,0,0,0,0,2023
LOM,MB,E 39,Attività di risanamento e altri servizi di gestione dei r...,0,0,0,0,0,2023
LOM,MB,F   ,Costruzioni                                                 ,6,1,30,4,41,2023
LOM,MB,F 41,Costruzione di edifici                                      ,5,1,7,3,16,2023
LOM,MB,F 42,Ingegneria civile                                           ,0,0,0,0,0,2023
LOM,MB,F 43,Lavori di costruzione specializzati                         ,1,0,23,1,25,2023
LOM,MB,G   ,Commercio all'ingrosso e al dettaglio; riparazione di aut...,7,2,64,0,73,2023
LOM,MB,G 45,Commercio all'ingrosso e al dettaglio e riparazione di au...,0,0,9,0,9,2023
LOM,MB,G 46,Commercio all'ingrosso (escluso quello di autoveicoli e d...,1,0,20,0,21,2023
LOM,MB,G 47,Commercio al dettaglio (escluso quello di autoveicoli e d...,6,2,35,0,43,2023
LOM,MB,H   ,Trasporto e magazzinaggio                                   ,1,1,5,3,10,2023
LOM,MB,H 49,Trasporto terrestre e mediante condotte                     ,0,1,4,0,5,2023
LOM,MB,H 50,Trasporto marittimo e per vie d'acqua                       ,0,0,0,0,0,2023
LOM,MB,H 51,Trasporto aereo                                             ,0,0,0,0,0,2023
LOM,MB,H 52,Magazzinaggio e attività di supporto ai trasporti           ,1,0,1,3,5,2023
LOM,MB,H 53,Servizi postali e attività di corriere                      ,0,0,0,0,0,2023
LOM,MB,I   ,Attività dei servizi alloggio e ristorazione                ,2,3,18,0,23,2023
LOM,MB,I 55,Alloggio                                                    ,1,0,0,0,1,2023
LOM,MB,I 56,Attività dei servizi di ristorazione                        ,1,3,18,0,22,2023
LOM,MB,J   ,Servizi di informazione e comunicazione                     ,1,0,6,0,7,2023
LOM,MB,J 58,Attività editoriali                                         ,1,0,0,0,1,2023
LOM,MB,J 59,"Attività di produzione cinematografica, di video e di pro...",0,0,0,0,0,2023
LOM,MB,J 60,Attività di programmazione e trasmissione                   ,0,0,0,0,0,2023
LOM,MB,J 61,Telecomunicazioni                                           ,0,0,2,0,2,2023
LOM,MB,J 62,"Produzione di software, consulenza informatica e attività...",0,0,2,0,2,2023
LOM,MB,J 63,Attività dei servizi d'informazione e altri servizi infor...,0,0,2,0,2,2023
LOM,MB,K   ,Attività finanziarie e assicurative                         ,0,0,3,0,3,2023
LOM,MB,K 64,Attività di servizi finanziari (escluse le assicurazioni ...,0,0,0,0,0,2023
LOM,MB,K 65,"Assicurazioni, riassicurazioni e fondi pensione (escluse ...",0,0,0,0,0,2023
LOM,MB,K 66,Attività ausiliarie dei servizi finanziari e delle attivi...,0,0,3,0,3,2023
LOM,MB,L   ,Attivita' immobiliari                                       ,5,2,3,0,10,2023
LOM,MB,L 68,Attivita' immobiliari                                       ,5,2,3,0,10,2023
LOM,MB,M   ,"Attività professionali, scientifiche e tecniche             ",7,0,5,0,12,2023
LOM,MB,M 69,Attività legali e contabilità                               ,1,0,0,0,1,2023
LOM,MB,M 70,Attività di direzione aziendale e di consulenza gestional...,2,0,1,0,3,2023
LOM,MB,M 71,Attività degli studi di architettura e d'ingegneria; coll...,0,0,0,0,0,2023
LOM,MB,M 72,Ricerca scientifica e sviluppo                              ,0,0,0,0,0,2023
LOM,MB,M 73,Pubblicità e ricerche di mercato                            ,1,0,0,0,1,2023
LOM,MB,M 74,"Altre attività professionali, scientifiche e tecniche       ",3,0,4,0,7,2023
LOM,MB,M 75,Servizi veterinari                                          ,0,0,0,0,0,2023
LOM,MB,N   ,"Noleggio, agenzie di viaggio, servizi di supporto alle im...",1,2,6,9,18,2023
LOM,MB,N 77,Attività di noleggio e leasing operativo                    ,0,0,0,0,0,2023
LOM,MB,N 78,"Attività di ricerca, selezione, fornitura di personale      ",0,0,0,0,0,2023
LOM,MB,N 79,"Attività dei servizi delle agenzie di viaggio, dei tour o...",0,0,0,0,0,2023
LOM,MB,N 80,Servizi di vigilanza e investigazione                       ,0,0,0,0,0,2023
LOM,MB,N 81,Attività di servizi per edifici e paesaggio                 ,1,1,3,2,7,2023
LOM,MB,N 82,Attività di supporto per le funzioni d'ufficio e altri se...,0,1,3,7,11,2023
LOM,MB,O   ,Amministrazione pubblica e difesa; assicurazione sociale ...,0,0,0,0,0,2023
LOM,MB,O 84,Amministrazione pubblica e difesa; assicurazione sociale ...,0,0,0,0,0,2023
LOM,MB,P   ,Istruzione                                                  ,0,0,0,0,0,2023
LOM,MB,P 85,Istruzione                                                  ,0,0,0,0,0,2023
LOM,MB,Q   ,Sanita' e assistenza sociale                                ,1,0,0,2,3,2023
LOM,MB,Q 86,Assistenza sanitaria                                        ,0,0,0,1,1,2023
LOM,MB,Q 87,Servizi di assistenza sociale residenziale                  ,0,0,0,0,0,2023
LOM,MB,Q 88,Assistenza sociale non residenziale                         ,1,0,0,1,2,2023
LOM,MB,R   ,"Attività artistiche, sportive, di intrattenimento e diver...",0,1,2,0,3,2023
LOM,MB,R 90,"Attività creative, artistiche e di intrattenimento          ",0,0,0,0,0,2023
LOM,MB,R 91,"Attività di biblioteche, archivi, musei ed altre attività...",0,0,0,0,0,2023
LOM,MB,R 92,"Attività riguardanti le lotterie, le scommesse, le case d...",0,0,1,0,1,2023
LOM,MB,R 93,"Attività sportive, di intrattenimento e di divertimento     ",0,1,1,0,2,2023
LOM,MB,S   ,Altre attività di servizi                                   ,0,1,5,0,6,2023
LOM,MB,S 94,Attività di organizzazioni associative                      ,0,0,0,0,0,2023
LOM,MB,S 95,Riparazione di computer e di beni per uso personale e per...,0,0,0,0,0,2023
LOM,MB,S 96,Altre attività di servizi per la persona                    ,0,1,5,0,6,2023
LOM,MB,T   ,Attività di famiglie e convivenze come datori di lavoro p...,0,0,0,0,0,2023
LOM,MB,T 97,Attività di famiglie e convivenze come datori di lavoro p...,0,0,0,0,0,2023
LOM,MB,T 98,Produzione di beni e servizi indifferenziati per uso prop...,0,0,0,0,0,2023
LOM,MB,U   ,Organizzazioni ed organismi extraterritoriali               ,0,0,0,0,0,2023
LOM,MB,U 99,Organizzazioni ed organismi extraterritoriali               ,0,0,0,0,0,2023
LOM,MB,XX  ,Imprese non classificate                                    ,3,0,56,3,62,2023
LOM,MB,TOT ,TOTALE                                                      ,38,16,230,21,305,2023
TAA,  ,A   ,"Agricoltura, silvicoltura pesca                             ",0,0,64,1,65,2023
TAA,  ,A 01,"Coltivazioni agricole e produzione di prodotti animali, c...",0,0,58,1,59,2023
TAA,  ,A 02,Silvicoltura ed utilizzo di aree forestali                  ,0,0,6,0,6,2023
TAA,  ,A 03,Pesca e acquacoltura                                        ,0,0,0,0,0,2023
TAA,  ,B   ,Estrazione di minerali da cave e miniere                    ,0,0,0,0,0,2023
TAA,  ,B 05,Estrazione di carbone (esclusa torba)                       ,0,0,0,0,0,2023
TAA,  ,B 06,Estraz.di petrolio greggio e di gas naturale                ,0,0,0,0,0,2023
TAA,  ,B 07,Estrazione di minerali metalliferi                          ,0,0,0,0,0,2023
TAA,  ,B 08,Altre attività di estrazione di minerali da cave e miniere  ,0,0,0,0,0,2023
TAA,  ,B 09,Attività dei servizi di supporto all'estrazione             ,0,0,0,0,0,2023
TAA,  ,C   ,Attività manifatturiere                                     ,0,0,47,0,47,2023
TAA,  ,C 10,Industrie alimentari                                        ,0,0,3,0,3,2023
TAA,  ,C 11,Industria delle bevande                                     ,0,0,0,0,0,2023
TAA,  ,C 12,Industria del tabacco                                       ,0,0,0,0,0,2023
TAA,  ,C 13,Industrie tessili                                           ,0,0,1,0,1,2023
TAA,  ,C 14,Confezione di articoli di abbigliamento; confezione di ar...,0,0,5,0,5,2023
TAA,  ,C 15,Fabbricazione di articoli in pelle e simili                 ,0,0,0,0,0,2023
TAA,  ,C 16,Industria del legno e dei prodotti in legno e sughero (es...,0,0,6,0,6,2023
TAA,  ,C 17,Fabbricazione di carta e di prodotti di carta               ,0,0,0,0,0,2023
TAA,  ,C 18,Stampa e riproduzione di supporti registrati                ,0,0,1,0,1,2023
TAA,  ,C 19,Fabbricazione di coke e prodotti derivanti dalla raffinaz...,0,0,0,0,0,2023
TAA,  ,C 20,Fabbricazione di prodotti chimici                           ,0,0,0,0,0,2023
TAA,  ,C 21,Fabbricazione di prodotti farmaceutici di base e di prepa...,0,0,0,0,0,2023
TAA,  ,C 22,Fabbricazione di articoli in gomma e materie plastiche      ,0,0,2,0,2,2023
TAA,  ,C 23,Fabbricazione di altri prodotti della lavorazione di miner..,0,0,5,0,5,2023
TAA,  ,C 24,Metallurgia                                                 ,0,0,0,0,0,2023
TAA,  ,C 25,Fabbricazione di prodotti in metallo (esclusi macchinari ...,0,0,11,0,11,2023
TAA,  ,C 26,Fabbricazione di computer e prodotti di elettronica e ott...,0,0,1,0,1,2023
TAA,  ,C 27,Fabbricazione di apparecchiature elettriche ed apparecchi...,0,0,0,0,0,2023
TAA,  ,C 28,Fabbricazione di macchinari ed apparecchiature nca          ,0,0,2,0,2,2023
TAA,  ,C 29,"Fabbricazione di autoveicoli, rimorchi e semirimorchi       ",0,0,0,0,0,2023
TAA,  ,C 30,Fabbricazione di altri mezzi di trasporto                   ,0,0,0,0,0,2023
TAA,  ,C 31,Fabbricazione di mobili                                     ,0,0,4,0,4,2023
TAA,  ,C 32,Altre industrie manifatturiere                              ,0,0,1,0,1,2023
TAA,  ,C 33,"Riparazione, manutenzione ed installazione di macchine ed...",0,0,5,0,5,2023
TAA,  ,D   ,"Fornitura di energia elettrica, gas, vapore e aria condiz...",0,0,1,0,1,2023
TAA,  ,D 35,"Fornitura di energia elettrica, gas, vapore e aria condiz...",0,0,1,0,1,2023
TAA,  ,E   ,"Fornitura di acqua; reti fognarie, attività di gestione d...",0,0,0,0,0,2023
TAA,  ,E 36,"Raccolta, trattamento e fornitura di acqua                  ",0,0,0,0,0,2023
TAA,  ,E 37,Gestione delle reti fognarie                                ,0,0,0,0,0,2023
TAA,  ,E 38,"Attività di raccolta, trattamento e smaltimento dei rifiu...",0,0,0,0,0,2023
TAA,  ,E 39,Attività di risanamento e altri servizi di gestione dei r...,0,0,0,0,0,2023
TAA,  ,F   ,Costruzioni                                                 ,0,0,257,0,257,2023
TAA,  ,F 41,Costruzione di edifici                                      ,0,0,21,0,21,2023
TAA,  ,F 42,Ingegneria civile                                           ,0,0,5,0,5,2023
TAA,  ,F 43,Lavori di costruzione specializzati                         ,0,0,231,0,231,2023
TAA,  ,G   ,Commercio all'ingrosso e al dettaglio; riparazione di aut...,0,0,343,0,343,2023
TAA,  ,G 45,Commercio all'ingrosso e al dettaglio e riparazione di au...,0,0,26,0,26,2023
TAA,  ,G 46,Commercio all'ingrosso (escluso quello di autoveicoli e d...,0,0,123,0,123,2023
TAA,  ,G 47,Commercio al dettaglio (escluso quello di autoveicoli e d...,0,0,194,0,194,2023
TAA,  ,H   ,Trasporto e magazzinaggio                                   ,0,0,27,1,28,2023
TAA,  ,H 49,Trasporto terrestre e mediante condotte                     ,0,0,24,0,24,2023
TAA,  ,H 50,Trasporto marittimo e per vie d'acqua                       ,0,0,0,0,0,2023
TAA,  ,H 51,Trasporto aereo                                             ,0,0,0,0,0,2023
TAA,  ,H 52,Magazzinaggio e attività di supporto ai trasporti           ,0,0,2,1,3,2023
TAA,  ,H 53,Servizi postali e attività di corriere                      ,0,0,1,0,1,2023
TAA,  ,I   ,Attività dei servizi alloggio e ristorazione                ,0,0,97,2,99,2023
TAA,  ,I 55,Alloggio                                                    ,0,0,10,0,10,2023
TAA,  ,I 56,Attività dei servizi di ristorazione                        ,0,0,87,2,89,2023
TAA,  ,J   ,Servizi di informazione e comunicazione                     ,0,0,11,0,11,2023
TAA,  ,J 58,Attività editoriali                                         ,0,0,1,0,1,2023
TAA,  ,J 59,"Attività di produzione cinematografica, di video e di pro...",0,0,1,0,1,2023
TAA,  ,J 60,Attività di programmazione e trasmissione                   ,0,0,1,0,1,2023
TAA,  ,J 61,Telecomunicazioni                                           ,0,0,1,0,1,2023
TAA,  ,J 62,"Produzione di software, consulenza informatica e attività...",0,0,6,0,6,2023
TAA,  ,J 63,Attività dei servizi d'informazione e altri servizi infor...,0,0,1,0,1,2023
TAA,  ,K   ,Attività finanziarie e assicurative                         ,0,0,18,0,18,2023
TAA,  ,K 64,Attività di servizi finanziari (escluse le assicurazioni ...,0,0,0,0,0,2023
TAA,  ,K 65,"Assicurazioni, riassicurazioni e fondi pensione (escluse ...",0,0,0,0,0,2023
TAA,  ,K 66,Attività ausiliarie dei servizi finanziari e delle attivi...,0,0,18,0,18,2023
TAA,  ,L   ,Attivita' immobiliari                                       ,0,0,4,0,4,2023
TAA,  ,L 68,Attivita' immobiliari                                       ,0,0,4,0,4,2023
TAA,  ,M   ,"Attività professionali, scientifiche e tecniche             ",0,0,24,2,26,2023
TAA,  ,M 69,Attività legali e contabilità                               ,0,0,0,0,0,2023
TAA,  ,M 70,Attività di direzione aziendale e di consulenza gestional...,0,0,4,1,5,2023
TAA,  ,M 71,Attività degli studi di architettura e d'ingegneria; coll...,0,0,1,0,1,2023
TAA,  ,M 72,Ricerca scientifica e sviluppo                              ,0,0,0,0,0,2023
TAA,  ,M 73,Pubblicità e ricerche di mercato                            ,0,0,10,1,11,2023
TAA,  ,M 74,"Altre attività professionali, scientifiche e tecniche       ",0,0,9,0,9,2023
TAA,  ,M 75,Servizi veterinari                                          ,0,0,0,0,0,2023
TAA,  ,N   ,"Noleggio, agenzie di viaggio, servizi di supporto alle im...",0,0,44,0,44,2023
TAA,  ,N 77,Attività di noleggio e leasing operativo                    ,0,0,5,0,5,2023
TAA,  ,N 78,"Attività di ricerca, selezione, fornitura di personale      ",0,0,0,0,0,2023
TAA,  ,N 79,"Attività dei servizi delle agenzie di viaggio, dei tour o...",0,0,2,0,2,2023
TAA,  ,N 80,Servizi di vigilanza e investigazione                       ,0,0,0,0,0,2023
TAA,  ,N 81,Attività di servizi per edifici e paesaggio                 ,0,0,18,0,18,2023
TAA,  ,N 82,Attività di supporto per le funzioni d'ufficio e altri se...,0,0,19,0,19,2023
TAA,  ,O   ,Amministrazione pubblica e difesa; assicurazione sociale ...,0,0,0,0,0,2023
TAA,  ,O 84,Amministrazione pubblica e difesa; assicurazione sociale ...,0,0,0,0,0,2023
TAA,  ,P   ,Istruzione                                                  ,0,0,3,2,5,2023
TAA,  ,P 85,Istruzione                                                  ,0,0,3,2,5,2023
TAA,  ,Q   ,Sanita' e assistenza sociale                                ,0,0,1,0,1,2023
TAA,  ,Q 86,Assistenza sanitaria                                        ,0,0,0,0,0,2023
TAA,  ,Q 87,Servizi di assistenza sociale residenziale                  ,0,0,0,0,0,2023
TAA,  ,Q 88,Assistenza sociale non residenziale                         ,0,0,1,0,1,2023
TAA,  ,R   ,"Attività artistiche, sportive, di intrattenimento e diver...",0,0,4,0,4,2023
TAA,  ,R 90,"Attività creative, artistiche e di intrattenimento          ",0,0,1,0,1,2023
TAA,  ,R 91,"Attività di biblioteche, archivi, musei ed altre attività...",0,0,0,0,0,2023
TAA,  ,R 92,"Attività riguardanti le lotterie, le scommesse, le case d...",0,0,0,0,0,2023
TAA,  ,R 93,"Attività sportive, di intrattenimento e di divertimento     ",0,0,3,0,3,2023
TAA,  ,S   ,Altre attività di servizi                                   ,0,0,18,0,18,2023
TAA,  ,S 94,Attività di organizzazioni associative                      ,0,0,0,0,0,2023
TAA,  ,S 95,Riparazione di computer e di beni per uso personale e per...,0,0,6,0,6,2023
TAA,  ,S 96,Altre attività di servizi per la persona                    ,0,0,12,0,12,2023
TAA,  ,T   ,Attività di famiglie e convivenze come datori di lavoro p...,0,0,0,0,0,2023
TAA,  ,T 97,Attività di famiglie e convivenze come datori di lavoro p...,0,0,0,0,0,2023
TAA,  ,T 98,Produzione di beni e servizi indifferenziati per uso prop...,0,0,0,0,0,2023
TAA,  ,U   ,Organizzazioni ed organismi extraterritoriali               ,0,0,0,0,0,2023
TAA,  ,U 99,Organizzazioni ed organismi extraterritoriali               ,0,0,0,0,0,2023
TAA,  ,XX  ,Imprese non classificate                                    ,0,0,63,0,63,2023
TAA,  ,TOT ,TOTALE                                                      ,0,0,1026,8,1034,2023
TAA,BZ,A   ,"Agricoltura, silvicoltura pesca                             ",0,0,42,1,43,2023
TAA,BZ,A 01,"Coltivazioni agricole e produzione di prodotti animali, c...",0,0,42,1,43,2023
TAA,BZ,A 02,Silvicoltura ed utilizzo di aree forestali                  ,0,0,0,0,0,2023
TAA,BZ,A 03,Pesca e acquacoltura                                        ,0,0,0,0,0,2023
TAA,BZ,B   ,Estrazione di minerali da cave e miniere                    ,0,0,0,0,0,2023
TAA,BZ,B 05,Estrazione di carbone (esclusa torba)                       ,0,0,0,0,0,2023
TAA,BZ,B 06,Estraz.di petrolio greggio e di gas naturale                ,0,0,0,0,0,2023
TAA,BZ,B 07,Estrazione di minerali metalliferi                          ,0,0,0,0,0,2023
TAA,BZ,B 08,Altre attività di estrazione di minerali da cave e miniere  ,0,0,0,0,0,2023
TAA,BZ,B 09,Attività dei servizi di supporto all'estrazione             ,0,0,0,0,0,2023
TAA,BZ,C   ,Attività manifatturiere                                     ,0,0,7,0,7,2023
TAA,BZ,C 10,Industrie alimentari                                        ,0,0,1,0,1,2023
TAA,BZ,C 11,Industria delle bevande                                     ,0,0,0,0,0,2023
TAA,BZ,C 12,Industria del tabacco                                       ,0,0,0,0,0,2023
TAA,BZ,C 13,Industrie tessili                                           ,0,0,0,0,0,2023
TAA,BZ,C 14,Confezione di articoli di abbigliamento; confezione di ar...,0,0,0,0,0,2023
TAA,BZ,C 15,Fabbricazione di articoli in pelle e simili                 ,0,0,0,0,0,2023
TAA,BZ,C 16,Industria del legno e dei prodotti in legno e sughero (es...,0,0,1,0,1,2023
TAA,BZ,C 17,Fabbricazione di carta e di prodotti di carta               ,0,0,0,0,0,2023
TAA,BZ,C 18,Stampa e riproduzione di supporti registrati                ,0,0,1,0,1,2023
TAA,BZ,C 19,Fabbricazione di coke e prodotti derivanti dalla raffinaz...,0,0,0,0,0,2023
TAA,BZ,C 20,Fabbricazione di prodotti chimici                           ,0,0,0,0,0,2023
TAA,BZ,C 21,Fabbricazione di prodotti farmaceutici di base e di prepa...,0,0,0,0,0,2023
TAA,BZ,C 22,Fabbricazione di articoli in gomma e materie plastiche      ,0,0,0,0,0,2023
TAA,BZ,C 23,Fabbricazione di altri prodotti della lavorazione di miner..,0,0,0,0,0,2023
TAA,BZ,C 24,Metallurgia                                                 ,0,0,0,0,0,2023
TAA,BZ,C 25,Fabbricazione di prodotti in metallo (esclusi macchinari ...,0,0,4,0,4,2023
TAA,BZ,C 26,Fabbricazione di computer e prodotti di elettronica e ott...,0,0,0,0,0,2023
TAA,BZ,C 27,Fabbricazione di apparecchiature elettriche ed apparecchi...,0,0,0,0,0,2023
TAA,BZ,C 28,Fabbricazione di macchinari ed apparecchiature nca          ,0,0,0,0,0,2023
TAA,BZ,C 29,"Fabbricazione di autoveicoli, rimorchi e semirimorchi       ",0,0,0,0,0,2023
TAA,BZ,C 30,Fabbricazione di altri mezzi di trasporto                   ,0,0,0,0,0,2023
TAA,BZ,C 31,Fabbricazione di mobili                                     ,0,0,0,0,0,2023
TAA,BZ,C 32,Altre industrie manifatturiere                              ,0,0,0,0,0,2023
TAA,BZ,C 33,"Riparazione, manutenzione ed installazione di macchine ed...",0,0,0,0,0,2023
TAA,BZ,D   ,"Fornitura di energia elettrica, gas, vapore e aria condiz...",0,0,0,0,0,2023
TAA,BZ,D 35,"Fornitura di energia elettrica, gas, vapore e aria condiz...",0,0,0,0,0,2023
TAA,BZ,E   ,"Fornitura di acqua; reti fognarie, attività di gestione d...",0,0,0,0,0,2023
TAA,BZ,E 36,"Raccolta, trattamento e fornitura di acqua                  ",0,0,0,0,0,2023
TAA,BZ,E 37,Gestione delle reti fognarie                                ,0,0,0,0,0,2023
TAA,BZ,E 38,"Attività di raccolta, trattamento e smaltimento dei rifiu...",0,0,0,0,0,2023
TAA,BZ,E 39,Attività di risanamento e altri servizi di gestione dei r...,0,0,0,0,0,2023
TAA,BZ,F   ,Costruzioni                                                 ,0,0,90,0,90,2023
TAA,BZ,F 41,Costruzione di edifici                                      ,0,0,5,0,5,2023
TAA,BZ,F 42,Ingegneria civile                                           ,0,0,1,0,1,2023
TAA,BZ,F 43,Lavori di costruzione specializzati                         ,0,0,84,0,84,2023
TAA,BZ,G   ,Commercio all'ingrosso e al dettaglio; riparazione di aut...,0,0,131,0,131,2023
TAA,BZ,G 45,Commercio all'ingrosso e al dettaglio e riparazione di au...,0,0,3,0,3,2023
TAA,BZ,G 46,Commercio all'ingrosso (escluso quello di autoveicoli e d...,0,0,61,0,61,2023
TAA,BZ,G 47,Commercio al dettaglio (escluso quello di autoveicoli e d...,0,0,67,0,67,2023
TAA,BZ,H   ,Trasporto e magazzinaggio                                   ,0,0,4,1,5,2023
TAA,BZ,H 49,Trasporto terrestre e mediante condotte                     ,0,0,3,0,3,2023
TAA,BZ,H 50,Trasporto marittimo e per vie d'acqua                       ,0,0,0,0,0,2023
TAA,BZ,H 51,Trasporto aereo                                             ,0,0,0,0,0,2023
TAA,BZ,H 52,Magazzinaggio e attività di supporto ai trasporti           ,0,0,1,1,2,2023
TAA,BZ,H 53,Servizi postali e attività di corriere                      ,0,0,0,0,0,2023
TAA,BZ,I   ,Attività dei servizi alloggio e ristorazione                ,0,0,32,2,34,2023
TAA,BZ,I 55,Alloggio                                                    ,0,0,2,0,2,2023
TAA,BZ,I 56,Attività dei servizi di ristorazione                        ,0,0,30,2,32,2023
TAA,BZ,J   ,Servizi di informazione e comunicazione                     ,0,0,6,0,6,2023
TAA,BZ,J 58,Attività editoriali                                         ,0,0,1,0,1,2023
TAA,BZ,J 59,"Attività di produzione cinematografica, di video e di pro...",0,0,1,0,1,2023
TAA,BZ,J 60,Attività di programmazione e trasmissione                   ,0,0,0,0,0,2023
TAA,BZ,J 61,Telecomunicazioni                                           ,0,0,0,0,0,2023
TAA,BZ,J 62,"Produzione di software, consulenza informatica e attività...",0,0,3,0,3,2023
TAA,BZ,J 63,Attività dei servizi d'informazione e altri servizi infor...,0,0,1,0,1,2023
TAA,BZ,K   ,Attività finanziarie e assicurative                         ,0,0,6,0,6,2023
TAA,BZ,K 64,Attività di servizi finanziari (escluse le assicurazioni ...,0,0,0,0,0,2023
TAA,BZ,K 65,"Assicurazioni, riassicurazioni e fondi pensione (escluse ...",0,0,0,0,0,2023
TAA,BZ,K 66,Attività ausiliarie dei servizi finanziari e delle attivi...,0,0,6,0,6,2023
TAA,BZ,L   ,Attivita' immobiliari                                       ,0,0,2,0,2,2023
TAA,BZ,L 68,Attivita' immobiliari                                       ,0,0,2,0,2,2023
TAA,BZ,M   ,"Attività professionali, scientifiche e tecniche             ",0,0,12,2,14,2023
TAA,BZ,M 69,Attività legali e contabilità                               ,0,0,0,0,0,2023
TAA,BZ,M 70,Attività di direzione aziendale e di consulenza gestional...,0,0,4,1,5,2023
TAA,BZ,M 71,Attività degli studi di architettura e d'ingegneria; coll...,0,0,1,0,1,2023
TAA,BZ,M 72,Ricerca scientifica e sviluppo                              ,0,0,0,0,0,2023
TAA,BZ,M 73,Pubblicità e ricerche di mercato                            ,0,0,4,1,5,2023
TAA,BZ,M 74,"Altre attività professionali, scientifiche e tecniche       ",0,0,3,0,3,2023
TAA,BZ,M 75,Servizi veterinari                                          ,0,0,0,0,0,2023
TAA,BZ,N   ,"Noleggio, agenzie di viaggio, servizi di supporto alle im...",0,0,13,0,13,2023
TAA,BZ,N 77,Attività di noleggio e leasing operativo                    ,0,0,2,0,2,2023
TAA,BZ,N 78,"Attività di ricerca, selezione, fornitura di personale      ",0,0,0,0,0,2023
TAA,BZ,N 79,"Attività dei servizi delle agenzie di viaggio, dei tour o...",0,0,0,0,0,2023
TAA,BZ,N 80,Servizi di vigilanza e investigazione                       ,0,0,0,0,0,2023
TAA,BZ,N 81,Attività di servizi per edifici e paesaggio                 ,0,0,5,0,5,2023
TAA,BZ,N 82,Attività di supporto per le funzioni d'ufficio e altri se...,0,0,6,0,6,2023
TAA,BZ,O   ,Amministrazione pubblica e difesa; assicurazione sociale ...,0,0,0,0,0,2023
TAA,BZ,O 84,Amministrazione pubblica e difesa; assicurazione sociale ...,0,0,0,0,0,2023
TAA,BZ,P   ,Istruzione                                                  ,0,0,0,2,2,2023
TAA,BZ,P 85,Istruzione                                                  ,0,0,0,2,2,2023
TAA,BZ,Q   ,Sanita' e assistenza sociale                                ,0,0,1,0,1,2023
TAA,BZ,Q 86,Assistenza sanitaria                                        ,0,0,0,0,0,2023
TAA,BZ,Q 87,Servizi di assistenza sociale residenziale                  ,0,0,0,0,0,2023
TAA,BZ,Q 88,Assistenza sociale non residenziale                         ,0,0,1,0,1,2023
TAA,BZ,R   ,"Attività artistiche, sportive, di intrattenimento e diver...",0,0,1,0,1,2023
TAA,BZ,R 90,"Attività creative, artistiche e di intrattenimento          ",0,0,1,0,1,2023
TAA,BZ,R 91,"Attività di biblioteche, archivi, musei ed altre attività...",0,0,0,0,0,2023
TAA,BZ,R 92,"Attività riguardanti le lotterie, le scommesse, le case d...",0,0,0,0,0,2023
TAA,BZ,R 93,"Attività sportive, di intrattenimento e di divertimento     ",0,0,0,0,0,2023
TAA,BZ,S   ,Altre attività di servizi                                   ,0,0,3,0,3,2023
TAA,BZ,S 94,Attività di organizzazioni associative                      ,0,0,0,0,0,2023
TAA,BZ,S 95,Riparazione di computer e di beni per uso personale e per...,0,0,1,0,1,2023
TAA,BZ,S 96,Altre attività di servizi per la persona                    ,0,0,2,0,2,2023
TAA,BZ,T   ,Attività di famiglie e convivenze come datori di lavoro p...,0,0,0,0,0,2023
TAA,BZ,T 97,Attività di famiglie e convivenze come datori di lavoro p...,0,0,0,0,0,2023
TAA,BZ,T 98,Produzione di beni e servizi indifferenziati per uso prop...,0,0,0,0,0,2023
TAA,BZ,U   ,Organizzazioni ed organismi extraterritoriali               ,0,0,0,0,0,2023
TAA,BZ,U 99,Organizzazioni ed organismi extraterritoriali               ,0,0,0,0,0,2023
TAA,BZ,XX  ,Imprese non classificate                                    ,0,0,16,0,16,2023
TAA,BZ,TOT ,TOTALE                                                      ,0,0,366,8,374,2023
TAA,TN,A   ,"Agricoltura, silvicoltura pesca                             ",0,0,22,0,22,2023
TAA,TN,A 01,"Coltivazioni agricole e produzione di prodotti animali, c...",0,0,16,0,16,2023
TAA,TN,A 02,Silvicoltura ed utilizzo di aree forestali                  ,0,0,6,0,6,2023
TAA,TN,A 03,Pesca e acquacoltura                                        ,0,0,0,0,0,2023
TAA,TN,B   ,Estrazione di minerali da cave e miniere                    ,0,0,0,0,0,2023
TAA,TN,B 05,Estrazione di carbone (esclusa torba)                       ,0,0,0,0,0,2023
TAA,TN,B 06,Estraz.di petrolio greggio e di gas naturale                ,0,0,0,0,0,2023
TAA,TN,B 07,Estrazione di minerali metalliferi                          ,0,0,0,0,0,2023
TAA,TN,B 08,Altre attività di estrazione di minerali da cave e miniere  ,0,0,0,0,0,2023
TAA,TN,B 09,Attività dei servizi di supporto all'estrazione             ,0,0,0,0,0,2023
TAA,TN,C   ,Attività manifatturiere                                     ,0,0,40,0,40,2023
TAA,TN,C 10,Industrie alimentari                                        ,0,0,2,0,2,2023
TAA,TN,C 11,Industria delle bevande                                     ,0,0,0,0,0,2023
TAA,TN,C 12,Industria del tabacco                                       ,0,0,0,0,0,2023
TAA,TN,C 13,Industrie tessili                                           ,0,0,1,0,1,2023
TAA,TN,C 14,Confezione di articoli di abbigliamento; confezione di ar...,0,0,5,0,5,2023
TAA,TN,C 15,Fabbricazione di articoli in pelle e simili                 ,0,0,0,0,0,2023
TAA,TN,C 16,Industria del legno e dei prodotti in legno e sughero (es...,0,0,5,0,5,2023
TAA,TN,C 17,Fabbricazione di carta e di prodotti di carta               ,0,0,0,0,0,2023
TAA,TN,C 18,Stampa e riproduzione di supporti registrati                ,0,0,0,0,0,2023
TAA,TN,C 19,Fabbricazione di coke e prodotti derivanti dalla raffinaz...,0,0,0,0,0,2023
TAA,TN,C 20,Fabbricazione di prodotti chimici                           ,0,0,0,0,0,2023
TAA,TN,C 21,Fabbricazione di prodotti farmaceutici di base e di prepa...,0,0,0,0,0,2023
TAA,TN,C 22,Fabbricazione di articoli in gomma e materie plastiche      ,0,0,2,0,2,2023
TAA,TN,C 23,Fabbricazione di altri prodotti della lavorazione di miner..,0,0,5,0,5,2023
TAA,TN,C 24,Metallurgia                                                 ,0,0,0,0,0,2023
TAA,TN,C 25,Fabbricazione di prodotti in metallo (esclusi macchinari ...,0,0,7,0,7,2023
TAA,TN,C 26,Fabbricazione di computer e prodotti di elettronica e ott...,0,0,1,0,1,2023
TAA,TN,C 27,Fabbricazione di apparecchiature elettriche ed apparecchi...,0,0,0,0,0,2023
TAA,TN,C 28,Fabbricazione di macchinari ed apparecchiature nca          ,0,0,2,0,2,2023
TAA,TN,C 29,"Fabbricazione di autoveicoli, rimorchi e semirimorchi       ",0,0,0,0,0,2023
TAA,TN,C 30,Fabbricazione di altri mezzi di trasporto                   ,0,0,0,0,0,2023
TAA,TN,C 31,Fabbricazione di mobili                                     ,0,0,4,0,4,2023
TAA,TN,C 32,Altre industrie manifatturiere                              ,0,0,1,0,1,2023
TAA,TN,C 33,"Riparazione, manutenzione ed installazione di macchine ed...",0,0,5,0,5,2023
TAA,TN,D   ,"Fornitura di energia elettrica, gas, vapore e aria condiz...",0,0,1,0,1,2023
TAA,TN,D 35,"Fornitura di energia elettrica, gas, vapore e aria condiz...",0,0,1,0,1,2023
TAA,TN,E   ,"Fornitura di acqua; reti fognarie, attività di gestione d...",0,0,0,0,0,2023
TAA,TN,E 36,"Raccolta, trattamento e fornitura di acqua                  ",0,0,0,0,0,2023
TAA,TN,E 37,Gestione delle reti fognarie                                ,0,0,0,0,0,2023
TAA,TN,E 38,"Attività di raccolta, trattamento e smaltimento dei rifiu...",0,0,0,0,0,2023
TAA,TN,E 39,Attività di risanamento e altri servizi di gestione dei r...,0,0,0,0,0,2023
TAA,TN,F   ,Costruzioni                                                 ,0,0,167,0,167,2023
TAA,TN,F 41,Costruzione di edifici                                      ,0,0,16,0,16,2023
TAA,TN,F 42,Ingegneria civile                                           ,0,0,4,0,4,2023
TAA,TN,F 43,Lavori di costruzione specializzati                         ,0,0,147,0,147,2023
TAA,TN,G   ,Commercio all'ingrosso e al dettaglio; riparazione di aut...,0,0,212,0,212,2023
TAA,TN,G 45,Commercio all'ingrosso e al dettaglio e riparazione di au...,0,0,23,0,23,2023
TAA,TN,G 46,Commercio all'ingrosso (escluso quello di autoveicoli e d...,0,0,62,0,62,2023
TAA,TN,G 47,Commercio al dettaglio (escluso quello di autoveicoli e d...,0,0,127,0,127,2023
TAA,TN,H   ,Trasporto e magazzinaggio                                   ,0,0,23,0,23,2023
TAA,TN,H 49,Trasporto terrestre e mediante condotte                     ,0,0,21,0,21,2023
TAA,TN,H 50,Trasporto marittimo e per vie d'acqua                       ,0,0,0,0,0,2023
TAA,TN,H 51,Trasporto aereo                                             ,0,0,0,0,0,2023
TAA,TN,H 52,Magazzinaggio e attività di supporto ai trasporti           ,0,0,1,0,1,2023
TAA,TN,H 53,Servizi postali e attività di corriere                      ,0,0,1,0,1,2023
TAA,TN,I   ,Attività dei servizi alloggio e ristorazione                ,0,0,65,0,65,2023
TAA,TN,I 55,Alloggio                                                    ,0,0,8,0,8,2023
TAA,TN,I 56,Attività dei servizi di ristorazione                        ,0,0,57,0,57,2023
TAA,TN,J   ,Servizi di informazione e comunicazione                     ,0,0,5,0,5,2023
TAA,TN,J 58,Attività editoriali                                         ,0,0,0,0,0,2023
TAA,TN,J 59,"Attività di produzione cinematografica, di video e di pro...",0,0,0,0,0,2023
TAA,TN,J 60,Attività di programmazione e trasmissione                   ,0,0,1,0,1,2023
TAA,TN,J 61,Telecomunicazioni                                           ,0,0,1,0,1,2023
TAA,TN,J 62,"Produzione di software, consulenza informatica e attività...",0,0,3,0,3,2023
TAA,TN,J 63,Attività dei servizi d'informazione e altri servizi infor...,0,0,0,0,0,2023
TAA,TN,K   ,Attività finanziarie e assicurative                         ,0,0,12,0,12,2023
TAA,TN,K 64,Attività di servizi finanziari (escluse le assicurazioni ...,0,0,0,0,0,2023
TAA,TN,K 65,"Assicurazioni, riassicurazioni e fondi pensione (escluse ...",0,0,0,0,0,2023
TAA,TN,K 66,Attività ausiliarie dei servizi finanziari e delle attivi...,0,0,12,0,12,2023
TAA,TN,L   ,Attivita' immobiliari                                       ,0,0,2,0,2,2023
TAA,TN,L 68,Attivita' immobiliari                                       ,0,0,2,0,2,2023
TAA,TN,M   ,"Attività professionali, scientifiche e tecniche             ",0,0,12,0,12,2023
TAA,TN,M 69,Attività legali e contabilità                               ,0,0,0,0,0,2023
TAA,TN,M 70,Attività di direzione aziendale e di consulenza gestional...,0,0,0,0,0,2023
TAA,TN,M 71,Attività degli studi di architettura e d'ingegneria; coll...,0,0,0,0,0,2023
TAA,TN,M 72,Ricerca scientifica e sviluppo                              ,0,0,0,0,0,2023
TAA,TN,M 73,Pubblicità e ricerche di mercato                            ,0,0,6,0,6,2023
TAA,TN,M 74,"Altre attività professionali, scientifiche e tecniche       ",0,0,6,0,6,2023
TAA,TN,M 75,Servizi veterinari                                          ,0,0,0,0,0,2023
TAA,TN,N   ,"Noleggio, agenzie di viaggio, servizi di supporto alle im...",0,0,31,0,31,2023
TAA,TN,N 77,Attività di noleggio e leasing operativo                    ,0,0,3,0,3,2023
TAA,TN,N 78,"Attività di ricerca, selezione, fornitura di personale      ",0,0,0,0,0,2023
TAA,TN,N 79,"Attività dei servizi delle agenzie di viaggio, dei tour o...",0,0,2,0,2,2023
TAA,TN,N 80,Servizi di vigilanza e investigazione                       ,0,0,0,0,0,2023
TAA,TN,N 81,Attività di servizi per edifici e paesaggio                 ,0,0,13,0,13,2023
TAA,TN,N 82,Attività di supporto per le funzioni d'ufficio e altri se...,0,0,13,0,13,2023
TAA,TN,O   ,Amministrazione pubblica e difesa; assicurazione sociale ...,0,0,0,0,0,2023
TAA,TN,O 84,Amministrazione pubblica e difesa; assicurazione sociale ...,0,0,0,0,0,2023
TAA,TN,P   ,Istruzione                                                  ,0,0,3,0,3,2023
TAA,TN,P 85,Istruzione                                                  ,0,0,3,0,3,2023
TAA,TN,Q   ,Sanita' e assistenza sociale                                ,0,0,0,0,0,2023
TAA,TN,Q 86,Assistenza sanitaria                                        ,0,0,0,0,0,2023
TAA,TN,Q 87,Servizi di assistenza sociale residenziale                  ,0,0,0,0,0,2023
TAA,TN,Q 88,Assistenza sociale non residenziale                         ,0,0,0,0,0,2023
TAA,TN,R   ,"Attività artistiche, sportive, di intrattenimento e diver...",0,0,3,0,3,2023
TAA,TN,R 90,"Attività creative, artistiche e di intrattenimento          ",0,0,0,0,0,2023
TAA,TN,R 91,"Attività di biblioteche, archivi, musei ed altre attività...",0,0,0,0,0,2023
TAA,TN,R 92,"Attività riguardanti le lotterie, le scommesse, le case d...",0,0,0,0,0,2023
TAA,TN,R 93,"Attività sportive, di intrattenimento e di divertimento     ",0,0,3,0,3,2023
TAA,TN,S   ,Altre attività di servizi                                   ,0,0,15,0,15,2023
TAA,TN,S 94,Attività di organizzazioni associative                      ,0,0,0,0,0,2023
TAA,TN,S 95,Riparazione di computer e di beni per uso personale e per...,0,0,5,0,5,2023
TAA,TN,S 96,Altre attività di servizi per la persona                    ,0,0,10,0,10,2023
TAA,TN,T   ,Attività di famiglie e convivenze come datori di lavoro p...,0,0,0,0,0,2023
TAA,TN,T 97,Attività di famiglie e convivenze come datori di lavoro p...,0,0,0,0,0,2023
TAA,TN,T 98,Produzione di beni e servizi indifferenziati per uso prop...,0,0,0,0,0,2023
TAA,TN,U   ,Organizzazioni ed organismi extraterritoriali               ,0,0,0,0,0,2023
TAA,TN,U 99,Organizzazioni ed organismi extraterritoriali               ,0,0,0,0,0,2023
TAA,TN,XX  ,Imprese non classificate                                    ,0,0,47,0,47,2023
TAA,TN,TOT ,TOTALE                                                      ,0,0,660,0,660,2023
VEN,  ,A   ,"Agricoltura, silvicoltura pesca                             ",9,77,533,17,636,2023
VEN,  ,A 01,"Coltivazioni agricole e produzione di prodotti animali, c...",9,72,519,13,613,2023
VEN,  ,A 02,Silvicoltura ed utilizzo di aree forestali                  ,0,0,5,0,5,2023
VEN,  ,A 03,Pesca e acquacoltura                                        ,0,5,9,4,18,2023
VEN,  ,B   ,Estrazione di minerali da cave e miniere                    ,3,0,0,0,3,2023
VEN,  ,B 05,Estrazione di carbone (esclusa torba)                       ,0,0,0,0,0,2023
VEN,  ,B 06,Estraz.di petrolio greggio e di gas naturale                ,0,0,0,0,0,2023
VEN,  ,B 07,Estrazione di minerali metalliferi                          ,0,0,0,0,0,2023
VEN,  ,B 08,Altre attività di estrazione di minerali da cave e miniere  ,3,0,0,0,3,2023
VEN,  ,B 09,Attività dei servizi di supporto all'estrazione             ,0,0,0,0,0,2023
VEN,  ,C   ,Attività manifatturiere                                     ,252,152,404,17,825,2023
VEN,  ,C 10,Industrie alimentari                                        ,3,14,12,4,33,2023
VEN,  ,C 11,Industria delle bevande                                     ,1,0,1,0,2,2023
VEN,  ,C 12,Industria del tabacco                                       ,1,0,0,0,1,2023
VEN,  ,C 13,Industrie tessili                                           ,8,5,12,1,26,2023
VEN,  ,C 14,Confezione di articoli di abbigliamento; confezione di ar...,35,16,139,1,191,2023
VEN,  ,C 15,Fabbricazione di articoli in pelle e simili                 ,16,5,21,0,42,2023
VEN,  ,C 16,Industria del legno e dei prodotti in legno e sughero (es...,4,6,19,0,29,2023
VEN,  ,C 17,Fabbricazione di carta e di prodotti di carta               ,3,0,3,0,6,2023
VEN,  ,C 18,Stampa e riproduzione di supporti registrati                ,9,10,4,0,23,2023
VEN,  ,C 19,Fabbricazione di coke e prodotti derivanti dalla raffinaz...,1,0,0,0,1,2023
VEN,  ,C 20,Fabbricazione di prodotti chimici                           ,2,2,5,0,9,2023
VEN,  ,C 21,Fabbricazione di prodotti farmaceutici di base e di prepa...,0,0,0,0,0,2023
VEN,  ,C 22,Fabbricazione di articoli in gomma e materie plastiche      ,7,4,6,2,19,2023
VEN,  ,C 23,Fabbricazione di altri prodotti della lavorazione di miner..,18,13,10,0,41,2023
VEN,  ,C 24,Metallurgia                                                 ,6,1,2,0,9,2023
VEN,  ,C 25,Fabbricazione di prodotti in metallo (esclusi macchinari ...,44,24,70,7,145,2023
VEN,  ,C 26,Fabbricazione di computer e prodotti di elettronica e ott...,12,2,6,0,20,2023
VEN,  ,C 27,Fabbricazione di apparecchiature elettriche ed apparecchi...,8,5,6,0,19,2023
VEN,  ,C 28,Fabbricazione di macchinari ed apparecchiature nca          ,29,9,15,1,54,2023
VEN,  ,C 29,"Fabbricazione di autoveicoli, rimorchi e semirimorchi       ",3,3,1,0,7,2023
VEN,  ,C 30,Fabbricazione di altri mezzi di trasporto                   ,6,0,7,0,13,2023
VEN,  ,C 31,Fabbricazione di mobili                                     ,20,18,28,0,66,2023
VEN,  ,C 32,Altre industrie manifatturiere                              ,16,11,16,1,44,2023
VEN,  ,C 33,"Riparazione, manutenzione ed installazione di macchine ed...",0,4,21,0,25,2023
VEN,  ,D   ,"Fornitura di energia elettrica, gas, vapore e aria condiz...",1,0,1,0,2,2023
VEN,  ,D 35,"Fornitura di energia elettrica, gas, vapore e aria condiz...",1,0,1,0,2,2023
VEN,  ,E   ,"Fornitura di acqua; reti fognarie, attività di gestione d...",2,2,5,0,9,2023
VEN,  ,E 36,"Raccolta, trattamento e fornitura di acqua                  ",0,0,0,0,0,2023
VEN,  ,E 37,Gestione delle reti fognarie                                ,0,0,0,0,0,2023
VEN,  ,E 38,"Attività di raccolta, trattamento e smaltimento dei rifiu...",2,2,5,0,9,2023
VEN,  ,E 39,Attività di risanamento e altri servizi di gestione dei r...,0,0,0,0,0,2023
VEN,  ,F   ,Costruzioni                                                 ,172,161,1010,26,1369,2023
VEN,  ,F 41,Costruzione di edifici                                      ,118,70,213,18,419,2023
VEN,  ,F 42,Ingegneria civile                                           ,6,2,5,2,15,2023
VEN,  ,F 43,Lavori di costruzione specializzati                         ,48,89,792,6,935,2023
VEN,  ,G   ,Commercio all'ingrosso e al dettaglio; riparazione di aut...,315,321,994,1,1631,2023
VEN,  ,G 45,Commercio all'ingrosso e al dettaglio e riparazione di au...,38,22,99,0,159,2023
VEN,  ,G 46,Commercio all'ingrosso (escluso quello di autoveicoli e d...,193,97,282,0,572,2023
VEN,  ,G 47,Commercio al dettaglio (escluso quello di autoveicoli e d...,84,202,613,1,900,2023
VEN,  ,H   ,Trasporto e magazzinaggio                                   ,40,28,105,21,194,2023
VEN,  ,H 49,Trasporto terrestre e mediante condotte                     ,24,22,85,7,138,2023
VEN,  ,H 50,Trasporto marittimo e per vie d'acqua                       ,0,1,6,0,7,2023
VEN,  ,H 51,Trasporto aereo                                             ,0,0,0,0,0,2023
VEN,  ,H 52,Magazzinaggio e attività di supporto ai trasporti           ,15,5,14,14,48,2023
VEN,  ,H 53,Servizi postali e attività di corriere                      ,1,0,0,0,1,2023
VEN,  ,I   ,Attività dei servizi alloggio e ristorazione                ,93,383,197,3,676,2023
VEN,  ,I 55,Alloggio                                                    ,13,10,8,0,31,2023
VEN,  ,I 56,Attività dei servizi di ristorazione                        ,80,373,189,3,645,2023
VEN,  ,J   ,Servizi di informazione e comunicazione                     ,60,24,52,0,136,2023
VEN,  ,J 58,Attività editoriali                                         ,6,1,8,0,15,2023
VEN,  ,J 59,"Attività di produzione cinematografica, di video e di pro...",2,1,2,0,5,2023
VEN,  ,J 60,Attività di programmazione e trasmissione                   ,1,0,0,0,1,2023
VEN,  ,J 61,Telecomunicazioni                                           ,4,4,21,0,29,2023
VEN,  ,J 62,"Produzione di software, consulenza informatica e attività...",30,6,12,0,48,2023
VEN,  ,J 63,Attività dei servizi d'informazione e altri servizi infor...,17,12,9,0,38,2023
VEN,  ,K   ,Attività finanziarie e assicurative                         ,16,15,38,0,69,2023
VEN,  ,K 64,Attività di servizi finanziari (escluse le assicurazioni ...,6,3,0,0,9,2023
VEN,  ,K 65,"Assicurazioni, riassicurazioni e fondi pensione (escluse ...",0,0,0,0,0,2023
VEN,  ,K 66,Attività ausiliarie dei servizi finanziari e delle attivi...,10,12,38,0,60,2023
VEN,  ,L   ,Attivita' immobiliari                                       ,112,139,20,5,276,2023
VEN,  ,L 68,Attivita' immobiliari                                       ,112,139,20,5,276,2023
VEN,  ,M   ,"Attività professionali, scientifiche e tecniche             ",92,39,78,8,217,2023
VEN,  ,M 69,Attività legali e contabilità                               ,5,4,1,0,10,2023
VEN,  ,M 70,Attività di direzione aziendale e di consulenza gestional...,23,12,8,3,46,2023
VEN,  ,M 71,Attività degli studi di architettura e d'ingegneria; coll...,19,2,6,1,28,2023
VEN,  ,M 72,Ricerca scientifica e sviluppo                              ,0,0,0,0,0,2023
VEN,  ,M 73,Pubblicità e ricerche di mercato                            ,24,9,30,3,66,2023
VEN,  ,M 74,"Altre attività professionali, scientifiche e tecniche       ",21,12,33,1,67,2023
VEN,  ,M 75,Servizi veterinari                                          ,0,0,0,0,0,2023
VEN,  ,N   ,"Noleggio, agenzie di viaggio, servizi di supporto alle im...",46,34,110,19,209,2023
VEN,  ,N 77,Attività di noleggio e leasing operativo                    ,12,10,6,0,28,2023
VEN,  ,N 78,"Attività di ricerca, selezione, fornitura di personale      ",0,0,0,0,0,2023
VEN,  ,N 79,"Attività dei servizi delle agenzie di viaggio, dei tour o...",8,4,5,2,19,2023
VEN,  ,N 80,Servizi di vigilanza e investigazione                       ,0,1,1,0,2,2023
VEN,  ,N 81,Attività di servizi per edifici e paesaggio                 ,8,8,40,10,66,2023
VEN,  ,N 82,Attività di supporto per le funzioni d'ufficio e altri se...,18,11,58,7,94,2023
VEN,  ,O   ,Amministrazione pubblica e difesa; assicurazione sociale ...,0,0,0,0,0,2023
VEN,  ,O 84,Amministrazione pubblica e difesa; assicurazione sociale ...,0,0,0,0,0,2023
VEN,  ,P   ,Istruzione                                                  ,3,6,4,0,13,2023
VEN,  ,P 85,Istruzione                                                  ,3,6,4,0,13,2023
VEN,  ,Q   ,Sanita' e assistenza sociale                                ,5,3,3,9,20,2023
VEN,  ,Q 86,Assistenza sanitaria                                        ,5,1,1,1,8,2023
VEN,  ,Q 87,Servizi di assistenza sociale residenziale                  ,0,2,0,0,2,2023
VEN,  ,Q 88,Assistenza sociale non residenziale                         ,0,0,2,8,10,2023
VEN,  ,R   ,"Attività artistiche, sportive, di intrattenimento e diver...",31,15,35,1,82,2023
VEN,  ,R 90,"Attività creative, artistiche e di intrattenimento          ",5,2,7,0,14,2023
VEN,  ,R 91,"Attività di biblioteche, archivi, musei ed altre attività...",0,0,0,0,0,2023
VEN,  ,R 92,"Attività riguardanti le lotterie, le scommesse, le case d...",0,1,1,0,2,2023
VEN,  ,R 93,"Attività sportive, di intrattenimento e di divertimento     ",26,12,27,1,66,2023
VEN,  ,S   ,Altre attività di servizi                                   ,13,40,66,3,122,2023
VEN,  ,S 94,Attività di organizzazioni associative                      ,0,0,0,0,0,2023
VEN,  ,S 95,Riparazione di computer e di beni per uso personale e per...,3,3,27,0,33,2023
VEN,  ,S 96,Altre attività di servizi per la persona                    ,10,37,39,3,89,2023
VEN,  ,T   ,Attività di famiglie e convivenze come datori di lavoro p...,0,0,0,0,0,2023
VEN,  ,T 97,Attività di famiglie e convivenze come datori di lavoro p...,0,0,0,0,0,2023
VEN,  ,T 98,Produzione di beni e servizi indifferenziati per uso prop...,0,0,0,0,0,2023
VEN,  ,U   ,Organizzazioni ed organismi extraterritoriali               ,0,0,0,0,0,2023
VEN,  ,U 99,Organizzazioni ed organismi extraterritoriali               ,0,0,0,0,0,2023
VEN,  ,XX  ,Imprese non classificate                                    ,422,199,75,17,713,2023
VEN,  ,TOT ,TOTALE                                                      ,1687,1638,3730,147,7202,2023
VEN,VR,A   ,"Agricoltura, silvicoltura pesca                             ",6,23,131,5,165,2023
VEN,VR,A 01,"Coltivazioni agricole e produzione di prodotti animali, c...",6,23,129,5,163,2023
VEN,VR,A 02,Silvicoltura ed utilizzo di aree forestali                  ,0,0,1,0,1,2023
VEN,VR,A 03,Pesca e acquacoltura                                        ,0,0,1,0,1,2023
VEN,VR,B   ,Estrazione di minerali da cave e miniere                    ,2,0,0,0,2,2023
VEN,VR,B 05,Estrazione di carbone (esclusa torba)                       ,0,0,0,0,0,2023
VEN,VR,B 06,Estraz.di petrolio greggio e di gas naturale                ,0,0,0,0,0,2023
VEN,VR,B 07,Estrazione di minerali metalliferi                          ,0,0,0,0,0,2023
VEN,VR,B 08,Altre attività di estrazione di minerali da cave e miniere  ,2,0,0,0,2,2023
VEN,VR,B 09,Attività dei servizi di supporto all'estrazione             ,0,0,0,0,0,2023
VEN,VR,C   ,Attività manifatturiere                                     ,108,42,50,7,207,2023
VEN,VR,C 10,Industrie alimentari                                        ,3,3,2,1,9,2023
VEN,VR,C 11,Industria delle bevande                                     ,1,0,0,0,1,2023
VEN,VR,C 12,Industria del tabacco                                       ,0,0,0,0,0,2023
VEN,VR,C 13,Industrie tessili                                           ,2,0,0,0,2,2023
VEN,VR,C 14,Confezione di articoli di abbigliamento; confezione di ar...,14,3,10,0,27,2023
VEN,VR,C 15,Fabbricazione di articoli in pelle e simili                 ,8,1,0,0,9,2023
VEN,VR,C 16,Industria del legno e dei prodotti in legno e sughero (es...,2,1,6,0,9,2023
VEN,VR,C 17,Fabbricazione di carta e di prodotti di carta               ,3,0,0,0,3,2023
VEN,VR,C 18,Stampa e riproduzione di supporti registrati                ,6,1,0,0,7,2023
VEN,VR,C 19,Fabbricazione di coke e prodotti derivanti dalla raffinaz...,1,0,0,0,1,2023
VEN,VR,C 20,Fabbricazione di prodotti chimici                           ,1,0,0,0,1,2023
VEN,VR,C 21,Fabbricazione di prodotti farmaceutici di base e di prepa...,0,0,0,0,0,2023
VEN,VR,C 22,Fabbricazione di articoli in gomma e materie plastiche      ,2,0,1,2,5,2023
VEN,VR,C 23,Fabbricazione di altri prodotti della lavorazione di miner..,8,5,1,0,14,2023
VEN,VR,C 24,Metallurgia                                                 ,1,0,0,0,1,2023
VEN,VR,C 25,Fabbricazione di prodotti in metallo (esclusi macchinari ...,19,8,14,4,45,2023
VEN,VR,C 26,Fabbricazione di computer e prodotti di elettronica e ott...,5,1,1,0,7,2023
VEN,VR,C 27,Fabbricazione di apparecchiature elettriche ed apparecchi...,4,2,0,0,6,2023
VEN,VR,C 28,Fabbricazione di macchinari ed apparecchiature nca          ,13,3,2,0,18,2023
VEN,VR,C 29,"Fabbricazione di autoveicoli, rimorchi e semirimorchi       ",2,2,0,0,4,2023
VEN,VR,C 30,Fabbricazione di altri mezzi di trasporto                   ,2,0,0,0,2,2023
VEN,VR,C 31,Fabbricazione di mobili                                     ,9,10,3,0,22,2023
VEN,VR,C 32,Altre industrie manifatturiere                              ,2,1,3,0,6,2023
VEN,VR,C 33,"Riparazione, manutenzione ed installazione di macchine ed...",0,1,7,0,8,2023
VEN,VR,D   ,"Fornitura di energia elettrica, gas, vapore e aria condiz...",0,0,1,0,1,2023
VEN,VR,D 35,"Fornitura di energia elettrica, gas, vapore e aria condiz...",0,0,1,0,1,2023
VEN,VR,E   ,"Fornitura di acqua; reti fognarie, attività di gestione d...",2,0,1,0,3,2023
VEN,VR,E 36,"Raccolta, trattamento e fornitura di acqua                  ",0,0,0,0,0,2023
VEN,VR,E 37,Gestione delle reti fognarie                                ,0,0,0,0,0,2023
VEN,VR,E 38,"Attività di raccolta, trattamento e smaltimento dei rifiu...",2,0,1,0,3,2023
VEN,VR,E 39,Attività di risanamento e altri servizi di gestione dei r...,0,0,0,0,0,2023
VEN,VR,F   ,Costruzioni                                                 ,123,28,243,9,403,2023
VEN,VR,F 41,Costruzione di edifici                                      ,82,16,45,5,148,2023
VEN,VR,F 42,Ingegneria civile                                           ,4,1,1,0,6,2023
VEN,VR,F 43,Lavori di costruzione specializzati                         ,37,11,197,4,249,2023
VEN,VR,G   ,Commercio all'ingrosso e al dettaglio; riparazione di aut...,164,52,160,0,376,2023
VEN,VR,G 45,Commercio all'ingrosso e al dettaglio e riparazione di au...,23,7,21,0,51,2023
VEN,VR,G 46,Commercio all'ingrosso (escluso quello di autoveicoli e d...,101,20,49,0,170,2023
VEN,VR,G 47,Commercio al dettaglio (escluso quello di autoveicoli e d...,40,25,90,0,155,2023
VEN,VR,H   ,Trasporto e magazzinaggio                                   ,29,11,22,10,72,2023
VEN,VR,H 49,Trasporto terrestre e mediante condotte                     ,17,10,14,2,43,2023
VEN,VR,H 50,Trasporto marittimo e per vie d'acqua                       ,0,0,0,0,0,2023
VEN,VR,H 51,Trasporto aereo                                             ,0,0,0,0,0,2023
VEN,VR,H 52,Magazzinaggio e attività di supporto ai trasporti           ,12,1,8,8,29,2023
VEN,VR,H 53,Servizi postali e attività di corriere                      ,0,0,0,0,0,2023
VEN,VR,I   ,Attività dei servizi alloggio e ristorazione                ,56,36,41,0,133,2023
VEN,VR,I 55,Alloggio                                                    ,8,0,1,0,9,2023
VEN,VR,I 56,Attività dei servizi di ristorazione                        ,48,36,40,0,124,2023
VEN,VR,J   ,Servizi di informazione e comunicazione                     ,33,5,7,0,45,2023
VEN,VR,J 58,Attività editoriali                                         ,3,0,0,0,3,2023
VEN,VR,J 59,"Attività di produzione cinematografica, di video e di pro...",1,1,1,0,3,2023
VEN,VR,J 60,Attività di programmazione e trasmissione                   ,1,0,0,0,1,2023
VEN,VR,J 61,Telecomunicazioni                                           ,3,0,2,0,5,2023
VEN,VR,J 62,"Produzione di software, consulenza informatica e attività...",16,2,1,0,19,2023
VEN,VR,J 63,Attività dei servizi d'informazione e altri servizi infor...,9,2,3,0,14,2023
VEN,VR,K   ,Attività finanziarie e assicurative                         ,8,3,13,0,24,2023
VEN,VR,K 64,Attività di servizi finanziari (escluse le assicurazioni ...,0,0,0,0,0,2023
VEN,VR,K 65,"Assicurazioni, riassicurazioni e fondi pensione (escluse ...",0,0,0,0,0,2023
VEN,VR,K 66,Attività ausiliarie dei servizi finanziari e delle attivi...,8,3,13,0,24,2023
VEN,VR,L   ,Attivita' immobiliari                                       ,60,18,1,2,81,2023
VEN,VR,L 68,Attivita' immobiliari                                       ,60,18,1,2,81,2023
VEN,VR,M   ,"Attività professionali, scientifiche e tecniche             ",57,7,12,2,78,2023
VEN,VR,M 69,Attività legali e contabilità                               ,4,1,0,0,5,2023
VEN,VR,M 70,Attività di direzione aziendale e di consulenza gestional...,18,1,1,0,20,2023
VEN,VR,M 71,Attività degli studi di architettura e d'ingegneria; coll...,11,0,0,1,12,2023
VEN,VR,M 72,Ricerca scientifica e sviluppo                              ,0,0,0,0,0,2023
VEN,VR,M 73,Pubblicità e ricerche di mercato                            ,16,3,6,0,25,2023
VEN,VR,M 74,"Altre attività professionali, scientifiche e tecniche       ",8,2,5,1,16,2023
VEN,VR,M 75,Servizi veterinari                                          ,0,0,0,0,0,2023
VEN,VR,N   ,"Noleggio, agenzie di viaggio, servizi di supporto alle im...",31,6,24,7,68,2023
VEN,VR,N 77,Attività di noleggio e leasing operativo                    ,10,3,2,0,15,2023
VEN,VR,N 78,"Attività di ricerca, selezione, fornitura di personale      ",0,0,0,0,0,2023
VEN,VR,N 79,"Attività dei servizi delle agenzie di viaggio, dei tour o...",7,0,1,0,8,2023
VEN,VR,N 80,Servizi di vigilanza e investigazione                       ,0,0,0,0,0,2023
VEN,VR,N 81,Attività di servizi per edifici e paesaggio                 ,2,1,12,2,17,2023
VEN,VR,N 82,Attività di supporto per le funzioni d'ufficio e altri se...,12,2,9,5,28,2023
VEN,VR,O   ,Amministrazione pubblica e difesa; assicurazione sociale ...,0,0,0,0,0,2023
VEN,VR,O 84,Amministrazione pubblica e difesa; assicurazione sociale ...,0,0,0,0,0,2023
VEN,VR,P   ,Istruzione                                                  ,1,2,1,0,4,2023
VEN,VR,P 85,Istruzione                                                  ,1,2,1,0,4,2023
VEN,VR,Q   ,Sanita' e assistenza sociale                                ,3,0,1,5,9,2023
VEN,VR,Q 86,Assistenza sanitaria                                        ,3,0,0,1,4,2023
VEN,VR,Q 87,Servizi di assistenza sociale residenziale                  ,0,0,0,0,0,2023
VEN,VR,Q 88,Assistenza sociale non residenziale                         ,0,0,1,4,5,2023
VEN,VR,R   ,"Attività artistiche, sportive, di intrattenimento e diver...",15,2,2,1,20,2023
VEN,VR,R 90,"Attività creative, artistiche e di intrattenimento          ",3,1,0,0,4,2023
VEN,VR,R 91,"Attività di biblioteche, archivi, musei ed altre attività...",0,0,0,0,0,2023
VEN,VR,R 92,"Attività riguardanti le lotterie, le scommesse, le case d...",0,0,1,0,1,2023
VEN,VR,R 93,"Attività sportive, di intrattenimento e di divertimento     ",12,1,1,1,15,2023
VEN,VR,S   ,Altre attività di servizi                                   ,11,3,16,2,32,2023
VEN,VR,S 94,Attività di organizzazioni associative                      ,0,0,0,0,0,2023
VEN,VR,S 95,Riparazione di computer e di beni per uso personale e per...,3,1,7,0,11,2023
VEN,VR,S 96,Altre attività di servizi per la persona                    ,8,2,9,2,21,2023
VEN,VR,T   ,Attività di famiglie e convivenze come datori di lavoro p...,0,0,0,0,0,2023
VEN,VR,T 97,Attività di famiglie e convivenze come datori di lavoro p...,0,0,0,0,0,2023
VEN,VR,T 98,Produzione di beni e servizi indifferenziati per uso prop...,0,0,0,0,0,2023
VEN,VR,U   ,Organizzazioni ed organismi extraterritoriali               ,0,0,0,0,0,2023
VEN,VR,U 99,Organizzazioni ed organismi extraterritoriali               ,0,0,0,0,0,2023
VEN,VR,XX  ,Imprese non classificate                                    ,215,43,30,5,293,2023
VEN,VR,TOT ,TOTALE                                                      ,924,281,756,55,2016,2023
VEN,VI,A   ,"Agricoltura, silvicoltura pesca                             ",3,0,0,1,4,2023
VEN,VI,A 01,"Coltivazioni agricole e produzione di prodotti animali, c...",3,0,0,1,4,2023
VEN,VI,A 02,Silvicoltura ed utilizzo di aree forestali                  ,0,0,0,0,0,2023
VEN,VI,A 03,Pesca e acquacoltura                                        ,0,0,0,0,0,2023
VEN,VI,B   ,Estrazione di minerali da cave e miniere                    ,1,0,0,0,1,2023
VEN,VI,B 05,Estrazione di carbone (esclusa torba)                       ,0,0,0,0,0,2023
VEN,VI,B 06,Estraz.di petrolio greggio e di gas naturale                ,0,0,0,0,0,2023
VEN,VI,B 07,Estrazione di minerali metalliferi                          ,0,0,0,0,0,2023
VEN,VI,B 08,Altre attività di estrazione di minerali da cave e miniere  ,1,0,0,0,1,2023
VEN,VI,B 09,Attività dei servizi di supporto all'estrazione             ,0,0,0,0,0,2023
VEN,VI,C   ,Attività manifatturiere                                     ,134,10,0,2,146,2023
VEN,VI,C 10,Industrie alimentari                                        ,0,1,0,1,2,2023
VEN,VI,C 11,Industria delle bevande                                     ,0,0,0,0,0,2023
VEN,VI,C 12,Industria del tabacco                                       ,1,0,0,0,1,2023
VEN,VI,C 13,Industrie tessili                                           ,6,2,0,0,8,2023
VEN,VI,C 14,Confezione di articoli di abbigliamento; confezione di ar...,20,0,0,1,21,2023
VEN,VI,C 15,Fabbricazione di articoli in pelle e simili                 ,8,0,0,0,8,2023
VEN,VI,C 16,Industria del legno e dei prodotti in legno e sughero (es...,1,1,0,0,2,2023
VEN,VI,C 17,Fabbricazione di carta e di prodotti di carta               ,0,0,0,0,0,2023
VEN,VI,C 18,Stampa e riproduzione di supporti registrati                ,1,0,0,0,1,2023
VEN,VI,C 19,Fabbricazione di coke e prodotti derivanti dalla raffinaz...,0,0,0,0,0,2023
VEN,VI,C 20,Fabbricazione di prodotti chimici                           ,1,0,0,0,1,2023
VEN,VI,C 21,Fabbricazione di prodotti farmaceutici di base e di prepa...,0,0,0,0,0,2023
VEN,VI,C 22,Fabbricazione di articoli in gomma e materie plastiche      ,4,2,0,0,6,2023
VEN,VI,C 23,Fabbricazione di altri prodotti della lavorazione di miner..,9,1,0,0,10,2023
VEN,VI,C 24,Metallurgia                                                 ,5,0,0,0,5,2023
VEN,VI,C 25,Fabbricazione di prodotti in metallo (esclusi macchinari ...,24,0,0,0,24,2023
VEN,VI,C 26,Fabbricazione di computer e prodotti di elettronica e ott...,7,0,0,0,7,2023
VEN,VI,C 27,Fabbricazione di apparecchiature elettriche ed apparecchi...,4,0,0,0,4,2023
VEN,VI,C 28,Fabbricazione di macchinari ed apparecchiature nca          ,15,2,0,0,17,2023
VEN,VI,C 29,"Fabbricazione di autoveicoli, rimorchi e semirimorchi       ",1,0,0,0,1,2023
VEN,VI,C 30,Fabbricazione di altri mezzi di trasporto                   ,3,0,0,0,3,2023
VEN,VI,C 31,Fabbricazione di mobili                                     ,10,1,0,0,11,2023
VEN,VI,C 32,Altre industrie manifatturiere                              ,14,0,0,0,14,2023
VEN,VI,C 33,"Riparazione, manutenzione ed installazione di macchine ed...",0,0,0,0,0,2023
VEN,VI,D   ,"Fornitura di energia elettrica, gas, vapore e aria condiz...",0,0,0,0,0,2023
VEN,VI,D 35,"Fornitura di energia elettrica, gas, vapore e aria condiz...",0,0,0,0,0,2023
VEN,VI,E   ,"Fornitura di acqua; reti fognarie, attività di gestione d...",0,0,0,0,0,2023
VEN,VI,E 36,"Raccolta, trattamento e fornitura di acqua                  ",0,0,0,0,0,2023
VEN,VI,E 37,Gestione delle reti fognarie                                ,0,0,0,0,0,2023
VEN,VI,E 38,"Attività di raccolta, trattamento e smaltimento dei rifiu...",0,0,0,0,0,2023
VEN,VI,E 39,Attività di risanamento e altri servizi di gestione dei r...,0,0,0,0,0,2023
VEN,VI,F   ,Costruzioni                                                 ,41,2,0,1,44,2023
VEN,VI,F 41,Costruzione di edifici                                      ,30,2,0,0,32,2023
VEN,VI,F 42,Ingegneria civile                                           ,2,0,0,0,2,2023
VEN,VI,F 43,Lavori di costruzione specializzati                         ,9,0,0,1,10,2023
VEN,VI,G   ,Commercio all'ingrosso e al dettaglio; riparazione di aut...,139,7,0,0,146,2023
VEN,VI,G 45,Commercio all'ingrosso e al dettaglio e riparazione di au...,15,1,0,0,16,2023
VEN,VI,G 46,Commercio all'ingrosso (escluso quello di autoveicoli e d...,88,4,0,0,92,2023
VEN,VI,G 47,Commercio al dettaglio (escluso quello di autoveicoli e d...,36,2,0,0,38,2023
VEN,VI,H   ,Trasporto e magazzinaggio                                   ,11,1,0,0,12,2023
VEN,VI,H 49,Trasporto terrestre e mediante condotte                     ,7,1,0,0,8,2023
VEN,VI,H 50,Trasporto marittimo e per vie d'acqua                       ,0,0,0,0,0,2023
VEN,VI,H 51,Trasporto aereo                                             ,0,0,0,0,0,2023
VEN,VI,H 52,Magazzinaggio e attività di supporto ai trasporti           ,3,0,0,0,3,2023
VEN,VI,H 53,Servizi postali e attività di corriere                      ,1,0,0,0,1,2023
VEN,VI,I   ,Attività dei servizi alloggio e ristorazione                ,28,1,0,0,29,2023
VEN,VI,I 55,Alloggio                                                    ,3,0,0,0,3,2023
VEN,VI,I 56,Attività dei servizi di ristorazione                        ,25,1,0,0,26,2023
VEN,VI,J   ,Servizi di informazione e comunicazione                     ,25,0,0,0,25,2023
VEN,VI,J 58,Attività editoriali                                         ,3,0,0,0,3,2023
VEN,VI,J 59,"Attività di produzione cinematografica, di video e di pro...",0,0,0,0,0,2023
VEN,VI,J 60,Attività di programmazione e trasmissione                   ,0,0,0,0,0,2023
VEN,VI,J 61,Telecomunicazioni                                           ,1,0,0,0,1,2023
VEN,VI,J 62,"Produzione di software, consulenza informatica e attività...",13,0,0,0,13,2023
VEN,VI,J 63,Attività dei servizi d'informazione e altri servizi infor...,8,0,0,0,8,2023
VEN,VI,K   ,Attività finanziarie e assicurative                         ,7,0,0,0,7,2023
VEN,VI,K 64,Attività di servizi finanziari (escluse le assicurazioni ...,5,0,0,0,5,2023
VEN,VI,K 65,"Assicurazioni, riassicurazioni e fondi pensione (escluse ...",0,0,0,0,0,2023
VEN,VI,K 66,Attività ausiliarie dei servizi finanziari e delle attivi...,2,0,0,0,2,2023
VEN,VI,L   ,Attivita' immobiliari                                       ,49,0,0,0,49,2023
VEN,VI,L 68,Attivita' immobiliari                                       ,49,0,0,0,49,2023
VEN,VI,M   ,"Attività professionali, scientifiche e tecniche             ",30,0,0,2,32,2023
VEN,VI,M 69,Attività legali e contabilità                               ,0,0,0,0,0,2023
VEN,VI,M 70,Attività di direzione aziendale e di consulenza gestional...,4,0,0,0,4,2023
VEN,VI,M 71,Attività degli studi di architettura e d'ingegneria; coll...,5,0,0,0,5,2023
VEN,VI,M 72,Ricerca scientifica e sviluppo                              ,0,0,0,0,0,2023
VEN,VI,M 73,Pubblicità e ricerche di mercato                            ,8,0,0,2,10,2023
VEN,VI,M 74,"Altre attività professionali, scientifiche e tecniche       ",13,0,0,0,13,2023
VEN,VI,M 75,Servizi veterinari                                          ,0,0,0,0,0,2023
VEN,VI,N   ,"Noleggio, agenzie di viaggio, servizi di supporto alle im...",14,1,0,1,16,2023
VEN,VI,N 77,Attività di noleggio e leasing operativo                    ,2,0,0,0,2,2023
VEN,VI,N 78,"Attività di ricerca, selezione, fornitura di personale      ",0,0,0,0,0,2023
VEN,VI,N 79,"Attività dei servizi delle agenzie di viaggio, dei tour o...",1,0,0,0,1,2023
VEN,VI,N 80,Servizi di vigilanza e investigazione                       ,0,0,0,0,0,2023
VEN,VI,N 81,Attività di servizi per edifici e paesaggio                 ,6,0,0,1,7,2023
VEN,VI,N 82,Attività di supporto per le funzioni d'ufficio e altri se...,5,1,0,0,6,2023
VEN,VI,O   ,Amministrazione pubblica e difesa; assicurazione sociale ...,0,0,0,0,0,2023
VEN,VI,O 84,Amministrazione pubblica e difesa; assicurazione sociale ...,0,0,0,0,0,2023
VEN,VI,P   ,Istruzione                                                  ,1,0,0,0,1,2023
VEN,VI,P 85,Istruzione                                                  ,1,0,0,0,1,2023
VEN,VI,Q   ,Sanita' e assistenza sociale                                ,2,0,0,1,3,2023
VEN,VI,Q 86,Assistenza sanitaria                                        ,2,0,0,0,2,2023
VEN,VI,Q 87,Servizi di assistenza sociale residenziale                  ,0,0,0,0,0,2023
VEN,VI,Q 88,Assistenza sociale non residenziale                         ,0,0,0,1,1,2023
VEN,VI,R   ,"Attività artistiche, sportive, di intrattenimento e diver...",12,0,0,0,12,2023
VEN,VI,R 90,"Attività creative, artistiche e di intrattenimento          ",1,0,0,0,1,2023
VEN,VI,R 91,"Attività di biblioteche, archivi, musei ed altre attività...",0,0,0,0,0,2023
VEN,VI,R 92,"Attività riguardanti le lotterie, le scommesse, le case d...",0,0,0,0,0,2023
VEN,VI,R 93,"Attività sportive, di intrattenimento e di divertimento     ",11,0,0,0,11,2023
VEN,VI,S   ,Altre attività di servizi                                   ,2,0,0,0,2,2023
VEN,VI,S 94,Attività di organizzazioni associative                      ,0,0,0,0,0,2023
VEN,VI,S 95,Riparazione di computer e di beni per uso personale e per...,0,0,0,0,0,2023
VEN,VI,S 96,Altre attività di servizi per la persona                    ,2,0,0,0,2,2023
VEN,VI,T   ,Attività di famiglie e convivenze come datori di lavoro p...,0,0,0,0,0,2023
VEN,VI,T 97,Attività di famiglie e convivenze come datori di lavoro p...,0,0,0,0,0,2023
VEN,VI,T 98,Produzione di beni e servizi indifferenziati per uso prop...,0,0,0,0,0,2023
VEN,VI,U   ,Organizzazioni ed organismi extraterritoriali               ,0,0,0,0,0,2023
VEN,VI,U 99,Organizzazioni ed organismi extraterritoriali               ,0,0,0,0,0,2023
VEN,VI,XX  ,Imprese non classificate                                    ,195,26,0,4,225,2023
VEN,VI,TOT ,TOTALE                                                      ,694,48,0,12,754,2023
VEN,BL,A   ,"Agricoltura, silvicoltura pesca                             ",0,0,32,0,32,2023
VEN,BL,A 01,"Coltivazioni agricole e produzione di prodotti animali, c...",0,0,30,0,30,2023
VEN,BL,A 02,Silvicoltura ed utilizzo di aree forestali                  ,0,0,2,0,2,2023
VEN,BL,A 03,Pesca e acquacoltura                                        ,0,0,0,0,0,2023
VEN,BL,B   ,Estrazione di minerali da cave e miniere                    ,0,0,0,0,0,2023
VEN,BL,B 05,Estrazione di carbone (esclusa torba)                       ,0,0,0,0,0,2023
VEN,BL,B 06,Estraz.di petrolio greggio e di gas naturale                ,0,0,0,0,0,2023
VEN,BL,B 07,Estrazione di minerali metalliferi                          ,0,0,0,0,0,2023
VEN,BL,B 08,Altre attività di estrazione di minerali da cave e miniere  ,0,0,0,0,0,2023
VEN,BL,B 09,Attività dei servizi di supporto all'estrazione             ,0,0,0,0,0,2023
VEN,BL,C   ,Attività manifatturiere                                     ,0,1,13,0,14,2023
VEN,BL,C 10,Industrie alimentari                                        ,0,0,2,0,2,2023
VEN,BL,C 11,Industria delle bevande                                     ,0,0,0,0,0,2023
VEN,BL,C 12,Industria del tabacco                                       ,0,0,0,0,0,2023
VEN,BL,C 13,Industrie tessili                                           ,0,0,1,0,1,2023
VEN,BL,C 14,Confezione di articoli di abbigliamento; confezione di ar...,0,0,2,0,2,2023
VEN,BL,C 15,Fabbricazione di articoli in pelle e simili                 ,0,0,0,0,0,2023
VEN,BL,C 16,Industria del legno e dei prodotti in legno e sughero (es...,0,1,0,0,1,2023
VEN,BL,C 17,Fabbricazione di carta e di prodotti di carta               ,0,0,0,0,0,2023
VEN,BL,C 18,Stampa e riproduzione di supporti registrati                ,0,0,0,0,0,2023
VEN,BL,C 19,Fabbricazione di coke e prodotti derivanti dalla raffinaz...,0,0,0,0,0,2023
VEN,BL,C 20,Fabbricazione di prodotti chimici                           ,0,0,0,0,0,2023
VEN,BL,C 21,Fabbricazione di prodotti farmaceutici di base e di prepa...,0,0,0,0,0,2023
VEN,BL,C 22,Fabbricazione di articoli in gomma e materie plastiche      ,0,0,0,0,0,2023
VEN,BL,C 23,Fabbricazione di altri prodotti della lavorazione di miner..,0,0,0,0,0,2023
VEN,BL,C 24,Metallurgia                                                 ,0,0,0,0,0,2023
VEN,BL,C 25,Fabbricazione di prodotti in metallo (esclusi macchinari ...,0,0,1,0,1,2023
VEN,BL,C 26,Fabbricazione di computer e prodotti di elettronica e ott...,0,0,2,0,2,2023
VEN,BL,C 27,Fabbricazione di apparecchiature elettriche ed apparecchi...,0,0,1,0,1,2023
VEN,BL,C 28,Fabbricazione di macchinari ed apparecchiature nca          ,0,0,0,0,0,2023
VEN,BL,C 29,"Fabbricazione di autoveicoli, rimorchi e semirimorchi       ",0,0,0,0,0,2023
VEN,BL,C 30,Fabbricazione di altri mezzi di trasporto                   ,0,0,1,0,1,2023
VEN,BL,C 31,Fabbricazione di mobili                                     ,0,0,1,0,1,2023
VEN,BL,C 32,Altre industrie manifatturiere                              ,0,0,2,0,2,2023
VEN,BL,C 33,"Riparazione, manutenzione ed installazione di macchine ed...",0,0,0,0,0,2023
VEN,BL,D   ,"Fornitura di energia elettrica, gas, vapore e aria condiz...",0,0,0,0,0,2023
VEN,BL,D 35,"Fornitura di energia elettrica, gas, vapore e aria condiz...",0,0,0,0,0,2023
VEN,BL,E   ,"Fornitura di acqua; reti fognarie, attività di gestione d...",0,0,1,0,1,2023
VEN,BL,E 36,"Raccolta, trattamento e fornitura di acqua                  ",0,0,0,0,0,2023
VEN,BL,E 37,Gestione delle reti fognarie                                ,0,0,0,0,0,2023
VEN,BL,E 38,"Attività di raccolta, trattamento e smaltimento dei rifiu...",0,0,1,0,1,2023
VEN,BL,E 39,Attività di risanamento e altri servizi di gestione dei r...,0,0,0,0,0,2023
VEN,BL,F   ,Costruzioni                                                 ,0,0,46,0,46,2023
VEN,BL,F 41,Costruzione di edifici                                      ,0,0,5,0,5,2023
VEN,BL,F 42,Ingegneria civile                                           ,0,0,0,0,0,2023
VEN,BL,F 43,Lavori di costruzione specializzati                         ,0,0,41,0,41,2023
VEN,BL,G   ,Commercio all'ingrosso e al dettaglio; riparazione di aut...,0,0,63,0,63,2023
VEN,BL,G 45,Commercio all'ingrosso e al dettaglio e riparazione di au...,0,0,2,0,2,2023
VEN,BL,G 46,Commercio all'ingrosso (escluso quello di autoveicoli e d...,0,0,17,0,17,2023
VEN,BL,G 47,Commercio al dettaglio (escluso quello di autoveicoli e d...,0,0,44,0,44,2023
VEN,BL,H   ,Trasporto e magazzinaggio                                   ,0,0,0,0,0,2023
VEN,BL,H 49,Trasporto terrestre e mediante condotte                     ,0,0,0,0,0,2023
VEN,BL,H 50,Trasporto marittimo e per vie d'acqua                       ,0,0,0,0,0,2023
VEN,BL,H 51,Trasporto aereo                                             ,0,0,0,0,0,2023
VEN,BL,H 52,Magazzinaggio e attività di supporto ai trasporti           ,0,0,0,0,0,2023
VEN,BL,H 53,Servizi postali e attività di corriere                      ,0,0,0,0,0,2023
VEN,BL,I   ,Attività dei servizi alloggio e ristorazione                ,0,1,10,0,11,2023
VEN,BL,I 55,Alloggio                                                    ,0,0,1,0,1,2023
VEN,BL,I 56,Attività dei servizi di ristorazione                        ,0,1,9,0,10,2023
VEN,BL,J   ,Servizi di informazione e comunicazione                     ,0,0,9,0,9,2023
VEN,BL,J 58,Attività editoriali                                         ,0,0,0,0,0,2023
VEN,BL,J 59,"Attività di produzione cinematografica, di video e di pro...",0,0,1,0,1,2023
VEN,BL,J 60,Attività di programmazione e trasmissione                   ,0,0,0,0,0,2023
VEN,BL,J 61,Telecomunicazioni                                           ,0,0,5,0,5,2023
VEN,BL,J 62,"Produzione di software, consulenza informatica e attività...",0,0,3,0,3,2023
VEN,BL,J 63,Attività dei servizi d'informazione e altri servizi infor...,0,0,0,0,0,2023
VEN,BL,K   ,Attività finanziarie e assicurative                         ,0,0,3,0,3,2023
VEN,BL,K 64,Attività di servizi finanziari (escluse le assicurazioni ...,0,0,0,0,0,2023
VEN,BL,K 65,"Assicurazioni, riassicurazioni e fondi pensione (escluse ...",0,0,0,0,0,2023
VEN,BL,K 66,Attività ausiliarie dei servizi finanziari e delle attivi...,0,0,3,0,3,2023
VEN,BL,L   ,Attivita' immobiliari                                       ,0,0,1,0,1,2023
VEN,BL,L 68,Attivita' immobiliari                                       ,0,0,1,0,1,2023
VEN,BL,M   ,"Attività professionali, scientifiche e tecniche             ",0,0,1,0,1,2023
VEN,BL,M 69,Attività legali e contabilità                               ,0,0,0,0,0,2023
VEN,BL,M 70,Attività di direzione aziendale e di consulenza gestional...,0,0,0,0,0,2023
VEN,BL,M 71,Attività degli studi di architettura e d'ingegneria; coll...,0,0,0,0,0,2023
VEN,BL,M 72,Ricerca scientifica e sviluppo                              ,0,0,0,0,0,2023
VEN,BL,M 73,Pubblicità e ricerche di mercato                            ,0,0,0,0,0,2023
VEN,BL,M 74,"Altre attività professionali, scientifiche e tecniche       ",0,0,1,0,1,2023
VEN,BL,M 75,Servizi veterinari                                          ,0,0,0,0,0,2023
VEN,BL,N   ,"Noleggio, agenzie di viaggio, servizi di supporto alle im...",0,0,4,1,5,2023
VEN,BL,N 77,Attività di noleggio e leasing operativo                    ,0,0,0,0,0,2023
VEN,BL,N 78,"Attività di ricerca, selezione, fornitura di personale      ",0,0,0,0,0,2023
VEN,BL,N 79,"Attività dei servizi delle agenzie di viaggio, dei tour o...",0,0,1,1,2,2023
VEN,BL,N 80,Servizi di vigilanza e investigazione                       ,0,0,0,0,0,2023
VEN,BL,N 81,Attività di servizi per edifici e paesaggio                 ,0,0,0,0,0,2023
VEN,BL,N 82,Attività di supporto per le funzioni d'ufficio e altri se...,0,0,3,0,3,2023
VEN,BL,O   ,Amministrazione pubblica e difesa; assicurazione sociale ...,0,0,0,0,0,2023
VEN,BL,O 84,Amministrazione pubblica e difesa; assicurazione sociale ...,0,0,0,0,0,2023
VEN,BL,P   ,Istruzione                                                  ,0,0,1,0,1,2023
VEN,BL,P 85,Istruzione                                                  ,0,0,1,0,1,2023
VEN,BL,Q   ,Sanita' e assistenza sociale                                ,0,0,0,0,0,2023
VEN,BL,Q 86,Assistenza sanitaria                                        ,0,0,0,0,0,2023
VEN,BL,Q 87,Servizi di assistenza sociale residenziale                  ,0,0,0,0,0,2023
VEN,BL,Q 88,Assistenza sociale non residenziale                         ,0,0,0,0,0,2023
VEN,BL,R   ,"Attività artistiche, sportive, di intrattenimento e diver...",0,0,3,0,3,2023
VEN,BL,R 90,"Attività creative, artistiche e di intrattenimento          ",0,0,2,0,2,2023
VEN,BL,R 91,"Attività di biblioteche, archivi, musei ed altre attività...",0,0,0,0,0,2023
VEN,BL,R 92,"Attività riguardanti le lotterie, le scommesse, le case d...",0,0,0,0,0,2023
VEN,BL,R 93,"Attività sportive, di intrattenimento e di divertimento     ",0,0,1,0,1,2023
VEN,BL,S   ,Altre attività di servizi                                   ,0,0,5,0,5,2023
VEN,BL,S 94,Attività di organizzazioni associative                      ,0,0,0,0,0,2023
VEN,BL,S 95,Riparazione di computer e di beni per uso personale e per...,0,0,2,0,2,2023
VEN,BL,S 96,Altre attività di servizi per la persona                    ,0,0,3,0,3,2023
VEN,BL,T   ,Attività di famiglie e convivenze come datori di lavoro p...,0,0,0,0,0,2023
VEN,BL,T 97,Attività di famiglie e convivenze come datori di lavoro p...,0,0,0,0,0,2023
VEN,BL,T 98,Produzione di beni e servizi indifferenziati per uso prop...,0,0,0,0,0,2023
VEN,BL,U   ,Organizzazioni ed organismi extraterritoriali               ,0,0,0,0,0,2023
VEN,BL,U 99,Organizzazioni ed organismi extraterritoriali               ,0,0,0,0,0,2023
VEN,BL,XX  ,Imprese non classificate                                    ,0,0,5,0,5,2023
VEN,BL,TOT ,TOTALE                                                      ,0,2,197,1,200,2023
VEN,TV,A   ,"Agricoltura, silvicoltura pesca                             ",0,3,140,0,143,2023
VEN,TV,A 01,"Coltivazioni agricole e produzione di prodotti animali, c...",0,3,139,0,142,2023
VEN,TV,A 02,Silvicoltura ed utilizzo di aree forestali                  ,0,0,1,0,1,2023
VEN,TV,A 03,Pesca e acquacoltura                                        ,0,0,0,0,0,2023
VEN,TV,B   ,Estrazione di minerali da cave e miniere                    ,0,0,0,0,0,2023
VEN,TV,B 05,Estrazione di carbone (esclusa torba)                       ,0,0,0,0,0,2023
VEN,TV,B 06,Estraz.di petrolio greggio e di gas naturale                ,0,0,0,0,0,2023
VEN,TV,B 07,Estrazione di minerali metalliferi                          ,0,0,0,0,0,2023
VEN,TV,B 08,Altre attività di estrazione di minerali da cave e miniere  ,0,0,0,0,0,2023
VEN,TV,B 09,Attività dei servizi di supporto all'estrazione             ,0,0,0,0,0,2023
VEN,TV,C   ,Attività manifatturiere                                     ,0,18,229,4,251,2023
VEN,TV,C 10,Industrie alimentari                                        ,0,0,5,1,6,2023
VEN,TV,C 11,Industria delle bevande                                     ,0,0,0,0,0,2023
VEN,TV,C 12,Industria del tabacco                                       ,0,0,0,0,0,2023
VEN,TV,C 13,Industrie tessili                                           ,0,2,6,0,8,2023
VEN,TV,C 14,Confezione di articoli di abbigliamento; confezione di ar...,0,2,87,0,89,2023
VEN,TV,C 15,Fabbricazione di articoli in pelle e simili                 ,0,1,12,0,13,2023
VEN,TV,C 16,Industria del legno e dei prodotti in legno e sughero (es...,0,2,9,0,11,2023
VEN,TV,C 17,Fabbricazione di carta e di prodotti di carta               ,0,0,1,0,1,2023
VEN,TV,C 18,Stampa e riproduzione di supporti registrati                ,0,0,4,0,4,2023
VEN,TV,C 19,Fabbricazione di coke e prodotti derivanti dalla raffinaz...,0,0,0,0,0,2023
VEN,TV,C 20,Fabbricazione di prodotti chimici                           ,0,0,2,0,2,2023
VEN,TV,C 21,Fabbricazione di prodotti farmaceutici di base e di prepa...,0,0,0,0,0,2023
VEN,TV,C 22,Fabbricazione di articoli in gomma e materie plastiche      ,0,0,2,0,2,2023
VEN,TV,C 23,Fabbricazione di altri prodotti della lavorazione di miner..,0,1,5,0,6,2023
VEN,TV,C 24,Metallurgia                                                 ,0,0,1,0,1,2023
VEN,TV,C 25,Fabbricazione di prodotti in metallo (esclusi macchinari ...,0,5,43,2,50,2023
VEN,TV,C 26,Fabbricazione di computer e prodotti di elettronica e ott...,0,0,1,0,1,2023
VEN,TV,C 27,Fabbricazione di apparecchiature elettriche ed apparecchi...,0,0,4,0,4,2023
VEN,TV,C 28,Fabbricazione di macchinari ed apparecchiature nca          ,0,1,7,0,8,2023
VEN,TV,C 29,"Fabbricazione di autoveicoli, rimorchi e semirimorchi       ",0,1,0,0,1,2023
VEN,TV,C 30,Fabbricazione di altri mezzi di trasporto                   ,0,0,5,0,5,2023
VEN,TV,C 31,Fabbricazione di mobili                                     ,0,1,18,0,19,2023
VEN,TV,C 32,Altre industrie manifatturiere                              ,0,2,7,1,10,2023
VEN,TV,C 33,"Riparazione, manutenzione ed installazione di macchine ed...",0,0,10,0,10,2023
VEN,TV,D   ,"Fornitura di energia elettrica, gas, vapore e aria condiz...",0,0,0,0,0,2023
VEN,TV,D 35,"Fornitura di energia elettrica, gas, vapore e aria condiz...",0,0,0,0,0,2023
VEN,TV,E   ,"Fornitura di acqua; reti fognarie, attività di gestione d...",0,1,3,0,4,2023
VEN,TV,E 36,"Raccolta, trattamento e fornitura di acqua                  ",0,0,0,0,0,2023
VEN,TV,E 37,Gestione delle reti fognarie                                ,0,0,0,0,0,2023
VEN,TV,E 38,"Attività di raccolta, trattamento e smaltimento dei rifiu...",0,1,3,0,4,2023
VEN,TV,E 39,Attività di risanamento e altri servizi di gestione dei r...,0,0,0,0,0,2023
VEN,TV,F   ,Costruzioni                                                 ,0,61,559,3,623,2023
VEN,TV,F 41,Costruzione di edifici                                      ,0,29,119,3,151,2023
VEN,TV,F 42,Ingegneria civile                                           ,0,0,2,0,2,2023
VEN,TV,F 43,Lavori di costruzione specializzati                         ,0,32,438,0,470,2023
VEN,TV,G   ,Commercio all'ingrosso e al dettaglio; riparazione di aut...,0,72,498,0,570,2023
VEN,TV,G 45,Commercio all'ingrosso e al dettaglio e riparazione di au...,0,5,52,0,57,2023
VEN,TV,G 46,Commercio all'ingrosso (escluso quello di autoveicoli e d...,0,9,110,0,119,2023
VEN,TV,G 47,Commercio al dettaglio (escluso quello di autoveicoli e d...,0,58,336,0,394,2023
VEN,TV,H   ,Trasporto e magazzinaggio                                   ,0,5,49,2,56,2023
VEN,TV,H 49,Trasporto terrestre e mediante condotte                     ,0,3,44,1,48,2023
VEN,TV,H 50,Trasporto marittimo e per vie d'acqua                       ,0,0,1,0,1,2023
VEN,TV,H 51,Trasporto aereo                                             ,0,0,0,0,0,2023
VEN,TV,H 52,Magazzinaggio e attività di supporto ai trasporti           ,0,2,4,1,7,2023
VEN,TV,H 53,Servizi postali e attività di corriere                      ,0,0,0,0,0,2023
VEN,TV,I   ,Attività dei servizi alloggio e ristorazione                ,0,146,74,3,223,2023
VEN,TV,I 55,Alloggio                                                    ,0,5,1,0,6,2023
VEN,TV,I 56,Attività dei servizi di ristorazione                        ,0,141,73,3,217,2023
VEN,TV,J   ,Servizi di informazione e comunicazione                     ,0,6,24,0,30,2023
VEN,TV,J 58,Attività editoriali                                         ,0,0,6,0,6,2023
VEN,TV,J 59,"Attività di produzione cinematografica, di video e di pro...",0,0,0,0,0,2023
VEN,TV,J 60,Attività di programmazione e trasmissione                   ,0,0,0,0,0,2023
VEN,TV,J 61,Telecomunicazioni                                           ,0,3,12,0,15,2023
VEN,TV,J 62,"Produzione di software, consulenza informatica e attività...",0,2,5,0,7,2023
VEN,TV,J 63,Attività dei servizi d'informazione e altri servizi infor...,0,1,1,0,2,2023
VEN,TV,K   ,Attività finanziarie e assicurative                         ,0,4,13,0,17,2023
VEN,TV,K 64,Attività di servizi finanziari (escluse le assicurazioni ...,0,0,0,0,0,2023
VEN,TV,K 65,"Assicurazioni, riassicurazioni e fondi pensione (escluse ...",0,0,0,0,0,2023
VEN,TV,K 66,Attività ausiliarie dei servizi finanziari e delle attivi...,0,4,13,0,17,2023
VEN,TV,L   ,Attivita' immobiliari                                       ,0,15,5,2,22,2023
VEN,TV,L 68,Attivita' immobiliari                                       ,0,15,5,2,22,2023
VEN,TV,M   ,"Attività professionali, scientifiche e tecniche             ",0,5,46,1,52,2023
VEN,TV,M 69,Attività legali e contabilità                               ,0,1,0,0,1,2023
VEN,TV,M 70,Attività di direzione aziendale e di consulenza gestional...,0,2,4,0,6,2023
VEN,TV,M 71,Attività degli studi di architettura e d'ingegneria; coll...,0,0,3,0,3,2023
VEN,TV,M 72,Ricerca scientifica e sviluppo                              ,0,0,0,0,0,2023
VEN,TV,M 73,Pubblicità e ricerche di mercato                            ,0,1,16,1,18,2023
VEN,TV,M 74,"Altre attività professionali, scientifiche e tecniche       ",0,1,23,0,24,2023
VEN,TV,M 75,Servizi veterinari                                          ,0,0,0,0,0,2023
VEN,TV,N   ,"Noleggio, agenzie di viaggio, servizi di supporto alle im...",0,8,62,2,72,2023
VEN,TV,N 77,Attività di noleggio e leasing operativo                    ,0,5,4,0,9,2023
VEN,TV,N 78,"Attività di ricerca, selezione, fornitura di personale      ",0,0,0,0,0,2023
VEN,TV,N 79,"Attività dei servizi delle agenzie di viaggio, dei tour o...",0,1,2,0,3,2023
VEN,TV,N 80,Servizi di vigilanza e investigazione                       ,0,0,1,0,1,2023
VEN,TV,N 81,Attività di servizi per edifici e paesaggio                 ,0,1,18,2,21,2023
VEN,TV,N 82,Attività di supporto per le funzioni d'ufficio e altri se...,0,1,37,0,38,2023
VEN,TV,O   ,Amministrazione pubblica e difesa; assicurazione sociale ...,0,0,0,0,0,2023
VEN,TV,O 84,Amministrazione pubblica e difesa; assicurazione sociale ...,0,0,0,0,0,2023
VEN,TV,P   ,Istruzione                                                  ,0,0,1,0,1,2023
VEN,TV,P 85,Istruzione                                                  ,0,0,1,0,1,2023
VEN,TV,Q   ,Sanita' e assistenza sociale                                ,0,1,1,0,2,2023
VEN,TV,Q 86,Assistenza sanitaria                                        ,0,0,1,0,1,2023
VEN,TV,Q 87,Servizi di assistenza sociale residenziale                  ,0,1,0,0,1,2023
VEN,TV,Q 88,Assistenza sociale non residenziale                         ,0,0,0,0,0,2023
VEN,TV,R   ,"Attività artistiche, sportive, di intrattenimento e diver...",0,5,28,0,33,2023
VEN,TV,R 90,"Attività creative, artistiche e di intrattenimento          ",0,1,5,0,6,2023
VEN,TV,R 91,"Attività di biblioteche, archivi, musei ed altre attività...",0,0,0,0,0,2023
VEN,TV,R 92,"Attività riguardanti le lotterie, le scommesse, le case d...",0,0,0,0,0,2023
VEN,TV,R 93,"Attività sportive, di intrattenimento e di divertimento     ",0,4,23,0,27,2023
VEN,TV,S   ,Altre attività di servizi                                   ,0,11,29,0,40,2023
VEN,TV,S 94,Attività di organizzazioni associative                      ,0,0,0,0,0,2023
VEN,TV,S 95,Riparazione di computer e di beni per uso personale e per...,0,0,14,0,14,2023
VEN,TV,S 96,Altre attività di servizi per la persona                    ,0,11,15,0,26,2023
VEN,TV,T   ,Attività di famiglie e convivenze come datori di lavoro p...,0,0,0,0,0,2023
VEN,TV,T 97,Attività di famiglie e convivenze come datori di lavoro p...,0,0,0,0,0,2023
VEN,TV,T 98,Produzione di beni e servizi indifferenziati per uso prop...,0,0,0,0,0,2023
VEN,TV,U   ,Organizzazioni ed organismi extraterritoriali               ,0,0,0,0,0,2023
VEN,TV,U 99,Organizzazioni ed organismi extraterritoriali               ,0,0,0,0,0,2023
VEN,TV,XX  ,Imprese non classificate                                    ,0,37,20,2,59,2023
VEN,TV,TOT ,TOTALE                                                      ,0,398,1781,19,2198,2023
VEN,VE,A   ,"Agricoltura, silvicoltura pesca                             ",0,10,24,3,37,2023
VEN,VE,A 01,"Coltivazioni agricole e produzione di prodotti animali, c...",0,5,21,0,26,2023
VEN,VE,A 02,Silvicoltura ed utilizzo di aree forestali                  ,0,0,0,0,0,2023
VEN,VE,A 03,Pesca e acquacoltura                                        ,0,5,3,3,11,2023
VEN,VE,B   ,Estrazione di minerali da cave e miniere                    ,0,0,0,0,0,2023
VEN,VE,B 05,Estrazione di carbone (esclusa torba)                       ,0,0,0,0,0,2023
VEN,VE,B 06,Estraz.di petrolio greggio e di gas naturale                ,0,0,0,0,0,2023
VEN,VE,B 07,Estrazione di minerali metalliferi                          ,0,0,0,0,0,2023
VEN,VE,B 08,Altre attività di estrazione di minerali da cave e miniere  ,0,0,0,0,0,2023
VEN,VE,B 09,Attività dei servizi di supporto all'estrazione             ,0,0,0,0,0,2023
VEN,VE,C   ,Attività manifatturiere                                     ,8,38,25,0,71,2023
VEN,VE,C 10,Industrie alimentari                                        ,0,3,1,0,4,2023
VEN,VE,C 11,Industria delle bevande                                     ,0,0,0,0,0,2023
VEN,VE,C 12,Industria del tabacco                                       ,0,0,0,0,0,2023
VEN,VE,C 13,Industrie tessili                                           ,0,0,3,0,3,2023
VEN,VE,C 14,Confezione di articoli di abbigliamento; confezione di ar...,1,5,8,0,14,2023
VEN,VE,C 15,Fabbricazione di articoli in pelle e simili                 ,0,0,2,0,2,2023
VEN,VE,C 16,Industria del legno e dei prodotti in legno e sughero (es...,1,0,0,0,1,2023
VEN,VE,C 17,Fabbricazione di carta e di prodotti di carta               ,0,0,0,0,0,2023
VEN,VE,C 18,Stampa e riproduzione di supporti registrati                ,2,7,0,0,9,2023
VEN,VE,C 19,Fabbricazione di coke e prodotti derivanti dalla raffinaz...,0,0,0,0,0,2023
VEN,VE,C 20,Fabbricazione di prodotti chimici                           ,0,1,0,0,1,2023
VEN,VE,C 21,Fabbricazione di prodotti farmaceutici di base e di prepa...,0,0,0,0,0,2023
VEN,VE,C 22,Fabbricazione di articoli in gomma e materie plastiche      ,1,0,0,0,1,2023
VEN,VE,C 23,Fabbricazione di altri prodotti della lavorazione di miner..,1,4,1,0,6,2023
VEN,VE,C 24,Metallurgia                                                 ,0,1,0,0,1,2023
VEN,VE,C 25,Fabbricazione di prodotti in metallo (esclusi macchinari ...,0,7,5,0,12,2023
VEN,VE,C 26,Fabbricazione di computer e prodotti di elettronica e ott...,0,1,0,0,1,2023
VEN,VE,C 27,Fabbricazione di apparecchiature elettriche ed apparecchi...,0,1,0,0,1,2023
VEN,VE,C 28,Fabbricazione di macchinari ed apparecchiature nca          ,1,0,1,0,2,2023
VEN,VE,C 29,"Fabbricazione di autoveicoli, rimorchi e semirimorchi       ",0,0,1,0,1,2023
VEN,VE,C 30,Fabbricazione di altri mezzi di trasporto                   ,0,0,0,0,0,2023
VEN,VE,C 31,Fabbricazione di mobili                                     ,1,3,1,0,5,2023
VEN,VE,C 32,Altre industrie manifatturiere                              ,0,3,0,0,3,2023
VEN,VE,C 33,"Riparazione, manutenzione ed installazione di macchine ed...",0,2,2,0,4,2023
VEN,VE,D   ,"Fornitura di energia elettrica, gas, vapore e aria condiz...",1,0,0,0,1,2023
VEN,VE,D 35,"Fornitura di energia elettrica, gas, vapore e aria condiz...",1,0,0,0,1,2023
VEN,VE,E   ,"Fornitura di acqua; reti fognarie, attività di gestione d...",0,1,0,0,1,2023
VEN,VE,E 36,"Raccolta, trattamento e fornitura di acqua                  ",0,0,0,0,0,2023
VEN,VE,E 37,Gestione delle reti fognarie                                ,0,0,0,0,0,2023
VEN,VE,E 38,"Attività di raccolta, trattamento e smaltimento dei rifiu...",0,1,0,0,1,2023
VEN,VE,E 39,Attività di risanamento e altri servizi di gestione dei r...,0,0,0,0,0,2023
VEN,VE,F   ,Costruzioni                                                 ,6,24,53,3,86,2023
VEN,VE,F 41,Costruzione di edifici                                      ,4,9,10,3,26,2023
VEN,VE,F 42,Ingegneria civile                                           ,0,0,0,0,0,2023
VEN,VE,F 43,Lavori di costruzione specializzati                         ,2,15,43,0,60,2023
VEN,VE,G   ,Commercio all'ingrosso e al dettaglio; riparazione di aut...,6,74,84,0,164,2023
VEN,VE,G 45,Commercio all'ingrosso e al dettaglio e riparazione di au...,0,2,8,0,10,2023
VEN,VE,G 46,Commercio all'ingrosso (escluso quello di autoveicoli e d...,2,16,18,0,36,2023
VEN,VE,G 47,Commercio al dettaglio (escluso quello di autoveicoli e d...,4,56,58,0,118,2023
VEN,VE,H   ,Trasporto e magazzinaggio                                   ,0,9,15,2,26,2023
VEN,VE,H 49,Trasporto terrestre e mediante condotte                     ,0,6,8,1,15,2023
VEN,VE,H 50,Trasporto marittimo e per vie d'acqua                       ,0,1,5,0,6,2023
VEN,VE,H 51,Trasporto aereo                                             ,0,0,0,0,0,2023
VEN,VE,H 52,Magazzinaggio e attività di supporto ai trasporti           ,0,2,2,1,5,2023
VEN,VE,H 53,Servizi postali e attività di corriere                      ,0,0,0,0,0,2023
VEN,VE,I   ,Attività dei servizi alloggio e ristorazione                ,6,113,28,0,147,2023
VEN,VE,I 55,Alloggio                                                    ,2,4,3,0,9,2023
VEN,VE,I 56,Attività dei servizi di ristorazione                        ,4,109,25,0,138,2023
VEN,VE,J   ,Servizi di informazione e comunicazione                     ,2,5,4,0,11,2023
VEN,VE,J 58,Attività editoriali                                         ,0,1,1,0,2,2023
VEN,VE,J 59,"Attività di produzione cinematografica, di video e di pro...",1,0,0,0,1,2023
VEN,VE,J 60,Attività di programmazione e trasmissione                   ,0,0,0,0,0,2023
VEN,VE,J 61,Telecomunicazioni                                           ,0,0,2,0,2,2023
VEN,VE,J 62,"Produzione di software, consulenza informatica e attività...",1,0,0,0,1,2023
VEN,VE,J 63,Attività dei servizi d'informazione e altri servizi infor...,0,4,1,0,5,2023
VEN,VE,K   ,Attività finanziarie e assicurative                         ,1,3,3,0,7,2023
VEN,VE,K 64,Attività di servizi finanziari (escluse le assicurazioni ...,1,0,0,0,1,2023
VEN,VE,K 65,"Assicurazioni, riassicurazioni e fondi pensione (escluse ...",0,0,0,0,0,2023
VEN,VE,K 66,Attività ausiliarie dei servizi finanziari e delle attivi...,0,3,3,0,6,2023
VEN,VE,L   ,Attivita' immobiliari                                       ,2,14,4,0,20,2023
VEN,VE,L 68,Attivita' immobiliari                                       ,2,14,4,0,20,2023
VEN,VE,M   ,"Attività professionali, scientifiche e tecniche             ",4,4,7,2,17,2023
VEN,VE,M 69,Attività legali e contabilità                               ,0,0,0,0,0,2023
VEN,VE,M 70,Attività di direzione aziendale e di consulenza gestional...,1,1,0,2,4,2023
VEN,VE,M 71,Attività degli studi di architettura e d'ingegneria; coll...,3,0,1,0,4,2023
VEN,VE,M 72,Ricerca scientifica e sviluppo                              ,0,0,0,0,0,2023
VEN,VE,M 73,Pubblicità e ricerche di mercato                            ,0,1,4,0,5,2023
VEN,VE,M 74,"Altre attività professionali, scientifiche e tecniche       ",0,2,2,0,4,2023
VEN,VE,M 75,Servizi veterinari                                          ,0,0,0,0,0,2023
VEN,VE,N   ,"Noleggio, agenzie di viaggio, servizi di supporto alle im...",1,7,9,3,20,2023
VEN,VE,N 77,Attività di noleggio e leasing operativo                    ,0,1,0,0,1,2023
VEN,VE,N 78,"Attività di ricerca, selezione, fornitura di personale      ",0,0,0,0,0,2023
VEN,VE,N 79,"Attività dei servizi delle agenzie di viaggio, dei tour o...",0,1,1,0,2,2023
VEN,VE,N 80,Servizi di vigilanza e investigazione                       ,0,1,0,0,1,2023
VEN,VE,N 81,Attività di servizi per edifici e paesaggio                 ,0,3,5,2,10,2023
VEN,VE,N 82,Attività di supporto per le funzioni d'ufficio e altri se...,1,1,3,1,6,2023
VEN,VE,O   ,Amministrazione pubblica e difesa; assicurazione sociale ...,0,0,0,0,0,2023
VEN,VE,O 84,Amministrazione pubblica e difesa; assicurazione sociale ...,0,0,0,0,0,2023
VEN,VE,P   ,Istruzione                                                  ,1,0,0,0,1,2023
VEN,VE,P 85,Istruzione                                                  ,1,0,0,0,1,2023
VEN,VE,Q   ,Sanita' e assistenza sociale                                ,0,0,1,0,1,2023
VEN,VE,Q 86,Assistenza sanitaria                                        ,0,0,0,0,0,2023
VEN,VE,Q 87,Servizi di assistenza sociale residenziale                  ,0,0,0,0,0,2023
VEN,VE,Q 88,Assistenza sociale non residenziale                         ,0,0,1,0,1,2023
VEN,VE,R   ,"Attività artistiche, sportive, di intrattenimento e diver...",3,5,0,0,8,2023
VEN,VE,R 90,"Attività creative, artistiche e di intrattenimento          ",1,0,0,0,1,2023
VEN,VE,R 91,"Attività di biblioteche, archivi, musei ed altre attività...",0,0,0,0,0,2023
VEN,VE,R 92,"Attività riguardanti le lotterie, le scommesse, le case d...",0,0,0,0,0,2023
VEN,VE,R 93,"Attività sportive, di intrattenimento e di divertimento     ",2,5,0,0,7,2023
VEN,VE,S   ,Altre attività di servizi                                   ,0,7,7,1,15,2023
VEN,VE,S 94,Attività di organizzazioni associative                      ,0,0,0,0,0,2023
VEN,VE,S 95,Riparazione di computer e di beni per uso personale e per...,0,0,2,0,2,2023
VEN,VE,S 96,Altre attività di servizi per la persona                    ,0,7,5,1,13,2023
VEN,VE,T   ,Attività di famiglie e convivenze come datori di lavoro p...,0,0,0,0,0,2023
VEN,VE,T 97,Attività di famiglie e convivenze come datori di lavoro p...,0,0,0,0,0,2023
VEN,VE,T 98,Produzione di beni e servizi indifferenziati per uso prop...,0,0,0,0,0,2023
VEN,VE,U   ,Organizzazioni ed organismi extraterritoriali               ,0,0,0,0,0,2023
VEN,VE,U 99,Organizzazioni ed organismi extraterritoriali               ,0,0,0,0,0,2023
VEN,VE,XX  ,Imprese non classificate                                    ,4,57,12,1,74,2023
VEN,VE,TOT ,TOTALE                                                      ,45,371,276,15,707,2023
VEN,PD,A   ,"Agricoltura, silvicoltura pesca                             ",0,39,187,1,227,2023
VEN,PD,A 01,"Coltivazioni agricole e produzione di prodotti animali, c...",0,39,186,1,226,2023
VEN,PD,A 02,Silvicoltura ed utilizzo di aree forestali                  ,0,0,1,0,1,2023
VEN,PD,A 03,Pesca e acquacoltura                                        ,0,0,0,0,0,2023
VEN,PD,B   ,Estrazione di minerali da cave e miniere                    ,0,0,0,0,0,2023
VEN,PD,B 05,Estrazione di carbone (esclusa torba)                       ,0,0,0,0,0,2023
VEN,PD,B 06,Estraz.di petrolio greggio e di gas naturale                ,0,0,0,0,0,2023
VEN,PD,B 07,Estrazione di minerali metalliferi                          ,0,0,0,0,0,2023
VEN,PD,B 08,Altre attività di estrazione di minerali da cave e miniere  ,0,0,0,0,0,2023
VEN,PD,B 09,Attività dei servizi di supporto all'estrazione             ,0,0,0,0,0,2023
VEN,PD,C   ,Attività manifatturiere                                     ,0,35,53,0,88,2023
VEN,PD,C 10,Industrie alimentari                                        ,0,6,0,0,6,2023
VEN,PD,C 11,Industria delle bevande                                     ,0,0,1,0,1,2023
VEN,PD,C 12,Industria del tabacco                                       ,0,0,0,0,0,2023
VEN,PD,C 13,Industrie tessili                                           ,0,1,1,0,2,2023
VEN,PD,C 14,Confezione di articoli di abbigliamento; confezione di ar...,0,5,20,0,25,2023
VEN,PD,C 15,Fabbricazione di articoli in pelle e simili                 ,0,3,4,0,7,2023
VEN,PD,C 16,Industria del legno e dei prodotti in legno e sughero (es...,0,1,1,0,2,2023
VEN,PD,C 17,Fabbricazione di carta e di prodotti di carta               ,0,0,2,0,2,2023
VEN,PD,C 18,Stampa e riproduzione di supporti registrati                ,0,2,0,0,2,2023
VEN,PD,C 19,Fabbricazione di coke e prodotti derivanti dalla raffinaz...,0,0,0,0,0,2023
VEN,PD,C 20,Fabbricazione di prodotti chimici                           ,0,1,3,0,4,2023
VEN,PD,C 21,Fabbricazione di prodotti farmaceutici di base e di prepa...,0,0,0,0,0,2023
VEN,PD,C 22,Fabbricazione di articoli in gomma e materie plastiche      ,0,2,3,0,5,2023
VEN,PD,C 23,Fabbricazione di altri prodotti della lavorazione di miner..,0,1,2,0,3,2023
VEN,PD,C 24,Metallurgia                                                 ,0,0,1,0,1,2023
VEN,PD,C 25,Fabbricazione di prodotti in metallo (esclusi macchinari ...,0,2,2,0,4,2023
VEN,PD,C 26,Fabbricazione di computer e prodotti di elettronica e ott...,0,0,1,0,1,2023
VEN,PD,C 27,Fabbricazione di apparecchiature elettriche ed apparecchi...,0,2,1,0,3,2023
VEN,PD,C 28,Fabbricazione di macchinari ed apparecchiature nca          ,0,2,3,0,5,2023
VEN,PD,C 29,"Fabbricazione di autoveicoli, rimorchi e semirimorchi       ",0,0,0,0,0,2023
VEN,PD,C 30,Fabbricazione di altri mezzi di trasporto                   ,0,0,0,0,0,2023
VEN,PD,C 31,Fabbricazione di mobili                                     ,0,1,4,0,5,2023
VEN,PD,C 32,Altre industrie manifatturiere                              ,0,5,3,0,8,2023
VEN,PD,C 33,"Riparazione, manutenzione ed installazione di macchine ed...",0,1,1,0,2,2023
VEN,PD,D   ,"Fornitura di energia elettrica, gas, vapore e aria condiz...",0,0,0,0,0,2023
VEN,PD,D 35,"Fornitura di energia elettrica, gas, vapore e aria condiz...",0,0,0,0,0,2023
VEN,PD,E   ,"Fornitura di acqua; reti fognarie, attività di gestione d...",0,0,0,0,0,2023
VEN,PD,E 36,"Raccolta, trattamento e fornitura di acqua                  ",0,0,0,0,0,2023
VEN,PD,E 37,Gestione delle reti fognarie                                ,0,0,0,0,0,2023
VEN,PD,E 38,"Attività di raccolta, trattamento e smaltimento dei rifiu...",0,0,0,0,0,2023
VEN,PD,E 39,Attività di risanamento e altri servizi di gestione dei r...,0,0,0,0,0,2023
VEN,PD,F   ,Costruzioni                                                 ,1,39,63,1,104,2023
VEN,PD,F 41,Costruzione di edifici                                      ,1,12,25,0,38,2023
VEN,PD,F 42,Ingegneria civile                                           ,0,0,2,1,3,2023
VEN,PD,F 43,Lavori di costruzione specializzati                         ,0,27,36,0,63,2023
VEN,PD,G   ,Commercio all'ingrosso e al dettaglio; riparazione di aut...,2,99,139,0,240,2023
VEN,PD,G 45,Commercio all'ingrosso e al dettaglio e riparazione di au...,0,5,14,0,19,2023
VEN,PD,G 46,Commercio all'ingrosso (escluso quello di autoveicoli e d...,1,44,68,0,113,2023
VEN,PD,G 47,Commercio al dettaglio (escluso quello di autoveicoli e d...,1,50,57,0,108,2023
VEN,PD,H   ,Trasporto e magazzinaggio                                   ,0,2,15,3,20,2023
VEN,PD,H 49,Trasporto terrestre e mediante condotte                     ,0,2,15,1,18,2023
VEN,PD,H 50,Trasporto marittimo e per vie d'acqua                       ,0,0,0,0,0,2023
VEN,PD,H 51,Trasporto aereo                                             ,0,0,0,0,0,2023
VEN,PD,H 52,Magazzinaggio e attività di supporto ai trasporti           ,0,0,0,2,2,2023
VEN,PD,H 53,Servizi postali e attività di corriere                      ,0,0,0,0,0,2023
VEN,PD,I   ,Attività dei servizi alloggio e ristorazione                ,1,59,31,0,91,2023
VEN,PD,I 55,Alloggio                                                    ,0,0,2,0,2,2023
VEN,PD,I 56,Attività dei servizi di ristorazione                        ,1,59,29,0,89,2023
VEN,PD,J   ,Servizi di informazione e comunicazione                     ,0,7,7,0,14,2023
VEN,PD,J 58,Attività editoriali                                         ,0,0,1,0,1,2023
VEN,PD,J 59,"Attività di produzione cinematografica, di video e di pro...",0,0,0,0,0,2023
VEN,PD,J 60,Attività di programmazione e trasmissione                   ,0,0,0,0,0,2023
VEN,PD,J 61,Telecomunicazioni                                           ,0,0,0,0,0,2023
VEN,PD,J 62,"Produzione di software, consulenza informatica e attività...",0,2,2,0,4,2023
VEN,PD,J 63,Attività dei servizi d'informazione e altri servizi infor...,0,5,4,0,9,2023
VEN,PD,K   ,Attività finanziarie e assicurative                         ,0,5,6,0,11,2023
VEN,PD,K 64,Attività di servizi finanziari (escluse le assicurazioni ...,0,3,0,0,3,2023
VEN,PD,K 65,"Assicurazioni, riassicurazioni e fondi pensione (escluse ...",0,0,0,0,0,2023
VEN,PD,K 66,Attività ausiliarie dei servizi finanziari e delle attivi...,0,2,6,0,8,2023
VEN,PD,L   ,Attivita' immobiliari                                       ,1,89,8,0,98,2023
VEN,PD,L 68,Attivita' immobiliari                                       ,1,89,8,0,98,2023
VEN,PD,M   ,"Attività professionali, scientifiche e tecniche             ",1,21,10,0,32,2023
VEN,PD,M 69,Attività legali e contabilità                               ,1,1,1,0,3,2023
VEN,PD,M 70,Attività di direzione aziendale e di consulenza gestional...,0,8,3,0,11,2023
VEN,PD,M 71,Attività degli studi di architettura e d'ingegneria; coll...,0,2,2,0,4,2023
VEN,PD,M 72,Ricerca scientifica e sviluppo                              ,0,0,0,0,0,2023
VEN,PD,M 73,Pubblicità e ricerche di mercato                            ,0,3,2,0,5,2023
VEN,PD,M 74,"Altre attività professionali, scientifiche e tecniche       ",0,7,2,0,9,2023
VEN,PD,M 75,Servizi veterinari                                          ,0,0,0,0,0,2023
VEN,PD,N   ,"Noleggio, agenzie di viaggio, servizi di supporto alle im...",0,11,7,1,19,2023
VEN,PD,N 77,Attività di noleggio e leasing operativo                    ,0,1,0,0,1,2023
VEN,PD,N 78,"Attività di ricerca, selezione, fornitura di personale      ",0,0,0,0,0,2023
VEN,PD,N 79,"Attività dei servizi delle agenzie di viaggio, dei tour o...",0,1,0,0,1,2023
VEN,PD,N 80,Servizi di vigilanza e investigazione                       ,0,0,0,0,0,2023
VEN,PD,N 81,Attività di servizi per edifici e paesaggio                 ,0,3,4,1,8,2023
VEN,PD,N 82,Attività di supporto per le funzioni d'ufficio e altri se...,0,6,3,0,9,2023
VEN,PD,O   ,Amministrazione pubblica e difesa; assicurazione sociale ...,0,0,0,0,0,2023
VEN,PD,O 84,Amministrazione pubblica e difesa; assicurazione sociale ...,0,0,0,0,0,2023
VEN,PD,P   ,Istruzione                                                  ,0,4,0,0,4,2023
VEN,PD,P 85,Istruzione                                                  ,0,4,0,0,4,2023
VEN,PD,Q   ,Sanita' e assistenza sociale                                ,0,2,0,2,4,2023
VEN,PD,Q 86,Assistenza sanitaria                                        ,0,1,0,0,1,2023
VEN,PD,Q 87,Servizi di assistenza sociale residenziale                  ,0,1,0,0,1,2023
VEN,PD,Q 88,Assistenza sociale non residenziale                         ,0,0,0,2,2,2023
VEN,PD,R   ,"Attività artistiche, sportive, di intrattenimento e diver...",0,2,0,0,2,2023
VEN,PD,R 90,"Attività creative, artistiche e di intrattenimento          ",0,0,0,0,0,2023
VEN,PD,R 91,"Attività di biblioteche, archivi, musei ed altre attività...",0,0,0,0,0,2023
VEN,PD,R 92,"Attività riguardanti le lotterie, le scommesse, le case d...",0,1,0,0,1,2023
VEN,PD,R 93,"Attività sportive, di intrattenimento e di divertimento     ",0,1,0,0,1,2023
VEN,PD,S   ,Altre attività di servizi                                   ,0,19,6,0,25,2023
VEN,PD,S 94,Attività di organizzazioni associative                      ,0,0,0,0,0,2023
VEN,PD,S 95,Riparazione di computer e di beni per uso personale e per...,0,2,2,0,4,2023
VEN,PD,S 96,Altre attività di servizi per la persona                    ,0,17,4,0,21,2023
VEN,PD,T   ,Attività di famiglie e convivenze come datori di lavoro p...,0,0,0,0,0,2023
VEN,PD,T 97,Attività di famiglie e convivenze come datori di lavoro p...,0,0,0,0,0,2023
VEN,PD,T 98,Produzione di beni e servizi indifferenziati per uso prop...,0,0,0,0,0,2023
VEN,PD,U   ,Organizzazioni ed organismi extraterritoriali               ,0,0,0,0,0,2023
VEN,PD,U 99,Organizzazioni ed organismi extraterritoriali               ,0,0,0,0,0,2023
VEN,PD,XX  ,Imprese non classificate                                    ,3,25,3,2,33,2023
VEN,PD,TOT ,TOTALE                                                      ,9,458,535,10,1012,2023
VEN,RO,A   ,"Agricoltura, silvicoltura pesca                             ",0,2,19,7,28,2023
VEN,RO,A 01,"Coltivazioni agricole e produzione di prodotti animali, c...",0,2,14,6,22,2023
VEN,RO,A 02,Silvicoltura ed utilizzo di aree forestali                  ,0,0,0,0,0,2023
VEN,RO,A 03,Pesca e acquacoltura                                        ,0,0,5,1,6,2023
VEN,RO,B   ,Estrazione di minerali da cave e miniere                    ,0,0,0,0,0,2023
VEN,RO,B 05,Estrazione di carbone (esclusa torba)                       ,0,0,0,0,0,2023
VEN,RO,B 06,Estraz.di petrolio greggio e di gas naturale                ,0,0,0,0,0,2023
VEN,RO,B 07,Estrazione di minerali metalliferi                          ,0,0,0,0,0,2023
VEN,RO,B 08,Altre attività di estrazione di minerali da cave e miniere  ,0,0,0,0,0,2023
VEN,RO,B 09,Attività dei servizi di supporto all'estrazione             ,0,0,0,0,0,2023
VEN,RO,C   ,Attività manifatturiere                                     ,2,8,34,4,48,2023
VEN,RO,C 10,Industrie alimentari                                        ,0,1,2,1,4,2023
VEN,RO,C 11,Industria delle bevande                                     ,0,0,0,0,0,2023
VEN,RO,C 12,Industria del tabacco                                       ,0,0,0,0,0,2023
VEN,RO,C 13,Industrie tessili                                           ,0,0,1,1,2,2023
VEN,RO,C 14,Confezione di articoli di abbigliamento; confezione di ar...,0,1,12,0,13,2023
VEN,RO,C 15,Fabbricazione di articoli in pelle e simili                 ,0,0,3,0,3,2023
VEN,RO,C 16,Industria del legno e dei prodotti in legno e sughero (es...,0,0,3,0,3,2023
VEN,RO,C 17,Fabbricazione di carta e di prodotti di carta               ,0,0,0,0,0,2023
VEN,RO,C 18,Stampa e riproduzione di supporti registrati                ,0,0,0,0,0,2023
VEN,RO,C 19,Fabbricazione di coke e prodotti derivanti dalla raffinaz...,0,0,0,0,0,2023
VEN,RO,C 20,Fabbricazione di prodotti chimici                           ,0,0,0,0,0,2023
VEN,RO,C 21,Fabbricazione di prodotti farmaceutici di base e di prepa...,0,0,0,0,0,2023
VEN,RO,C 22,Fabbricazione di articoli in gomma e materie plastiche      ,0,0,0,0,0,2023
VEN,RO,C 23,Fabbricazione di altri prodotti della lavorazione di miner..,0,1,1,0,2,2023
VEN,RO,C 24,Metallurgia                                                 ,0,0,0,0,0,2023
VEN,RO,C 25,Fabbricazione di prodotti in metallo (esclusi macchinari ...,1,2,5,1,9,2023
VEN,RO,C 26,Fabbricazione di computer e prodotti di elettronica e ott...,0,0,1,0,1,2023
VEN,RO,C 27,Fabbricazione di apparecchiature elettriche ed apparecchi...,0,0,0,0,0,2023
VEN,RO,C 28,Fabbricazione di macchinari ed apparecchiature nca          ,0,1,2,1,4,2023
VEN,RO,C 29,"Fabbricazione di autoveicoli, rimorchi e semirimorchi       ",0,0,0,0,0,2023
VEN,RO,C 30,Fabbricazione di altri mezzi di trasporto                   ,1,0,1,0,2,2023
VEN,RO,C 31,Fabbricazione di mobili                                     ,0,2,1,0,3,2023
VEN,RO,C 32,Altre industrie manifatturiere                              ,0,0,1,0,1,2023
VEN,RO,C 33,"Riparazione, manutenzione ed installazione di macchine ed...",0,0,1,0,1,2023
VEN,RO,D   ,"Fornitura di energia elettrica, gas, vapore e aria condiz...",0,0,0,0,0,2023
VEN,RO,D 35,"Fornitura di energia elettrica, gas, vapore e aria condiz...",0,0,0,0,0,2023
VEN,RO,E   ,"Fornitura di acqua; reti fognarie, attività di gestione d...",0,0,0,0,0,2023
VEN,RO,E 36,"Raccolta, trattamento e fornitura di acqua                  ",0,0,0,0,0,2023
VEN,RO,E 37,Gestione delle reti fognarie                                ,0,0,0,0,0,2023
VEN,RO,E 38,"Attività di raccolta, trattamento e smaltimento dei rifiu...",0,0,0,0,0,2023
VEN,RO,E 39,Attività di risanamento e altri servizi di gestione dei r...,0,0,0,0,0,2023
VEN,RO,F   ,Costruzioni                                                 ,1,7,46,9,63,2023
VEN,RO,F 41,Costruzione di edifici                                      ,1,2,9,7,19,2023
VEN,RO,F 42,Ingegneria civile                                           ,0,1,0,1,2,2023
VEN,RO,F 43,Lavori di costruzione specializzati                         ,0,4,37,1,42,2023
VEN,RO,G   ,Commercio all'ingrosso e al dettaglio; riparazione di aut...,4,17,50,1,72,2023
VEN,RO,G 45,Commercio all'ingrosso e al dettaglio e riparazione di au...,0,2,2,0,4,2023
VEN,RO,G 46,Commercio all'ingrosso (escluso quello di autoveicoli e d...,1,4,20,0,25,2023
VEN,RO,G 47,Commercio al dettaglio (escluso quello di autoveicoli e d...,3,11,28,1,43,2023
VEN,RO,H   ,Trasporto e magazzinaggio                                   ,0,0,4,4,8,2023
VEN,RO,H 49,Trasporto terrestre e mediante condotte                     ,0,0,4,2,6,2023
VEN,RO,H 50,Trasporto marittimo e per vie d'acqua                       ,0,0,0,0,0,2023
VEN,RO,H 51,Trasporto aereo                                             ,0,0,0,0,0,2023
VEN,RO,H 52,Magazzinaggio e attività di supporto ai trasporti           ,0,0,0,2,2,2023
VEN,RO,H 53,Servizi postali e attività di corriere                      ,0,0,0,0,0,2023
VEN,RO,I   ,Attività dei servizi alloggio e ristorazione                ,2,27,13,0,42,2023
VEN,RO,I 55,Alloggio                                                    ,0,1,0,0,1,2023
VEN,RO,I 56,Attività dei servizi di ristorazione                        ,2,26,13,0,41,2023
VEN,RO,J   ,Servizi di informazione e comunicazione                     ,0,1,1,0,2,2023
VEN,RO,J 58,Attività editoriali                                         ,0,0,0,0,0,2023
VEN,RO,J 59,"Attività di produzione cinematografica, di video e di pro...",0,0,0,0,0,2023
VEN,RO,J 60,Attività di programmazione e trasmissione                   ,0,0,0,0,0,2023
VEN,RO,J 61,Telecomunicazioni                                           ,0,1,0,0,1,2023
VEN,RO,J 62,"Produzione di software, consulenza informatica e attività...",0,0,1,0,1,2023
VEN,RO,J 63,Attività dei servizi d'informazione e altri servizi infor...,0,0,0,0,0,2023
VEN,RO,K   ,Attività finanziarie e assicurative                         ,0,0,0,0,0,2023
VEN,RO,K 64,Attività di servizi finanziari (escluse le assicurazioni ...,0,0,0,0,0,2023
VEN,RO,K 65,"Assicurazioni, riassicurazioni e fondi pensione (escluse ...",0,0,0,0,0,2023
VEN,RO,K 66,Attività ausiliarie dei servizi finanziari e delle attivi...,0,0,0,0,0,2023
VEN,RO,L   ,Attivita' immobiliari                                       ,0,3,1,1,5,2023
VEN,RO,L 68,Attivita' immobiliari                                       ,0,3,1,1,5,2023
VEN,RO,M   ,"Attività professionali, scientifiche e tecniche             ",0,2,2,1,5,2023
VEN,RO,M 69,Attività legali e contabilità                               ,0,1,0,0,1,2023
VEN,RO,M 70,Attività di direzione aziendale e di consulenza gestional...,0,0,0,1,1,2023
VEN,RO,M 71,Attività degli studi di architettura e d'ingegneria; coll...,0,0,0,0,0,2023
VEN,RO,M 72,Ricerca scientifica e sviluppo                              ,0,0,0,0,0,2023
VEN,RO,M 73,Pubblicità e ricerche di mercato                            ,0,1,2,0,3,2023
VEN,RO,M 74,"Altre attività professionali, scientifiche e tecniche       ",0,0,0,0,0,2023
VEN,RO,M 75,Servizi veterinari                                          ,0,0,0,0,0,2023
VEN,RO,N   ,"Noleggio, agenzie di viaggio, servizi di supporto alle im...",0,1,4,4,9,2023
VEN,RO,N 77,Attività di noleggio e leasing operativo                    ,0,0,0,0,0,2023
VEN,RO,N 78,"Attività di ricerca, selezione, fornitura di personale      ",0,0,0,0,0,2023
VEN,RO,N 79,"Attività dei servizi delle agenzie di viaggio, dei tour o...",0,1,0,1,2,2023
VEN,RO,N 80,Servizi di vigilanza e investigazione                       ,0,0,0,0,0,2023
VEN,RO,N 81,Attività di servizi per edifici e paesaggio                 ,0,0,1,2,3,2023
VEN,RO,N 82,Attività di supporto per le funzioni d'ufficio e altri se...,0,0,3,1,4,2023
VEN,RO,O   ,Amministrazione pubblica e difesa; assicurazione sociale ...,0,0,0,0,0,2023
VEN,RO,O 84,Amministrazione pubblica e difesa; assicurazione sociale ...,0,0,0,0,0,2023
VEN,RO,P   ,Istruzione                                                  ,0,0,1,0,1,2023
VEN,RO,P 85,Istruzione                                                  ,0,0,1,0,1,2023
VEN,RO,Q   ,Sanita' e assistenza sociale                                ,0,0,0,1,1,2023
VEN,RO,Q 86,Assistenza sanitaria                                        ,0,0,0,0,0,2023
VEN,RO,Q 87,Servizi di assistenza sociale residenziale                  ,0,0,0,0,0,2023
VEN,RO,Q 88,Assistenza sociale non residenziale                         ,0,0,0,1,1,2023
VEN,RO,R   ,"Attività artistiche, sportive, di intrattenimento e diver...",1,1,2,0,4,2023
VEN,RO,R 90,"Attività creative, artistiche e di intrattenimento          ",0,0,0,0,0,2023
VEN,RO,R 91,"Attività di biblioteche, archivi, musei ed altre attività...",0,0,0,0,0,2023
VEN,RO,R 92,"Attività riguardanti le lotterie, le scommesse, le case d...",0,0,0,0,0,2023
VEN,RO,R 93,"Attività sportive, di intrattenimento e di divertimento     ",1,1,2,0,4,2023
VEN,RO,S   ,Altre attività di servizi                                   ,0,0,3,0,3,2023
VEN,RO,S 94,Attività di organizzazioni associative                      ,0,0,0,0,0,2023
VEN,RO,S 95,Riparazione di computer e di beni per uso personale e per...,0,0,0,0,0,2023
VEN,RO,S 96,Altre attività di servizi per la persona                    ,0,0,3,0,3,2023
VEN,RO,T   ,Attività di famiglie e convivenze come datori di lavoro p...,0,0,0,0,0,2023
VEN,RO,T 97,Attività di famiglie e convivenze come datori di lavoro p...,0,0,0,0,0,2023
VEN,RO,T 98,Produzione di beni e servizi indifferenziati per uso prop...,0,0,0,0,0,2023
VEN,RO,U   ,Organizzazioni ed organismi extraterritoriali               ,0,0,0,0,0,2023
VEN,RO,U 99,Organizzazioni ed organismi extraterritoriali               ,0,0,0,0,0,2023
VEN,RO,XX  ,Imprese non classificate                                    ,5,11,5,3,24,2023
VEN,RO,TOT ,TOTALE                                                      ,15,80,185,35,315,2023
FVG,  ,A   ,"Agricoltura, silvicoltura pesca                             ",2,0,4,0,6,2023
FVG,  ,A 01,"Coltivazioni agricole e produzione di prodotti animali, c...",1,0,4,0,5,2023
FVG,  ,A 02,Silvicoltura ed utilizzo di aree forestali                  ,0,0,0,0,0,2023
FVG,  ,A 03,Pesca e acquacoltura                                        ,1,0,0,0,1,2023
FVG,  ,B   ,Estrazione di minerali da cave e miniere                    ,2,0,0,0,2,2023
FVG,  ,B 05,Estrazione di carbone (esclusa torba)                       ,0,0,0,0,0,2023
FVG,  ,B 06,Estraz.di petrolio greggio e di gas naturale                ,0,0,0,0,0,2023
FVG,  ,B 07,Estrazione di minerali metalliferi                          ,0,0,0,0,0,2023
FVG,  ,B 08,Altre attività di estrazione di minerali da cave e miniere  ,2,0,0,0,2,2023
FVG,  ,B 09,Attività dei servizi di supporto all'estrazione             ,0,0,0,0,0,2023
FVG,  ,C   ,Attività manifatturiere                                     ,52,0,2,0,54,2023
FVG,  ,C 10,Industrie alimentari                                        ,1,0,0,0,1,2023
FVG,  ,C 11,Industria delle bevande                                     ,2,0,0,0,2,2023
FVG,  ,C 12,Industria del tabacco                                       ,0,0,0,0,0,2023
FVG,  ,C 13,Industrie tessili                                           ,3,0,0,0,3,2023
FVG,  ,C 14,Confezione di articoli di abbigliamento; confezione di ar...,3,0,0,0,3,2023
FVG,  ,C 15,Fabbricazione di articoli in pelle e simili                 ,2,0,0,0,2,2023
FVG,  ,C 16,Industria del legno e dei prodotti in legno e sughero (es...,4,0,0,0,4,2023
FVG,  ,C 17,Fabbricazione di carta e di prodotti di carta               ,1,0,0,0,1,2023
FVG,  ,C 18,Stampa e riproduzione di supporti registrati                ,0,0,0,0,0,2023
FVG,  ,C 19,Fabbricazione di coke e prodotti derivanti dalla raffinaz...,0,0,0,0,0,2023
FVG,  ,C 20,Fabbricazione di prodotti chimici                           ,3,0,0,0,3,2023
FVG,  ,C 21,Fabbricazione di prodotti farmaceutici di base e di prepa...,0,0,0,0,0,2023
FVG,  ,C 22,Fabbricazione di articoli in gomma e materie plastiche      ,1,0,0,0,1,2023
FVG,  ,C 23,Fabbricazione di altri prodotti della lavorazione di miner..,6,0,0,0,6,2023
FVG,  ,C 24,Metallurgia                                                 ,0,0,0,0,0,2023
FVG,  ,C 25,Fabbricazione di prodotti in metallo (esclusi macchinari ...,11,0,2,0,13,2023
FVG,  ,C 26,Fabbricazione di computer e prodotti di elettronica e ott...,3,0,0,0,3,2023
FVG,  ,C 27,Fabbricazione di apparecchiature elettriche ed apparecchi...,1,0,0,0,1,2023
FVG,  ,C 28,Fabbricazione di macchinari ed apparecchiature nca          ,4,0,0,0,4,2023
FVG,  ,C 29,"Fabbricazione di autoveicoli, rimorchi e semirimorchi       ",0,0,0,0,0,2023
FVG,  ,C 30,Fabbricazione di altri mezzi di trasporto                   ,4,0,0,0,4,2023
FVG,  ,C 31,Fabbricazione di mobili                                     ,2,0,0,0,2,2023
FVG,  ,C 32,Altre industrie manifatturiere                              ,0,0,0,0,0,2023
FVG,  ,C 33,"Riparazione, manutenzione ed installazione di macchine ed...",1,0,0,0,1,2023
FVG,  ,D   ,"Fornitura di energia elettrica, gas, vapore e aria condiz...",0,0,0,0,0,2023
FVG,  ,D 35,"Fornitura di energia elettrica, gas, vapore e aria condiz...",0,0,0,0,0,2023
FVG,  ,E   ,"Fornitura di acqua; reti fognarie, attività di gestione d...",0,0,0,0,0,2023
FVG,  ,E 36,"Raccolta, trattamento e fornitura di acqua                  ",0,0,0,0,0,2023
FVG,  ,E 37,Gestione delle reti fognarie                                ,0,0,0,0,0,2023
FVG,  ,E 38,"Attività di raccolta, trattamento e smaltimento dei rifiu...",0,0,0,0,0,2023
FVG,  ,E 39,Attività di risanamento e altri servizi di gestione dei r...,0,0,0,0,0,2023
FVG,  ,F   ,Costruzioni                                                 ,43,0,6,0,49,2023
FVG,  ,F 41,Costruzione di edifici                                      ,27,0,2,0,29,2023
FVG,  ,F 42,Ingegneria civile                                           ,0,0,0,0,0,2023
FVG,  ,F 43,Lavori di costruzione specializzati                         ,16,0,4,0,20,2023
FVG,  ,G   ,Commercio all'ingrosso e al dettaglio; riparazione di aut...,148,0,29,1,178,2023
FVG,  ,G 45,Commercio all'ingrosso e al dettaglio e riparazione di au...,3,0,2,0,5,2023
FVG,  ,G 46,Commercio all'ingrosso (escluso quello di autoveicoli e d...,115,0,9,0,124,2023
FVG,  ,G 47,Commercio al dettaglio (escluso quello di autoveicoli e d...,30,0,18,1,49,2023
FVG,  ,H   ,Trasporto e magazzinaggio                                   ,14,0,3,0,17,2023
FVG,  ,H 49,Trasporto terrestre e mediante condotte                     ,2,0,3,0,5,2023
FVG,  ,H 50,Trasporto marittimo e per vie d'acqua                       ,2,0,0,0,2,2023
FVG,  ,H 51,Trasporto aereo                                             ,1,0,0,0,1,2023
FVG,  ,H 52,Magazzinaggio e attività di supporto ai trasporti           ,9,0,0,0,9,2023
FVG,  ,H 53,Servizi postali e attività di corriere                      ,0,0,0,0,0,2023
FVG,  ,I   ,Attività dei servizi alloggio e ristorazione                ,15,0,7,0,22,2023
FVG,  ,I 55,Alloggio                                                    ,1,0,1,0,2,2023
FVG,  ,I 56,Attività dei servizi di ristorazione                        ,14,0,6,0,20,2023
FVG,  ,J   ,Servizi di informazione e comunicazione                     ,21,0,0,0,21,2023
FVG,  ,J 58,Attività editoriali                                         ,3,0,0,0,3,2023
FVG,  ,J 59,"Attività di produzione cinematografica, di video e di pro...",1,0,0,0,1,2023
FVG,  ,J 60,Attività di programmazione e trasmissione                   ,1,0,0,0,1,2023
FVG,  ,J 61,Telecomunicazioni                                           ,1,0,0,0,1,2023
FVG,  ,J 62,"Produzione di software, consulenza informatica e attività...",9,0,0,0,9,2023
FVG,  ,J 63,Attività dei servizi d'informazione e altri servizi infor...,6,0,0,0,6,2023
FVG,  ,K   ,Attività finanziarie e assicurative                         ,5,0,2,0,7,2023
FVG,  ,K 64,Attività di servizi finanziari (escluse le assicurazioni ...,4,0,1,0,5,2023
FVG,  ,K 65,"Assicurazioni, riassicurazioni e fondi pensione (escluse ...",1,0,0,0,1,2023
FVG,  ,K 66,Attività ausiliarie dei servizi finanziari e delle attivi...,0,0,1,0,1,2023
FVG,  ,L   ,Attivita' immobiliari                                       ,20,0,2,0,22,2023
FVG,  ,L 68,Attivita' immobiliari                                       ,20,0,2,0,22,2023
FVG,  ,M   ,"Attività professionali, scientifiche e tecniche             ",25,0,2,0,27,2023
FVG,  ,M 69,Attività legali e contabilità                               ,3,0,0,0,3,2023
FVG,  ,M 70,Attività di direzione aziendale e di consulenza gestional...,10,0,1,0,11,2023
FVG,  ,M 71,Attività degli studi di architettura e d'ingegneria; coll...,3,0,0,0,3,2023
FVG,  ,M 72,Ricerca scientifica e sviluppo                              ,1,0,0,0,1,2023
FVG,  ,M 73,Pubblicità e ricerche di mercato                            ,3,0,1,0,4,2023
FVG,  ,M 74,"Altre attività professionali, scientifiche e tecniche       ",5,0,0,0,5,2023
FVG,  ,M 75,Servizi veterinari                                          ,0,0,0,0,0,2023
FVG,  ,N   ,"Noleggio, agenzie di viaggio, servizi di supporto alle im...",11,0,1,0,12,2023
FVG,  ,N 77,Attività di noleggio e leasing operativo                    ,4,0,0,0,4,2023
FVG,  ,N 78,"Attività di ricerca, selezione, fornitura di personale      ",1,0,0,0,1,2023
FVG,  ,N 79,"Attività dei servizi delle agenzie di viaggio, dei tour o...",2,0,0,0,2,2023
FVG,  ,N 80,Servizi di vigilanza e investigazione                       ,0,0,0,0,0,2023
FVG,  ,N 81,Attività di servizi per edifici e paesaggio                 ,1,0,1,0,2,2023
FVG,  ,N 82,Attività di supporto per le funzioni d'ufficio e altri se...,3,0,0,0,3,2023
FVG,  ,O   ,Amministrazione pubblica e difesa; assicurazione sociale ...,0,0,0,0,0,2023
FVG,  ,O 84,Amministrazione pubblica e difesa; assicurazione sociale ...,0,0,0,0,0,2023
FVG,  ,P   ,Istruzione                                                  ,3,0,0,0,3,2023
FVG,  ,P 85,Istruzione                                                  ,3,0,0,0,3,2023
FVG,  ,Q   ,Sanita' e assistenza sociale                                ,2,0,0,1,3,2023
FVG,  ,Q 86,Assistenza sanitaria                                        ,2,0,0,0,2,2023
FVG,  ,Q 87,Servizi di assistenza sociale residenziale                  ,0,0,0,0,0,2023
FVG,  ,Q 88,Assistenza sociale non residenziale                         ,0,0,0,1,1,2023
FVG,  ,R   ,"Attività artistiche, sportive, di intrattenimento e diver...",3,0,0,0,3,2023
FVG,  ,R 90,"Attività creative, artistiche e di intrattenimento          ",1,0,0,0,1,2023
FVG,  ,R 91,"Attività di biblioteche, archivi, musei ed altre attività...",0,0,0,0,0,2023
FVG,  ,R 92,"Attività riguardanti le lotterie, le scommesse, le case d...",0,0,0,0,0,2023
FVG,  ,R 93,"Attività sportive, di intrattenimento e di divertimento     ",2,0,0,0,2,2023
FVG,  ,S   ,Altre attività di servizi                                   ,2,0,1,0,3,2023
FVG,  ,S 94,Attività di organizzazioni associative                      ,0,0,0,0,0,2023
FVG,  ,S 95,Riparazione di computer e di beni per uso personale e per...,0,0,1,0,1,2023
FVG,  ,S 96,Altre attività di servizi per la persona                    ,2,0,0,0,2,2023
FVG,  ,T   ,Attività di famiglie e convivenze come datori di lavoro p...,0,0,0,0,0,2023
FVG,  ,T 97,Attività di famiglie e convivenze come datori di lavoro p...,0,0,0,0,0,2023
FVG,  ,T 98,Produzione di beni e servizi indifferenziati per uso prop...,0,0,0,0,0,2023
FVG,  ,U   ,Organizzazioni ed organismi extraterritoriali               ,0,0,0,0,0,2023
FVG,  ,U 99,Organizzazioni ed organismi extraterritoriali               ,0,0,0,0,0,2023
FVG,  ,XX  ,Imprese non classificate                                    ,43,0,1,0,44,2023
FVG,  ,TOT ,TOTALE                                                      ,411,0,60,2,473,2023
FVG,UD,A   ,"Agricoltura, silvicoltura pesca                             ",0,0,0,0,0,2023
FVG,UD,A 01,"Coltivazioni agricole e produzione di prodotti animali, c...",0,0,0,0,0,2023
FVG,UD,A 02,Silvicoltura ed utilizzo di aree forestali                  ,0,0,0,0,0,2023
FVG,UD,A 03,Pesca e acquacoltura                                        ,0,0,0,0,0,2023
FVG,UD,B   ,Estrazione di minerali da cave e miniere                    ,0,0,0,0,0,2023
FVG,UD,B 05,Estrazione di carbone (esclusa torba)                       ,0,0,0,0,0,2023
FVG,UD,B 06,Estraz.di petrolio greggio e di gas naturale                ,0,0,0,0,0,2023
FVG,UD,B 07,Estrazione di minerali metalliferi                          ,0,0,0,0,0,2023
FVG,UD,B 08,Altre attività di estrazione di minerali da cave e miniere  ,0,0,0,0,0,2023
FVG,UD,B 09,Attività dei servizi di supporto all'estrazione             ,0,0,0,0,0,2023
FVG,UD,C   ,Attività manifatturiere                                     ,0,0,0,0,0,2023
FVG,UD,C 10,Industrie alimentari                                        ,0,0,0,0,0,2023
FVG,UD,C 11,Industria delle bevande                                     ,0,0,0,0,0,2023
FVG,UD,C 12,Industria del tabacco                                       ,0,0,0,0,0,2023
FVG,UD,C 13,Industrie tessili                                           ,0,0,0,0,0,2023
FVG,UD,C 14,Confezione di articoli di abbigliamento; confezione di ar...,0,0,0,0,0,2023
FVG,UD,C 15,Fabbricazione di articoli in pelle e simili                 ,0,0,0,0,0,2023
FVG,UD,C 16,Industria del legno e dei prodotti in legno e sughero (es...,0,0,0,0,0,2023
FVG,UD,C 17,Fabbricazione di carta e di prodotti di carta               ,0,0,0,0,0,2023
FVG,UD,C 18,Stampa e riproduzione di supporti registrati                ,0,0,0,0,0,2023
FVG,UD,C 19,Fabbricazione di coke e prodotti derivanti dalla raffinaz...,0,0,0,0,0,2023
FVG,UD,C 20,Fabbricazione di prodotti chimici                           ,0,0,0,0,0,2023
FVG,UD,C 21,Fabbricazione di prodotti farmaceutici di base e di prepa...,0,0,0,0,0,2023
FVG,UD,C 22,Fabbricazione di articoli in gomma e materie plastiche      ,0,0,0,0,0,2023
FVG,UD,C 23,Fabbricazione di altri prodotti della lavorazione di miner..,0,0,0,0,0,2023
FVG,UD,C 24,Metallurgia                                                 ,0,0,0,0,0,2023
FVG,UD,C 25,Fabbricazione di prodotti in metallo (esclusi macchinari ...,0,0,0,0,0,2023
FVG,UD,C 26,Fabbricazione di computer e prodotti di elettronica e ott...,0,0,0,0,0,2023
FVG,UD,C 27,Fabbricazione di apparecchiature elettriche ed apparecchi...,0,0,0,0,0,2023
FVG,UD,C 28,Fabbricazione di macchinari ed apparecchiature nca          ,0,0,0,0,0,2023
FVG,UD,C 29,"Fabbricazione di autoveicoli, rimorchi e semirimorchi       ",0,0,0,0,0,2023
FVG,UD,C 30,Fabbricazione di altri mezzi di trasporto                   ,0,0,0,0,0,2023
FVG,UD,C 31,Fabbricazione di mobili                                     ,0,0,0,0,0,2023
FVG,UD,C 32,Altre industrie manifatturiere                              ,0,0,0,0,0,2023
FVG,UD,C 33,"Riparazione, manutenzione ed installazione di macchine ed...",0,0,0,0,0,2023
FVG,UD,D   ,"Fornitura di energia elettrica, gas, vapore e aria condiz...",0,0,0,0,0,2023
FVG,UD,D 35,"Fornitura di energia elettrica, gas, vapore e aria condiz...",0,0,0,0,0,2023
FVG,UD,E   ,"Fornitura di acqua; reti fognarie, attività di gestione d...",0,0,0,0,0,2023
FVG,UD,E 36,"Raccolta, trattamento e fornitura di acqua                  ",0,0,0,0,0,2023
FVG,UD,E 37,Gestione delle reti fognarie                                ,0,0,0,0,0,2023
FVG,UD,E 38,"Attività di raccolta, trattamento e smaltimento dei rifiu...",0,0,0,0,0,2023
FVG,UD,E 39,Attività di risanamento e altri servizi di gestione dei r...,0,0,0,0,0,2023
FVG,UD,F   ,Costruzioni                                                 ,0,0,0,0,0,2023
FVG,UD,F 41,Costruzione di edifici                                      ,0,0,0,0,0,2023
FVG,UD,F 42,Ingegneria civile                                           ,0,0,0,0,0,2023
FVG,UD,F 43,Lavori di costruzione specializzati                         ,0,0,0,0,0,2023
FVG,UD,G   ,Commercio all'ingrosso e al dettaglio; riparazione di aut...,0,0,0,0,0,2023
FVG,UD,G 45,Commercio all'ingrosso e al dettaglio e riparazione di au...,0,0,0,0,0,2023
FVG,UD,G 46,Commercio all'ingrosso (escluso quello di autoveicoli e d...,0,0,0,0,0,2023
FVG,UD,G 47,Commercio al dettaglio (escluso quello di autoveicoli e d...,0,0,0,0,0,2023
FVG,UD,H   ,Trasporto e magazzinaggio                                   ,0,0,0,0,0,2023
FVG,UD,H 49,Trasporto terrestre e mediante condotte                     ,0,0,0,0,0,2023
FVG,UD,H 50,Trasporto marittimo e per vie d'acqua                       ,0,0,0,0,0,2023
FVG,UD,H 51,Trasporto aereo                                             ,0,0,0,0,0,2023
FVG,UD,H 52,Magazzinaggio e attività di supporto ai trasporti           ,0,0,0,0,0,2023
FVG,UD,H 53,Servizi postali e attività di corriere                      ,0,0,0,0,0,2023
FVG,UD,I   ,Attività dei servizi alloggio e ristorazione                ,0,0,0,0,0,2023
FVG,UD,I 55,Alloggio                                                    ,0,0,0,0,0,2023
FVG,UD,I 56,Attività dei servizi di ristorazione                        ,0,0,0,0,0,2023
FVG,UD,J   ,Servizi di informazione e comunicazione                     ,0,0,0,0,0,2023
FVG,UD,J 58,Attività editoriali                                         ,0,0,0,0,0,2023
FVG,UD,J 59,"Attività di produzione cinematografica, di video e di pro...",0,0,0,0,0,2023
FVG,UD,J 60,Attività di programmazione e trasmissione                   ,0,0,0,0,0,2023
FVG,UD,J 61,Telecomunicazioni                                           ,0,0,0,0,0,2023
FVG,UD,J 62,"Produzione di software, consulenza informatica e attività...",0,0,0,0,0,2023
FVG,UD,J 63,Attività dei servizi d'informazione e altri servizi infor...,0,0,0,0,0,2023
FVG,UD,K   ,Attività finanziarie e assicurative                         ,0,0,0,0,0,2023
FVG,UD,K 64,Attività di servizi finanziari (escluse le assicurazioni ...,0,0,0,0,0,2023
FVG,UD,K 65,"Assicurazioni, riassicurazioni e fondi pensione (escluse ...",0,0,0,0,0,2023
FVG,UD,K 66,Attività ausiliarie dei servizi finanziari e delle attivi...,0,0,0,0,0,2023
FVG,UD,L   ,Attivita' immobiliari                                       ,0,0,0,0,0,2023
FVG,UD,L 68,Attivita' immobiliari                                       ,0,0,0,0,0,2023
FVG,UD,M   ,"Attività professionali, scientifiche e tecniche             ",0,0,0,0,0,2023
FVG,UD,M 69,Attività legali e contabilità                               ,0,0,0,0,0,2023
FVG,UD,M 70,Attività di direzione aziendale e di consulenza gestional...,0,0,0,0,0,2023
FVG,UD,M 71,Attività degli studi di architettura e d'ingegneria; coll...,0,0,0,0,0,2023
FVG,UD,M 72,Ricerca scientifica e sviluppo                              ,0,0,0,0,0,2023
FVG,UD,M 73,Pubblicità e ricerche di mercato                            ,0,0,0,0,0,2023
FVG,UD,M 74,"Altre attività professionali, scientifiche e tecniche       ",0,0,0,0,0,2023
FVG,UD,M 75,Servizi veterinari                                          ,0,0,0,0,0,2023
FVG,UD,N   ,"Noleggio, agenzie di viaggio, servizi di supporto alle im...",0,0,0,0,0,2023
FVG,UD,N 77,Attività di noleggio e leasing operativo                    ,0,0,0,0,0,2023
FVG,UD,N 78,"Attività di ricerca, selezione, fornitura di personale      ",0,0,0,0,0,2023
FVG,UD,N 79,"Attività dei servizi delle agenzie di viaggio, dei tour o...",0,0,0,0,0,2023
FVG,UD,N 80,Servizi di vigilanza e investigazione                       ,0,0,0,0,0,2023
FVG,UD,N 81,Attività di servizi per edifici e paesaggio                 ,0,0,0,0,0,2023
FVG,UD,N 82,Attività di supporto per le funzioni d'ufficio e altri se...,0,0,0,0,0,2023
FVG,UD,O   ,Amministrazione pubblica e difesa; assicurazione sociale ...,0,0,0,0,0,2023
FVG,UD,O 84,Amministrazione pubblica e difesa; assicurazione sociale ...,0,0,0,0,0,2023
FVG,UD,P   ,Istruzione                                                  ,0,0,0,0,0,2023
FVG,UD,P 85,Istruzione                                                  ,0,0,0,0,0,2023
FVG,UD,Q   ,Sanita' e assistenza sociale                                ,0,0,0,0,0,2023
FVG,UD,Q 86,Assistenza sanitaria                                        ,0,0,0,0,0,2023
FVG,UD,Q 87,Servizi di assistenza sociale residenziale                  ,0,0,0,0,0,2023
FVG,UD,Q 88,Assistenza sociale non residenziale                         ,0,0,0,0,0,2023
FVG,UD,R   ,"Attività artistiche, sportive, di intrattenimento e diver...",0,0,0,0,0,2023
FVG,UD,R 90,"Attività creative, artistiche e di intrattenimento          ",0,0,0,0,0,2023
FVG,UD,R 91,"Attività di biblioteche, archivi, musei ed altre attività...",0,0,0,0,0,2023
FVG,UD,R 92,"Attività riguardanti le lotterie, le scommesse, le case d...",0,0,0,0,0,2023
FVG,UD,R 93,"Attività sportive, di intrattenimento e di divertimento     ",0,0,0,0,0,2023
FVG,UD,S   ,Altre attività di servizi                                   ,0,0,0,0,0,2023
FVG,UD,S 94,Attività di organizzazioni associative                      ,0,0,0,0,0,2023
FVG,UD,S 95,Riparazione di computer e di beni per uso personale e per...,0,0,0,0,0,2023
FVG,UD,S 96,Altre attività di servizi per la persona                    ,0,0,0,0,0,2023
FVG,UD,T   ,Attività di famiglie e convivenze come datori di lavoro p...,0,0,0,0,0,2023
FVG,UD,T 97,Attività di famiglie e convivenze come datori di lavoro p...,0,0,0,0,0,2023
FVG,UD,T 98,Produzione di beni e servizi indifferenziati per uso prop...,0,0,0,0,0,2023
FVG,UD,U   ,Organizzazioni ed organismi extraterritoriali               ,0,0,0,0,0,2023
FVG,UD,U 99,Organizzazioni ed organismi extraterritoriali               ,0,0,0,0,0,2023
FVG,UD,XX  ,Imprese non classificate                                    ,0,0,0,0,0,2023
FVG,UD,TOT ,TOTALE                                                      ,0,0,0,0,0,2023
FVG,GO,A   ,"Agricoltura, silvicoltura pesca                             ",1,0,3,0,4,2023
FVG,GO,A 01,"Coltivazioni agricole e produzione di prodotti animali, c...",1,0,3,0,4,2023
FVG,GO,A 02,Silvicoltura ed utilizzo di aree forestali                  ,0,0,0,0,0,2023
FVG,GO,A 03,Pesca e acquacoltura                                        ,0,0,0,0,0,2023
FVG,GO,B   ,Estrazione di minerali da cave e miniere                    ,1,0,0,0,1,2023
FVG,GO,B 05,Estrazione di carbone (esclusa torba)                       ,0,0,0,0,0,2023
FVG,GO,B 06,Estraz.di petrolio greggio e di gas naturale                ,0,0,0,0,0,2023
FVG,GO,B 07,Estrazione di minerali metalliferi                          ,0,0,0,0,0,2023
FVG,GO,B 08,Altre attività di estrazione di minerali da cave e miniere  ,1,0,0,0,1,2023
FVG,GO,B 09,Attività dei servizi di supporto all'estrazione             ,0,0,0,0,0,2023
FVG,GO,C   ,Attività manifatturiere                                     ,37,0,1,0,38,2023
FVG,GO,C 10,Industrie alimentari                                        ,1,0,0,0,1,2023
FVG,GO,C 11,Industria delle bevande                                     ,2,0,0,0,2,2023
FVG,GO,C 12,Industria del tabacco                                       ,0,0,0,0,0,2023
FVG,GO,C 13,Industrie tessili                                           ,3,0,0,0,3,2023
FVG,GO,C 14,Confezione di articoli di abbigliamento; confezione di ar...,1,0,0,0,1,2023
FVG,GO,C 15,Fabbricazione di articoli in pelle e simili                 ,1,0,0,0,1,2023
FVG,GO,C 16,Industria del legno e dei prodotti in legno e sughero (es...,4,0,0,0,4,2023
FVG,GO,C 17,Fabbricazione di carta e di prodotti di carta               ,1,0,0,0,1,2023
FVG,GO,C 18,Stampa e riproduzione di supporti registrati                ,0,0,0,0,0,2023
FVG,GO,C 19,Fabbricazione di coke e prodotti derivanti dalla raffinaz...,0,0,0,0,0,2023
FVG,GO,C 20,Fabbricazione di prodotti chimici                           ,1,0,0,0,1,2023
FVG,GO,C 21,Fabbricazione di prodotti farmaceutici di base e di prepa...,0,0,0,0,0,2023
FVG,GO,C 22,Fabbricazione di articoli in gomma e materie plastiche      ,0,0,0,0,0,2023
FVG,GO,C 23,Fabbricazione di altri prodotti della lavorazione di miner..,6,0,0,0,6,2023
FVG,GO,C 24,Metallurgia                                                 ,0,0,0,0,0,2023
FVG,GO,C 25,Fabbricazione di prodotti in metallo (esclusi macchinari ...,6,0,1,0,7,2023
FVG,GO,C 26,Fabbricazione di computer e prodotti di elettronica e ott...,2,0,0,0,2,2023
FVG,GO,C 27,Fabbricazione di apparecchiature elettriche ed apparecchi...,0,0,0,0,0,2023
FVG,GO,C 28,Fabbricazione di macchinari ed apparecchiature nca          ,3,0,0,0,3,2023
FVG,GO,C 29,"Fabbricazione di autoveicoli, rimorchi e semirimorchi       ",0,0,0,0,0,2023
FVG,GO,C 30,Fabbricazione di altri mezzi di trasporto                   ,3,0,0,0,3,2023
FVG,GO,C 31,Fabbricazione di mobili                                     ,2,0,0,0,2,2023
FVG,GO,C 32,Altre industrie manifatturiere                              ,0,0,0,0,0,2023
FVG,GO,C 33,"Riparazione, manutenzione ed installazione di macchine ed...",1,0,0,0,1,2023
FVG,GO,D   ,"Fornitura di energia elettrica, gas, vapore e aria condiz...",0,0,0,0,0,2023
FVG,GO,D 35,"Fornitura di energia elettrica, gas, vapore e aria condiz...",0,0,0,0,0,2023
FVG,GO,E   ,"Fornitura di acqua; reti fognarie, attività di gestione d...",0,0,0,0,0,2023
FVG,GO,E 36,"Raccolta, trattamento e fornitura di acqua                  ",0,0,0,0,0,2023
FVG,GO,E 37,Gestione delle reti fognarie                                ,0,0,0,0,0,2023
FVG,GO,E 38,"Attività di raccolta, trattamento e smaltimento dei rifiu...",0,0,0,0,0,2023
FVG,GO,E 39,Attività di risanamento e altri servizi di gestione dei r...,0,0,0,0,0,2023
FVG,GO,F   ,Costruzioni                                                 ,19,0,3,0,22,2023
FVG,GO,F 41,Costruzione di edifici                                      ,13,0,0,0,13,2023
FVG,GO,F 42,Ingegneria civile                                           ,0,0,0,0,0,2023
FVG,GO,F 43,Lavori di costruzione specializzati                         ,6,0,3,0,9,2023
FVG,GO,G   ,Commercio all'ingrosso e al dettaglio; riparazione di aut...,67,0,6,0,73,2023
FVG,GO,G 45,Commercio all'ingrosso e al dettaglio e riparazione di au...,3,0,0,0,3,2023
FVG,GO,G 46,Commercio all'ingrosso (escluso quello di autoveicoli e d...,54,0,1,0,55,2023
FVG,GO,G 47,Commercio al dettaglio (escluso quello di autoveicoli e d...,10,0,5,0,15,2023
FVG,GO,H   ,Trasporto e magazzinaggio                                   ,5,0,0,0,5,2023
FVG,GO,H 49,Trasporto terrestre e mediante condotte                     ,1,0,0,0,1,2023
FVG,GO,H 50,Trasporto marittimo e per vie d'acqua                       ,1,0,0,0,1,2023
FVG,GO,H 51,Trasporto aereo                                             ,0,0,0,0,0,2023
FVG,GO,H 52,Magazzinaggio e attività di supporto ai trasporti           ,3,0,0,0,3,2023
FVG,GO,H 53,Servizi postali e attività di corriere                      ,0,0,0,0,0,2023
FVG,GO,I   ,Attività dei servizi alloggio e ristorazione                ,5,0,0,0,5,2023
FVG,GO,I 55,Alloggio                                                    ,0,0,0,0,0,2023
FVG,GO,I 56,Attività dei servizi di ristorazione                        ,5,0,0,0,5,2023
FVG,GO,J   ,Servizi di informazione e comunicazione                     ,9,0,0,0,9,2023
FVG,GO,J 58,Attività editoriali                                         ,2,0,0,0,2,2023
FVG,GO,J 59,"Attività di produzione cinematografica, di video e di pro...",0,0,0,0,0,2023
FVG,GO,J 60,Attività di programmazione e trasmissione                   ,0,0,0,0,0,2023
FVG,GO,J 61,Telecomunicazioni                                           ,0,0,0,0,0,2023
FVG,GO,J 62,"Produzione di software, consulenza informatica e attività...",5,0,0,0,5,2023
FVG,GO,J 63,Attività dei servizi d'informazione e altri servizi infor...,2,0,0,0,2,2023
FVG,GO,K   ,Attività finanziarie e assicurative                         ,2,0,0,0,2,2023
FVG,GO,K 64,Attività di servizi finanziari (escluse le assicurazioni ...,1,0,0,0,1,2023
FVG,GO,K 65,"Assicurazioni, riassicurazioni e fondi pensione (escluse ...",1,0,0,0,1,2023
FVG,GO,K 66,Attività ausiliarie dei servizi finanziari e delle attivi...,0,0,0,0,0,2023
FVG,GO,L   ,Attivita' immobiliari                                       ,8,0,0,0,8,2023
FVG,GO,L 68,Attivita' immobiliari                                       ,8,0,0,0,8,2023
FVG,GO,M   ,"Attività professionali, scientifiche e tecniche             ",2,0,1,0,3,2023
FVG,GO,M 69,Attività legali e contabilità                               ,0,0,0,0,0,2023
FVG,GO,M 70,Attività di direzione aziendale e di consulenza gestional...,0,0,1,0,1,2023
FVG,GO,M 71,Attività degli studi di architettura e d'ingegneria; coll...,2,0,0,0,2,2023
FVG,GO,M 72,Ricerca scientifica e sviluppo                              ,0,0,0,0,0,2023
FVG,GO,M 73,Pubblicità e ricerche di mercato                            ,0,0,0,0,0,2023
FVG,GO,M 74,"Altre attività professionali, scientifiche e tecniche       ",0,0,0,0,0,2023
FVG,GO,M 75,Servizi veterinari                                          ,0,0,0,0,0,2023
FVG,GO,N   ,"Noleggio, agenzie di viaggio, servizi di supporto alle im...",3,0,0,0,3,2023
FVG,GO,N 77,Attività di noleggio e leasing operativo                    ,2,0,0,0,2,2023
FVG,GO,N 78,"Attività di ricerca, selezione, fornitura di personale      ",1,0,0,0,1,2023
FVG,GO,N 79,"Attività dei servizi delle agenzie di viaggio, dei tour o...",0,0,0,0,0,2023
FVG,GO,N 80,Servizi di vigilanza e investigazione                       ,0,0,0,0,0,2023
FVG,GO,N 81,Attività di servizi per edifici e paesaggio                 ,0,0,0,0,0,2023
FVG,GO,N 82,Attività di supporto per le funzioni d'ufficio e altri se...,0,0,0,0,0,2023
FVG,GO,O   ,Amministrazione pubblica e difesa; assicurazione sociale ...,0,0,0,0,0,2023
FVG,GO,O 84,Amministrazione pubblica e difesa; assicurazione sociale ...,0,0,0,0,0,2023
FVG,GO,P   ,Istruzione                                                  ,1,0,0,0,1,2023
FVG,GO,P 85,Istruzione                                                  ,1,0,0,0,1,2023
FVG,GO,Q   ,Sanita' e assistenza sociale                                ,2,0,0,0,2,2023
FVG,GO,Q 86,Assistenza sanitaria                                        ,2,0,0,0,2,2023
FVG,GO,Q 87,Servizi di assistenza sociale residenziale                  ,0,0,0,0,0,2023
FVG,GO,Q 88,Assistenza sociale non residenziale                         ,0,0,0,0,0,2023
FVG,GO,R   ,"Attività artistiche, sportive, di intrattenimento e diver...",0,0,0,0,0,2023
FVG,GO,R 90,"Attività creative, artistiche e di intrattenimento          ",0,0,0,0,0,2023
FVG,GO,R 91,"Attività di biblioteche, archivi, musei ed altre attività...",0,0,0,0,0,2023
FVG,GO,R 92,"Attività riguardanti le lotterie, le scommesse, le case d...",0,0,0,0,0,2023
FVG,GO,R 93,"Attività sportive, di intrattenimento e di divertimento     ",0,0,0,0,0,2023
FVG,GO,S   ,Altre attività di servizi                                   ,1,0,1,0,2,2023
FVG,GO,S 94,Attività di organizzazioni associative                      ,0,0,0,0,0,2023
FVG,GO,S 95,Riparazione di computer e di beni per uso personale e per...,0,0,1,0,1,2023
FVG,GO,S 96,Altre attività di servizi per la persona                    ,1,0,0,0,1,2023
FVG,GO,T   ,Attività di famiglie e convivenze come datori di lavoro p...,0,0,0,0,0,2023
FVG,GO,T 97,Attività di famiglie e convivenze come datori di lavoro p...,0,0,0,0,0,2023
FVG,GO,T 98,Produzione di beni e servizi indifferenziati per uso prop...,0,0,0,0,0,2023
FVG,GO,U   ,Organizzazioni ed organismi extraterritoriali               ,0,0,0,0,0,2023
FVG,GO,U 99,Organizzazioni ed organismi extraterritoriali               ,0,0,0,0,0,2023
FVG,GO,XX  ,Imprese non classificate                                    ,26,0,0,0,26,2023
FVG,GO,TOT ,TOTALE                                                      ,189,0,15,0,204,2023
FVG,TS,A   ,"Agricoltura, silvicoltura pesca                             ",1,0,1,0,2,2023
FVG,TS,A 01,"Coltivazioni agricole e produzione di prodotti animali, c...",0,0,1,0,1,2023
FVG,TS,A 02,Silvicoltura ed utilizzo di aree forestali                  ,0,0,0,0,0,2023
FVG,TS,A 03,Pesca e acquacoltura                                        ,1,0,0,0,1,2023
FVG,TS,B   ,Estrazione di minerali da cave e miniere                    ,1,0,0,0,1,2023
FVG,TS,B 05,Estrazione di carbone (esclusa torba)                       ,0,0,0,0,0,2023
FVG,TS,B 06,Estraz.di petrolio greggio e di gas naturale                ,0,0,0,0,0,2023
FVG,TS,B 07,Estrazione di minerali metalliferi                          ,0,0,0,0,0,2023
FVG,TS,B 08,Altre attività di estrazione di minerali da cave e miniere  ,1,0,0,0,1,2023
FVG,TS,B 09,Attività dei servizi di supporto all'estrazione             ,0,0,0,0,0,2023
FVG,TS,C   ,Attività manifatturiere                                     ,15,0,1,0,16,2023
FVG,TS,C 10,Industrie alimentari                                        ,0,0,0,0,0,2023
FVG,TS,C 11,Industria delle bevande                                     ,0,0,0,0,0,2023
FVG,TS,C 12,Industria del tabacco                                       ,0,0,0,0,0,2023
FVG,TS,C 13,Industrie tessili                                           ,0,0,0,0,0,2023
FVG,TS,C 14,Confezione di articoli di abbigliamento; confezione di ar...,2,0,0,0,2,2023
FVG,TS,C 15,Fabbricazione di articoli in pelle e simili                 ,1,0,0,0,1,2023
FVG,TS,C 16,Industria del legno e dei prodotti in legno e sughero (es...,0,0,0,0,0,2023
FVG,TS,C 17,Fabbricazione di carta e di prodotti di carta               ,0,0,0,0,0,2023
FVG,TS,C 18,Stampa e riproduzione di supporti registrati                ,0,0,0,0,0,2023
FVG,TS,C 19,Fabbricazione di coke e prodotti derivanti dalla raffinaz...,0,0,0,0,0,2023
FVG,TS,C 20,Fabbricazione di prodotti chimici                           ,2,0,0,0,2,2023
FVG,TS,C 21,Fabbricazione di prodotti farmaceutici di base e di prepa...,0,0,0,0,0,2023
FVG,TS,C 22,Fabbricazione di articoli in gomma e materie plastiche      ,1,0,0,0,1,2023
FVG,TS,C 23,Fabbricazione di altri prodotti della lavorazione di miner..,0,0,0,0,0,2023
FVG,TS,C 24,Metallurgia                                                 ,0,0,0,0,0,2023
FVG,TS,C 25,Fabbricazione di prodotti in metallo (esclusi macchinari ...,5,0,1,0,6,2023
FVG,TS,C 26,Fabbricazione di computer e prodotti di elettronica e ott...,1,0,0,0,1,2023
FVG,TS,C 27,Fabbricazione di apparecchiature elettriche ed apparecchi...,1,0,0,0,1,2023
FVG,TS,C 28,Fabbricazione di macchinari ed apparecchiature nca          ,1,0,0,0,1,2023
FVG,TS,C 29,"Fabbricazione di autoveicoli, rimorchi e semirimorchi       ",0,0,0,0,0,2023
FVG,TS,C 30,Fabbricazione di altri mezzi di trasporto                   ,1,0,0,0,1,2023
FVG,TS,C 31,Fabbricazione di mobili                                     ,0,0,0,0,0,2023
FVG,TS,C 32,Altre industrie manifatturiere                              ,0,0,0,0,0,2023
FVG,TS,C 33,"Riparazione, manutenzione ed installazione di macchine ed...",0,0,0,0,0,2023
FVG,TS,D   ,"Fornitura di energia elettrica, gas, vapore e aria condiz...",0,0,0,0,0,2023
FVG,TS,D 35,"Fornitura di energia elettrica, gas, vapore e aria condiz...",0,0,0,0,0,2023
FVG,TS,E   ,"Fornitura di acqua; reti fognarie, attività di gestione d...",0,0,0,0,0,2023
FVG,TS,E 36,"Raccolta, trattamento e fornitura di acqua                  ",0,0,0,0,0,2023
FVG,TS,E 37,Gestione delle reti fognarie                                ,0,0,0,0,0,2023
FVG,TS,E 38,"Attività di raccolta, trattamento e smaltimento dei rifiu...",0,0,0,0,0,2023
FVG,TS,E 39,Attività di risanamento e altri servizi di gestione dei r...,0,0,0,0,0,2023
FVG,TS,F   ,Costruzioni                                                 ,23,0,3,0,26,2023
FVG,TS,F 41,Costruzione di edifici                                      ,14,0,2,0,16,2023
FVG,TS,F 42,Ingegneria civile                                           ,0,0,0,0,0,2023
FVG,TS,F 43,Lavori di costruzione specializzati                         ,9,0,1,0,10,2023
FVG,TS,G   ,Commercio all'ingrosso e al dettaglio; riparazione di aut...,81,0,23,1,105,2023
FVG,TS,G 45,Commercio all'ingrosso e al dettaglio e riparazione di au...,0,0,2,0,2,2023
FVG,TS,G 46,Commercio all'ingrosso (escluso quello di autoveicoli e d...,61,0,8,0,69,2023
FVG,TS,G 47,Commercio al dettaglio (escluso quello di autoveicoli e d...,20,0,13,1,34,2023
FVG,TS,H   ,Trasporto e magazzinaggio                                   ,9,0,3,0,12,2023
FVG,TS,H 49,Trasporto terrestre e mediante condotte                     ,1,0,3,0,4,2023
FVG,TS,H 50,Trasporto marittimo e per vie d'acqua                       ,1,0,0,0,1,2023
FVG,TS,H 51,Trasporto aereo                                             ,1,0,0,0,1,2023
FVG,TS,H 52,Magazzinaggio e attività di supporto ai trasporti           ,6,0,0,0,6,2023
FVG,TS,H 53,Servizi postali e attività di corriere                      ,0,0,0,0,0,2023
FVG,TS,I   ,Attività dei servizi alloggio e ristorazione                ,10,0,7,0,17,2023
FVG,TS,I 55,Alloggio                                                    ,1,0,1,0,2,2023
FVG,TS,I 56,Attività dei servizi di ristorazione                        ,9,0,6,0,15,2023
FVG,TS,J   ,Servizi di informazione e comunicazione                     ,12,0,0,0,12,2023
FVG,TS,J 58,Attività editoriali                                         ,1,0,0,0,1,2023
FVG,TS,J 59,"Attività di produzione cinematografica, di video e di pro...",1,0,0,0,1,2023
FVG,TS,J 60,Attività di programmazione e trasmissione                   ,1,0,0,0,1,2023
FVG,TS,J 61,Telecomunicazioni                                           ,1,0,0,0,1,2023
FVG,TS,J 62,"Produzione di software, consulenza informatica e attività...",4,0,0,0,4,2023
FVG,TS,J 63,Attività dei servizi d'informazione e altri servizi infor...,4,0,0,0,4,2023
FVG,TS,K   ,Attività finanziarie e assicurative                         ,3,0,2,0,5,2023
FVG,TS,K 64,Attività di servizi finanziari (escluse le assicurazioni ...,3,0,1,0,4,2023
FVG,TS,K 65,"Assicurazioni, riassicurazioni e fondi pensione (escluse ...",0,0,0,0,0,2023
FVG,TS,K 66,Attività ausiliarie dei servizi finanziari e delle attivi...,0,0,1,0,1,2023
FVG,TS,L   ,Attivita' immobiliari                                       ,11,0,2,0,13,2023
FVG,TS,L 68,Attivita' immobiliari                                       ,11,0,2,0,13,2023
FVG,TS,M   ,"Attività professionali, scientifiche e tecniche             ",23,0,1,0,24,2023
FVG,TS,M 69,Attività legali e contabilità                               ,3,0,0,0,3,2023
FVG,TS,M 70,Attività di direzione aziendale e di consulenza gestional...,10,0,0,0,10,2023
FVG,TS,M 71,Attività degli studi di architettura e d'ingegneria; coll...,1,0,0,0,1,2023
FVG,TS,M 72,Ricerca scientifica e sviluppo                              ,1,0,0,0,1,2023
FVG,TS,M 73,Pubblicità e ricerche di mercato                            ,3,0,1,0,4,2023
FVG,TS,M 74,"Altre attività professionali, scientifiche e tecniche       ",5,0,0,0,5,2023
FVG,TS,M 75,Servizi veterinari                                          ,0,0,0,0,0,2023
FVG,TS,N   ,"Noleggio, agenzie di viaggio, servizi di supporto alle im...",8,0,1,0,9,2023
FVG,TS,N 77,Attività di noleggio e leasing operativo                    ,2,0,0,0,2,2023
FVG,TS,N 78,"Attività di ricerca, selezione, fornitura di personale      ",0,0,0,0,0,2023
FVG,TS,N 79,"Attività dei servizi delle agenzie di viaggio, dei tour o...",2,0,0,0,2,2023
FVG,TS,N 80,Servizi di vigilanza e investigazione                       ,0,0,0,0,0,2023
FVG,TS,N 81,Attività di servizi per edifici e paesaggio                 ,1,0,1,0,2,2023
FVG,TS,N 82,Attività di supporto per le funzioni d'ufficio e altri se...,3,0,0,0,3,2023
FVG,TS,O   ,Amministrazione pubblica e difesa; assicurazione sociale ...,0,0,0,0,0,2023
FVG,TS,O 84,Amministrazione pubblica e difesa; assicurazione sociale ...,0,0,0,0,0,2023
FVG,TS,P   ,Istruzione                                                  ,2,0,0,0,2,2023
FVG,TS,P 85,Istruzione                                                  ,2,0,0,0,2,2023
FVG,TS,Q   ,Sanita' e assistenza sociale                                ,0,0,0,0,0,2023
FVG,TS,Q 86,Assistenza sanitaria                                        ,0,0,0,0,0,2023
FVG,TS,Q 87,Servizi di assistenza sociale residenziale                  ,0,0,0,0,0,2023
FVG,TS,Q 88,Assistenza sociale non residenziale                         ,0,0,0,0,0,2023
FVG,TS,R   ,"Attività artistiche, sportive, di intrattenimento e diver...",3,0,0,0,3,2023
FVG,TS,R 90,"Attività creative, artistiche e di intrattenimento          ",1,0,0,0,1,2023
FVG,TS,R 91,"Attività di biblioteche, archivi, musei ed altre attività...",0,0,0,0,0,2023
FVG,TS,R 92,"Attività riguardanti le lotterie, le scommesse, le case d...",0,0,0,0,0,2023
FVG,TS,R 93,"Attività sportive, di intrattenimento e di divertimento     ",2,0,0,0,2,2023
FVG,TS,S   ,Altre attività di servizi                                   ,1,0,0,0,1,2023
FVG,TS,S 94,Attività di organizzazioni associative                      ,0,0,0,0,0,2023
FVG,TS,S 95,Riparazione di computer e di beni per uso personale e per...,0,0,0,0,0,2023
FVG,TS,S 96,Altre attività di servizi per la persona                    ,1,0,0,0,1,2023
FVG,TS,T   ,Attività di famiglie e convivenze come datori di lavoro p...,0,0,0,0,0,2023
FVG,TS,T 97,Attività di famiglie e convivenze come datori di lavoro p...,0,0,0,0,0,2023
FVG,TS,T 98,Produzione di beni e servizi indifferenziati per uso prop...,0,0,0,0,0,2023
FVG,TS,U   ,Organizzazioni ed organismi extraterritoriali               ,0,0,0,0,0,2023
FVG,TS,U 99,Organizzazioni ed organismi extraterritoriali               ,0,0,0,0,0,2023
FVG,TS,XX  ,Imprese non classificate                                    ,17,0,1,0,18,2023
FVG,TS,TOT ,TOTALE                                                      ,220,0,45,1,266,2023
FVG,PN,A   ,"Agricoltura, silvicoltura pesca                             ",0,0,0,0,0,2023
FVG,PN,A 01,"Coltivazioni agricole e produzione di prodotti animali, c...",0,0,0,0,0,2023
FVG,PN,A 02,Silvicoltura ed utilizzo di aree forestali                  ,0,0,0,0,0,2023
FVG,PN,A 03,Pesca e acquacoltura                                        ,0,0,0,0,0,2023
FVG,PN,B   ,Estrazione di minerali da cave e miniere                    ,0,0,0,0,0,2023
FVG,PN,B 05,Estrazione di carbone (esclusa torba)                       ,0,0,0,0,0,2023
FVG,PN,B 06,Estraz.di petrolio greggio e di gas naturale                ,0,0,0,0,0,2023
FVG,PN,B 07,Estrazione di minerali metalliferi                          ,0,0,0,0,0,2023
FVG,PN,B 08,Altre attività di estrazione di minerali da cave e miniere  ,0,0,0,0,0,2023
FVG,PN,B 09,Attività dei servizi di supporto all'estrazione             ,0,0,0,0,0,2023
FVG,PN,C   ,Attività manifatturiere                                     ,0,0,0,0,0,2023
FVG,PN,C 10,Industrie alimentari                                        ,0,0,0,0,0,2023
FVG,PN,C 11,Industria delle bevande                                     ,0,0,0,0,0,2023
FVG,PN,C 12,Industria del tabacco                                       ,0,0,0,0,0,2023
FVG,PN,C 13,Industrie tessili                                           ,0,0,0,0,0,2023
FVG,PN,C 14,Confezione di articoli di abbigliamento; confezione di ar...,0,0,0,0,0,2023
FVG,PN,C 15,Fabbricazione di articoli in pelle e simili                 ,0,0,0,0,0,2023
FVG,PN,C 16,Industria del legno e dei prodotti in legno e sughero (es...,0,0,0,0,0,2023
FVG,PN,C 17,Fabbricazione di carta e di prodotti di carta               ,0,0,0,0,0,2023
FVG,PN,C 18,Stampa e riproduzione di supporti registrati                ,0,0,0,0,0,2023
FVG,PN,C 19,Fabbricazione di coke e prodotti derivanti dalla raffinaz...,0,0,0,0,0,2023
FVG,PN,C 20,Fabbricazione di prodotti chimici                           ,0,0,0,0,0,2023
FVG,PN,C 21,Fabbricazione di prodotti farmaceutici di base e di prepa...,0,0,0,0,0,2023
FVG,PN,C 22,Fabbricazione di articoli in gomma e materie plastiche      ,0,0,0,0,0,2023
FVG,PN,C 23,Fabbricazione di altri prodotti della lavorazione di miner..,0,0,0,0,0,2023
FVG,PN,C 24,Metallurgia                                                 ,0,0,0,0,0,2023
FVG,PN,C 25,Fabbricazione di prodotti in metallo (esclusi macchinari ...,0,0,0,0,0,2023
FVG,PN,C 26,Fabbricazione di computer e prodotti di elettronica e ott...,0,0,0,0,0,2023
FVG,PN,C 27,Fabbricazione di apparecchiature elettriche ed apparecchi...,0,0,0,0,0,2023
FVG,PN,C 28,Fabbricazione di macchinari ed apparecchiature nca          ,0,0,0,0,0,2023
FVG,PN,C 29,"Fabbricazione di autoveicoli, rimorchi e semirimorchi       ",0,0,0,0,0,2023
FVG,PN,C 30,Fabbricazione di altri mezzi di trasporto                   ,0,0,0,0,0,2023
FVG,PN,C 31,Fabbricazione di mobili                                     ,0,0,0,0,0,2023
FVG,PN,C 32,Altre industrie manifatturiere                              ,0,0,0,0,0,2023
FVG,PN,C 33,"Riparazione, manutenzione ed installazione di macchine ed...",0,0,0,0,0,2023
FVG,PN,D   ,"Fornitura di energia elettrica, gas, vapore e aria condiz...",0,0,0,0,0,2023
FVG,PN,D 35,"Fornitura di energia elettrica, gas, vapore e aria condiz...",0,0,0,0,0,2023
FVG,PN,E   ,"Fornitura di acqua; reti fognarie, attività di gestione d...",0,0,0,0,0,2023
FVG,PN,E 36,"Raccolta, trattamento e fornitura di acqua                  ",0,0,0,0,0,2023
FVG,PN,E 37,Gestione delle reti fognarie                                ,0,0,0,0,0,2023
FVG,PN,E 38,"Attività di raccolta, trattamento e smaltimento dei rifiu...",0,0,0,0,0,2023
FVG,PN,E 39,Attività di risanamento e altri servizi di gestione dei r...,0,0,0,0,0,2023
FVG,PN,F   ,Costruzioni                                                 ,1,0,0,0,1,2023
FVG,PN,F 41,Costruzione di edifici                                      ,0,0,0,0,0,2023
FVG,PN,F 42,Ingegneria civile                                           ,0,0,0,0,0,2023
FVG,PN,F 43,Lavori di costruzione specializzati                         ,1,0,0,0,1,2023
FVG,PN,G   ,Commercio all'ingrosso e al dettaglio; riparazione di aut...,0,0,0,0,0,2023
FVG,PN,G 45,Commercio all'ingrosso e al dettaglio e riparazione di au...,0,0,0,0,0,2023
FVG,PN,G 46,Commercio all'ingrosso (escluso quello di autoveicoli e d...,0,0,0,0,0,2023
FVG,PN,G 47,Commercio al dettaglio (escluso quello di autoveicoli e d...,0,0,0,0,0,2023
FVG,PN,H   ,Trasporto e magazzinaggio                                   ,0,0,0,0,0,2023
FVG,PN,H 49,Trasporto terrestre e mediante condotte                     ,0,0,0,0,0,2023
FVG,PN,H 50,Trasporto marittimo e per vie d'acqua                       ,0,0,0,0,0,2023
FVG,PN,H 51,Trasporto aereo                                             ,0,0,0,0,0,2023
FVG,PN,H 52,Magazzinaggio e attività di supporto ai trasporti           ,0,0,0,0,0,2023
FVG,PN,H 53,Servizi postali e attività di corriere                      ,0,0,0,0,0,2023
FVG,PN,I   ,Attività dei servizi alloggio e ristorazione                ,0,0,0,0,0,2023
FVG,PN,I 55,Alloggio                                                    ,0,0,0,0,0,2023
FVG,PN,I 56,Attività dei servizi di ristorazione                        ,0,0,0,0,0,2023
FVG,PN,J   ,Servizi di informazione e comunicazione                     ,0,0,0,0,0,2023
FVG,PN,J 58,Attività editoriali                                         ,0,0,0,0,0,2023
FVG,PN,J 59,"Attività di produzione cinematografica, di video e di pro...",0,0,0,0,0,2023
FVG,PN,J 60,Attività di programmazione e trasmissione                   ,0,0,0,0,0,2023
FVG,PN,J 61,Telecomunicazioni                                           ,0,0,0,0,0,2023
FVG,PN,J 62,"Produzione di software, consulenza informatica e attività...",0,0,0,0,0,2023
FVG,PN,J 63,Attività dei servizi d'informazione e altri servizi infor...,0,0,0,0,0,2023
FVG,PN,K   ,Attività finanziarie e assicurative                         ,0,0,0,0,0,2023
FVG,PN,K 64,Attività di servizi finanziari (escluse le assicurazioni ...,0,0,0,0,0,2023
FVG,PN,K 65,"Assicurazioni, riassicurazioni e fondi pensione (escluse ...",0,0,0,0,0,2023
FVG,PN,K 66,Attività ausiliarie dei servizi finanziari e delle attivi...,0,0,0,0,0,2023
FVG,PN,L   ,Attivita' immobiliari                                       ,1,0,0,0,1,2023
FVG,PN,L 68,Attivita' immobiliari                                       ,1,0,0,0,1,2023
FVG,PN,M   ,"Attività professionali, scientifiche e tecniche             ",0,0,0,0,0,2023
FVG,PN,M 69,Attività legali e contabilità                               ,0,0,0,0,0,2023
FVG,PN,M 70,Attività di direzione aziendale e di consulenza gestional...,0,0,0,0,0,2023
FVG,PN,M 71,Attività degli studi di architettura e d'ingegneria; coll...,0,0,0,0,0,2023
FVG,PN,M 72,Ricerca scientifica e sviluppo                              ,0,0,0,0,0,2023
FVG,PN,M 73,Pubblicità e ricerche di mercato                            ,0,0,0,0,0,2023
FVG,PN,M 74,"Altre attività professionali, scientifiche e tecniche       ",0,0,0,0,0,2023
FVG,PN,M 75,Servizi veterinari                                          ,0,0,0,0,0,2023
FVG,PN,N   ,"Noleggio, agenzie di viaggio, servizi di supporto alle im...",0,0,0,0,0,2023
FVG,PN,N 77,Attività di noleggio e leasing operativo                    ,0,0,0,0,0,2023
FVG,PN,N 78,"Attività di ricerca, selezione, fornitura di personale      ",0,0,0,0,0,2023
FVG,PN,N 79,"Attività dei servizi delle agenzie di viaggio, dei tour o...",0,0,0,0,0,2023
FVG,PN,N 80,Servizi di vigilanza e investigazione                       ,0,0,0,0,0,2023
FVG,PN,N 81,Attività di servizi per edifici e paesaggio                 ,0,0,0,0,0,2023
FVG,PN,N 82,Attività di supporto per le funzioni d'ufficio e altri se...,0,0,0,0,0,2023
FVG,PN,O   ,Amministrazione pubblica e difesa; assicurazione sociale ...,0,0,0,0,0,2023
FVG,PN,O 84,Amministrazione pubblica e difesa; assicurazione sociale ...,0,0,0,0,0,2023
FVG,PN,P   ,Istruzione                                                  ,0,0,0,0,0,2023
FVG,PN,P 85,Istruzione                                                  ,0,0,0,0,0,2023
FVG,PN,Q   ,Sanita' e assistenza sociale                                ,0,0,0,1,1,2023
FVG,PN,Q 86,Assistenza sanitaria                                        ,0,0,0,0,0,2023
FVG,PN,Q 87,Servizi di assistenza sociale residenziale                  ,0,0,0,0,0,2023
FVG,PN,Q 88,Assistenza sociale non residenziale                         ,0,0,0,1,1,2023
FVG,PN,R   ,"Attività artistiche, sportive, di intrattenimento e diver...",0,0,0,0,0,2023
FVG,PN,R 90,"Attività creative, artistiche e di intrattenimento          ",0,0,0,0,0,2023
FVG,PN,R 91,"Attività di biblioteche, archivi, musei ed altre attività...",0,0,0,0,0,2023
FVG,PN,R 92,"Attività riguardanti le lotterie, le scommesse, le case d...",0,0,0,0,0,2023
FVG,PN,R 93,"Attività sportive, di intrattenimento e di divertimento     ",0,0,0,0,0,2023
FVG,PN,S   ,Altre attività di servizi                                   ,0,0,0,0,0,2023
FVG,PN,S 94,Attività di organizzazioni associative                      ,0,0,0,0,0,2023
FVG,PN,S 95,Riparazione di computer e di beni per uso personale e per...,0,0,0,0,0,2023
FVG,PN,S 96,Altre attività di servizi per la persona                    ,0,0,0,0,0,2023
FVG,PN,T   ,Attività di famiglie e convivenze come datori di lavoro p...,0,0,0,0,0,2023
FVG,PN,T 97,Attività di famiglie e convivenze come datori di lavoro p...,0,0,0,0,0,2023
FVG,PN,T 98,Produzione di beni e servizi indifferenziati per uso prop...,0,0,0,0,0,2023
FVG,PN,U   ,Organizzazioni ed organismi extraterritoriali               ,0,0,0,0,0,2023
FVG,PN,U 99,Organizzazioni ed organismi extraterritoriali               ,0,0,0,0,0,2023
FVG,PN,XX  ,Imprese non classificate                                    ,0,0,0,0,0,2023
FVG,PN,TOT ,TOTALE                                                      ,2,0,0,1,3,2023
LIG,  ,A   ,"Agricoltura, silvicoltura pesca                             ",1,0,100,5,106,2023
LIG,  ,A 01,"Coltivazioni agricole e produzione di prodotti animali, c...",0,0,94,4,98,2023
LIG,  ,A 02,Silvicoltura ed utilizzo di aree forestali                  ,0,0,3,0,3,2023
LIG,  ,A 03,Pesca e acquacoltura                                        ,1,0,3,1,5,2023
LIG,  ,B   ,Estrazione di minerali da cave e miniere                    ,2,0,0,0,2,2023
LIG,  ,B 05,Estrazione di carbone (esclusa torba)                       ,0,0,0,0,0,2023
LIG,  ,B 06,Estraz.di petrolio greggio e di gas naturale                ,0,0,0,0,0,2023
LIG,  ,B 07,Estrazione di minerali metalliferi                          ,0,0,0,0,0,2023
LIG,  ,B 08,Altre attività di estrazione di minerali da cave e miniere  ,2,0,0,0,2,2023
LIG,  ,B 09,Attività dei servizi di supporto all'estrazione             ,0,0,0,0,0,2023
LIG,  ,C   ,Attività manifatturiere                                     ,19,13,42,3,77,2023
LIG,  ,C 10,Industrie alimentari                                        ,1,2,7,2,12,2023
LIG,  ,C 11,Industria delle bevande                                     ,0,0,0,0,0,2023
LIG,  ,C 12,Industria del tabacco                                       ,0,0,0,0,0,2023
LIG,  ,C 13,Industrie tessili                                           ,2,0,0,0,2,2023
LIG,  ,C 14,Confezione di articoli di abbigliamento; confezione di ar...,0,1,5,0,6,2023
LIG,  ,C 15,Fabbricazione di articoli in pelle e simili                 ,0,0,0,0,0,2023
LIG,  ,C 16,Industria del legno e dei prodotti in legno e sughero (es...,0,0,3,0,3,2023
LIG,  ,C 17,Fabbricazione di carta e di prodotti di carta               ,0,0,0,0,0,2023
LIG,  ,C 18,Stampa e riproduzione di supporti registrati                ,1,0,1,0,2,2023
LIG,  ,C 19,Fabbricazione di coke e prodotti derivanti dalla raffinaz...,0,0,0,0,0,2023
LIG,  ,C 20,Fabbricazione di prodotti chimici                           ,1,3,0,0,4,2023
LIG,  ,C 21,Fabbricazione di prodotti farmaceutici di base e di prepa...,0,0,0,0,0,2023
LIG,  ,C 22,Fabbricazione di articoli in gomma e materie plastiche      ,0,0,1,0,1,2023
LIG,  ,C 23,Fabbricazione di altri prodotti della lavorazione di miner..,0,2,2,0,4,2023
LIG,  ,C 24,Metallurgia                                                 ,0,0,0,0,0,2023
LIG,  ,C 25,Fabbricazione di prodotti in metallo (esclusi macchinari ...,5,1,14,1,21,2023
LIG,  ,C 26,Fabbricazione di computer e prodotti di elettronica e ott...,0,0,0,0,0,2023
LIG,  ,C 27,Fabbricazione di apparecchiature elettriche ed apparecchi...,2,0,0,0,2,2023
LIG,  ,C 28,Fabbricazione di macchinari ed apparecchiature nca          ,1,0,1,0,2,2023
LIG,  ,C 29,"Fabbricazione di autoveicoli, rimorchi e semirimorchi       ",0,0,0,0,0,2023
LIG,  ,C 30,Fabbricazione di altri mezzi di trasporto                   ,0,2,1,0,3,2023
LIG,  ,C 31,Fabbricazione di mobili                                     ,0,1,0,0,1,2023
LIG,  ,C 32,Altre industrie manifatturiere                              ,0,1,2,0,3,2023
LIG,  ,C 33,"Riparazione, manutenzione ed installazione di macchine ed...",6,0,5,0,11,2023
LIG,  ,D   ,"Fornitura di energia elettrica, gas, vapore e aria condiz...",0,0,0,1,1,2023
LIG,  ,D 35,"Fornitura di energia elettrica, gas, vapore e aria condiz...",0,0,0,1,1,2023
LIG,  ,E   ,"Fornitura di acqua; reti fognarie, attività di gestione d...",0,0,1,0,1,2023
LIG,  ,E 36,"Raccolta, trattamento e fornitura di acqua                  ",0,0,0,0,0,2023
LIG,  ,E 37,Gestione delle reti fognarie                                ,0,0,0,0,0,2023
LIG,  ,E 38,"Attività di raccolta, trattamento e smaltimento dei rifiu...",0,0,1,0,1,2023
LIG,  ,E 39,Attività di risanamento e altri servizi di gestione dei r...,0,0,0,0,0,2023
LIG,  ,F   ,Costruzioni                                                 ,29,17,106,21,173,2023
LIG,  ,F 41,Costruzione di edifici                                      ,20,15,19,10,64,2023
LIG,  ,F 42,Ingegneria civile                                           ,0,0,0,0,0,2023
LIG,  ,F 43,Lavori di costruzione specializzati                         ,9,2,87,11,109,2023
LIG,  ,G   ,Commercio all'ingrosso e al dettaglio; riparazione di aut...,37,43,248,8,336,2023
LIG,  ,G 45,Commercio all'ingrosso e al dettaglio e riparazione di au...,5,4,19,0,28,2023
LIG,  ,G 46,Commercio all'ingrosso (escluso quello di autoveicoli e d...,20,22,66,5,113,2023
LIG,  ,G 47,Commercio al dettaglio (escluso quello di autoveicoli e d...,12,17,163,3,195,2023
LIG,  ,H   ,Trasporto e magazzinaggio                                   ,9,9,28,7,53,2023
LIG,  ,H 49,Trasporto terrestre e mediante condotte                     ,4,6,21,4,35,2023
LIG,  ,H 50,Trasporto marittimo e per vie d'acqua                       ,2,0,0,1,3,2023
LIG,  ,H 51,Trasporto aereo                                             ,0,0,0,0,0,2023
LIG,  ,H 52,Magazzinaggio e attività di supporto ai trasporti           ,3,3,7,2,15,2023
LIG,  ,H 53,Servizi postali e attività di corriere                      ,0,0,0,0,0,2023
LIG,  ,I   ,Attività dei servizi alloggio e ristorazione                ,22,16,96,5,139,2023
LIG,  ,I 55,Alloggio                                                    ,2,0,10,0,12,2023
LIG,  ,I 56,Attività dei servizi di ristorazione                        ,20,16,86,5,127,2023
LIG,  ,J   ,Servizi di informazione e comunicazione                     ,3,2,2,0,7,2023
LIG,  ,J 58,Attività editoriali                                         ,0,0,0,0,0,2023
LIG,  ,J 59,"Attività di produzione cinematografica, di video e di pro...",0,2,1,0,3,2023
LIG,  ,J 60,Attività di programmazione e trasmissione                   ,0,0,0,0,0,2023
LIG,  ,J 61,Telecomunicazioni                                           ,0,0,0,0,0,2023
LIG,  ,J 62,"Produzione di software, consulenza informatica e attività...",2,0,1,0,3,2023
LIG,  ,J 63,Attività dei servizi d'informazione e altri servizi infor...,1,0,0,0,1,2023
LIG,  ,K   ,Attività finanziarie e assicurative                         ,0,0,7,0,7,2023
LIG,  ,K 64,Attività di servizi finanziari (escluse le assicurazioni ...,0,0,0,0,0,2023
LIG,  ,K 65,"Assicurazioni, riassicurazioni e fondi pensione (escluse ...",0,0,0,0,0,2023
LIG,  ,K 66,Attività ausiliarie dei servizi finanziari e delle attivi...,0,0,7,0,7,2023
LIG,  ,L   ,Attivita' immobiliari                                       ,20,11,8,8,47,2023
LIG,  ,L 68,Attivita' immobiliari                                       ,20,11,8,8,47,2023
LIG,  ,M   ,"Attività professionali, scientifiche e tecniche             ",8,3,11,5,27,2023
LIG,  ,M 69,Attività legali e contabilità                               ,1,0,1,1,3,2023
LIG,  ,M 70,Attività di direzione aziendale e di consulenza gestional...,2,0,4,2,8,2023
LIG,  ,M 71,Attività degli studi di architettura e d'ingegneria; coll...,1,0,1,1,3,2023
LIG,  ,M 72,Ricerca scientifica e sviluppo                              ,0,0,0,0,0,2023
LIG,  ,M 73,Pubblicità e ricerche di mercato                            ,1,0,1,1,3,2023
LIG,  ,M 74,"Altre attività professionali, scientifiche e tecniche       ",3,3,4,0,10,2023
LIG,  ,M 75,Servizi veterinari                                          ,0,0,0,0,0,2023
LIG,  ,N   ,"Noleggio, agenzie di viaggio, servizi di supporto alle im...",2,1,13,3,19,2023
LIG,  ,N 77,Attività di noleggio e leasing operativo                    ,0,1,5,0,6,2023
LIG,  ,N 78,"Attività di ricerca, selezione, fornitura di personale      ",0,0,0,0,0,2023
LIG,  ,N 79,"Attività dei servizi delle agenzie di viaggio, dei tour o...",0,0,0,0,0,2023
LIG,  ,N 80,Servizi di vigilanza e investigazione                       ,0,0,1,0,1,2023
LIG,  ,N 81,Attività di servizi per edifici e paesaggio                 ,2,0,4,3,9,2023
LIG,  ,N 82,Attività di supporto per le funzioni d'ufficio e altri se...,0,0,3,0,3,2023
LIG,  ,O   ,Amministrazione pubblica e difesa; assicurazione sociale ...,0,0,0,0,0,2023
LIG,  ,O 84,Amministrazione pubblica e difesa; assicurazione sociale ...,0,0,0,0,0,2023
LIG,  ,P   ,Istruzione                                                  ,1,0,0,0,1,2023
LIG,  ,P 85,Istruzione                                                  ,1,0,0,0,1,2023
LIG,  ,Q   ,Sanita' e assistenza sociale                                ,1,1,0,3,5,2023
LIG,  ,Q 86,Assistenza sanitaria                                        ,1,1,0,0,2,2023
LIG,  ,Q 87,Servizi di assistenza sociale residenziale                  ,0,0,0,0,0,2023
LIG,  ,Q 88,Assistenza sociale non residenziale                         ,0,0,0,3,3,2023
LIG,  ,R   ,"Attività artistiche, sportive, di intrattenimento e diver...",2,3,3,3,11,2023
LIG,  ,R 90,"Attività creative, artistiche e di intrattenimento          ",1,3,0,1,5,2023
LIG,  ,R 91,"Attività di biblioteche, archivi, musei ed altre attività...",0,0,0,0,0,2023
LIG,  ,R 92,"Attività riguardanti le lotterie, le scommesse, le case d...",0,0,0,0,0,2023
LIG,  ,R 93,"Attività sportive, di intrattenimento e di divertimento     ",1,0,3,2,6,2023
LIG,  ,S   ,Altre attività di servizi                                   ,1,3,16,0,20,2023
LIG,  ,S 94,Attività di organizzazioni associative                      ,0,0,0,0,0,2023
LIG,  ,S 95,Riparazione di computer e di beni per uso personale e per...,0,0,6,0,6,2023
LIG,  ,S 96,Altre attività di servizi per la persona                    ,1,3,10,0,14,2023
LIG,  ,T   ,Attività di famiglie e convivenze come datori di lavoro p...,0,0,0,0,0,2023
LIG,  ,T 97,Attività di famiglie e convivenze come datori di lavoro p...,0,0,0,0,0,2023
LIG,  ,T 98,Produzione di beni e servizi indifferenziati per uso prop...,0,0,0,0,0,2023
LIG,  ,U   ,Organizzazioni ed organismi extraterritoriali               ,0,0,0,0,0,2023
LIG,  ,U 99,Organizzazioni ed organismi extraterritoriali               ,0,0,0,0,0,2023
LIG,  ,XX  ,Imprese non classificate                                    ,17,3,66,9,95,2023
LIG,  ,TOT ,TOTALE                                                      ,174,125,747,81,1127,2023
LIG,IM,A   ,"Agricoltura, silvicoltura pesca                             ",0,0,22,2,24,2023
LIG,IM,A 01,"Coltivazioni agricole e produzione di prodotti animali, c...",0,0,20,2,22,2023
LIG,IM,A 02,Silvicoltura ed utilizzo di aree forestali                  ,0,0,1,0,1,2023
LIG,IM,A 03,Pesca e acquacoltura                                        ,0,0,1,0,1,2023
LIG,IM,B   ,Estrazione di minerali da cave e miniere                    ,0,0,0,0,0,2023
LIG,IM,B 05,Estrazione di carbone (esclusa torba)                       ,0,0,0,0,0,2023
LIG,IM,B 06,Estraz.di petrolio greggio e di gas naturale                ,0,0,0,0,0,2023
LIG,IM,B 07,Estrazione di minerali metalliferi                          ,0,0,0,0,0,2023
LIG,IM,B 08,Altre attività di estrazione di minerali da cave e miniere  ,0,0,0,0,0,2023
LIG,IM,B 09,Attività dei servizi di supporto all'estrazione             ,0,0,0,0,0,2023
LIG,IM,C   ,Attività manifatturiere                                     ,0,0,9,0,9,2023
LIG,IM,C 10,Industrie alimentari                                        ,0,0,4,0,4,2023
LIG,IM,C 11,Industria delle bevande                                     ,0,0,0,0,0,2023
LIG,IM,C 12,Industria del tabacco                                       ,0,0,0,0,0,2023
LIG,IM,C 13,Industrie tessili                                           ,0,0,0,0,0,2023
LIG,IM,C 14,Confezione di articoli di abbigliamento; confezione di ar...,0,0,2,0,2,2023
LIG,IM,C 15,Fabbricazione di articoli in pelle e simili                 ,0,0,0,0,0,2023
LIG,IM,C 16,Industria del legno e dei prodotti in legno e sughero (es...,0,0,0,0,0,2023
LIG,IM,C 17,Fabbricazione di carta e di prodotti di carta               ,0,0,0,0,0,2023
LIG,IM,C 18,Stampa e riproduzione di supporti registrati                ,0,0,0,0,0,2023
LIG,IM,C 19,Fabbricazione di coke e prodotti derivanti dalla raffinaz...,0,0,0,0,0,2023
LIG,IM,C 20,Fabbricazione di prodotti chimici                           ,0,0,0,0,0,2023
LIG,IM,C 21,Fabbricazione di prodotti farmaceutici di base e di prepa...,0,0,0,0,0,2023
LIG,IM,C 22,Fabbricazione di articoli in gomma e materie plastiche      ,0,0,0,0,0,2023
LIG,IM,C 23,Fabbricazione di altri prodotti della lavorazione di miner..,0,0,1,0,1,2023
LIG,IM,C 24,Metallurgia                                                 ,0,0,0,0,0,2023
LIG,IM,C 25,Fabbricazione di prodotti in metallo (esclusi macchinari ...,0,0,2,0,2,2023
LIG,IM,C 26,Fabbricazione di computer e prodotti di elettronica e ott...,0,0,0,0,0,2023
LIG,IM,C 27,Fabbricazione di apparecchiature elettriche ed apparecchi...,0,0,0,0,0,2023
LIG,IM,C 28,Fabbricazione di macchinari ed apparecchiature nca          ,0,0,0,0,0,2023
LIG,IM,C 29,"Fabbricazione di autoveicoli, rimorchi e semirimorchi       ",0,0,0,0,0,2023
LIG,IM,C 30,Fabbricazione di altri mezzi di trasporto                   ,0,0,0,0,0,2023
LIG,IM,C 31,Fabbricazione di mobili                                     ,0,0,0,0,0,2023
LIG,IM,C 32,Altre industrie manifatturiere                              ,0,0,0,0,0,2023
LIG,IM,C 33,"Riparazione, manutenzione ed installazione di macchine ed...",0,0,0,0,0,2023
LIG,IM,D   ,"Fornitura di energia elettrica, gas, vapore e aria condiz...",0,0,0,0,0,2023
LIG,IM,D 35,"Fornitura di energia elettrica, gas, vapore e aria condiz...",0,0,0,0,0,2023
LIG,IM,E   ,"Fornitura di acqua; reti fognarie, attività di gestione d...",0,0,0,0,0,2023
LIG,IM,E 36,"Raccolta, trattamento e fornitura di acqua                  ",0,0,0,0,0,2023
LIG,IM,E 37,Gestione delle reti fognarie                                ,0,0,0,0,0,2023
LIG,IM,E 38,"Attività di raccolta, trattamento e smaltimento dei rifiu...",0,0,0,0,0,2023
LIG,IM,E 39,Attività di risanamento e altri servizi di gestione dei r...,0,0,0,0,0,2023
LIG,IM,F   ,Costruzioni                                                 ,4,1,50,5,60,2023
LIG,IM,F 41,Costruzione di edifici                                      ,2,0,7,4,13,2023
LIG,IM,F 42,Ingegneria civile                                           ,0,0,0,0,0,2023
LIG,IM,F 43,Lavori di costruzione specializzati                         ,2,1,43,1,47,2023
LIG,IM,G   ,Commercio all'ingrosso e al dettaglio; riparazione di aut...,6,2,54,3,65,2023
LIG,IM,G 45,Commercio all'ingrosso e al dettaglio e riparazione di au...,0,1,5,0,6,2023
LIG,IM,G 46,Commercio all'ingrosso (escluso quello di autoveicoli e d...,0,0,11,2,13,2023
LIG,IM,G 47,Commercio al dettaglio (escluso quello di autoveicoli e d...,6,1,38,1,46,2023
LIG,IM,H   ,Trasporto e magazzinaggio                                   ,1,0,4,1,6,2023
LIG,IM,H 49,Trasporto terrestre e mediante condotte                     ,0,0,4,1,5,2023
LIG,IM,H 50,Trasporto marittimo e per vie d'acqua                       ,0,0,0,0,0,2023
LIG,IM,H 51,Trasporto aereo                                             ,0,0,0,0,0,2023
LIG,IM,H 52,Magazzinaggio e attività di supporto ai trasporti           ,1,0,0,0,1,2023
LIG,IM,H 53,Servizi postali e attività di corriere                      ,0,0,0,0,0,2023
LIG,IM,I   ,Attività dei servizi alloggio e ristorazione                ,3,3,19,0,25,2023
LIG,IM,I 55,Alloggio                                                    ,0,0,3,0,3,2023
LIG,IM,I 56,Attività dei servizi di ristorazione                        ,3,3,16,0,22,2023
LIG,IM,J   ,Servizi di informazione e comunicazione                     ,0,0,0,0,0,2023
LIG,IM,J 58,Attività editoriali                                         ,0,0,0,0,0,2023
LIG,IM,J 59,"Attività di produzione cinematografica, di video e di pro...",0,0,0,0,0,2023
LIG,IM,J 60,Attività di programmazione e trasmissione                   ,0,0,0,0,0,2023
LIG,IM,J 61,Telecomunicazioni                                           ,0,0,0,0,0,2023
LIG,IM,J 62,"Produzione di software, consulenza informatica e attività...",0,0,0,0,0,2023
LIG,IM,J 63,Attività dei servizi d'informazione e altri servizi infor...,0,0,0,0,0,2023
LIG,IM,K   ,Attività finanziarie e assicurative                         ,0,0,0,0,0,2023
LIG,IM,K 64,Attività di servizi finanziari (escluse le assicurazioni ...,0,0,0,0,0,2023
LIG,IM,K 65,"Assicurazioni, riassicurazioni e fondi pensione (escluse ...",0,0,0,0,0,2023
LIG,IM,K 66,Attività ausiliarie dei servizi finanziari e delle attivi...,0,0,0,0,0,2023
LIG,IM,L   ,Attivita' immobiliari                                       ,2,1,0,1,4,2023
LIG,IM,L 68,Attivita' immobiliari                                       ,2,1,0,1,4,2023
LIG,IM,M   ,"Attività professionali, scientifiche e tecniche             ",0,1,4,1,6,2023
LIG,IM,M 69,Attività legali e contabilità                               ,0,0,0,1,1,2023
LIG,IM,M 70,Attività di direzione aziendale e di consulenza gestional...,0,0,1,0,1,2023
LIG,IM,M 71,Attività degli studi di architettura e d'ingegneria; coll...,0,0,0,0,0,2023
LIG,IM,M 72,Ricerca scientifica e sviluppo                              ,0,0,0,0,0,2023
LIG,IM,M 73,Pubblicità e ricerche di mercato                            ,0,0,1,0,1,2023
LIG,IM,M 74,"Altre attività professionali, scientifiche e tecniche       ",0,1,2,0,3,2023
LIG,IM,M 75,Servizi veterinari                                          ,0,0,0,0,0,2023
LIG,IM,N   ,"Noleggio, agenzie di viaggio, servizi di supporto alle im...",0,0,1,0,1,2023
LIG,IM,N 77,Attività di noleggio e leasing operativo                    ,0,0,0,0,0,2023
LIG,IM,N 78,"Attività di ricerca, selezione, fornitura di personale      ",0,0,0,0,0,2023
LIG,IM,N 79,"Attività dei servizi delle agenzie di viaggio, dei tour o...",0,0,0,0,0,2023
LIG,IM,N 80,Servizi di vigilanza e investigazione                       ,0,0,0,0,0,2023
LIG,IM,N 81,Attività di servizi per edifici e paesaggio                 ,0,0,1,0,1,2023
LIG,IM,N 82,Attività di supporto per le funzioni d'ufficio e altri se...,0,0,0,0,0,2023
LIG,IM,O   ,Amministrazione pubblica e difesa; assicurazione sociale ...,0,0,0,0,0,2023
LIG,IM,O 84,Amministrazione pubblica e difesa; assicurazione sociale ...,0,0,0,0,0,2023
LIG,IM,P   ,Istruzione                                                  ,0,0,0,0,0,2023
LIG,IM,P 85,Istruzione                                                  ,0,0,0,0,0,2023
LIG,IM,Q   ,Sanita' e assistenza sociale                                ,0,0,0,1,1,2023
LIG,IM,Q 86,Assistenza sanitaria                                        ,0,0,0,0,0,2023
LIG,IM,Q 87,Servizi di assistenza sociale residenziale                  ,0,0,0,0,0,2023
LIG,IM,Q 88,Assistenza sociale non residenziale                         ,0,0,0,1,1,2023
LIG,IM,R   ,"Attività artistiche, sportive, di intrattenimento e diver...",0,0,0,0,0,2023
LIG,IM,R 90,"Attività creative, artistiche e di intrattenimento          ",0,0,0,0,0,2023
LIG,IM,R 91,"Attività di biblioteche, archivi, musei ed altre attività...",0,0,0,0,0,2023
LIG,IM,R 92,"Attività riguardanti le lotterie, le scommesse, le case d...",0,0,0,0,0,2023
LIG,IM,R 93,"Attività sportive, di intrattenimento e di divertimento     ",0,0,0,0,0,2023
LIG,IM,S   ,Altre attività di servizi                                   ,0,1,1,0,2,2023
LIG,IM,S 94,Attività di organizzazioni associative                      ,0,0,0,0,0,2023
LIG,IM,S 95,Riparazione di computer e di beni per uso personale e per...,0,0,0,0,0,2023
LIG,IM,S 96,Altre attività di servizi per la persona                    ,0,1,1,0,2,2023
LIG,IM,T   ,Attività di famiglie e convivenze come datori di lavoro p...,0,0,0,0,0,2023
LIG,IM,T 97,Attività di famiglie e convivenze come datori di lavoro p...,0,0,0,0,0,2023
LIG,IM,T 98,Produzione di beni e servizi indifferenziati per uso prop...,0,0,0,0,0,2023
LIG,IM,U   ,Organizzazioni ed organismi extraterritoriali               ,0,0,0,0,0,2023
LIG,IM,U 99,Organizzazioni ed organismi extraterritoriali               ,0,0,0,0,0,2023
LIG,IM,XX  ,Imprese non classificate                                    ,6,0,25,1,32,2023
LIG,IM,TOT ,TOTALE                                                      ,22,9,189,15,235,2023
LIG,SV,A   ,"Agricoltura, silvicoltura pesca                             ",0,0,41,0,41,2023
LIG,SV,A 01,"Coltivazioni agricole e produzione di prodotti animali, c...",0,0,39,0,39,2023
LIG,SV,A 02,Silvicoltura ed utilizzo di aree forestali                  ,0,0,2,0,2,2023
LIG,SV,A 03,Pesca e acquacoltura                                        ,0,0,0,0,0,2023
LIG,SV,B   ,Estrazione di minerali da cave e miniere                    ,0,0,0,0,0,2023
LIG,SV,B 05,Estrazione di carbone (esclusa torba)                       ,0,0,0,0,0,2023
LIG,SV,B 06,Estraz.di petrolio greggio e di gas naturale                ,0,0,0,0,0,2023
LIG,SV,B 07,Estrazione di minerali metalliferi                          ,0,0,0,0,0,2023
LIG,SV,B 08,Altre attività di estrazione di minerali da cave e miniere  ,0,0,0,0,0,2023
LIG,SV,B 09,Attività dei servizi di supporto all'estrazione             ,0,0,0,0,0,2023
LIG,SV,C   ,Attività manifatturiere                                     ,3,1,9,0,13,2023
LIG,SV,C 10,Industrie alimentari                                        ,0,1,2,0,3,2023
LIG,SV,C 11,Industria delle bevande                                     ,0,0,0,0,0,2023
LIG,SV,C 12,Industria del tabacco                                       ,0,0,0,0,0,2023
LIG,SV,C 13,Industrie tessili                                           ,0,0,0,0,0,2023
LIG,SV,C 14,Confezione di articoli di abbigliamento; confezione di ar...,0,0,0,0,0,2023
LIG,SV,C 15,Fabbricazione di articoli in pelle e simili                 ,0,0,0,0,0,2023
LIG,SV,C 16,Industria del legno e dei prodotti in legno e sughero (es...,0,0,1,0,1,2023
LIG,SV,C 17,Fabbricazione di carta e di prodotti di carta               ,0,0,0,0,0,2023
LIG,SV,C 18,Stampa e riproduzione di supporti registrati                ,0,0,0,0,0,2023
LIG,SV,C 19,Fabbricazione di coke e prodotti derivanti dalla raffinaz...,0,0,0,0,0,2023
LIG,SV,C 20,Fabbricazione di prodotti chimici                           ,0,0,0,0,0,2023
LIG,SV,C 21,Fabbricazione di prodotti farmaceutici di base e di prepa...,0,0,0,0,0,2023
LIG,SV,C 22,Fabbricazione di articoli in gomma e materie plastiche      ,0,0,0,0,0,2023
LIG,SV,C 23,Fabbricazione di altri prodotti della lavorazione di miner..,0,0,0,0,0,2023
LIG,SV,C 24,Metallurgia                                                 ,0,0,0,0,0,2023
LIG,SV,C 25,Fabbricazione di prodotti in metallo (esclusi macchinari ...,0,0,5,0,5,2023
LIG,SV,C 26,Fabbricazione di computer e prodotti di elettronica e ott...,0,0,0,0,0,2023
LIG,SV,C 27,Fabbricazione di apparecchiature elettriche ed apparecchi...,0,0,0,0,0,2023
LIG,SV,C 28,Fabbricazione di macchinari ed apparecchiature nca          ,0,0,1,0,1,2023
LIG,SV,C 29,"Fabbricazione di autoveicoli, rimorchi e semirimorchi       ",0,0,0,0,0,2023
LIG,SV,C 30,Fabbricazione di altri mezzi di trasporto                   ,0,0,0,0,0,2023
LIG,SV,C 31,Fabbricazione di mobili                                     ,0,0,0,0,0,2023
LIG,SV,C 32,Altre industrie manifatturiere                              ,0,0,0,0,0,2023
LIG,SV,C 33,"Riparazione, manutenzione ed installazione di macchine ed...",3,0,0,0,3,2023
LIG,SV,D   ,"Fornitura di energia elettrica, gas, vapore e aria condiz...",0,0,0,1,1,2023
LIG,SV,D 35,"Fornitura di energia elettrica, gas, vapore e aria condiz...",0,0,0,1,1,2023
LIG,SV,E   ,"Fornitura di acqua; reti fognarie, attività di gestione d...",0,0,1,0,1,2023
LIG,SV,E 36,"Raccolta, trattamento e fornitura di acqua                  ",0,0,0,0,0,2023
LIG,SV,E 37,Gestione delle reti fognarie                                ,0,0,0,0,0,2023
LIG,SV,E 38,"Attività di raccolta, trattamento e smaltimento dei rifiu...",0,0,1,0,1,2023
LIG,SV,E 39,Attività di risanamento e altri servizi di gestione dei r...,0,0,0,0,0,2023
LIG,SV,F   ,Costruzioni                                                 ,7,0,29,2,38,2023
LIG,SV,F 41,Costruzione di edifici                                      ,4,0,4,0,8,2023
LIG,SV,F 42,Ingegneria civile                                           ,0,0,0,0,0,2023
LIG,SV,F 43,Lavori di costruzione specializzati                         ,3,0,25,2,30,2023
LIG,SV,G   ,Commercio all'ingrosso e al dettaglio; riparazione di aut...,5,3,38,0,46,2023
LIG,SV,G 45,Commercio all'ingrosso e al dettaglio e riparazione di au...,1,0,3,0,4,2023
LIG,SV,G 46,Commercio all'ingrosso (escluso quello di autoveicoli e d...,3,0,6,0,9,2023
LIG,SV,G 47,Commercio al dettaglio (escluso quello di autoveicoli e d...,1,3,29,0,33,2023
LIG,SV,H   ,Trasporto e magazzinaggio                                   ,1,0,4,0,5,2023
LIG,SV,H 49,Trasporto terrestre e mediante condotte                     ,1,0,4,0,5,2023
LIG,SV,H 50,Trasporto marittimo e per vie d'acqua                       ,0,0,0,0,0,2023
LIG,SV,H 51,Trasporto aereo                                             ,0,0,0,0,0,2023
LIG,SV,H 52,Magazzinaggio e attività di supporto ai trasporti           ,0,0,0,0,0,2023
LIG,SV,H 53,Servizi postali e attività di corriere                      ,0,0,0,0,0,2023
LIG,SV,I   ,Attività dei servizi alloggio e ristorazione                ,4,6,36,0,46,2023
LIG,SV,I 55,Alloggio                                                    ,0,0,1,0,1,2023
LIG,SV,I 56,Attività dei servizi di ristorazione                        ,4,6,35,0,45,2023
LIG,SV,J   ,Servizi di informazione e comunicazione                     ,0,0,1,0,1,2023
LIG,SV,J 58,Attività editoriali                                         ,0,0,0,0,0,2023
LIG,SV,J 59,"Attività di produzione cinematografica, di video e di pro...",0,0,0,0,0,2023
LIG,SV,J 60,Attività di programmazione e trasmissione                   ,0,0,0,0,0,2023
LIG,SV,J 61,Telecomunicazioni                                           ,0,0,0,0,0,2023
LIG,SV,J 62,"Produzione di software, consulenza informatica e attività...",0,0,1,0,1,2023
LIG,SV,J 63,Attività dei servizi d'informazione e altri servizi infor...,0,0,0,0,0,2023
LIG,SV,K   ,Attività finanziarie e assicurative                         ,0,0,1,0,1,2023
LIG,SV,K 64,Attività di servizi finanziari (escluse le assicurazioni ...,0,0,0,0,0,2023
LIG,SV,K 65,"Assicurazioni, riassicurazioni e fondi pensione (escluse ...",0,0,0,0,0,2023
LIG,SV,K 66,Attività ausiliarie dei servizi finanziari e delle attivi...,0,0,1,0,1,2023
LIG,SV,L   ,Attivita' immobiliari                                       ,2,0,3,0,5,2023
LIG,SV,L 68,Attivita' immobiliari                                       ,2,0,3,0,5,2023
LIG,SV,M   ,"Attività professionali, scientifiche e tecniche             ",4,0,0,1,5,2023
LIG,SV,M 69,Attività legali e contabilità                               ,0,0,0,0,0,2023
LIG,SV,M 70,Attività di direzione aziendale e di consulenza gestional...,1,0,0,1,2,2023
LIG,SV,M 71,Attività degli studi di architettura e d'ingegneria; coll...,1,0,0,0,1,2023
LIG,SV,M 72,Ricerca scientifica e sviluppo                              ,0,0,0,0,0,2023
LIG,SV,M 73,Pubblicità e ricerche di mercato                            ,1,0,0,0,1,2023
LIG,SV,M 74,"Altre attività professionali, scientifiche e tecniche       ",1,0,0,0,1,2023
LIG,SV,M 75,Servizi veterinari                                          ,0,0,0,0,0,2023
LIG,SV,N   ,"Noleggio, agenzie di viaggio, servizi di supporto alle im...",0,0,3,0,3,2023
LIG,SV,N 77,Attività di noleggio e leasing operativo                    ,0,0,1,0,1,2023
LIG,SV,N 78,"Attività di ricerca, selezione, fornitura di personale      ",0,0,0,0,0,2023
LIG,SV,N 79,"Attività dei servizi delle agenzie di viaggio, dei tour o...",0,0,0,0,0,2023
LIG,SV,N 80,Servizi di vigilanza e investigazione                       ,0,0,0,0,0,2023
LIG,SV,N 81,Attività di servizi per edifici e paesaggio                 ,0,0,2,0,2,2023
LIG,SV,N 82,Attività di supporto per le funzioni d'ufficio e altri se...,0,0,0,0,0,2023
LIG,SV,O   ,Amministrazione pubblica e difesa; assicurazione sociale ...,0,0,0,0,0,2023
LIG,SV,O 84,Amministrazione pubblica e difesa; assicurazione sociale ...,0,0,0,0,0,2023
LIG,SV,P   ,Istruzione                                                  ,0,0,0,0,0,2023
LIG,SV,P 85,Istruzione                                                  ,0,0,0,0,0,2023
LIG,SV,Q   ,Sanita' e assistenza sociale                                ,1,0,0,2,3,2023
LIG,SV,Q 86,Assistenza sanitaria                                        ,1,0,0,0,1,2023
LIG,SV,Q 87,Servizi di assistenza sociale residenziale                  ,0,0,0,0,0,2023
LIG,SV,Q 88,Assistenza sociale non residenziale                         ,0,0,0,2,2,2023
LIG,SV,R   ,"Attività artistiche, sportive, di intrattenimento e diver...",0,0,1,3,4,2023
LIG,SV,R 90,"Attività creative, artistiche e di intrattenimento          ",0,0,0,1,1,2023
LIG,SV,R 91,"Attività di biblioteche, archivi, musei ed altre attività...",0,0,0,0,0,2023
LIG,SV,R 92,"Attività riguardanti le lotterie, le scommesse, le case d...",0,0,0,0,0,2023
LIG,SV,R 93,"Attività sportive, di intrattenimento e di divertimento     ",0,0,1,2,3,2023
LIG,SV,S   ,Altre attività di servizi                                   ,0,0,5,0,5,2023
LIG,SV,S 94,Attività di organizzazioni associative                      ,0,0,0,0,0,2023
LIG,SV,S 95,Riparazione di computer e di beni per uso personale e per...,0,0,1,0,1,2023
LIG,SV,S 96,Altre attività di servizi per la persona                    ,0,0,4,0,4,2023
LIG,SV,T   ,Attività di famiglie e convivenze come datori di lavoro p...,0,0,0,0,0,2023
LIG,SV,T 97,Attività di famiglie e convivenze come datori di lavoro p...,0,0,0,0,0,2023
LIG,SV,T 98,Produzione di beni e servizi indifferenziati per uso prop...,0,0,0,0,0,2023
LIG,SV,U   ,Organizzazioni ed organismi extraterritoriali               ,0,0,0,0,0,2023
LIG,SV,U 99,Organizzazioni ed organismi extraterritoriali               ,0,0,0,0,0,2023
LIG,SV,XX  ,Imprese non classificate                                    ,7,0,19,4,30,2023
LIG,SV,TOT ,TOTALE                                                      ,34,10,191,13,248,2023
LIG,GE,A   ,"Agricoltura, silvicoltura pesca                             ",1,0,16,3,20,2023
LIG,GE,A 01,"Coltivazioni agricole e produzione di prodotti animali, c...",0,0,16,2,18,2023
LIG,GE,A 02,Silvicoltura ed utilizzo di aree forestali                  ,0,0,0,0,0,2023
LIG,GE,A 03,Pesca e acquacoltura                                        ,1,0,0,1,2,2023
LIG,GE,B   ,Estrazione di minerali da cave e miniere                    ,2,0,0,0,2,2023
LIG,GE,B 05,Estrazione di carbone (esclusa torba)                       ,0,0,0,0,0,2023
LIG,GE,B 06,Estraz.di petrolio greggio e di gas naturale                ,0,0,0,0,0,2023
LIG,GE,B 07,Estrazione di minerali metalliferi                          ,0,0,0,0,0,2023
LIG,GE,B 08,Altre attività di estrazione di minerali da cave e miniere  ,2,0,0,0,2,2023
LIG,GE,B 09,Attività dei servizi di supporto all'estrazione             ,0,0,0,0,0,2023
LIG,GE,C   ,Attività manifatturiere                                     ,10,12,12,2,36,2023
LIG,GE,C 10,Industrie alimentari                                        ,1,1,0,1,3,2023
LIG,GE,C 11,Industria delle bevande                                     ,0,0,0,0,0,2023
LIG,GE,C 12,Industria del tabacco                                       ,0,0,0,0,0,2023
LIG,GE,C 13,Industrie tessili                                           ,2,0,0,0,2,2023
LIG,GE,C 14,Confezione di articoli di abbigliamento; confezione di ar...,0,1,2,0,3,2023
LIG,GE,C 15,Fabbricazione di articoli in pelle e simili                 ,0,0,0,0,0,2023
LIG,GE,C 16,Industria del legno e dei prodotti in legno e sughero (es...,0,0,0,0,0,2023
LIG,GE,C 17,Fabbricazione di carta e di prodotti di carta               ,0,0,0,0,0,2023
LIG,GE,C 18,Stampa e riproduzione di supporti registrati                ,1,0,1,0,2,2023
LIG,GE,C 19,Fabbricazione di coke e prodotti derivanti dalla raffinaz...,0,0,0,0,0,2023
LIG,GE,C 20,Fabbricazione di prodotti chimici                           ,1,3,0,0,4,2023
LIG,GE,C 21,Fabbricazione di prodotti farmaceutici di base e di prepa...,0,0,0,0,0,2023
LIG,GE,C 22,Fabbricazione di articoli in gomma e materie plastiche      ,0,0,0,0,0,2023
LIG,GE,C 23,Fabbricazione di altri prodotti della lavorazione di miner..,0,2,1,0,3,2023
LIG,GE,C 24,Metallurgia                                                 ,0,0,0,0,0,2023
LIG,GE,C 25,Fabbricazione di prodotti in metallo (esclusi macchinari ...,1,1,3,1,6,2023
LIG,GE,C 26,Fabbricazione di computer e prodotti di elettronica e ott...,0,0,0,0,0,2023
LIG,GE,C 27,Fabbricazione di apparecchiature elettriche ed apparecchi...,2,0,0,0,2,2023
LIG,GE,C 28,Fabbricazione di macchinari ed apparecchiature nca          ,1,0,0,0,1,2023
LIG,GE,C 29,"Fabbricazione di autoveicoli, rimorchi e semirimorchi       ",0,0,0,0,0,2023
LIG,GE,C 30,Fabbricazione di altri mezzi di trasporto                   ,0,2,0,0,2,2023
LIG,GE,C 31,Fabbricazione di mobili                                     ,0,1,0,0,1,2023
LIG,GE,C 32,Altre industrie manifatturiere                              ,0,1,2,0,3,2023
LIG,GE,C 33,"Riparazione, manutenzione ed installazione di macchine ed...",1,0,3,0,4,2023
LIG,GE,D   ,"Fornitura di energia elettrica, gas, vapore e aria condiz...",0,0,0,0,0,2023
LIG,GE,D 35,"Fornitura di energia elettrica, gas, vapore e aria condiz...",0,0,0,0,0,2023
LIG,GE,E   ,"Fornitura di acqua; reti fognarie, attività di gestione d...",0,0,0,0,0,2023
LIG,GE,E 36,"Raccolta, trattamento e fornitura di acqua                  ",0,0,0,0,0,2023
LIG,GE,E 37,Gestione delle reti fognarie                                ,0,0,0,0,0,2023
LIG,GE,E 38,"Attività di raccolta, trattamento e smaltimento dei rifiu...",0,0,0,0,0,2023
LIG,GE,E 39,Attività di risanamento e altri servizi di gestione dei r...,0,0,0,0,0,2023
LIG,GE,F   ,Costruzioni                                                 ,7,15,8,9,39,2023
LIG,GE,F 41,Costruzione di edifici                                      ,7,14,3,4,28,2023
LIG,GE,F 42,Ingegneria civile                                           ,0,0,0,0,0,2023
LIG,GE,F 43,Lavori di costruzione specializzati                         ,0,1,5,5,11,2023
LIG,GE,G   ,Commercio all'ingrosso e al dettaglio; riparazione di aut...,16,37,112,3,168,2023
LIG,GE,G 45,Commercio all'ingrosso e al dettaglio e riparazione di au...,0,3,9,0,12,2023
LIG,GE,G 46,Commercio all'ingrosso (escluso quello di autoveicoli e d...,14,22,44,2,82,2023
LIG,GE,G 47,Commercio al dettaglio (escluso quello di autoveicoli e d...,2,12,59,1,74,2023
LIG,GE,H   ,Trasporto e magazzinaggio                                   ,6,9,16,4,35,2023
LIG,GE,H 49,Trasporto terrestre e mediante condotte                     ,2,6,11,2,21,2023
LIG,GE,H 50,Trasporto marittimo e per vie d'acqua                       ,2,0,0,0,2,2023
LIG,GE,H 51,Trasporto aereo                                             ,0,0,0,0,0,2023
LIG,GE,H 52,Magazzinaggio e attività di supporto ai trasporti           ,2,3,5,2,12,2023
LIG,GE,H 53,Servizi postali e attività di corriere                      ,0,0,0,0,0,2023
LIG,GE,I   ,Attività dei servizi alloggio e ristorazione                ,3,6,25,4,38,2023
LIG,GE,I 55,Alloggio                                                    ,1,0,3,0,4,2023
LIG,GE,I 56,Attività dei servizi di ristorazione                        ,2,6,22,4,34,2023
LIG,GE,J   ,Servizi di informazione e comunicazione                     ,1,2,1,0,4,2023
LIG,GE,J 58,Attività editoriali                                         ,0,0,0,0,0,2023
LIG,GE,J 59,"Attività di produzione cinematografica, di video e di pro...",0,2,1,0,3,2023
LIG,GE,J 60,Attività di programmazione e trasmissione                   ,0,0,0,0,0,2023
LIG,GE,J 61,Telecomunicazioni                                           ,0,0,0,0,0,2023
LIG,GE,J 62,"Produzione di software, consulenza informatica e attività...",1,0,0,0,1,2023
LIG,GE,J 63,Attività dei servizi d'informazione e altri servizi infor...,0,0,0,0,0,2023
LIG,GE,K   ,Attività finanziarie e assicurative                         ,0,0,3,0,3,2023
LIG,GE,K 64,Attività di servizi finanziari (escluse le assicurazioni ...,0,0,0,0,0,2023
LIG,GE,K 65,"Assicurazioni, riassicurazioni e fondi pensione (escluse ...",0,0,0,0,0,2023
LIG,GE,K 66,Attività ausiliarie dei servizi finanziari e delle attivi...,0,0,3,0,3,2023
LIG,GE,L   ,Attivita' immobiliari                                       ,13,10,4,7,34,2023
LIG,GE,L 68,Attivita' immobiliari                                       ,13,10,4,7,34,2023
LIG,GE,M   ,"Attività professionali, scientifiche e tecniche             ",3,2,5,0,10,2023
LIG,GE,M 69,Attività legali e contabilità                               ,0,0,1,0,1,2023
LIG,GE,M 70,Attività di direzione aziendale e di consulenza gestional...,1,0,3,0,4,2023
LIG,GE,M 71,Attività degli studi di architettura e d'ingegneria; coll...,0,0,1,0,1,2023
LIG,GE,M 72,Ricerca scientifica e sviluppo                              ,0,0,0,0,0,2023
LIG,GE,M 73,Pubblicità e ricerche di mercato                            ,0,0,0,0,0,2023
LIG,GE,M 74,"Altre attività professionali, scientifiche e tecniche       ",2,2,0,0,4,2023
LIG,GE,M 75,Servizi veterinari                                          ,0,0,0,0,0,2023
LIG,GE,N   ,"Noleggio, agenzie di viaggio, servizi di supporto alle im...",0,1,7,3,11,2023
LIG,GE,N 77,Attività di noleggio e leasing operativo                    ,0,1,4,0,5,2023
LIG,GE,N 78,"Attività di ricerca, selezione, fornitura di personale      ",0,0,0,0,0,2023
LIG,GE,N 79,"Attività dei servizi delle agenzie di viaggio, dei tour o...",0,0,0,0,0,2023
LIG,GE,N 80,Servizi di vigilanza e investigazione                       ,0,0,0,0,0,2023
LIG,GE,N 81,Attività di servizi per edifici e paesaggio                 ,0,0,0,3,3,2023
LIG,GE,N 82,Attività di supporto per le funzioni d'ufficio e altri se...,0,0,3,0,3,2023
LIG,GE,O   ,Amministrazione pubblica e difesa; assicurazione sociale ...,0,0,0,0,0,2023
LIG,GE,O 84,Amministrazione pubblica e difesa; assicurazione sociale ...,0,0,0,0,0,2023
LIG,GE,P   ,Istruzione                                                  ,0,0,0,0,0,2023
LIG,GE,P 85,Istruzione                                                  ,0,0,0,0,0,2023
LIG,GE,Q   ,Sanita' e assistenza sociale                                ,0,1,0,0,1,2023
LIG,GE,Q 86,Assistenza sanitaria                                        ,0,1,0,0,1,2023
LIG,GE,Q 87,Servizi di assistenza sociale residenziale                  ,0,0,0,0,0,2023
LIG,GE,Q 88,Assistenza sociale non residenziale                         ,0,0,0,0,0,2023
LIG,GE,R   ,"Attività artistiche, sportive, di intrattenimento e diver...",2,3,0,0,5,2023
LIG,GE,R 90,"Attività creative, artistiche e di intrattenimento          ",1,3,0,0,4,2023
LIG,GE,R 91,"Attività di biblioteche, archivi, musei ed altre attività...",0,0,0,0,0,2023
LIG,GE,R 92,"Attività riguardanti le lotterie, le scommesse, le case d...",0,0,0,0,0,2023
LIG,GE,R 93,"Attività sportive, di intrattenimento e di divertimento     ",1,0,0,0,1,2023
LIG,GE,S   ,Altre attività di servizi                                   ,0,2,1,0,3,2023
LIG,GE,S 94,Attività di organizzazioni associative                      ,0,0,0,0,0,2023
LIG,GE,S 95,Riparazione di computer e di beni per uso personale e per...,0,0,0,0,0,2023
LIG,GE,S 96,Altre attività di servizi per la persona                    ,0,2,1,0,3,2023
LIG,GE,T   ,Attività di famiglie e convivenze come datori di lavoro p...,0,0,0,0,0,2023
LIG,GE,T 97,Attività di famiglie e convivenze come datori di lavoro p...,0,0,0,0,0,2023
LIG,GE,T 98,Produzione di beni e servizi indifferenziati per uso prop...,0,0,0,0,0,2023
LIG,GE,U   ,Organizzazioni ed organismi extraterritoriali               ,0,0,0,0,0,2023
LIG,GE,U 99,Organizzazioni ed organismi extraterritoriali               ,0,0,0,0,0,2023
LIG,GE,XX  ,Imprese non classificate                                    ,0,1,4,4,9,2023
LIG,GE,TOT ,TOTALE                                                      ,64,101,214,39,418,2023
LIG,SP,A   ,"Agricoltura, silvicoltura pesca                             ",0,0,21,0,21,2023
LIG,SP,A 01,"Coltivazioni agricole e produzione di prodotti animali, c...",0,0,19,0,19,2023
LIG,SP,A 02,Silvicoltura ed utilizzo di aree forestali                  ,0,0,0,0,0,2023
LIG,SP,A 03,Pesca e acquacoltura                                        ,0,0,2,0,2,2023
LIG,SP,B   ,Estrazione di minerali da cave e miniere                    ,0,0,0,0,0,2023
LIG,SP,B 05,Estrazione di carbone (esclusa torba)                       ,0,0,0,0,0,2023
LIG,SP,B 06,Estraz.di petrolio greggio e di gas naturale                ,0,0,0,0,0,2023
LIG,SP,B 07,Estrazione di minerali metalliferi                          ,0,0,0,0,0,2023
LIG,SP,B 08,Altre attività di estrazione di minerali da cave e miniere  ,0,0,0,0,0,2023
LIG,SP,B 09,Attività dei servizi di supporto all'estrazione             ,0,0,0,0,0,2023
LIG,SP,C   ,Attività manifatturiere                                     ,6,0,12,1,19,2023
LIG,SP,C 10,Industrie alimentari                                        ,0,0,1,1,2,2023
LIG,SP,C 11,Industria delle bevande                                     ,0,0,0,0,0,2023
LIG,SP,C 12,Industria del tabacco                                       ,0,0,0,0,0,2023
LIG,SP,C 13,Industrie tessili                                           ,0,0,0,0,0,2023
LIG,SP,C 14,Confezione di articoli di abbigliamento; confezione di ar...,0,0,1,0,1,2023
LIG,SP,C 15,Fabbricazione di articoli in pelle e simili                 ,0,0,0,0,0,2023
LIG,SP,C 16,Industria del legno e dei prodotti in legno e sughero (es...,0,0,2,0,2,2023
LIG,SP,C 17,Fabbricazione di carta e di prodotti di carta               ,0,0,0,0,0,2023
LIG,SP,C 18,Stampa e riproduzione di supporti registrati                ,0,0,0,0,0,2023
LIG,SP,C 19,Fabbricazione di coke e prodotti derivanti dalla raffinaz...,0,0,0,0,0,2023
LIG,SP,C 20,Fabbricazione di prodotti chimici                           ,0,0,0,0,0,2023
LIG,SP,C 21,Fabbricazione di prodotti farmaceutici di base e di prepa...,0,0,0,0,0,2023
LIG,SP,C 22,Fabbricazione di articoli in gomma e materie plastiche      ,0,0,1,0,1,2023
LIG,SP,C 23,Fabbricazione di altri prodotti della lavorazione di miner..,0,0,0,0,0,2023
LIG,SP,C 24,Metallurgia                                                 ,0,0,0,0,0,2023
LIG,SP,C 25,Fabbricazione di prodotti in metallo (esclusi macchinari ...,4,0,4,0,8,2023
LIG,SP,C 26,Fabbricazione di computer e prodotti di elettronica e ott...,0,0,0,0,0,2023
LIG,SP,C 27,Fabbricazione di apparecchiature elettriche ed apparecchi...,0,0,0,0,0,2023
LIG,SP,C 28,Fabbricazione di macchinari ed apparecchiature nca          ,0,0,0,0,0,2023
LIG,SP,C 29,"Fabbricazione di autoveicoli, rimorchi e semirimorchi       ",0,0,0,0,0,2023
LIG,SP,C 30,Fabbricazione di altri mezzi di trasporto                   ,0,0,1,0,1,2023
LIG,SP,C 31,Fabbricazione di mobili                                     ,0,0,0,0,0,2023
LIG,SP,C 32,Altre industrie manifatturiere                              ,0,0,0,0,0,2023
LIG,SP,C 33,"Riparazione, manutenzione ed installazione di macchine ed...",2,0,2,0,4,2023
LIG,SP,D   ,"Fornitura di energia elettrica, gas, vapore e aria condiz...",0,0,0,0,0,2023
LIG,SP,D 35,"Fornitura di energia elettrica, gas, vapore e aria condiz...",0,0,0,0,0,2023
LIG,SP,E   ,"Fornitura di acqua; reti fognarie, attività di gestione d...",0,0,0,0,0,2023
LIG,SP,E 36,"Raccolta, trattamento e fornitura di acqua                  ",0,0,0,0,0,2023
LIG,SP,E 37,Gestione delle reti fognarie                                ,0,0,0,0,0,2023
LIG,SP,E 38,"Attività di raccolta, trattamento e smaltimento dei rifiu...",0,0,0,0,0,2023
LIG,SP,E 39,Attività di risanamento e altri servizi di gestione dei r...,0,0,0,0,0,2023
LIG,SP,F   ,Costruzioni                                                 ,11,1,19,5,36,2023
LIG,SP,F 41,Costruzione di edifici                                      ,7,1,5,2,15,2023
LIG,SP,F 42,Ingegneria civile                                           ,0,0,0,0,0,2023
LIG,SP,F 43,Lavori di costruzione specializzati                         ,4,0,14,3,21,2023
LIG,SP,G   ,Commercio all'ingrosso e al dettaglio; riparazione di aut...,10,1,44,2,57,2023
LIG,SP,G 45,Commercio all'ingrosso e al dettaglio e riparazione di au...,4,0,2,0,6,2023
LIG,SP,G 46,Commercio all'ingrosso (escluso quello di autoveicoli e d...,3,0,5,1,9,2023
LIG,SP,G 47,Commercio al dettaglio (escluso quello di autoveicoli e d...,3,1,37,1,42,2023
LIG,SP,H   ,Trasporto e magazzinaggio                                   ,1,0,4,2,7,2023
LIG,SP,H 49,Trasporto terrestre e mediante condotte                     ,1,0,2,1,4,2023
LIG,SP,H 50,Trasporto marittimo e per vie d'acqua                       ,0,0,0,1,1,2023
LIG,SP,H 51,Trasporto aereo                                             ,0,0,0,0,0,2023
LIG,SP,H 52,Magazzinaggio e attività di supporto ai trasporti           ,0,0,2,0,2,2023
LIG,SP,H 53,Servizi postali e attività di corriere                      ,0,0,0,0,0,2023
LIG,SP,I   ,Attività dei servizi alloggio e ristorazione                ,12,1,16,1,30,2023
LIG,SP,I 55,Alloggio                                                    ,1,0,3,0,4,2023
LIG,SP,I 56,Attività dei servizi di ristorazione                        ,11,1,13,1,26,2023
LIG,SP,J   ,Servizi di informazione e comunicazione                     ,2,0,0,0,2,2023
LIG,SP,J 58,Attività editoriali                                         ,0,0,0,0,0,2023
LIG,SP,J 59,"Attività di produzione cinematografica, di video e di pro...",0,0,0,0,0,2023
LIG,SP,J 60,Attività di programmazione e trasmissione                   ,0,0,0,0,0,2023
LIG,SP,J 61,Telecomunicazioni                                           ,0,0,0,0,0,2023
LIG,SP,J 62,"Produzione di software, consulenza informatica e attività...",1,0,0,0,1,2023
LIG,SP,J 63,Attività dei servizi d'informazione e altri servizi infor...,1,0,0,0,1,2023
LIG,SP,K   ,Attività finanziarie e assicurative                         ,0,0,3,0,3,2023
LIG,SP,K 64,Attività di servizi finanziari (escluse le assicurazioni ...,0,0,0,0,0,2023
LIG,SP,K 65,"Assicurazioni, riassicurazioni e fondi pensione (escluse ...",0,0,0,0,0,2023
LIG,SP,K 66,Attività ausiliarie dei servizi finanziari e delle attivi...,0,0,3,0,3,2023
LIG,SP,L   ,Attivita' immobiliari                                       ,3,0,1,0,4,2023
LIG,SP,L 68,Attivita' immobiliari                                       ,3,0,1,0,4,2023
LIG,SP,M   ,"Attività professionali, scientifiche e tecniche             ",1,0,2,3,6,2023
LIG,SP,M 69,Attività legali e contabilità                               ,1,0,0,0,1,2023
LIG,SP,M 70,Attività di direzione aziendale e di consulenza gestional...,0,0,0,1,1,2023
LIG,SP,M 71,Attività degli studi di architettura e d'ingegneria; coll...,0,0,0,1,1,2023
LIG,SP,M 72,Ricerca scientifica e sviluppo                              ,0,0,0,0,0,2023
LIG,SP,M 73,Pubblicità e ricerche di mercato                            ,0,0,0,1,1,2023
LIG,SP,M 74,"Altre attività professionali, scientifiche e tecniche       ",0,0,2,0,2,2023
LIG,SP,M 75,Servizi veterinari                                          ,0,0,0,0,0,2023
LIG,SP,N   ,"Noleggio, agenzie di viaggio, servizi di supporto alle im...",2,0,2,0,4,2023
LIG,SP,N 77,Attività di noleggio e leasing operativo                    ,0,0,0,0,0,2023
LIG,SP,N 78,"Attività di ricerca, selezione, fornitura di personale      ",0,0,0,0,0,2023
LIG,SP,N 79,"Attività dei servizi delle agenzie di viaggio, dei tour o...",0,0,0,0,0,2023
LIG,SP,N 80,Servizi di vigilanza e investigazione                       ,0,0,1,0,1,2023
LIG,SP,N 81,Attività di servizi per edifici e paesaggio                 ,2,0,1,0,3,2023
LIG,SP,N 82,Attività di supporto per le funzioni d'ufficio e altri se...,0,0,0,0,0,2023
LIG,SP,O   ,Amministrazione pubblica e difesa; assicurazione sociale ...,0,0,0,0,0,2023
LIG,SP,O 84,Amministrazione pubblica e difesa; assicurazione sociale ...,0,0,0,0,0,2023
LIG,SP,P   ,Istruzione                                                  ,1,0,0,0,1,2023
LIG,SP,P 85,Istruzione                                                  ,1,0,0,0,1,2023
LIG,SP,Q   ,Sanita' e assistenza sociale                                ,0,0,0,0,0,2023
LIG,SP,Q 86,Assistenza sanitaria                                        ,0,0,0,0,0,2023
LIG,SP,Q 87,Servizi di assistenza sociale residenziale                  ,0,0,0,0,0,2023
LIG,SP,Q 88,Assistenza sociale non residenziale                         ,0,0,0,0,0,2023
LIG,SP,R   ,"Attività artistiche, sportive, di intrattenimento e diver...",0,0,2,0,2,2023
LIG,SP,R 90,"Attività creative, artistiche e di intrattenimento          ",0,0,0,0,0,2023
LIG,SP,R 91,"Attività di biblioteche, archivi, musei ed altre attività...",0,0,0,0,0,2023
LIG,SP,R 92,"Attività riguardanti le lotterie, le scommesse, le case d...",0,0,0,0,0,2023
LIG,SP,R 93,"Attività sportive, di intrattenimento e di divertimento     ",0,0,2,0,2,2023
LIG,SP,S   ,Altre attività di servizi                                   ,1,0,9,0,10,2023
LIG,SP,S 94,Attività di organizzazioni associative                      ,0,0,0,0,0,2023
LIG,SP,S 95,Riparazione di computer e di beni per uso personale e per...,0,0,5,0,5,2023
LIG,SP,S 96,Altre attività di servizi per la persona                    ,1,0,4,0,5,2023
LIG,SP,T   ,Attività di famiglie e convivenze come datori di lavoro p...,0,0,0,0,0,2023
LIG,SP,T 97,Attività di famiglie e convivenze come datori di lavoro p...,0,0,0,0,0,2023
LIG,SP,T 98,Produzione di beni e servizi indifferenziati per uso prop...,0,0,0,0,0,2023
LIG,SP,U   ,Organizzazioni ed organismi extraterritoriali               ,0,0,0,0,0,2023
LIG,SP,U 99,Organizzazioni ed organismi extraterritoriali               ,0,0,0,0,0,2023
LIG,SP,XX  ,Imprese non classificate                                    ,4,2,18,0,24,2023
LIG,SP,TOT ,TOTALE                                                      ,54,5,153,14,226,2023
EMI,  ,A   ,"Agricoltura, silvicoltura pesca                             ",18,18,454,5,495,2023
EMI,  ,A 01,"Coltivazioni agricole e produzione di prodotti animali, c...",17,15,445,4,481,2023
EMI,  ,A 02,Silvicoltura ed utilizzo di aree forestali                  ,0,1,2,1,4,2023
EMI,  ,A 03,Pesca e acquacoltura                                        ,1,2,7,0,10,2023
EMI,  ,B   ,Estrazione di minerali da cave e miniere                    ,0,0,1,0,1,2023
EMI,  ,B 05,Estrazione di carbone (esclusa torba)                       ,0,0,0,0,0,2023
EMI,  ,B 06,Estraz.di petrolio greggio e di gas naturale                ,0,0,0,0,0,2023
EMI,  ,B 07,Estrazione di minerali metalliferi                          ,0,0,0,0,0,2023
EMI,  ,B 08,Altre attività di estrazione di minerali da cave e miniere  ,0,0,1,0,1,2023
EMI,  ,B 09,Attività dei servizi di supporto all'estrazione             ,0,0,0,0,0,2023
EMI,  ,C   ,Attività manifatturiere                                     ,437,115,698,13,1263,2023
EMI,  ,C 10,Industrie alimentari                                        ,33,11,25,6,75,2023
EMI,  ,C 11,Industria delle bevande                                     ,3,1,0,0,4,2023
EMI,  ,C 12,Industria del tabacco                                       ,0,0,0,0,0,2023
EMI,  ,C 13,Industrie tessili                                           ,10,3,29,0,42,2023
EMI,  ,C 14,Confezione di articoli di abbigliamento; confezione di ar...,53,17,216,0,286,2023
EMI,  ,C 15,Fabbricazione di articoli in pelle e simili                 ,12,1,22,0,35,2023
EMI,  ,C 16,Industria del legno e dei prodotti in legno e sughero (es...,11,7,41,1,60,2023
EMI,  ,C 17,Fabbricazione di carta e di prodotti di carta               ,8,4,3,0,15,2023
EMI,  ,C 18,Stampa e riproduzione di supporti registrati                ,8,4,8,1,21,2023
EMI,  ,C 19,Fabbricazione di coke e prodotti derivanti dalla raffinaz...,1,0,0,0,1,2023
EMI,  ,C 20,Fabbricazione di prodotti chimici                           ,12,0,0,0,12,2023
EMI,  ,C 21,Fabbricazione di prodotti farmaceutici di base e di prepa...,0,1,0,0,1,2023
EMI,  ,C 22,Fabbricazione di articoli in gomma e materie plastiche      ,8,2,15,0,25,2023
EMI,  ,C 23,Fabbricazione di altri prodotti della lavorazione di miner..,27,9,16,0,52,2023
EMI,  ,C 24,Metallurgia                                                 ,8,0,4,0,12,2023
EMI,  ,C 25,Fabbricazione di prodotti in metallo (esclusi macchinari ...,92,21,170,3,286,2023
EMI,  ,C 26,Fabbricazione di computer e prodotti di elettronica e ott...,12,4,6,0,22,2023
EMI,  ,C 27,Fabbricazione di apparecchiature elettriche ed apparecchi...,23,6,8,0,37,2023
EMI,  ,C 28,Fabbricazione di macchinari ed apparecchiature nca          ,76,7,28,0,111,2023
EMI,  ,C 29,"Fabbricazione di autoveicoli, rimorchi e semirimorchi       ",3,0,2,0,5,2023
EMI,  ,C 30,Fabbricazione di altri mezzi di trasporto                   ,5,0,11,0,16,2023
EMI,  ,C 31,Fabbricazione di mobili                                     ,16,14,25,0,55,2023
EMI,  ,C 32,Altre industrie manifatturiere                              ,9,2,26,0,37,2023
EMI,  ,C 33,"Riparazione, manutenzione ed installazione di macchine ed...",7,1,43,2,53,2023
EMI,  ,D   ,"Fornitura di energia elettrica, gas, vapore e aria condiz...",3,0,1,1,5,2023
EMI,  ,D 35,"Fornitura di energia elettrica, gas, vapore e aria condiz...",3,0,1,1,5,2023
EMI,  ,E   ,"Fornitura di acqua; reti fognarie, attività di gestione d...",4,0,5,1,10,2023
EMI,  ,E 36,"Raccolta, trattamento e fornitura di acqua                  ",0,0,0,0,0,2023
EMI,  ,E 37,Gestione delle reti fognarie                                ,0,0,0,0,0,2023
EMI,  ,E 38,"Attività di raccolta, trattamento e smaltimento dei rifiu...",4,0,5,1,10,2023
EMI,  ,E 39,Attività di risanamento e altri servizi di gestione dei r...,0,0,0,0,0,2023
EMI,  ,F   ,Costruzioni                                                 ,297,54,2888,78,3317,2023
EMI,  ,F 41,Costruzione di edifici                                      ,201,20,434,52,707,2023
EMI,  ,F 42,Ingegneria civile                                           ,9,1,11,3,24,2023
EMI,  ,F 43,Lavori di costruzione specializzati                         ,87,33,2443,23,2586,2023
EMI,  ,G   ,Commercio all'ingrosso e al dettaglio; riparazione di aut...,496,163,1673,13,2345,2023
EMI,  ,G 45,Commercio all'ingrosso e al dettaglio e riparazione di au...,42,19,162,3,226,2023
EMI,  ,G 46,Commercio all'ingrosso (escluso quello di autoveicoli e d...,318,60,396,5,779,2023
EMI,  ,G 47,Commercio al dettaglio (escluso quello di autoveicoli e d...,136,84,1115,5,1340,2023
EMI,  ,H   ,Trasporto e magazzinaggio                                   ,45,18,187,50,300,2023
EMI,  ,H 49,Trasporto terrestre e mediante condotte                     ,29,16,172,10,227,2023
EMI,  ,H 50,Trasporto marittimo e per vie d'acqua                       ,0,0,0,0,0,2023
EMI,  ,H 51,Trasporto aereo                                             ,0,0,0,0,0,2023
EMI,  ,H 52,Magazzinaggio e attività di supporto ai trasporti           ,16,2,14,40,72,2023
EMI,  ,H 53,Servizi postali e attività di corriere                      ,0,0,1,0,1,2023
EMI,  ,I   ,Attività dei servizi alloggio e ristorazione                ,145,122,311,5,583,2023
EMI,  ,I 55,Alloggio                                                    ,13,10,19,1,43,2023
EMI,  ,I 56,Attività dei servizi di ristorazione                        ,132,112,292,4,540,2023
EMI,  ,J   ,Servizi di informazione e comunicazione                     ,70,11,85,2,168,2023
EMI,  ,J 58,Attività editoriali                                         ,9,1,8,1,19,2023
EMI,  ,J 59,"Attività di produzione cinematografica, di video e di pro...",4,1,5,0,10,2023
EMI,  ,J 60,Attività di programmazione e trasmissione                   ,1,0,0,0,1,2023
EMI,  ,J 61,Telecomunicazioni                                           ,3,0,42,0,45,2023
EMI,  ,J 62,"Produzione di software, consulenza informatica e attività...",34,5,13,1,53,2023
EMI,  ,J 63,Attività dei servizi d'informazione e altri servizi infor...,19,4,17,0,40,2023
EMI,  ,K   ,Attività finanziarie e assicurative                         ,34,7,39,0,80,2023
EMI,  ,K 64,Attività di servizi finanziari (escluse le assicurazioni ...,29,2,0,0,31,2023
EMI,  ,K 65,"Assicurazioni, riassicurazioni e fondi pensione (escluse ...",0,0,0,0,0,2023
EMI,  ,K 66,Attività ausiliarie dei servizi finanziari e delle attivi...,5,5,39,0,49,2023
EMI,  ,L   ,Attivita' immobiliari                                       ,144,43,25,5,217,2023
EMI,  ,L 68,Attivita' immobiliari                                       ,144,43,25,5,217,2023
EMI,  ,M   ,"Attività professionali, scientifiche e tecniche             ",120,16,93,12,241,2023
EMI,  ,M 69,Attività legali e contabilità                               ,10,2,1,2,15,2023
EMI,  ,M 70,Attività di direzione aziendale e di consulenza gestional...,32,2,15,7,56,2023
EMI,  ,M 71,Attività degli studi di architettura e d'ingegneria; coll...,25,1,3,2,31,2023
EMI,  ,M 72,Ricerca scientifica e sviluppo                              ,1,0,0,0,1,2023
EMI,  ,M 73,Pubblicità e ricerche di mercato                            ,27,1,32,1,61,2023
EMI,  ,M 74,"Altre attività professionali, scientifiche e tecniche       ",25,10,42,0,77,2023
EMI,  ,M 75,Servizi veterinari                                          ,0,0,0,0,0,2023
EMI,  ,N   ,"Noleggio, agenzie di viaggio, servizi di supporto alle im...",53,10,160,25,248,2023
EMI,  ,N 77,Attività di noleggio e leasing operativo                    ,12,0,16,1,29,2023
EMI,  ,N 78,"Attività di ricerca, selezione, fornitura di personale      ",0,0,1,0,1,2023
EMI,  ,N 79,"Attività dei servizi delle agenzie di viaggio, dei tour o...",7,4,5,1,17,2023
EMI,  ,N 80,Servizi di vigilanza e investigazione                       ,2,0,2,1,5,2023
EMI,  ,N 81,Attività di servizi per edifici e paesaggio                 ,5,3,74,11,93,2023
EMI,  ,N 82,Attività di supporto per le funzioni d'ufficio e altri se...,27,3,62,11,103,2023
EMI,  ,O   ,Amministrazione pubblica e difesa; assicurazione sociale ...,0,0,0,0,0,2023
EMI,  ,O 84,Amministrazione pubblica e difesa; assicurazione sociale ...,0,0,0,0,0,2023
EMI,  ,P   ,Istruzione                                                  ,8,1,7,4,20,2023
EMI,  ,P 85,Istruzione                                                  ,8,1,7,4,20,2023
EMI,  ,Q   ,Sanita' e assistenza sociale                                ,9,0,2,15,26,2023
EMI,  ,Q 86,Assistenza sanitaria                                        ,6,0,1,1,8,2023
EMI,  ,Q 87,Servizi di assistenza sociale residenziale                  ,3,0,0,3,6,2023
EMI,  ,Q 88,Assistenza sociale non residenziale                         ,0,0,1,11,12,2023
EMI,  ,R   ,"Attività artistiche, sportive, di intrattenimento e diver...",43,5,53,7,108,2023
EMI,  ,R 90,"Attività creative, artistiche e di intrattenimento          ",13,2,13,2,30,2023
EMI,  ,R 91,"Attività di biblioteche, archivi, musei ed altre attività...",0,0,0,1,1,2023
EMI,  ,R 92,"Attività riguardanti le lotterie, le scommesse, le case d...",3,1,1,0,5,2023
EMI,  ,R 93,"Attività sportive, di intrattenimento e di divertimento     ",27,2,39,4,72,2023
EMI,  ,S   ,Altre attività di servizi                                   ,15,9,123,7,154,2023
EMI,  ,S 94,Attività di organizzazioni associative                      ,0,0,0,1,1,2023
EMI,  ,S 95,Riparazione di computer e di beni per uso personale e per...,1,2,62,0,65,2023
EMI,  ,S 96,Altre attività di servizi per la persona                    ,14,7,61,6,88,2023
EMI,  ,T   ,Attività di famiglie e convivenze come datori di lavoro p...,0,0,0,0,0,2023
EMI,  ,T 97,Attività di famiglie e convivenze come datori di lavoro p...,0,0,0,0,0,2023
EMI,  ,T 98,Produzione di beni e servizi indifferenziati per uso prop...,0,0,0,0,0,2023
EMI,  ,U   ,Organizzazioni ed organismi extraterritoriali               ,0,0,0,0,0,2023
EMI,  ,U 99,Organizzazioni ed organismi extraterritoriali               ,0,0,0,0,0,2023
EMI,  ,XX  ,Imprese non classificate                                    ,367,41,130,31,569,2023
EMI,  ,TOT ,TOTALE                                                      ,2308,633,6935,274,10150,2023
EMI,PC,A   ,"Agricoltura, silvicoltura pesca                             ",0,6,91,1,98,2023
EMI,PC,A 01,"Coltivazioni agricole e produzione di prodotti animali, c...",0,5,91,1,97,2023
EMI,PC,A 02,Silvicoltura ed utilizzo di aree forestali                  ,0,1,0,0,1,2023
EMI,PC,A 03,Pesca e acquacoltura                                        ,0,0,0,0,0,2023
EMI,PC,B   ,Estrazione di minerali da cave e miniere                    ,0,0,0,0,0,2023
EMI,PC,B 05,Estrazione di carbone (esclusa torba)                       ,0,0,0,0,0,2023
EMI,PC,B 06,Estraz.di petrolio greggio e di gas naturale                ,0,0,0,0,0,2023
EMI,PC,B 07,Estrazione di minerali metalliferi                          ,0,0,0,0,0,2023
EMI,PC,B 08,Altre attività di estrazione di minerali da cave e miniere  ,0,0,0,0,0,2023
EMI,PC,B 09,Attività dei servizi di supporto all'estrazione             ,0,0,0,0,0,2023
EMI,PC,C   ,Attività manifatturiere                                     ,10,1,20,1,32,2023
EMI,PC,C 10,Industrie alimentari                                        ,0,0,2,1,3,2023
EMI,PC,C 11,Industria delle bevande                                     ,0,0,0,0,0,2023
EMI,PC,C 12,Industria del tabacco                                       ,0,0,0,0,0,2023
EMI,PC,C 13,Industrie tessili                                           ,0,0,3,0,3,2023
EMI,PC,C 14,Confezione di articoli di abbigliamento; confezione di ar...,1,0,3,0,4,2023
EMI,PC,C 15,Fabbricazione di articoli in pelle e simili                 ,0,0,0,0,0,2023
EMI,PC,C 16,Industria del legno e dei prodotti in legno e sughero (es...,0,0,0,0,0,2023
EMI,PC,C 17,Fabbricazione di carta e di prodotti di carta               ,0,0,1,0,1,2023
EMI,PC,C 18,Stampa e riproduzione di supporti registrati                ,1,0,1,0,2,2023
EMI,PC,C 19,Fabbricazione di coke e prodotti derivanti dalla raffinaz...,0,0,0,0,0,2023
EMI,PC,C 20,Fabbricazione di prodotti chimici                           ,0,0,0,0,0,2023
EMI,PC,C 21,Fabbricazione di prodotti farmaceutici di base e di prepa...,0,0,0,0,0,2023
EMI,PC,C 22,Fabbricazione di articoli in gomma e materie plastiche      ,0,0,1,0,1,2023
EMI,PC,C 23,Fabbricazione di altri prodotti della lavorazione di miner..,1,0,0,0,1,2023
EMI,PC,C 24,Metallurgia                                                 ,1,0,0,0,1,2023
EMI,PC,C 25,Fabbricazione di prodotti in metallo (esclusi macchinari ...,3,1,4,0,8,2023
EMI,PC,C 26,Fabbricazione di computer e prodotti di elettronica e ott...,0,0,1,0,1,2023
EMI,PC,C 27,Fabbricazione di apparecchiature elettriche ed apparecchi...,0,0,0,0,0,2023
EMI,PC,C 28,Fabbricazione di macchinari ed apparecchiature nca          ,2,0,3,0,5,2023
EMI,PC,C 29,"Fabbricazione di autoveicoli, rimorchi e semirimorchi       ",0,0,0,0,0,2023
EMI,PC,C 30,Fabbricazione di altri mezzi di trasporto                   ,1,0,0,0,1,2023
EMI,PC,C 31,Fabbricazione di mobili                                     ,0,0,0,0,0,2023
EMI,PC,C 32,Altre industrie manifatturiere                              ,0,0,1,0,1,2023
EMI,PC,C 33,"Riparazione, manutenzione ed installazione di macchine ed...",0,0,0,0,0,2023
EMI,PC,D   ,"Fornitura di energia elettrica, gas, vapore e aria condiz...",0,0,0,1,1,2023
EMI,PC,D 35,"Fornitura di energia elettrica, gas, vapore e aria condiz...",0,0,0,1,1,2023
EMI,PC,E   ,"Fornitura di acqua; reti fognarie, attività di gestione d...",0,0,0,0,0,2023
EMI,PC,E 36,"Raccolta, trattamento e fornitura di acqua                  ",0,0,0,0,0,2023
EMI,PC,E 37,Gestione delle reti fognarie                                ,0,0,0,0,0,2023
EMI,PC,E 38,"Attività di raccolta, trattamento e smaltimento dei rifiu...",0,0,0,0,0,2023
EMI,PC,E 39,Attività di risanamento e altri servizi di gestione dei r...,0,0,0,0,0,2023
EMI,PC,F   ,Costruzioni                                                 ,16,3,16,2,37,2023
EMI,PC,F 41,Costruzione di edifici                                      ,12,0,5,2,19,2023
EMI,PC,F 42,Ingegneria civile                                           ,1,0,0,0,1,2023
EMI,PC,F 43,Lavori di costruzione specializzati                         ,3,3,11,0,17,2023
EMI,PC,G   ,Commercio all'ingrosso e al dettaglio; riparazione di aut...,27,11,21,2,61,2023
EMI,PC,G 45,Commercio all'ingrosso e al dettaglio e riparazione di au...,7,1,2,1,11,2023
EMI,PC,G 46,Commercio all'ingrosso (escluso quello di autoveicoli e d...,15,2,5,0,22,2023
EMI,PC,G 47,Commercio al dettaglio (escluso quello di autoveicoli e d...,5,8,14,1,28,2023
EMI,PC,H   ,Trasporto e magazzinaggio                                   ,3,1,6,1,11,2023
EMI,PC,H 49,Trasporto terrestre e mediante condotte                     ,3,1,6,1,11,2023
EMI,PC,H 50,Trasporto marittimo e per vie d'acqua                       ,0,0,0,0,0,2023
EMI,PC,H 51,Trasporto aereo                                             ,0,0,0,0,0,2023
EMI,PC,H 52,Magazzinaggio e attività di supporto ai trasporti           ,0,0,0,0,0,2023
EMI,PC,H 53,Servizi postali e attività di corriere                      ,0,0,0,0,0,2023
EMI,PC,I   ,Attività dei servizi alloggio e ristorazione                ,9,13,7,0,29,2023
EMI,PC,I 55,Alloggio                                                    ,1,0,1,0,2,2023
EMI,PC,I 56,Attività dei servizi di ristorazione                        ,8,13,6,0,27,2023
EMI,PC,J   ,Servizi di informazione e comunicazione                     ,4,2,2,0,8,2023
EMI,PC,J 58,Attività editoriali                                         ,1,0,0,0,1,2023
EMI,PC,J 59,"Attività di produzione cinematografica, di video e di pro...",0,1,1,0,2,2023
EMI,PC,J 60,Attività di programmazione e trasmissione                   ,0,0,0,0,0,2023
EMI,PC,J 61,Telecomunicazioni                                           ,0,0,0,0,0,2023
EMI,PC,J 62,"Produzione di software, consulenza informatica e attività...",2,0,0,0,2,2023
EMI,PC,J 63,Attività dei servizi d'informazione e altri servizi infor...,1,1,1,0,3,2023
EMI,PC,K   ,Attività finanziarie e assicurative                         ,1,0,1,0,2,2023
EMI,PC,K 64,Attività di servizi finanziari (escluse le assicurazioni ...,0,0,0,0,0,2023
EMI,PC,K 65,"Assicurazioni, riassicurazioni e fondi pensione (escluse ...",0,0,0,0,0,2023
EMI,PC,K 66,Attività ausiliarie dei servizi finanziari e delle attivi...,1,0,1,0,2,2023
EMI,PC,L   ,Attivita' immobiliari                                       ,5,1,0,0,6,2023
EMI,PC,L 68,Attivita' immobiliari                                       ,5,1,0,0,6,2023
EMI,PC,M   ,"Attività professionali, scientifiche e tecniche             ",6,0,3,0,9,2023
EMI,PC,M 69,Attività legali e contabilità                               ,0,0,0,0,0,2023
EMI,PC,M 70,Attività di direzione aziendale e di consulenza gestional...,2,0,1,0,3,2023
EMI,PC,M 71,Attività degli studi di architettura e d'ingegneria; coll...,0,0,0,0,0,2023
EMI,PC,M 72,Ricerca scientifica e sviluppo                              ,0,0,0,0,0,2023
EMI,PC,M 73,Pubblicità e ricerche di mercato                            ,3,0,0,0,3,2023
EMI,PC,M 74,"Altre attività professionali, scientifiche e tecniche       ",1,0,2,0,3,2023
EMI,PC,M 75,Servizi veterinari                                          ,0,0,0,0,0,2023
EMI,PC,N   ,"Noleggio, agenzie di viaggio, servizi di supporto alle im...",3,2,1,1,7,2023
EMI,PC,N 77,Attività di noleggio e leasing operativo                    ,1,0,0,0,1,2023
EMI,PC,N 78,"Attività di ricerca, selezione, fornitura di personale      ",0,0,0,0,0,2023
EMI,PC,N 79,"Attività dei servizi delle agenzie di viaggio, dei tour o...",1,1,0,0,2,2023
EMI,PC,N 80,Servizi di vigilanza e investigazione                       ,0,0,0,0,0,2023
EMI,PC,N 81,Attività di servizi per edifici e paesaggio                 ,0,1,0,0,1,2023
EMI,PC,N 82,Attività di supporto per le funzioni d'ufficio e altri se...,1,0,1,1,3,2023
EMI,PC,O   ,Amministrazione pubblica e difesa; assicurazione sociale ...,0,0,0,0,0,2023
EMI,PC,O 84,Amministrazione pubblica e difesa; assicurazione sociale ...,0,0,0,0,0,2023
EMI,PC,P   ,Istruzione                                                  ,0,0,0,0,0,2023
EMI,PC,P 85,Istruzione                                                  ,0,0,0,0,0,2023
EMI,PC,Q   ,Sanita' e assistenza sociale                                ,1,0,0,0,1,2023
EMI,PC,Q 86,Assistenza sanitaria                                        ,1,0,0,0,1,2023
EMI,PC,Q 87,Servizi di assistenza sociale residenziale                  ,0,0,0,0,0,2023
EMI,PC,Q 88,Assistenza sociale non residenziale                         ,0,0,0,0,0,2023
EMI,PC,R   ,"Attività artistiche, sportive, di intrattenimento e diver...",1,1,0,2,4,2023
EMI,PC,R 90,"Attività creative, artistiche e di intrattenimento          ",0,0,0,1,1,2023
EMI,PC,R 91,"Attività di biblioteche, archivi, musei ed altre attività...",0,0,0,0,0,2023
EMI,PC,R 92,"Attività riguardanti le lotterie, le scommesse, le case d...",0,1,0,0,1,2023
EMI,PC,R 93,"Attività sportive, di intrattenimento e di divertimento     ",1,0,0,1,2,2023
EMI,PC,S   ,Altre attività di servizi                                   ,1,2,2,0,5,2023
EMI,PC,S 94,Attività di organizzazioni associative                      ,0,0,0,0,0,2023
EMI,PC,S 95,Riparazione di computer e di beni per uso personale e per...,0,0,1,0,1,2023
EMI,PC,S 96,Altre attività di servizi per la persona                    ,1,2,1,0,4,2023
EMI,PC,T   ,Attività di famiglie e convivenze come datori di lavoro p...,0,0,0,0,0,2023
EMI,PC,T 97,Attività di famiglie e convivenze come datori di lavoro p...,0,0,0,0,0,2023
EMI,PC,T 98,Produzione di beni e servizi indifferenziati per uso prop...,0,0,0,0,0,2023
EMI,PC,U   ,Organizzazioni ed organismi extraterritoriali               ,0,0,0,0,0,2023
EMI,PC,U 99,Organizzazioni ed organismi extraterritoriali               ,0,0,0,0,0,2023
EMI,PC,XX  ,Imprese non classificate                                    ,15,1,2,1,19,2023
EMI,PC,TOT ,TOTALE                                                      ,102,44,172,12,330,2023
EMI,PR,A   ,"Agricoltura, silvicoltura pesca                             ",5,0,0,2,7,2023
EMI,PR,A 01,"Coltivazioni agricole e produzione di prodotti animali, c...",5,0,0,1,6,2023
EMI,PR,A 02,Silvicoltura ed utilizzo di aree forestali                  ,0,0,0,1,1,2023
EMI,PR,A 03,Pesca e acquacoltura                                        ,0,0,0,0,0,2023
EMI,PR,B   ,Estrazione di minerali da cave e miniere                    ,0,0,0,0,0,2023
EMI,PR,B 05,Estrazione di carbone (esclusa torba)                       ,0,0,0,0,0,2023
EMI,PR,B 06,Estraz.di petrolio greggio e di gas naturale                ,0,0,0,0,0,2023
EMI,PR,B 07,Estrazione di minerali metalliferi                          ,0,0,0,0,0,2023
EMI,PR,B 08,Altre attività di estrazione di minerali da cave e miniere  ,0,0,0,0,0,2023
EMI,PR,B 09,Attività dei servizi di supporto all'estrazione             ,0,0,0,0,0,2023
EMI,PR,C   ,Attività manifatturiere                                     ,173,0,0,4,177,2023
EMI,PR,C 10,Industrie alimentari                                        ,15,0,0,3,18,2023
EMI,PR,C 11,Industria delle bevande                                     ,2,0,0,0,2,2023
EMI,PR,C 12,Industria del tabacco                                       ,0,0,0,0,0,2023
EMI,PR,C 13,Industrie tessili                                           ,3,0,0,0,3,2023
EMI,PR,C 14,Confezione di articoli di abbigliamento; confezione di ar...,16,0,0,0,16,2023
EMI,PR,C 15,Fabbricazione di articoli in pelle e simili                 ,6,0,0,0,6,2023
EMI,PR,C 16,Industria del legno e dei prodotti in legno e sughero (es...,3,0,0,0,3,2023
EMI,PR,C 17,Fabbricazione di carta e di prodotti di carta               ,4,0,0,0,4,2023
EMI,PR,C 18,Stampa e riproduzione di supporti registrati                ,2,0,0,0,2,2023
EMI,PR,C 19,Fabbricazione di coke e prodotti derivanti dalla raffinaz...,1,0,0,0,1,2023
EMI,PR,C 20,Fabbricazione di prodotti chimici                           ,3,0,0,0,3,2023
EMI,PR,C 21,Fabbricazione di prodotti farmaceutici di base e di prepa...,0,0,0,0,0,2023
EMI,PR,C 22,Fabbricazione di articoli in gomma e materie plastiche      ,4,0,0,0,4,2023
EMI,PR,C 23,Fabbricazione di altri prodotti della lavorazione di miner..,12,0,0,0,12,2023
EMI,PR,C 24,Metallurgia                                                 ,4,0,0,0,4,2023
EMI,PR,C 25,Fabbricazione di prodotti in metallo (esclusi macchinari ...,29,0,0,0,29,2023
EMI,PR,C 26,Fabbricazione di computer e prodotti di elettronica e ott...,6,0,0,0,6,2023
EMI,PR,C 27,Fabbricazione di apparecchiature elettriche ed apparecchi...,11,0,0,0,11,2023
EMI,PR,C 28,Fabbricazione di macchinari ed apparecchiature nca          ,35,0,0,0,35,2023
EMI,PR,C 29,"Fabbricazione di autoveicoli, rimorchi e semirimorchi       ",0,0,0,0,0,2023
EMI,PR,C 30,Fabbricazione di altri mezzi di trasporto                   ,2,0,0,0,2,2023
EMI,PR,C 31,Fabbricazione di mobili                                     ,10,0,0,0,10,2023
EMI,PR,C 32,Altre industrie manifatturiere                              ,3,0,0,0,3,2023
EMI,PR,C 33,"Riparazione, manutenzione ed installazione di macchine ed...",2,0,0,1,3,2023
EMI,PR,D   ,"Fornitura di energia elettrica, gas, vapore e aria condiz...",0,0,0,0,0,2023
EMI,PR,D 35,"Fornitura di energia elettrica, gas, vapore e aria condiz...",0,0,0,0,0,2023
EMI,PR,E   ,"Fornitura di acqua; reti fognarie, attività di gestione d...",2,0,0,0,2,2023
EMI,PR,E 36,"Raccolta, trattamento e fornitura di acqua                  ",0,0,0,0,0,2023
EMI,PR,E 37,Gestione delle reti fognarie                                ,0,0,0,0,0,2023
EMI,PR,E 38,"Attività di raccolta, trattamento e smaltimento dei rifiu...",2,0,0,0,2,2023
EMI,PR,E 39,Attività di risanamento e altri servizi di gestione dei r...,0,0,0,0,0,2023
EMI,PR,F   ,Costruzioni                                                 ,105,0,0,17,122,2023
EMI,PR,F 41,Costruzione di edifici                                      ,77,0,0,12,89,2023
EMI,PR,F 42,Ingegneria civile                                           ,4,0,0,3,7,2023
EMI,PR,F 43,Lavori di costruzione specializzati                         ,24,0,0,2,26,2023
EMI,PR,G   ,Commercio all'ingrosso e al dettaglio; riparazione di aut...,176,0,0,0,176,2023
EMI,PR,G 45,Commercio all'ingrosso e al dettaglio e riparazione di au...,11,0,0,0,11,2023
EMI,PR,G 46,Commercio all'ingrosso (escluso quello di autoveicoli e d...,121,0,0,0,121,2023
EMI,PR,G 47,Commercio al dettaglio (escluso quello di autoveicoli e d...,44,0,0,0,44,2023
EMI,PR,H   ,Trasporto e magazzinaggio                                   ,14,0,0,3,17,2023
EMI,PR,H 49,Trasporto terrestre e mediante condotte                     ,10,0,0,3,13,2023
EMI,PR,H 50,Trasporto marittimo e per vie d'acqua                       ,0,0,0,0,0,2023
EMI,PR,H 51,Trasporto aereo                                             ,0,0,0,0,0,2023
EMI,PR,H 52,Magazzinaggio e attività di supporto ai trasporti           ,4,0,0,0,4,2023
EMI,PR,H 53,Servizi postali e attività di corriere                      ,0,0,0,0,0,2023
EMI,PR,I   ,Attività dei servizi alloggio e ristorazione                ,40,0,0,1,41,2023
EMI,PR,I 55,Alloggio                                                    ,7,0,0,0,7,2023
EMI,PR,I 56,Attività dei servizi di ristorazione                        ,33,0,0,1,34,2023
EMI,PR,J   ,Servizi di informazione e comunicazione                     ,23,0,0,0,23,2023
EMI,PR,J 58,Attività editoriali                                         ,5,0,0,0,5,2023
EMI,PR,J 59,"Attività di produzione cinematografica, di video e di pro...",1,0,0,0,1,2023
EMI,PR,J 60,Attività di programmazione e trasmissione                   ,0,0,0,0,0,2023
EMI,PR,J 61,Telecomunicazioni                                           ,1,0,0,0,1,2023
EMI,PR,J 62,"Produzione di software, consulenza informatica e attività...",9,0,0,0,9,2023
EMI,PR,J 63,Attività dei servizi d'informazione e altri servizi infor...,7,0,0,0,7,2023
EMI,PR,K   ,Attività finanziarie e assicurative                         ,19,0,0,0,19,2023
EMI,PR,K 64,Attività di servizi finanziari (escluse le assicurazioni ...,17,0,0,0,17,2023
EMI,PR,K 65,"Assicurazioni, riassicurazioni e fondi pensione (escluse ...",0,0,0,0,0,2023
EMI,PR,K 66,Attività ausiliarie dei servizi finanziari e delle attivi...,2,0,0,0,2,2023
EMI,PR,L   ,Attivita' immobiliari                                       ,34,0,0,0,34,2023
EMI,PR,L 68,Attivita' immobiliari                                       ,34,0,0,0,34,2023
EMI,PR,M   ,"Attività professionali, scientifiche e tecniche             ",50,0,0,1,51,2023
EMI,PR,M 69,Attività legali e contabilità                               ,3,0,0,0,3,2023
EMI,PR,M 70,Attività di direzione aziendale e di consulenza gestional...,17,0,0,0,17,2023
EMI,PR,M 71,Attività degli studi di architettura e d'ingegneria; coll...,8,0,0,1,9,2023
EMI,PR,M 72,Ricerca scientifica e sviluppo                              ,0,0,0,0,0,2023
EMI,PR,M 73,Pubblicità e ricerche di mercato                            ,11,0,0,0,11,2023
EMI,PR,M 74,"Altre attività professionali, scientifiche e tecniche       ",11,0,0,0,11,2023
EMI,PR,M 75,Servizi veterinari                                          ,0,0,0,0,0,2023
EMI,PR,N   ,"Noleggio, agenzie di viaggio, servizi di supporto alle im...",16,0,0,3,19,2023
EMI,PR,N 77,Attività di noleggio e leasing operativo                    ,3,0,0,0,3,2023
EMI,PR,N 78,"Attività di ricerca, selezione, fornitura di personale      ",0,0,0,0,0,2023
EMI,PR,N 79,"Attività dei servizi delle agenzie di viaggio, dei tour o...",1,0,0,0,1,2023
EMI,PR,N 80,Servizi di vigilanza e investigazione                       ,1,0,0,0,1,2023
EMI,PR,N 81,Attività di servizi per edifici e paesaggio                 ,0,0,0,1,1,2023
EMI,PR,N 82,Attività di supporto per le funzioni d'ufficio e altri se...,11,0,0,2,13,2023
EMI,PR,O   ,Amministrazione pubblica e difesa; assicurazione sociale ...,0,0,0,0,0,2023
EMI,PR,O 84,Amministrazione pubblica e difesa; assicurazione sociale ...,0,0,0,0,0,2023
EMI,PR,P   ,Istruzione                                                  ,4,0,0,0,4,2023
EMI,PR,P 85,Istruzione                                                  ,4,0,0,0,4,2023
EMI,PR,Q   ,Sanita' e assistenza sociale                                ,4,0,0,3,7,2023
EMI,PR,Q 86,Assistenza sanitaria                                        ,2,0,0,0,2,2023
EMI,PR,Q 87,Servizi di assistenza sociale residenziale                  ,2,0,0,2,4,2023
EMI,PR,Q 88,Assistenza sociale non residenziale                         ,0,0,0,1,1,2023
EMI,PR,R   ,"Attività artistiche, sportive, di intrattenimento e diver...",10,0,0,1,11,2023
EMI,PR,R 90,"Attività creative, artistiche e di intrattenimento          ",4,0,0,0,4,2023
EMI,PR,R 91,"Attività di biblioteche, archivi, musei ed altre attività...",0,0,0,0,0,2023
EMI,PR,R 92,"Attività riguardanti le lotterie, le scommesse, le case d...",0,0,0,0,0,2023
EMI,PR,R 93,"Attività sportive, di intrattenimento e di divertimento     ",6,0,0,1,7,2023
EMI,PR,S   ,Altre attività di servizi                                   ,7,0,0,0,7,2023
EMI,PR,S 94,Attività di organizzazioni associative                      ,0,0,0,0,0,2023
EMI,PR,S 95,Riparazione di computer e di beni per uso personale e per...,1,0,0,0,1,2023
EMI,PR,S 96,Altre attività di servizi per la persona                    ,6,0,0,0,6,2023
EMI,PR,T   ,Attività di famiglie e convivenze come datori di lavoro p...,0,0,0,0,0,2023
EMI,PR,T 97,Attività di famiglie e convivenze come datori di lavoro p...,0,0,0,0,0,2023
EMI,PR,T 98,Produzione di beni e servizi indifferenziati per uso prop...,0,0,0,0,0,2023
EMI,PR,U   ,Organizzazioni ed organismi extraterritoriali               ,0,0,0,0,0,2023
EMI,PR,U 99,Organizzazioni ed organismi extraterritoriali               ,0,0,0,0,0,2023
EMI,PR,XX  ,Imprese non classificate                                    ,118,0,0,4,122,2023
EMI,PR,TOT ,TOTALE                                                      ,800,0,0,39,839,2023
EMI,RE,A   ,"Agricoltura, silvicoltura pesca                             ",1,1,14,1,17,2023
EMI,RE,A 01,"Coltivazioni agricole e produzione di prodotti animali, c...",1,1,14,1,17,2023
EMI,RE,A 02,Silvicoltura ed utilizzo di aree forestali                  ,0,0,0,0,0,2023
EMI,RE,A 03,Pesca e acquacoltura                                        ,0,0,0,0,0,2023
EMI,RE,B   ,Estrazione di minerali da cave e miniere                    ,0,0,1,0,1,2023
EMI,RE,B 05,Estrazione di carbone (esclusa torba)                       ,0,0,0,0,0,2023
EMI,RE,B 06,Estraz.di petrolio greggio e di gas naturale                ,0,0,0,0,0,2023
EMI,RE,B 07,Estrazione di minerali metalliferi                          ,0,0,0,0,0,2023
EMI,RE,B 08,Altre attività di estrazione di minerali da cave e miniere  ,0,0,1,0,1,2023
EMI,RE,B 09,Attività dei servizi di supporto all'estrazione             ,0,0,0,0,0,2023
EMI,RE,C   ,Attività manifatturiere                                     ,20,9,212,1,242,2023
EMI,RE,C 10,Industrie alimentari                                        ,0,1,3,0,4,2023
EMI,RE,C 11,Industria delle bevande                                     ,0,0,0,0,0,2023
EMI,RE,C 12,Industria del tabacco                                       ,0,0,0,0,0,2023
EMI,RE,C 13,Industrie tessili                                           ,1,2,12,0,15,2023
EMI,RE,C 14,Confezione di articoli di abbigliamento; confezione di ar...,0,0,117,0,117,2023
EMI,RE,C 15,Fabbricazione di articoli in pelle e simili                 ,0,0,2,0,2,2023
EMI,RE,C 16,Industria del legno e dei prodotti in legno e sughero (es...,2,2,5,0,9,2023
EMI,RE,C 17,Fabbricazione di carta e di prodotti di carta               ,0,0,0,0,0,2023
EMI,RE,C 18,Stampa e riproduzione di supporti registrati                ,0,0,1,1,2,2023
EMI,RE,C 19,Fabbricazione di coke e prodotti derivanti dalla raffinaz...,0,0,0,0,0,2023
EMI,RE,C 20,Fabbricazione di prodotti chimici                           ,1,0,0,0,1,2023
EMI,RE,C 21,Fabbricazione di prodotti farmaceutici di base e di prepa...,0,0,0,0,0,2023
EMI,RE,C 22,Fabbricazione di articoli in gomma e materie plastiche      ,2,0,5,0,7,2023
EMI,RE,C 23,Fabbricazione di altri prodotti della lavorazione di miner..,1,1,6,0,8,2023
EMI,RE,C 24,Metallurgia                                                 ,0,0,0,0,0,2023
EMI,RE,C 25,Fabbricazione di prodotti in metallo (esclusi macchinari ...,7,2,43,0,52,2023
EMI,RE,C 26,Fabbricazione di computer e prodotti di elettronica e ott...,1,0,0,0,1,2023
EMI,RE,C 27,Fabbricazione di apparecchiature elettriche ed apparecchi...,2,0,2,0,4,2023
EMI,RE,C 28,Fabbricazione di macchinari ed apparecchiature nca          ,2,1,6,0,9,2023
EMI,RE,C 29,"Fabbricazione di autoveicoli, rimorchi e semirimorchi       ",0,0,1,0,1,2023
EMI,RE,C 30,Fabbricazione di altri mezzi di trasporto                   ,0,0,0,0,0,2023
EMI,RE,C 31,Fabbricazione di mobili                                     ,0,0,3,0,3,2023
EMI,RE,C 32,Altre industrie manifatturiere                              ,0,0,1,0,1,2023
EMI,RE,C 33,"Riparazione, manutenzione ed installazione di macchine ed...",1,0,5,0,6,2023
EMI,RE,D   ,"Fornitura di energia elettrica, gas, vapore e aria condiz...",0,0,0,0,0,2023
EMI,RE,D 35,"Fornitura di energia elettrica, gas, vapore e aria condiz...",0,0,0,0,0,2023
EMI,RE,E   ,"Fornitura di acqua; reti fognarie, attività di gestione d...",1,0,1,0,2,2023
EMI,RE,E 36,"Raccolta, trattamento e fornitura di acqua                  ",0,0,0,0,0,2023
EMI,RE,E 37,Gestione delle reti fognarie                                ,0,0,0,0,0,2023
EMI,RE,E 38,"Attività di raccolta, trattamento e smaltimento dei rifiu...",1,0,1,0,2,2023
EMI,RE,E 39,Attività di risanamento e altri servizi di gestione dei r...,0,0,0,0,0,2023
EMI,RE,F   ,Costruzioni                                                 ,19,1,711,12,743,2023
EMI,RE,F 41,Costruzione di edifici                                      ,13,0,88,6,107,2023
EMI,RE,F 42,Ingegneria civile                                           ,0,0,0,0,0,2023
EMI,RE,F 43,Lavori di costruzione specializzati                         ,6,1,623,6,636,2023
EMI,RE,G   ,Commercio all'ingrosso e al dettaglio; riparazione di aut...,22,10,150,1,183,2023
EMI,RE,G 45,Commercio all'ingrosso e al dettaglio e riparazione di au...,3,1,15,0,19,2023
EMI,RE,G 46,Commercio all'ingrosso (escluso quello di autoveicoli e d...,11,2,40,0,53,2023
EMI,RE,G 47,Commercio al dettaglio (escluso quello di autoveicoli e d...,8,7,95,1,111,2023
EMI,RE,H   ,Trasporto e magazzinaggio                                   ,1,2,10,3,16,2023
EMI,RE,H 49,Trasporto terrestre e mediante condotte                     ,1,2,8,0,11,2023
EMI,RE,H 50,Trasporto marittimo e per vie d'acqua                       ,0,0,0,0,0,2023
EMI,RE,H 51,Trasporto aereo                                             ,0,0,0,0,0,2023
EMI,RE,H 52,Magazzinaggio e attività di supporto ai trasporti           ,0,0,2,3,5,2023
EMI,RE,H 53,Servizi postali e attività di corriere                      ,0,0,0,0,0,2023
EMI,RE,I   ,Attività dei servizi alloggio e ristorazione                ,15,12,35,0,62,2023
EMI,RE,I 55,Alloggio                                                    ,1,0,1,0,2,2023
EMI,RE,I 56,Attività dei servizi di ristorazione                        ,14,12,34,0,60,2023
EMI,RE,J   ,Servizi di informazione e comunicazione                     ,0,0,12,0,12,2023
EMI,RE,J 58,Attività editoriali                                         ,0,0,0,0,0,2023
EMI,RE,J 59,"Attività di produzione cinematografica, di video e di pro...",0,0,0,0,0,2023
EMI,RE,J 60,Attività di programmazione e trasmissione                   ,0,0,0,0,0,2023
EMI,RE,J 61,Telecomunicazioni                                           ,0,0,6,0,6,2023
EMI,RE,J 62,"Produzione di software, consulenza informatica e attività...",0,0,2,0,2,2023
EMI,RE,J 63,Attività dei servizi d'informazione e altri servizi infor...,0,0,4,0,4,2023
EMI,RE,K   ,Attività finanziarie e assicurative                         ,2,0,3,0,5,2023
EMI,RE,K 64,Attività di servizi finanziari (escluse le assicurazioni ...,0,0,0,0,0,2023
EMI,RE,K 65,"Assicurazioni, riassicurazioni e fondi pensione (escluse ...",0,0,0,0,0,2023
EMI,RE,K 66,Attività ausiliarie dei servizi finanziari e delle attivi...,2,0,3,0,5,2023
EMI,RE,L   ,Attivita' immobiliari                                       ,6,3,2,1,12,2023
EMI,RE,L 68,Attivita' immobiliari                                       ,6,3,2,1,12,2023
EMI,RE,M   ,"Attività professionali, scientifiche e tecniche             ",4,1,11,1,17,2023
EMI,RE,M 69,Attività legali e contabilità                               ,2,0,0,0,2,2023
EMI,RE,M 70,Attività di direzione aziendale e di consulenza gestional...,2,0,4,0,6,2023
EMI,RE,M 71,Attività degli studi di architettura e d'ingegneria; coll...,0,0,0,0,0,2023
EMI,RE,M 72,Ricerca scientifica e sviluppo                              ,0,0,0,0,0,2023
EMI,RE,M 73,Pubblicità e ricerche di mercato                            ,0,0,3,1,4,2023
EMI,RE,M 74,"Altre attività professionali, scientifiche e tecniche       ",0,1,4,0,5,2023
EMI,RE,M 75,Servizi veterinari                                          ,0,0,0,0,0,2023
EMI,RE,N   ,"Noleggio, agenzie di viaggio, servizi di supporto alle im...",1,0,26,0,27,2023
EMI,RE,N 77,Attività di noleggio e leasing operativo                    ,0,0,2,0,2,2023
EMI,RE,N 78,"Attività di ricerca, selezione, fornitura di personale      ",0,0,0,0,0,2023
EMI,RE,N 79,"Attività dei servizi delle agenzie di viaggio, dei tour o...",0,0,1,0,1,2023
EMI,RE,N 80,Servizi di vigilanza e investigazione                       ,0,0,0,0,0,2023
EMI,RE,N 81,Attività di servizi per edifici e paesaggio                 ,0,0,11,0,11,2023
EMI,RE,N 82,Attività di supporto per le funzioni d'ufficio e altri se...,1,0,12,0,13,2023
EMI,RE,O   ,Amministrazione pubblica e difesa; assicurazione sociale ...,0,0,0,0,0,2023
EMI,RE,O 84,Amministrazione pubblica e difesa; assicurazione sociale ...,0,0,0,0,0,2023
EMI,RE,P   ,Istruzione                                                  ,0,0,0,0,0,2023
EMI,RE,P 85,Istruzione                                                  ,0,0,0,0,0,2023
EMI,RE,Q   ,Sanita' e assistenza sociale                                ,0,0,0,0,0,2023
EMI,RE,Q 86,Assistenza sanitaria                                        ,0,0,0,0,0,2023
EMI,RE,Q 87,Servizi di assistenza sociale residenziale                  ,0,0,0,0,0,2023
EMI,RE,Q 88,Assistenza sociale non residenziale                         ,0,0,0,0,0,2023
EMI,RE,R   ,"Attività artistiche, sportive, di intrattenimento e diver...",3,0,10,0,13,2023
EMI,RE,R 90,"Attività creative, artistiche e di intrattenimento          ",0,0,3,0,3,2023
EMI,RE,R 91,"Attività di biblioteche, archivi, musei ed altre attività...",0,0,0,0,0,2023
EMI,RE,R 92,"Attività riguardanti le lotterie, le scommesse, le case d...",0,0,0,0,0,2023
EMI,RE,R 93,"Attività sportive, di intrattenimento e di divertimento     ",3,0,7,0,10,2023
EMI,RE,S   ,Altre attività di servizi                                   ,1,0,12,1,14,2023
EMI,RE,S 94,Attività di organizzazioni associative                      ,0,0,0,0,0,2023
EMI,RE,S 95,Riparazione di computer e di beni per uso personale e per...,0,0,5,0,5,2023
EMI,RE,S 96,Altre attività di servizi per la persona                    ,1,0,7,1,9,2023
EMI,RE,T   ,Attività di famiglie e convivenze come datori di lavoro p...,0,0,0,0,0,2023
EMI,RE,T 97,Attività di famiglie e convivenze come datori di lavoro p...,0,0,0,0,0,2023
EMI,RE,T 98,Produzione di beni e servizi indifferenziati per uso prop...,0,0,0,0,0,2023
EMI,RE,U   ,Organizzazioni ed organismi extraterritoriali               ,0,0,0,0,0,2023
EMI,RE,U 99,Organizzazioni ed organismi extraterritoriali               ,0,0,0,0,0,2023
EMI,RE,XX  ,Imprese non classificate                                    ,13,6,3,0,22,2023
EMI,RE,TOT ,TOTALE                                                      ,109,45,1213,21,1388,2023
EMI,MO,A   ,"Agricoltura, silvicoltura pesca                             ",4,1,7,0,12,2023
EMI,MO,A 01,"Coltivazioni agricole e produzione di prodotti animali, c...",3,1,7,0,11,2023
EMI,MO,A 02,Silvicoltura ed utilizzo di aree forestali                  ,0,0,0,0,0,2023
EMI,MO,A 03,Pesca e acquacoltura                                        ,1,0,0,0,1,2023
EMI,MO,B   ,Estrazione di minerali da cave e miniere                    ,0,0,0,0,0,2023
EMI,MO,B 05,Estrazione di carbone (esclusa torba)                       ,0,0,0,0,0,2023
EMI,MO,B 06,Estraz.di petrolio greggio e di gas naturale                ,0,0,0,0,0,2023
EMI,MO,B 07,Estrazione di minerali metalliferi                          ,0,0,0,0,0,2023
EMI,MO,B 08,Altre attività di estrazione di minerali da cave e miniere  ,0,0,0,0,0,2023
EMI,MO,B 09,Attività dei servizi di supporto all'estrazione             ,0,0,0,0,0,2023
EMI,MO,C   ,Attività manifatturiere                                     ,115,40,112,4,271,2023
EMI,MO,C 10,Industrie alimentari                                        ,11,6,4,2,23,2023
EMI,MO,C 11,Industria delle bevande                                     ,1,0,0,0,1,2023
EMI,MO,C 12,Industria del tabacco                                       ,0,0,0,0,0,2023
EMI,MO,C 13,Industrie tessili                                           ,3,1,8,0,12,2023
EMI,MO,C 14,Confezione di articoli di abbigliamento; confezione di ar...,22,10,40,0,72,2023
EMI,MO,C 15,Fabbricazione di articoli in pelle e simili                 ,2,0,2,0,4,2023
EMI,MO,C 16,Industria del legno e dei prodotti in legno e sughero (es...,2,2,4,0,8,2023
EMI,MO,C 17,Fabbricazione di carta e di prodotti di carta               ,2,0,1,0,3,2023
EMI,MO,C 18,Stampa e riproduzione di supporti registrati                ,4,0,0,0,4,2023
EMI,MO,C 19,Fabbricazione di coke e prodotti derivanti dalla raffinaz...,0,0,0,0,0,2023
EMI,MO,C 20,Fabbricazione di prodotti chimici                           ,2,0,0,0,2,2023
EMI,MO,C 21,Fabbricazione di prodotti farmaceutici di base e di prepa...,0,0,0,0,0,2023
EMI,MO,C 22,Fabbricazione di articoli in gomma e materie plastiche      ,1,0,1,0,2,2023
EMI,MO,C 23,Fabbricazione di altri prodotti della lavorazione di miner..,10,3,3,0,16,2023
EMI,MO,C 24,Metallurgia                                                 ,1,0,0,0,1,2023
EMI,MO,C 25,Fabbricazione di prodotti in metallo (esclusi macchinari ...,24,6,30,1,61,2023
EMI,MO,C 26,Fabbricazione di computer e prodotti di elettronica e ott...,1,2,0,0,3,2023
EMI,MO,C 27,Fabbricazione di apparecchiature elettriche ed apparecchi...,4,1,0,0,5,2023
EMI,MO,C 28,Fabbricazione di macchinari ed apparecchiature nca          ,16,3,3,0,22,2023
EMI,MO,C 29,"Fabbricazione di autoveicoli, rimorchi e semirimorchi       ",1,0,0,0,1,2023
EMI,MO,C 30,Fabbricazione di altri mezzi di trasporto                   ,0,0,0,0,0,2023
EMI,MO,C 31,Fabbricazione di mobili                                     ,1,4,0,0,5,2023
EMI,MO,C 32,Altre industrie manifatturiere                              ,4,1,1,0,6,2023
EMI,MO,C 33,"Riparazione, manutenzione ed installazione di macchine ed...",3,1,15,1,20,2023
EMI,MO,D   ,"Fornitura di energia elettrica, gas, vapore e aria condiz...",0,0,0,0,0,2023
EMI,MO,D 35,"Fornitura di energia elettrica, gas, vapore e aria condiz...",0,0,0,0,0,2023
EMI,MO,E   ,"Fornitura di acqua; reti fognarie, attività di gestione d...",0,0,0,0,0,2023
EMI,MO,E 36,"Raccolta, trattamento e fornitura di acqua                  ",0,0,0,0,0,2023
EMI,MO,E 37,Gestione delle reti fognarie                                ,0,0,0,0,0,2023
EMI,MO,E 38,"Attività di raccolta, trattamento e smaltimento dei rifiu...",0,0,0,0,0,2023
EMI,MO,E 39,Attività di risanamento e altri servizi di gestione dei r...,0,0,0,0,0,2023
EMI,MO,F   ,Costruzioni                                                 ,74,27,270,12,383,2023
EMI,MO,F 41,Costruzione di edifici                                      ,47,8,27,8,90,2023
EMI,MO,F 42,Ingegneria civile                                           ,1,1,1,0,3,2023
EMI,MO,F 43,Lavori di costruzione specializzati                         ,26,18,242,4,290,2023
EMI,MO,G   ,Commercio all'ingrosso e al dettaglio; riparazione di aut...,124,57,184,2,367,2023
EMI,MO,G 45,Commercio all'ingrosso e al dettaglio e riparazione di au...,10,8,17,1,36,2023
EMI,MO,G 46,Commercio all'ingrosso (escluso quello di autoveicoli e d...,93,18,56,0,167,2023
EMI,MO,G 47,Commercio al dettaglio (escluso quello di autoveicoli e d...,21,31,111,1,164,2023
EMI,MO,H   ,Trasporto e magazzinaggio                                   ,13,9,10,19,51,2023
EMI,MO,H 49,Trasporto terrestre e mediante condotte                     ,8,7,6,2,23,2023
EMI,MO,H 50,Trasporto marittimo e per vie d'acqua                       ,0,0,0,0,0,2023
EMI,MO,H 51,Trasporto aereo                                             ,0,0,0,0,0,2023
EMI,MO,H 52,Magazzinaggio e attività di supporto ai trasporti           ,5,2,3,17,27,2023
EMI,MO,H 53,Servizi postali e attività di corriere                      ,0,0,1,0,1,2023
EMI,MO,I   ,Attività dei servizi alloggio e ristorazione                ,33,43,51,2,129,2023
EMI,MO,I 55,Alloggio                                                    ,2,2,0,0,4,2023
EMI,MO,I 56,Attività dei servizi di ristorazione                        ,31,41,51,2,125,2023
EMI,MO,J   ,Servizi di informazione e comunicazione                     ,20,3,16,0,39,2023
EMI,MO,J 58,Attività editoriali                                         ,1,0,0,0,1,2023
EMI,MO,J 59,"Attività di produzione cinematografica, di video e di pro...",2,0,0,0,2,2023
EMI,MO,J 60,Attività di programmazione e trasmissione                   ,1,0,0,0,1,2023
EMI,MO,J 61,Telecomunicazioni                                           ,2,0,6,0,8,2023
EMI,MO,J 62,"Produzione di software, consulenza informatica e attività...",10,3,4,0,17,2023
EMI,MO,J 63,Attività dei servizi d'informazione e altri servizi infor...,4,0,6,0,10,2023
EMI,MO,K   ,Attività finanziarie e assicurative                         ,5,0,4,0,9,2023
EMI,MO,K 64,Attività di servizi finanziari (escluse le assicurazioni ...,5,0,0,0,5,2023
EMI,MO,K 65,"Assicurazioni, riassicurazioni e fondi pensione (escluse ...",0,0,0,0,0,2023
EMI,MO,K 66,Attività ausiliarie dei servizi finanziari e delle attivi...,0,0,4,0,4,2023
EMI,MO,L   ,Attivita' immobiliari                                       ,42,10,2,1,55,2023
EMI,MO,L 68,Attivita' immobiliari                                       ,42,10,2,1,55,2023
EMI,MO,M   ,"Attività professionali, scientifiche e tecniche             ",26,5,16,2,49,2023
EMI,MO,M 69,Attività legali e contabilità                               ,3,0,0,1,4,2023
EMI,MO,M 70,Attività di direzione aziendale e di consulenza gestional...,4,1,3,1,9,2023
EMI,MO,M 71,Attività degli studi di architettura e d'ingegneria; coll...,6,0,0,0,6,2023
EMI,MO,M 72,Ricerca scientifica e sviluppo                              ,0,0,0,0,0,2023
EMI,MO,M 73,Pubblicità e ricerche di mercato                            ,4,0,5,0,9,2023
EMI,MO,M 74,"Altre attività professionali, scientifiche e tecniche       ",9,4,8,0,21,2023
EMI,MO,M 75,Servizi veterinari                                          ,0,0,0,0,0,2023
EMI,MO,N   ,"Noleggio, agenzie di viaggio, servizi di supporto alle im...",8,1,38,4,51,2023
EMI,MO,N 77,Attività di noleggio e leasing operativo                    ,1,0,2,0,3,2023
EMI,MO,N 78,"Attività di ricerca, selezione, fornitura di personale      ",0,0,0,0,0,2023
EMI,MO,N 79,"Attività dei servizi delle agenzie di viaggio, dei tour o...",0,1,1,0,2,2023
EMI,MO,N 80,Servizi di vigilanza e investigazione                       ,0,0,0,0,0,2023
EMI,MO,N 81,Attività di servizi per edifici e paesaggio                 ,2,0,19,3,24,2023
EMI,MO,N 82,Attività di supporto per le funzioni d'ufficio e altri se...,5,0,16,1,22,2023
EMI,MO,O   ,Amministrazione pubblica e difesa; assicurazione sociale ...,0,0,0,0,0,2023
EMI,MO,O 84,Amministrazione pubblica e difesa; assicurazione sociale ...,0,0,0,0,0,2023
EMI,MO,P   ,Istruzione                                                  ,3,0,1,0,4,2023
EMI,MO,P 85,Istruzione                                                  ,3,0,1,0,4,2023
EMI,MO,Q   ,Sanita' e assistenza sociale                                ,2,0,0,5,7,2023
EMI,MO,Q 86,Assistenza sanitaria                                        ,2,0,0,1,3,2023
EMI,MO,Q 87,Servizi di assistenza sociale residenziale                  ,0,0,0,1,1,2023
EMI,MO,Q 88,Assistenza sociale non residenziale                         ,0,0,0,3,3,2023
EMI,MO,R   ,"Attività artistiche, sportive, di intrattenimento e diver...",13,0,12,0,25,2023
EMI,MO,R 90,"Attività creative, artistiche e di intrattenimento          ",3,0,1,0,4,2023
EMI,MO,R 91,"Attività di biblioteche, archivi, musei ed altre attività...",0,0,0,0,0,2023
EMI,MO,R 92,"Attività riguardanti le lotterie, le scommesse, le case d...",1,0,0,0,1,2023
EMI,MO,R 93,"Attività sportive, di intrattenimento e di divertimento     ",9,0,11,0,20,2023
EMI,MO,S   ,Altre attività di servizi                                   ,1,4,17,3,25,2023
EMI,MO,S 94,Attività di organizzazioni associative                      ,0,0,0,0,0,2023
EMI,MO,S 95,Riparazione di computer e di beni per uso personale e per...,0,2,10,0,12,2023
EMI,MO,S 96,Altre attività di servizi per la persona                    ,1,2,7,3,13,2023
EMI,MO,T   ,Attività di famiglie e convivenze come datori di lavoro p...,0,0,0,0,0,2023
EMI,MO,T 97,Attività di famiglie e convivenze come datori di lavoro p...,0,0,0,0,0,2023
EMI,MO,T 98,Produzione di beni e servizi indifferenziati per uso prop...,0,0,0,0,0,2023
EMI,MO,U   ,Organizzazioni ed organismi extraterritoriali               ,0,0,0,0,0,2023
EMI,MO,U 99,Organizzazioni ed organismi extraterritoriali               ,0,0,0,0,0,2023
EMI,MO,XX  ,Imprese non classificate                                    ,100,11,40,7,158,2023
EMI,MO,TOT ,TOTALE                                                      ,583,211,780,61,1635,2023
EMI,BO,A   ,"Agricoltura, silvicoltura pesca                             ",0,1,94,0,95,2023
EMI,BO,A 01,"Coltivazioni agricole e produzione di prodotti animali, c...",0,1,93,0,94,2023
EMI,BO,A 02,Silvicoltura ed utilizzo di aree forestali                  ,0,0,0,0,0,2023
EMI,BO,A 03,Pesca e acquacoltura                                        ,0,0,1,0,1,2023
EMI,BO,B   ,Estrazione di minerali da cave e miniere                    ,0,0,0,0,0,2023
EMI,BO,B 05,Estrazione di carbone (esclusa torba)                       ,0,0,0,0,0,2023
EMI,BO,B 06,Estraz.di petrolio greggio e di gas naturale                ,0,0,0,0,0,2023
EMI,BO,B 07,Estrazione di minerali metalliferi                          ,0,0,0,0,0,2023
EMI,BO,B 08,Altre attività di estrazione di minerali da cave e miniere  ,0,0,0,0,0,2023
EMI,BO,B 09,Attività dei servizi di supporto all'estrazione             ,0,0,0,0,0,2023
EMI,BO,C   ,Attività manifatturiere                                     ,11,8,128,0,147,2023
EMI,BO,C 10,Industrie alimentari                                        ,1,1,5,0,7,2023
EMI,BO,C 11,Industria delle bevande                                     ,0,0,0,0,0,2023
EMI,BO,C 12,Industria del tabacco                                       ,0,0,0,0,0,2023
EMI,BO,C 13,Industrie tessili                                           ,0,0,4,0,4,2023
EMI,BO,C 14,Confezione di articoli di abbigliamento; confezione di ar...,2,1,23,0,26,2023
EMI,BO,C 15,Fabbricazione di articoli in pelle e simili                 ,0,0,10,0,10,2023
EMI,BO,C 16,Industria del legno e dei prodotti in legno e sughero (es...,1,0,13,0,14,2023
EMI,BO,C 17,Fabbricazione di carta e di prodotti di carta               ,0,0,1,0,1,2023
EMI,BO,C 18,Stampa e riproduzione di supporti registrati                ,1,1,3,0,5,2023
EMI,BO,C 19,Fabbricazione di coke e prodotti derivanti dalla raffinaz...,0,0,0,0,0,2023
EMI,BO,C 20,Fabbricazione di prodotti chimici                           ,0,0,0,0,0,2023
EMI,BO,C 21,Fabbricazione di prodotti farmaceutici di base e di prepa...,0,0,0,0,0,2023
EMI,BO,C 22,Fabbricazione di articoli in gomma e materie plastiche      ,0,0,5,0,5,2023
EMI,BO,C 23,Fabbricazione di altri prodotti della lavorazione di miner..,0,0,2,0,2,2023
EMI,BO,C 24,Metallurgia                                                 ,0,0,1,0,1,2023
EMI,BO,C 25,Fabbricazione di prodotti in metallo (esclusi macchinari ...,3,2,27,0,32,2023
EMI,BO,C 26,Fabbricazione di computer e prodotti di elettronica e ott...,0,0,4,0,4,2023
EMI,BO,C 27,Fabbricazione di apparecchiature elettriche ed apparecchi...,0,1,0,0,1,2023
EMI,BO,C 28,Fabbricazione di macchinari ed apparecchiature nca          ,1,1,6,0,8,2023
EMI,BO,C 29,"Fabbricazione di autoveicoli, rimorchi e semirimorchi       ",0,0,1,0,1,2023
EMI,BO,C 30,Fabbricazione di altri mezzi di trasporto                   ,1,0,1,0,2,2023
EMI,BO,C 31,Fabbricazione di mobili                                     ,0,1,6,0,7,2023
EMI,BO,C 32,Altre industrie manifatturiere                              ,1,0,10,0,11,2023
EMI,BO,C 33,"Riparazione, manutenzione ed installazione di macchine ed...",0,0,6,0,6,2023
EMI,BO,D   ,"Fornitura di energia elettrica, gas, vapore e aria condiz...",0,0,1,0,1,2023
EMI,BO,D 35,"Fornitura di energia elettrica, gas, vapore e aria condiz...",0,0,1,0,1,2023
EMI,BO,E   ,"Fornitura di acqua; reti fognarie, attività di gestione d...",0,0,2,0,2,2023
EMI,BO,E 36,"Raccolta, trattamento e fornitura di acqua                  ",0,0,0,0,0,2023
EMI,BO,E 37,Gestione delle reti fognarie                                ,0,0,0,0,0,2023
EMI,BO,E 38,"Attività di raccolta, trattamento e smaltimento dei rifiu...",0,0,2,0,2,2023
EMI,BO,E 39,Attività di risanamento e altri servizi di gestione dei r...,0,0,0,0,0,2023
EMI,BO,F   ,Costruzioni                                                 ,19,4,589,15,627,2023
EMI,BO,F 41,Costruzione di edifici                                      ,10,0,100,10,120,2023
EMI,BO,F 42,Ingegneria civile                                           ,1,0,4,0,5,2023
EMI,BO,F 43,Lavori di costruzione specializzati                         ,8,4,485,5,502,2023
EMI,BO,G   ,Commercio all'ingrosso e al dettaglio; riparazione di aut...,28,12,503,1,544,2023
EMI,BO,G 45,Commercio all'ingrosso e al dettaglio e riparazione di au...,2,1,42,0,45,2023
EMI,BO,G 46,Commercio all'ingrosso (escluso quello di autoveicoli e d...,14,4,162,1,181,2023
EMI,BO,G 47,Commercio al dettaglio (escluso quello di autoveicoli e d...,12,7,299,0,318,2023
EMI,BO,H   ,Trasporto e magazzinaggio                                   ,3,1,87,12,103,2023
EMI,BO,H 49,Trasporto terrestre e mediante condotte                     ,1,1,82,1,85,2023
EMI,BO,H 50,Trasporto marittimo e per vie d'acqua                       ,0,0,0,0,0,2023
EMI,BO,H 51,Trasporto aereo                                             ,0,0,0,0,0,2023
EMI,BO,H 52,Magazzinaggio e attività di supporto ai trasporti           ,2,0,5,11,18,2023
EMI,BO,H 53,Servizi postali e attività di corriere                      ,0,0,0,0,0,2023
EMI,BO,I   ,Attività dei servizi alloggio e ristorazione                ,9,13,74,0,96,2023
EMI,BO,I 55,Alloggio                                                    ,1,0,1,0,2,2023
EMI,BO,I 56,Attività dei servizi di ristorazione                        ,8,13,73,0,94,2023
EMI,BO,J   ,Servizi di informazione e comunicazione                     ,6,2,34,1,43,2023
EMI,BO,J 58,Attività editoriali                                         ,1,1,5,1,8,2023
EMI,BO,J 59,"Attività di produzione cinematografica, di video e di pro...",0,0,2,0,2,2023
EMI,BO,J 60,Attività di programmazione e trasmissione                   ,0,0,0,0,0,2023
EMI,BO,J 61,Telecomunicazioni                                           ,0,0,20,0,20,2023
EMI,BO,J 62,"Produzione di software, consulenza informatica e attività...",5,0,2,0,7,2023
EMI,BO,J 63,Attività dei servizi d'informazione e altri servizi infor...,0,1,5,0,6,2023
EMI,BO,K   ,Attività finanziarie e assicurative                         ,0,5,15,0,20,2023
EMI,BO,K 64,Attività di servizi finanziari (escluse le assicurazioni ...,0,2,0,0,2,2023
EMI,BO,K 65,"Assicurazioni, riassicurazioni e fondi pensione (escluse ...",0,0,0,0,0,2023
EMI,BO,K 66,Attività ausiliarie dei servizi finanziari e delle attivi...,0,3,15,0,18,2023
EMI,BO,L   ,Attivita' immobiliari                                       ,18,2,4,2,26,2023
EMI,BO,L 68,Attivita' immobiliari                                       ,18,2,4,2,26,2023
EMI,BO,M   ,"Attività professionali, scientifiche e tecniche             ",7,2,27,2,38,2023
EMI,BO,M 69,Attività legali e contabilità                               ,0,0,1,0,1,2023
EMI,BO,M 70,Attività di direzione aziendale e di consulenza gestional...,2,0,1,2,5,2023
EMI,BO,M 71,Attività degli studi di architettura e d'ingegneria; coll...,1,0,0,0,1,2023
EMI,BO,M 72,Ricerca scientifica e sviluppo                              ,0,0,0,0,0,2023
EMI,BO,M 73,Pubblicità e ricerche di mercato                            ,4,1,10,0,15,2023
EMI,BO,M 74,"Altre attività professionali, scientifiche e tecniche       ",0,1,15,0,16,2023
EMI,BO,M 75,Servizi veterinari                                          ,0,0,0,0,0,2023
EMI,BO,N   ,"Noleggio, agenzie di viaggio, servizi di supporto alle im...",9,1,43,5,58,2023
EMI,BO,N 77,Attività di noleggio e leasing operativo                    ,1,0,8,0,9,2023
EMI,BO,N 78,"Attività di ricerca, selezione, fornitura di personale      ",0,0,0,0,0,2023
EMI,BO,N 79,"Attività dei servizi delle agenzie di viaggio, dei tour o...",2,0,2,0,4,2023
EMI,BO,N 80,Servizi di vigilanza e investigazione                       ,0,0,0,0,0,2023
EMI,BO,N 81,Attività di servizi per edifici e paesaggio                 ,1,0,19,1,21,2023
EMI,BO,N 82,Attività di supporto per le funzioni d'ufficio e altri se...,5,1,14,4,24,2023
EMI,BO,O   ,Amministrazione pubblica e difesa; assicurazione sociale ...,0,0,0,0,0,2023
EMI,BO,O 84,Amministrazione pubblica e difesa; assicurazione sociale ...,0,0,0,0,0,2023
EMI,BO,P   ,Istruzione                                                  ,1,0,3,2,6,2023
EMI,BO,P 85,Istruzione                                                  ,1,0,3,2,6,2023
EMI,BO,Q   ,Sanita' e assistenza sociale                                ,1,0,0,1,2,2023
EMI,BO,Q 86,Assistenza sanitaria                                        ,0,0,0,0,0,2023
EMI,BO,Q 87,Servizi di assistenza sociale residenziale                  ,1,0,0,0,1,2023
EMI,BO,Q 88,Assistenza sociale non residenziale                         ,0,0,0,1,1,2023
EMI,BO,R   ,"Attività artistiche, sportive, di intrattenimento e diver...",4,2,15,3,24,2023
EMI,BO,R 90,"Attività creative, artistiche e di intrattenimento          ",1,2,3,1,7,2023
EMI,BO,R 91,"Attività di biblioteche, archivi, musei ed altre attività...",0,0,0,1,1,2023
EMI,BO,R 92,"Attività riguardanti le lotterie, le scommesse, le case d...",0,0,0,0,0,2023
EMI,BO,R 93,"Attività sportive, di intrattenimento e di divertimento     ",3,0,12,1,16,2023
EMI,BO,S   ,Altre attività di servizi                                   ,2,0,37,0,39,2023
EMI,BO,S 94,Attività di organizzazioni associative                      ,0,0,0,0,0,2023
EMI,BO,S 95,Riparazione di computer e di beni per uso personale e per...,0,0,19,0,19,2023
EMI,BO,S 96,Altre attività di servizi per la persona                    ,2,0,18,0,20,2023
EMI,BO,T   ,Attività di famiglie e convivenze come datori di lavoro p...,0,0,0,0,0,2023
EMI,BO,T 97,Attività di famiglie e convivenze come datori di lavoro p...,0,0,0,0,0,2023
EMI,BO,T 98,Produzione di beni e servizi indifferenziati per uso prop...,0,0,0,0,0,2023
EMI,BO,U   ,Organizzazioni ed organismi extraterritoriali               ,0,0,0,0,0,2023
EMI,BO,U 99,Organizzazioni ed organismi extraterritoriali               ,0,0,0,0,0,2023
EMI,BO,XX  ,Imprese non classificate                                    ,16,12,45,0,73,2023
EMI,BO,TOT ,TOTALE                                                      ,134,65,1701,44,1944,2023
EMI,FE,A   ,"Agricoltura, silvicoltura pesca                             ",7,6,4,1,18,2023
EMI,FE,A 01,"Coltivazioni agricole e produzione di prodotti animali, c...",7,5,3,1,16,2023
EMI,FE,A 02,Silvicoltura ed utilizzo di aree forestali                  ,0,0,0,0,0,2023
EMI,FE,A 03,Pesca e acquacoltura                                        ,0,1,1,0,2,2023
EMI,FE,B   ,Estrazione di minerali da cave e miniere                    ,0,0,0,0,0,2023
EMI,FE,B 05,Estrazione di carbone (esclusa torba)                       ,0,0,0,0,0,2023
EMI,FE,B 06,Estraz.di petrolio greggio e di gas naturale                ,0,0,0,0,0,2023
EMI,FE,B 07,Estrazione di minerali metalliferi                          ,0,0,0,0,0,2023
EMI,FE,B 08,Altre attività di estrazione di minerali da cave e miniere  ,0,0,0,0,0,2023
EMI,FE,B 09,Attività dei servizi di supporto all'estrazione             ,0,0,0,0,0,2023
EMI,FE,C   ,Attività manifatturiere                                     ,83,4,9,0,96,2023
EMI,FE,C 10,Industrie alimentari                                        ,4,0,1,0,5,2023
EMI,FE,C 11,Industria delle bevande                                     ,0,0,0,0,0,2023
EMI,FE,C 12,Industria del tabacco                                       ,0,0,0,0,0,2023
EMI,FE,C 13,Industrie tessili                                           ,2,0,0,0,2,2023
EMI,FE,C 14,Confezione di articoli di abbigliamento; confezione di ar...,7,0,2,0,9,2023
EMI,FE,C 15,Fabbricazione di articoli in pelle e simili                 ,3,0,0,0,3,2023
EMI,FE,C 16,Industria del legno e dei prodotti in legno e sughero (es...,1,0,0,0,1,2023
EMI,FE,C 17,Fabbricazione di carta e di prodotti di carta               ,2,0,0,0,2,2023
EMI,FE,C 18,Stampa e riproduzione di supporti registrati                ,0,1,0,0,1,2023
EMI,FE,C 19,Fabbricazione di coke e prodotti derivanti dalla raffinaz...,0,0,0,0,0,2023
EMI,FE,C 20,Fabbricazione di prodotti chimici                           ,5,0,0,0,5,2023
EMI,FE,C 21,Fabbricazione di prodotti farmaceutici di base e di prepa...,0,0,0,0,0,2023
EMI,FE,C 22,Fabbricazione di articoli in gomma e materie plastiche      ,1,0,0,0,1,2023
EMI,FE,C 23,Fabbricazione di altri prodotti della lavorazione di miner..,1,0,0,0,1,2023
EMI,FE,C 24,Metallurgia                                                 ,2,0,0,0,2,2023
EMI,FE,C 25,Fabbricazione di prodotti in metallo (esclusi macchinari ...,21,2,2,0,25,2023
EMI,FE,C 26,Fabbricazione di computer e prodotti di elettronica e ott...,4,0,0,0,4,2023
EMI,FE,C 27,Fabbricazione di apparecchiature elettriche ed apparecchi...,6,0,1,0,7,2023
EMI,FE,C 28,Fabbricazione di macchinari ed apparecchiature nca          ,17,1,1,0,19,2023
EMI,FE,C 29,"Fabbricazione di autoveicoli, rimorchi e semirimorchi       ",2,0,0,0,2,2023
EMI,FE,C 30,Fabbricazione di altri mezzi di trasporto                   ,0,0,0,0,0,2023
EMI,FE,C 31,Fabbricazione di mobili                                     ,3,0,0,0,3,2023
EMI,FE,C 32,Altre industrie manifatturiere                              ,1,0,0,0,1,2023
EMI,FE,C 33,"Riparazione, manutenzione ed installazione di macchine ed...",1,0,2,0,3,2023
EMI,FE,D   ,"Fornitura di energia elettrica, gas, vapore e aria condiz...",1,0,0,0,1,2023
EMI,FE,D 35,"Fornitura di energia elettrica, gas, vapore e aria condiz...",1,0,0,0,1,2023
EMI,FE,E   ,"Fornitura di acqua; reti fognarie, attività di gestione d...",1,0,0,0,1,2023
EMI,FE,E 36,"Raccolta, trattamento e fornitura di acqua                  ",0,0,0,0,0,2023
EMI,FE,E 37,Gestione delle reti fognarie                                ,0,0,0,0,0,2023
EMI,FE,E 38,"Attività di raccolta, trattamento e smaltimento dei rifiu...",1,0,0,0,1,2023
EMI,FE,E 39,Attività di risanamento e altri servizi di gestione dei r...,0,0,0,0,0,2023
EMI,FE,F   ,Costruzioni                                                 ,45,5,16,12,78,2023
EMI,FE,F 41,Costruzione di edifici                                      ,29,4,2,8,43,2023
EMI,FE,F 42,Ingegneria civile                                           ,1,0,0,0,1,2023
EMI,FE,F 43,Lavori di costruzione specializzati                         ,15,1,14,4,34,2023
EMI,FE,G   ,Commercio all'ingrosso e al dettaglio; riparazione di aut...,81,6,16,3,106,2023
EMI,FE,G 45,Commercio all'ingrosso e al dettaglio e riparazione di au...,5,0,2,0,7,2023
EMI,FE,G 46,Commercio all'ingrosso (escluso quello di autoveicoli e d...,47,3,3,3,56,2023
EMI,FE,G 47,Commercio al dettaglio (escluso quello di autoveicoli e d...,29,3,11,0,43,2023
EMI,FE,H   ,Trasporto e magazzinaggio                                   ,8,0,0,5,13,2023
EMI,FE,H 49,Trasporto terrestre e mediante condotte                     ,5,0,0,1,6,2023
EMI,FE,H 50,Trasporto marittimo e per vie d'acqua                       ,0,0,0,0,0,2023
EMI,FE,H 51,Trasporto aereo                                             ,0,0,0,0,0,2023
EMI,FE,H 52,Magazzinaggio e attività di supporto ai trasporti           ,3,0,0,4,7,2023
EMI,FE,H 53,Servizi postali e attività di corriere                      ,0,0,0,0,0,2023
EMI,FE,I   ,Attività dei servizi alloggio e ristorazione                ,17,5,5,0,27,2023
EMI,FE,I 55,Alloggio                                                    ,0,2,1,0,3,2023
EMI,FE,I 56,Attività dei servizi di ristorazione                        ,17,3,4,0,24,2023
EMI,FE,J   ,Servizi di informazione e comunicazione                     ,12,1,0,0,13,2023
EMI,FE,J 58,Attività editoriali                                         ,1,0,0,0,1,2023
EMI,FE,J 59,"Attività di produzione cinematografica, di video e di pro...",1,0,0,0,1,2023
EMI,FE,J 60,Attività di programmazione e trasmissione                   ,0,0,0,0,0,2023
EMI,FE,J 61,Telecomunicazioni                                           ,0,0,0,0,0,2023
EMI,FE,J 62,"Produzione di software, consulenza informatica e attività...",7,1,0,0,8,2023
EMI,FE,J 63,Attività dei servizi d'informazione e altri servizi infor...,3,0,0,0,3,2023
EMI,FE,K   ,Attività finanziarie e assicurative                         ,6,0,0,0,6,2023
EMI,FE,K 64,Attività di servizi finanziari (escluse le assicurazioni ...,6,0,0,0,6,2023
EMI,FE,K 65,"Assicurazioni, riassicurazioni e fondi pensione (escluse ...",0,0,0,0,0,2023
EMI,FE,K 66,Attività ausiliarie dei servizi finanziari e delle attivi...,0,0,0,0,0,2023
EMI,FE,L   ,Attivita' immobiliari                                       ,21,10,1,0,32,2023
EMI,FE,L 68,Attivita' immobiliari                                       ,21,10,1,0,32,2023
EMI,FE,M   ,"Attività professionali, scientifiche e tecniche             ",17,1,1,3,22,2023
EMI,FE,M 69,Attività legali e contabilità                               ,2,1,0,0,3,2023
EMI,FE,M 70,Attività di direzione aziendale e di consulenza gestional...,2,0,0,3,5,2023
EMI,FE,M 71,Attività degli studi di architettura e d'ingegneria; coll...,6,0,0,0,6,2023
EMI,FE,M 72,Ricerca scientifica e sviluppo                              ,1,0,0,0,1,2023
EMI,FE,M 73,Pubblicità e ricerche di mercato                            ,5,0,1,0,6,2023
EMI,FE,M 74,"Altre attività professionali, scientifiche e tecniche       ",1,0,0,0,1,2023
EMI,FE,M 75,Servizi veterinari                                          ,0,0,0,0,0,2023
EMI,FE,N   ,"Noleggio, agenzie di viaggio, servizi di supporto alle im...",11,1,4,6,22,2023
EMI,FE,N 77,Attività di noleggio e leasing operativo                    ,5,0,0,0,5,2023
EMI,FE,N 78,"Attività di ricerca, selezione, fornitura di personale      ",0,0,0,0,0,2023
EMI,FE,N 79,"Attività dei servizi delle agenzie di viaggio, dei tour o...",3,0,0,1,4,2023
EMI,FE,N 80,Servizi di vigilanza e investigazione                       ,0,0,0,0,0,2023
EMI,FE,N 81,Attività di servizi per edifici e paesaggio                 ,2,0,2,2,6,2023
EMI,FE,N 82,Attività di supporto per le funzioni d'ufficio e altri se...,1,1,2,3,7,2023
EMI,FE,O   ,Amministrazione pubblica e difesa; assicurazione sociale ...,0,0,0,0,0,2023
EMI,FE,O 84,Amministrazione pubblica e difesa; assicurazione sociale ...,0,0,0,0,0,2023
EMI,FE,P   ,Istruzione                                                  ,0,1,0,2,3,2023
EMI,FE,P 85,Istruzione                                                  ,0,1,0,2,3,2023
EMI,FE,Q   ,Sanita' e assistenza sociale                                ,1,0,0,0,1,2023
EMI,FE,Q 86,Assistenza sanitaria                                        ,1,0,0,0,1,2023
EMI,FE,Q 87,Servizi di assistenza sociale residenziale                  ,0,0,0,0,0,2023
EMI,FE,Q 88,Assistenza sociale non residenziale                         ,0,0,0,0,0,2023
EMI,FE,R   ,"Attività artistiche, sportive, di intrattenimento e diver...",9,0,0,1,10,2023
EMI,FE,R 90,"Attività creative, artistiche e di intrattenimento          ",3,0,0,0,3,2023
EMI,FE,R 91,"Attività di biblioteche, archivi, musei ed altre attività...",0,0,0,0,0,2023
EMI,FE,R 92,"Attività riguardanti le lotterie, le scommesse, le case d...",2,0,0,0,2,2023
EMI,FE,R 93,"Attività sportive, di intrattenimento e di divertimento     ",4,0,0,1,5,2023
EMI,FE,S   ,Altre attività di servizi                                   ,2,0,2,3,7,2023
EMI,FE,S 94,Attività di organizzazioni associative                      ,0,0,0,1,1,2023
EMI,FE,S 95,Riparazione di computer e di beni per uso personale e per...,0,0,0,0,0,2023
EMI,FE,S 96,Altre attività di servizi per la persona                    ,2,0,2,2,6,2023
EMI,FE,T   ,Attività di famiglie e convivenze come datori di lavoro p...,0,0,0,0,0,2023
EMI,FE,T 97,Attività di famiglie e convivenze come datori di lavoro p...,0,0,0,0,0,2023
EMI,FE,T 98,Produzione di beni e servizi indifferenziati per uso prop...,0,0,0,0,0,2023
EMI,FE,U   ,Organizzazioni ed organismi extraterritoriali               ,0,0,0,0,0,2023
EMI,FE,U 99,Organizzazioni ed organismi extraterritoriali               ,0,0,0,0,0,2023
EMI,FE,XX  ,Imprese non classificate                                    ,77,1,2,8,88,2023
EMI,FE,TOT ,TOTALE                                                      ,399,41,60,44,544,2023
EMI,RA,A   ,"Agricoltura, silvicoltura pesca                             ",1,0,91,0,92,2023
EMI,RA,A 01,"Coltivazioni agricole e produzione di prodotti animali, c...",1,0,88,0,89,2023
EMI,RA,A 02,Silvicoltura ed utilizzo di aree forestali                  ,0,0,0,0,0,2023
EMI,RA,A 03,Pesca e acquacoltura                                        ,0,0,3,0,3,2023
EMI,RA,B   ,Estrazione di minerali da cave e miniere                    ,0,0,0,0,0,2023
EMI,RA,B 05,Estrazione di carbone (esclusa torba)                       ,0,0,0,0,0,2023
EMI,RA,B 06,Estraz.di petrolio greggio e di gas naturale                ,0,0,0,0,0,2023
EMI,RA,B 07,Estrazione di minerali metalliferi                          ,0,0,0,0,0,2023
EMI,RA,B 08,Altre attività di estrazione di minerali da cave e miniere  ,0,0,0,0,0,2023
EMI,RA,B 09,Attività dei servizi di supporto all'estrazione             ,0,0,0,0,0,2023
EMI,RA,C   ,Attività manifatturiere                                     ,25,0,74,3,102,2023
EMI,RA,C 10,Industrie alimentari                                        ,2,0,3,0,5,2023
EMI,RA,C 11,Industria delle bevande                                     ,0,0,0,0,0,2023
EMI,RA,C 12,Industria del tabacco                                       ,0,0,0,0,0,2023
EMI,RA,C 13,Industrie tessili                                           ,1,0,1,0,2,2023
EMI,RA,C 14,Confezione di articoli di abbigliamento; confezione di ar...,5,0,13,0,18,2023
EMI,RA,C 15,Fabbricazione di articoli in pelle e simili                 ,1,0,0,0,1,2023
EMI,RA,C 16,Industria del legno e dei prodotti in legno e sughero (es...,2,0,3,1,6,2023
EMI,RA,C 17,Fabbricazione di carta e di prodotti di carta               ,0,0,0,0,0,2023
EMI,RA,C 18,Stampa e riproduzione di supporti registrati                ,0,0,0,0,0,2023
EMI,RA,C 19,Fabbricazione di coke e prodotti derivanti dalla raffinaz...,0,0,0,0,0,2023
EMI,RA,C 20,Fabbricazione di prodotti chimici                           ,1,0,0,0,1,2023
EMI,RA,C 21,Fabbricazione di prodotti farmaceutici di base e di prepa...,0,0,0,0,0,2023
EMI,RA,C 22,Fabbricazione di articoli in gomma e materie plastiche      ,0,0,1,0,1,2023
EMI,RA,C 23,Fabbricazione di altri prodotti della lavorazione di miner..,2,0,2,0,4,2023
EMI,RA,C 24,Metallurgia                                                 ,0,0,1,0,1,2023
EMI,RA,C 25,Fabbricazione di prodotti in metallo (esclusi macchinari ...,5,0,31,2,38,2023
EMI,RA,C 26,Fabbricazione di computer e prodotti di elettronica e ott...,0,0,0,0,0,2023
EMI,RA,C 27,Fabbricazione di apparecchiature elettriche ed apparecchi...,0,0,1,0,1,2023
EMI,RA,C 28,Fabbricazione di macchinari ed apparecchiature nca          ,3,0,1,0,4,2023
EMI,RA,C 29,"Fabbricazione di autoveicoli, rimorchi e semirimorchi       ",0,0,0,0,0,2023
EMI,RA,C 30,Fabbricazione di altri mezzi di trasporto                   ,1,0,3,0,4,2023
EMI,RA,C 31,Fabbricazione di mobili                                     ,2,0,3,0,5,2023
EMI,RA,C 32,Altre industrie manifatturiere                              ,0,0,5,0,5,2023
EMI,RA,C 33,"Riparazione, manutenzione ed installazione di macchine ed...",0,0,6,0,6,2023
EMI,RA,D   ,"Fornitura di energia elettrica, gas, vapore e aria condiz...",2,0,0,0,2,2023
EMI,RA,D 35,"Fornitura di energia elettrica, gas, vapore e aria condiz...",2,0,0,0,2,2023
EMI,RA,E   ,"Fornitura di acqua; reti fognarie, attività di gestione d...",0,0,0,1,1,2023
EMI,RA,E 36,"Raccolta, trattamento e fornitura di acqua                  ",0,0,0,0,0,2023
EMI,RA,E 37,Gestione delle reti fognarie                                ,0,0,0,0,0,2023
EMI,RA,E 38,"Attività di raccolta, trattamento e smaltimento dei rifiu...",0,0,0,1,1,2023
EMI,RA,E 39,Attività di risanamento e altri servizi di gestione dei r...,0,0,0,0,0,2023
EMI,RA,F   ,Costruzioni                                                 ,19,0,606,2,627,2023
EMI,RA,F 41,Costruzione di edifici                                      ,13,0,96,1,110,2023
EMI,RA,F 42,Ingegneria civile                                           ,1,0,1,0,2,2023
EMI,RA,F 43,Lavori di costruzione specializzati                         ,5,0,509,1,515,2023
EMI,RA,G   ,Commercio all'ingrosso e al dettaglio; riparazione di aut...,38,0,438,2,478,2023
EMI,RA,G 45,Commercio all'ingrosso e al dettaglio e riparazione di au...,4,0,59,0,63,2023
EMI,RA,G 46,Commercio all'ingrosso (escluso quello di autoveicoli e d...,17,0,50,1,68,2023
EMI,RA,G 47,Commercio al dettaglio (escluso quello di autoveicoli e d...,17,0,329,1,347,2023
EMI,RA,H   ,Trasporto e magazzinaggio                                   ,3,0,16,1,20,2023
EMI,RA,H 49,Trasporto terrestre e mediante condotte                     ,1,0,14,1,16,2023
EMI,RA,H 50,Trasporto marittimo e per vie d'acqua                       ,0,0,0,0,0,2023
EMI,RA,H 51,Trasporto aereo                                             ,0,0,0,0,0,2023
EMI,RA,H 52,Magazzinaggio e attività di supporto ai trasporti           ,2,0,2,0,4,2023
EMI,RA,H 53,Servizi postali e attività di corriere                      ,0,0,0,0,0,2023
EMI,RA,I   ,Attività dei servizi alloggio e ristorazione                ,22,0,51,2,75,2023
EMI,RA,I 55,Alloggio                                                    ,1,0,3,1,5,2023
EMI,RA,I 56,Attività dei servizi di ristorazione                        ,21,0,48,1,70,2023
EMI,RA,J   ,Servizi di informazione e comunicazione                     ,5,0,7,0,12,2023
EMI,RA,J 58,Attività editoriali                                         ,0,0,0,0,0,2023
EMI,RA,J 59,"Attività di produzione cinematografica, di video e di pro...",0,0,1,0,1,2023
EMI,RA,J 60,Attività di programmazione e trasmissione                   ,0,0,0,0,0,2023
EMI,RA,J 61,Telecomunicazioni                                           ,0,0,3,0,3,2023
EMI,RA,J 62,"Produzione di software, consulenza informatica e attività...",1,0,2,0,3,2023
EMI,RA,J 63,Attività dei servizi d'informazione e altri servizi infor...,4,0,1,0,5,2023
EMI,RA,K   ,Attività finanziarie e assicurative                         ,1,0,5,0,6,2023
EMI,RA,K 64,Attività di servizi finanziari (escluse le assicurazioni ...,1,0,0,0,1,2023
EMI,RA,K 65,"Assicurazioni, riassicurazioni e fondi pensione (escluse ...",0,0,0,0,0,2023
EMI,RA,K 66,Attività ausiliarie dei servizi finanziari e delle attivi...,0,0,5,0,5,2023
EMI,RA,L   ,Attivita' immobiliari                                       ,18,0,6,0,24,2023
EMI,RA,L 68,Attivita' immobiliari                                       ,18,0,6,0,24,2023
EMI,RA,M   ,"Attività professionali, scientifiche e tecniche             ",10,0,11,0,21,2023
EMI,RA,M 69,Attività legali e contabilità                               ,0,0,0,0,0,2023
EMI,RA,M 70,Attività di direzione aziendale e di consulenza gestional...,3,0,3,0,6,2023
EMI,RA,M 71,Attività degli studi di architettura e d'ingegneria; coll...,4,0,0,0,4,2023
EMI,RA,M 72,Ricerca scientifica e sviluppo                              ,0,0,0,0,0,2023
EMI,RA,M 73,Pubblicità e ricerche di mercato                            ,0,0,3,0,3,2023
EMI,RA,M 74,"Altre attività professionali, scientifiche e tecniche       ",3,0,5,0,8,2023
EMI,RA,M 75,Servizi veterinari                                          ,0,0,0,0,0,2023
EMI,RA,N   ,"Noleggio, agenzie di viaggio, servizi di supporto alle im...",5,0,23,2,30,2023
EMI,RA,N 77,Attività di noleggio e leasing operativo                    ,1,0,3,1,5,2023
EMI,RA,N 78,"Attività di ricerca, selezione, fornitura di personale      ",0,0,0,0,0,2023
EMI,RA,N 79,"Attività dei servizi delle agenzie di viaggio, dei tour o...",0,0,1,0,1,2023
EMI,RA,N 80,Servizi di vigilanza e investigazione                       ,1,0,2,0,3,2023
EMI,RA,N 81,Attività di servizi per edifici e paesaggio                 ,0,0,8,1,9,2023
EMI,RA,N 82,Attività di supporto per le funzioni d'ufficio e altri se...,3,0,9,0,12,2023
EMI,RA,O   ,Amministrazione pubblica e difesa; assicurazione sociale ...,0,0,0,0,0,2023
EMI,RA,O 84,Amministrazione pubblica e difesa; assicurazione sociale ...,0,0,0,0,0,2023
EMI,RA,P   ,Istruzione                                                  ,0,0,0,0,0,2023
EMI,RA,P 85,Istruzione                                                  ,0,0,0,0,0,2023
EMI,RA,Q   ,Sanita' e assistenza sociale                                ,0,0,0,4,4,2023
EMI,RA,Q 86,Assistenza sanitaria                                        ,0,0,0,0,0,2023
EMI,RA,Q 87,Servizi di assistenza sociale residenziale                  ,0,0,0,0,0,2023
EMI,RA,Q 88,Assistenza sociale non residenziale                         ,0,0,0,4,4,2023
EMI,RA,R   ,"Attività artistiche, sportive, di intrattenimento e diver...",3,0,8,0,11,2023
EMI,RA,R 90,"Attività creative, artistiche e di intrattenimento          ",2,0,4,0,6,2023
EMI,RA,R 91,"Attività di biblioteche, archivi, musei ed altre attività...",0,0,0,0,0,2023
EMI,RA,R 92,"Attività riguardanti le lotterie, le scommesse, le case d...",0,0,0,0,0,2023
EMI,RA,R 93,"Attività sportive, di intrattenimento e di divertimento     ",1,0,4,0,5,2023
EMI,RA,S   ,Altre attività di servizi                                   ,1,0,21,0,22,2023
EMI,RA,S 94,Attività di organizzazioni associative                      ,0,0,0,0,0,2023
EMI,RA,S 95,Riparazione di computer e di beni per uso personale e per...,0,0,11,0,11,2023
EMI,RA,S 96,Altre attività di servizi per la persona                    ,1,0,10,0,11,2023
EMI,RA,T   ,Attività di famiglie e convivenze come datori di lavoro p...,0,0,0,0,0,2023
EMI,RA,T 97,Attività di famiglie e convivenze come datori di lavoro p...,0,0,0,0,0,2023
EMI,RA,T 98,Produzione di beni e servizi indifferenziati per uso prop...,0,0,0,0,0,2023
EMI,RA,U   ,Organizzazioni ed organismi extraterritoriali               ,0,0,0,0,0,2023
EMI,RA,U 99,Organizzazioni ed organismi extraterritoriali               ,0,0,0,0,0,2023
EMI,RA,XX  ,Imprese non classificate                                    ,28,0,34,4,66,2023
EMI,RA,TOT ,TOTALE                                                      ,181,0,1391,21,1593,2023
EMI,FO,A   ,"Agricoltura, silvicoltura pesca                             ",0,2,102,0,104,2023
EMI,FO,A 01,"Coltivazioni agricole e produzione di prodotti animali, c...",0,2,100,0,102,2023
EMI,FO,A 02,Silvicoltura ed utilizzo di aree forestali                  ,0,0,1,0,1,2023
EMI,FO,A 03,Pesca e acquacoltura                                        ,0,0,1,0,1,2023
EMI,FO,B   ,Estrazione di minerali da cave e miniere                    ,0,0,0,0,0,2023
EMI,FO,B 05,Estrazione di carbone (esclusa torba)                       ,0,0,0,0,0,2023
EMI,FO,B 06,Estraz.di petrolio greggio e di gas naturale                ,0,0,0,0,0,2023
EMI,FO,B 07,Estrazione di minerali metalliferi                          ,0,0,0,0,0,2023
EMI,FO,B 08,Altre attività di estrazione di minerali da cave e miniere  ,0,0,0,0,0,2023
EMI,FO,B 09,Attività dei servizi di supporto all'estrazione             ,0,0,0,0,0,2023
EMI,FO,C   ,Attività manifatturiere                                     ,0,35,85,0,120,2023
EMI,FO,C 10,Industrie alimentari                                        ,0,3,3,0,6,2023
EMI,FO,C 11,Industria delle bevande                                     ,0,1,0,0,1,2023
EMI,FO,C 12,Industria del tabacco                                       ,0,0,0,0,0,2023
EMI,FO,C 13,Industrie tessili                                           ,0,0,1,0,1,2023
EMI,FO,C 14,Confezione di articoli di abbigliamento; confezione di ar...,0,2,7,0,9,2023
EMI,FO,C 15,Fabbricazione di articoli in pelle e simili                 ,0,1,5,0,6,2023
EMI,FO,C 16,Industria del legno e dei prodotti in legno e sughero (es...,0,1,11,0,12,2023
EMI,FO,C 17,Fabbricazione di carta e di prodotti di carta               ,0,3,0,0,3,2023
EMI,FO,C 18,Stampa e riproduzione di supporti registrati                ,0,2,1,0,3,2023
EMI,FO,C 19,Fabbricazione di coke e prodotti derivanti dalla raffinaz...,0,0,0,0,0,2023
EMI,FO,C 20,Fabbricazione di prodotti chimici                           ,0,0,0,0,0,2023
EMI,FO,C 21,Fabbricazione di prodotti farmaceutici di base e di prepa...,0,1,0,0,1,2023
EMI,FO,C 22,Fabbricazione di articoli in gomma e materie plastiche      ,0,2,1,0,3,2023
EMI,FO,C 23,Fabbricazione di altri prodotti della lavorazione di miner..,0,5,1,0,6,2023
EMI,FO,C 24,Metallurgia                                                 ,0,0,1,0,1,2023
EMI,FO,C 25,Fabbricazione di prodotti in metallo (esclusi macchinari ...,0,7,28,0,35,2023
EMI,FO,C 26,Fabbricazione di computer e prodotti di elettronica e ott...,0,1,0,0,1,2023
EMI,FO,C 27,Fabbricazione di apparecchiature elettriche ed apparecchi...,0,2,1,0,3,2023
EMI,FO,C 28,Fabbricazione di macchinari ed apparecchiature nca          ,0,0,3,0,3,2023
EMI,FO,C 29,"Fabbricazione di autoveicoli, rimorchi e semirimorchi       ",0,0,0,0,0,2023
EMI,FO,C 30,Fabbricazione di altri mezzi di trasporto                   ,0,0,6,0,6,2023
EMI,FO,C 31,Fabbricazione di mobili                                     ,0,4,8,0,12,2023
EMI,FO,C 32,Altre industrie manifatturiere                              ,0,0,3,0,3,2023
EMI,FO,C 33,"Riparazione, manutenzione ed installazione di macchine ed...",0,0,5,0,5,2023
EMI,FO,D   ,"Fornitura di energia elettrica, gas, vapore e aria condiz...",0,0,0,0,0,2023
EMI,FO,D 35,"Fornitura di energia elettrica, gas, vapore e aria condiz...",0,0,0,0,0,2023
EMI,FO,E   ,"Fornitura di acqua; reti fognarie, attività di gestione d...",0,0,1,0,1,2023
EMI,FO,E 36,"Raccolta, trattamento e fornitura di acqua                  ",0,0,0,0,0,2023
EMI,FO,E 37,Gestione delle reti fognarie                                ,0,0,0,0,0,2023
EMI,FO,E 38,"Attività di raccolta, trattamento e smaltimento dei rifiu...",0,0,1,0,1,2023
EMI,FO,E 39,Attività di risanamento e altri servizi di gestione dei r...,0,0,0,0,0,2023
EMI,FO,F   ,Costruzioni                                                 ,0,9,364,1,374,2023
EMI,FO,F 41,Costruzione di edifici                                      ,0,6,63,1,70,2023
EMI,FO,F 42,Ingegneria civile                                           ,0,0,5,0,5,2023
EMI,FO,F 43,Lavori di costruzione specializzati                         ,0,3,296,0,299,2023
EMI,FO,G   ,Commercio all'ingrosso e al dettaglio; riparazione di aut...,0,29,205,2,236,2023
EMI,FO,G 45,Commercio all'ingrosso e al dettaglio e riparazione di au...,0,5,17,1,23,2023
EMI,FO,G 46,Commercio all'ingrosso (escluso quello di autoveicoli e d...,0,14,48,0,62,2023
EMI,FO,G 47,Commercio al dettaglio (escluso quello di autoveicoli e d...,0,10,140,1,151,2023
EMI,FO,H   ,Trasporto e magazzinaggio                                   ,0,2,28,3,33,2023
EMI,FO,H 49,Trasporto terrestre e mediante condotte                     ,0,2,27,1,30,2023
EMI,FO,H 50,Trasporto marittimo e per vie d'acqua                       ,0,0,0,0,0,2023
EMI,FO,H 51,Trasporto aereo                                             ,0,0,0,0,0,2023
EMI,FO,H 52,Magazzinaggio e attività di supporto ai trasporti           ,0,0,1,2,3,2023
EMI,FO,H 53,Servizi postali e attività di corriere                      ,0,0,0,0,0,2023
EMI,FO,I   ,Attività dei servizi alloggio e ristorazione                ,0,18,41,0,59,2023
EMI,FO,I 55,Alloggio                                                    ,0,4,0,0,4,2023
EMI,FO,I 56,Attività dei servizi di ristorazione                        ,0,14,41,0,55,2023
EMI,FO,J   ,Servizi di informazione e comunicazione                     ,0,2,9,1,12,2023
EMI,FO,J 58,Attività editoriali                                         ,0,0,1,0,1,2023
EMI,FO,J 59,"Attività di produzione cinematografica, di video e di pro...",0,0,0,0,0,2023
EMI,FO,J 60,Attività di programmazione e trasmissione                   ,0,0,0,0,0,2023
EMI,FO,J 61,Telecomunicazioni                                           ,0,0,6,0,6,2023
EMI,FO,J 62,"Produzione di software, consulenza informatica e attività...",0,1,2,1,4,2023
EMI,FO,J 63,Attività dei servizi d'informazione e altri servizi infor...,0,1,0,0,1,2023
EMI,FO,K   ,Attività finanziarie e assicurative                         ,0,1,6,0,7,2023
EMI,FO,K 64,Attività di servizi finanziari (escluse le assicurazioni ...,0,0,0,0,0,2023
EMI,FO,K 65,"Assicurazioni, riassicurazioni e fondi pensione (escluse ...",0,0,0,0,0,2023
EMI,FO,K 66,Attività ausiliarie dei servizi finanziari e delle attivi...,0,1,6,0,7,2023
EMI,FO,L   ,Attivita' immobiliari                                       ,0,9,7,1,17,2023
EMI,FO,L 68,Attivita' immobiliari                                       ,0,9,7,1,17,2023
EMI,FO,M   ,"Attività professionali, scientifiche e tecniche             ",0,4,12,2,18,2023
EMI,FO,M 69,Attività legali e contabilità                               ,0,0,0,1,1,2023
EMI,FO,M 70,Attività di direzione aziendale e di consulenza gestional...,0,1,2,1,4,2023
EMI,FO,M 71,Attività degli studi di architettura e d'ingegneria; coll...,0,0,2,0,2,2023
EMI,FO,M 72,Ricerca scientifica e sviluppo                              ,0,0,0,0,0,2023
EMI,FO,M 73,Pubblicità e ricerche di mercato                            ,0,0,6,0,6,2023
EMI,FO,M 74,"Altre attività professionali, scientifiche e tecniche       ",0,3,2,0,5,2023
EMI,FO,M 75,Servizi veterinari                                          ,0,0,0,0,0,2023
EMI,FO,N   ,"Noleggio, agenzie di viaggio, servizi di supporto alle im...",0,2,11,1,14,2023
EMI,FO,N 77,Attività di noleggio e leasing operativo                    ,0,0,0,0,0,2023
EMI,FO,N 78,"Attività di ricerca, selezione, fornitura di personale      ",0,0,1,0,1,2023
EMI,FO,N 79,"Attività dei servizi delle agenzie di viaggio, dei tour o...",0,1,0,0,1,2023
EMI,FO,N 80,Servizi di vigilanza e investigazione                       ,0,0,0,1,1,2023
EMI,FO,N 81,Attività di servizi per edifici e paesaggio                 ,0,1,6,0,7,2023
EMI,FO,N 82,Attività di supporto per le funzioni d'ufficio e altri se...,0,0,4,0,4,2023
EMI,FO,O   ,Amministrazione pubblica e difesa; assicurazione sociale ...,0,0,0,0,0,2023
EMI,FO,O 84,Amministrazione pubblica e difesa; assicurazione sociale ...,0,0,0,0,0,2023
EMI,FO,P   ,Istruzione                                                  ,0,0,3,0,3,2023
EMI,FO,P 85,Istruzione                                                  ,0,0,3,0,3,2023
EMI,FO,Q   ,Sanita' e assistenza sociale                                ,0,0,1,0,1,2023
EMI,FO,Q 86,Assistenza sanitaria                                        ,0,0,1,0,1,2023
EMI,FO,Q 87,Servizi di assistenza sociale residenziale                  ,0,0,0,0,0,2023
EMI,FO,Q 88,Assistenza sociale non residenziale                         ,0,0,0,0,0,2023
EMI,FO,R   ,"Attività artistiche, sportive, di intrattenimento e diver...",0,1,2,0,3,2023
EMI,FO,R 90,"Attività creative, artistiche e di intrattenimento          ",0,0,1,0,1,2023
EMI,FO,R 91,"Attività di biblioteche, archivi, musei ed altre attività...",0,0,0,0,0,2023
EMI,FO,R 92,"Attività riguardanti le lotterie, le scommesse, le case d...",0,0,0,0,0,2023
EMI,FO,R 93,"Attività sportive, di intrattenimento e di divertimento     ",0,1,1,0,2,2023
EMI,FO,S   ,Altre attività di servizi                                   ,0,0,19,0,19,2023
EMI,FO,S 94,Attività di organizzazioni associative                      ,0,0,0,0,0,2023
EMI,FO,S 95,Riparazione di computer e di beni per uso personale e per...,0,0,10,0,10,2023
EMI,FO,S 96,Altre attività di servizi per la persona                    ,0,0,9,0,9,2023
EMI,FO,T   ,Attività di famiglie e convivenze come datori di lavoro p...,0,0,0,0,0,2023
EMI,FO,T 97,Attività di famiglie e convivenze come datori di lavoro p...,0,0,0,0,0,2023
EMI,FO,T 98,Produzione di beni e servizi indifferenziati per uso prop...,0,0,0,0,0,2023
EMI,FO,U   ,Organizzazioni ed organismi extraterritoriali               ,0,0,0,0,0,2023
EMI,FO,U 99,Organizzazioni ed organismi extraterritoriali               ,0,0,0,0,0,2023
EMI,FO,XX  ,Imprese non classificate                                    ,0,4,1,0,5,2023
EMI,FO,TOT ,TOTALE                                                      ,0,118,897,11,1026,2023
EMI,RN,A   ,"Agricoltura, silvicoltura pesca                             ",0,1,51,0,52,2023
EMI,RN,A 01,"Coltivazioni agricole e produzione di prodotti animali, c...",0,0,49,0,49,2023
EMI,RN,A 02,Silvicoltura ed utilizzo di aree forestali                  ,0,0,1,0,1,2023
EMI,RN,A 03,Pesca e acquacoltura                                        ,0,1,1,0,2,2023
EMI,RN,B   ,Estrazione di minerali da cave e miniere                    ,0,0,0,0,0,2023
EMI,RN,B 05,Estrazione di carbone (esclusa torba)                       ,0,0,0,0,0,2023
EMI,RN,B 06,Estraz.di petrolio greggio e di gas naturale                ,0,0,0,0,0,2023
EMI,RN,B 07,Estrazione di minerali metalliferi                          ,0,0,0,0,0,2023
EMI,RN,B 08,Altre attività di estrazione di minerali da cave e miniere  ,0,0,0,0,0,2023
EMI,RN,B 09,Attività dei servizi di supporto all'estrazione             ,0,0,0,0,0,2023
EMI,RN,C   ,Attività manifatturiere                                     ,0,18,58,0,76,2023
EMI,RN,C 10,Industrie alimentari                                        ,0,0,4,0,4,2023
EMI,RN,C 11,Industria delle bevande                                     ,0,0,0,0,0,2023
EMI,RN,C 12,Industria del tabacco                                       ,0,0,0,0,0,2023
EMI,RN,C 13,Industrie tessili                                           ,0,0,0,0,0,2023
EMI,RN,C 14,Confezione di articoli di abbigliamento; confezione di ar...,0,4,11,0,15,2023
EMI,RN,C 15,Fabbricazione di articoli in pelle e simili                 ,0,0,3,0,3,2023
EMI,RN,C 16,Industria del legno e dei prodotti in legno e sughero (es...,0,2,5,0,7,2023
EMI,RN,C 17,Fabbricazione di carta e di prodotti di carta               ,0,1,0,0,1,2023
EMI,RN,C 18,Stampa e riproduzione di supporti registrati                ,0,0,2,0,2,2023
EMI,RN,C 19,Fabbricazione di coke e prodotti derivanti dalla raffinaz...,0,0,0,0,0,2023
EMI,RN,C 20,Fabbricazione di prodotti chimici                           ,0,0,0,0,0,2023
EMI,RN,C 21,Fabbricazione di prodotti farmaceutici di base e di prepa...,0,0,0,0,0,2023
EMI,RN,C 22,Fabbricazione di articoli in gomma e materie plastiche      ,0,0,1,0,1,2023
EMI,RN,C 23,Fabbricazione di altri prodotti della lavorazione di miner..,0,0,2,0,2,2023
EMI,RN,C 24,Metallurgia                                                 ,0,0,1,0,1,2023
EMI,RN,C 25,Fabbricazione di prodotti in metallo (esclusi macchinari ...,0,1,5,0,6,2023
EMI,RN,C 26,Fabbricazione di computer e prodotti di elettronica e ott...,0,1,1,0,2,2023
EMI,RN,C 27,Fabbricazione di apparecchiature elettriche ed apparecchi...,0,2,3,0,5,2023
EMI,RN,C 28,Fabbricazione di macchinari ed apparecchiature nca          ,0,1,5,0,6,2023
EMI,RN,C 29,"Fabbricazione di autoveicoli, rimorchi e semirimorchi       ",0,0,0,0,0,2023
EMI,RN,C 30,Fabbricazione di altri mezzi di trasporto                   ,0,0,1,0,1,2023
EMI,RN,C 31,Fabbricazione di mobili                                     ,0,5,5,0,10,2023
EMI,RN,C 32,Altre industrie manifatturiere                              ,0,1,5,0,6,2023
EMI,RN,C 33,"Riparazione, manutenzione ed installazione di macchine ed...",0,0,4,0,4,2023
EMI,RN,D   ,"Fornitura di energia elettrica, gas, vapore e aria condiz...",0,0,0,0,0,2023
EMI,RN,D 35,"Fornitura di energia elettrica, gas, vapore e aria condiz...",0,0,0,0,0,2023
EMI,RN,E   ,"Fornitura di acqua; reti fognarie, attività di gestione d...",0,0,1,0,1,2023
EMI,RN,E 36,"Raccolta, trattamento e fornitura di acqua                  ",0,0,0,0,0,2023
EMI,RN,E 37,Gestione delle reti fognarie                                ,0,0,0,0,0,2023
EMI,RN,E 38,"Attività di raccolta, trattamento e smaltimento dei rifiu...",0,0,1,0,1,2023
EMI,RN,E 39,Attività di risanamento e altri servizi di gestione dei r...,0,0,0,0,0,2023
EMI,RN,F   ,Costruzioni                                                 ,0,5,316,5,326,2023
EMI,RN,F 41,Costruzione di edifici                                      ,0,2,53,4,59,2023
EMI,RN,F 42,Ingegneria civile                                           ,0,0,0,0,0,2023
EMI,RN,F 43,Lavori di costruzione specializzati                         ,0,3,263,1,267,2023
EMI,RN,G   ,Commercio all'ingrosso e al dettaglio; riparazione di aut...,0,38,156,0,194,2023
EMI,RN,G 45,Commercio all'ingrosso e al dettaglio e riparazione di au...,0,3,8,0,11,2023
EMI,RN,G 46,Commercio all'ingrosso (escluso quello di autoveicoli e d...,0,17,32,0,49,2023
EMI,RN,G 47,Commercio al dettaglio (escluso quello di autoveicoli e d...,0,18,116,0,134,2023
EMI,RN,H   ,Trasporto e magazzinaggio                                   ,0,3,30,3,36,2023
EMI,RN,H 49,Trasporto terrestre e mediante condotte                     ,0,3,29,0,32,2023
EMI,RN,H 50,Trasporto marittimo e per vie d'acqua                       ,0,0,0,0,0,2023
EMI,RN,H 51,Trasporto aereo                                             ,0,0,0,0,0,2023
EMI,RN,H 52,Magazzinaggio e attività di supporto ai trasporti           ,0,0,1,3,4,2023
EMI,RN,H 53,Servizi postali e attività di corriere                      ,0,0,0,0,0,2023
EMI,RN,I   ,Attività dei servizi alloggio e ristorazione                ,0,18,47,0,65,2023
EMI,RN,I 55,Alloggio                                                    ,0,2,12,0,14,2023
EMI,RN,I 56,Attività dei servizi di ristorazione                        ,0,16,35,0,51,2023
EMI,RN,J   ,Servizi di informazione e comunicazione                     ,0,1,5,0,6,2023
EMI,RN,J 58,Attività editoriali                                         ,0,0,2,0,2,2023
EMI,RN,J 59,"Attività di produzione cinematografica, di video e di pro...",0,0,1,0,1,2023
EMI,RN,J 60,Attività di programmazione e trasmissione                   ,0,0,0,0,0,2023
EMI,RN,J 61,Telecomunicazioni                                           ,0,0,1,0,1,2023
EMI,RN,J 62,"Produzione di software, consulenza informatica e attività...",0,0,1,0,1,2023
EMI,RN,J 63,Attività dei servizi d'informazione e altri servizi infor...,0,1,0,0,1,2023
EMI,RN,K   ,Attività finanziarie e assicurative                         ,0,1,5,0,6,2023
EMI,RN,K 64,Attività di servizi finanziari (escluse le assicurazioni ...,0,0,0,0,0,2023
EMI,RN,K 65,"Assicurazioni, riassicurazioni e fondi pensione (escluse ...",0,0,0,0,0,2023
EMI,RN,K 66,Attività ausiliarie dei servizi finanziari e delle attivi...,0,1,5,0,6,2023
EMI,RN,L   ,Attivita' immobiliari                                       ,0,8,3,0,11,2023
EMI,RN,L 68,Attivita' immobiliari                                       ,0,8,3,0,11,2023
EMI,RN,M   ,"Attività professionali, scientifiche e tecniche             ",0,3,12,1,16,2023
EMI,RN,M 69,Attività legali e contabilità                               ,0,1,0,0,1,2023
EMI,RN,M 70,Attività di direzione aziendale e di consulenza gestional...,0,0,1,0,1,2023
EMI,RN,M 71,Attività degli studi di architettura e d'ingegneria; coll...,0,1,1,1,3,2023
EMI,RN,M 72,Ricerca scientifica e sviluppo                              ,0,0,0,0,0,2023
EMI,RN,M 73,Pubblicità e ricerche di mercato                            ,0,0,4,0,4,2023
EMI,RN,M 74,"Altre attività professionali, scientifiche e tecniche       ",0,1,6,0,7,2023
EMI,RN,M 75,Servizi veterinari                                          ,0,0,0,0,0,2023
EMI,RN,N   ,"Noleggio, agenzie di viaggio, servizi di supporto alle im...",0,3,14,3,20,2023
EMI,RN,N 77,Attività di noleggio e leasing operativo                    ,0,0,1,0,1,2023
EMI,RN,N 78,"Attività di ricerca, selezione, fornitura di personale      ",0,0,0,0,0,2023
EMI,RN,N 79,"Attività dei servizi delle agenzie di viaggio, dei tour o...",0,1,0,0,1,2023
EMI,RN,N 80,Servizi di vigilanza e investigazione                       ,0,0,0,0,0,2023
EMI,RN,N 81,Attività di servizi per edifici e paesaggio                 ,0,1,9,3,13,2023
EMI,RN,N 82,Attività di supporto per le funzioni d'ufficio e altri se...,0,1,4,0,5,2023
EMI,RN,O   ,Amministrazione pubblica e difesa; assicurazione sociale ...,0,0,0,0,0,2023
EMI,RN,O 84,Amministrazione pubblica e difesa; assicurazione sociale ...,0,0,0,0,0,2023
EMI,RN,P   ,Istruzione                                                  ,0,0,0,0,0,2023
EMI,RN,P 85,Istruzione                                                  ,0,0,0,0,0,2023
EMI,RN,Q   ,Sanita' e assistenza sociale                                ,0,0,1,2,3,2023
EMI,RN,Q 86,Assistenza sanitaria                                        ,0,0,0,0,0,2023
EMI,RN,Q 87,Servizi di assistenza sociale residenziale                  ,0,0,0,0,0,2023
EMI,RN,Q 88,Assistenza sociale non residenziale                         ,0,0,1,2,3,2023
EMI,RN,R   ,"Attività artistiche, sportive, di intrattenimento e diver...",0,1,6,0,7,2023
EMI,RN,R 90,"Attività creative, artistiche e di intrattenimento          ",0,0,1,0,1,2023
EMI,RN,R 91,"Attività di biblioteche, archivi, musei ed altre attività...",0,0,0,0,0,2023
EMI,RN,R 92,"Attività riguardanti le lotterie, le scommesse, le case d...",0,0,1,0,1,2023
EMI,RN,R 93,"Attività sportive, di intrattenimento e di divertimento     ",0,1,4,0,5,2023
EMI,RN,S   ,Altre attività di servizi                                   ,0,3,13,0,16,2023
EMI,RN,S 94,Attività di organizzazioni associative                      ,0,0,0,0,0,2023
EMI,RN,S 95,Riparazione di computer e di beni per uso personale e per...,0,0,6,0,6,2023
EMI,RN,S 96,Altre attività di servizi per la persona                    ,0,3,7,0,10,2023
EMI,RN,T   ,Attività di famiglie e convivenze come datori di lavoro p...,0,0,0,0,0,2023
EMI,RN,T 97,Attività di famiglie e convivenze come datori di lavoro p...,0,0,0,0,0,2023
EMI,RN,T 98,Produzione di beni e servizi indifferenziati per uso prop...,0,0,0,0,0,2023
EMI,RN,U   ,Organizzazioni ed organismi extraterritoriali               ,0,0,0,0,0,2023
EMI,RN,U 99,Organizzazioni ed organismi extraterritoriali               ,0,0,0,0,0,2023
EMI,RN,XX  ,Imprese non classificate                                    ,0,6,3,7,16,2023
EMI,RN,TOT ,TOTALE                                                      ,0,109,721,21,851,2023
TOS,  ,A   ,"Agricoltura, silvicoltura pesca                             ",36,51,388,10,485,2023
TOS,  ,A 01,"Coltivazioni agricole e produzione di prodotti animali, c...",30,45,375,9,459,2023
TOS,  ,A 02,Silvicoltura ed utilizzo di aree forestali                  ,6,5,4,0,15,2023
TOS,  ,A 03,Pesca e acquacoltura                                        ,0,1,9,1,11,2023
TOS,  ,B   ,Estrazione di minerali da cave e miniere                    ,13,1,0,0,14,2023
TOS,  ,B 05,Estrazione di carbone (esclusa torba)                       ,0,0,0,0,0,2023
TOS,  ,B 06,Estraz.di petrolio greggio e di gas naturale                ,0,0,0,0,0,2023
TOS,  ,B 07,Estrazione di minerali metalliferi                          ,0,0,0,0,0,2023
TOS,  ,B 08,Altre attività di estrazione di minerali da cave e miniere  ,13,1,0,0,14,2023
TOS,  ,B 09,Attività dei servizi di supporto all'estrazione             ,0,0,0,0,0,2023
TOS,  ,C   ,Attività manifatturiere                                     ,1486,180,133,6,1805,2023
TOS,  ,C 10,Industrie alimentari                                        ,48,13,7,2,70,2023
TOS,  ,C 11,Industria delle bevande                                     ,11,0,0,0,11,2023
TOS,  ,C 12,Industria del tabacco                                       ,1,0,0,0,1,2023
TOS,  ,C 13,Industrie tessili                                           ,133,20,12,0,165,2023
TOS,  ,C 14,Confezione di articoli di abbigliamento; confezione di ar...,348,42,39,0,429,2023
TOS,  ,C 15,Fabbricazione di articoli in pelle e simili                 ,247,26,18,1,292,2023
TOS,  ,C 16,Industria del legno e dei prodotti in legno e sughero (es...,39,6,6,0,51,2023
TOS,  ,C 17,Fabbricazione di carta e di prodotti di carta               ,16,2,2,0,20,2023
TOS,  ,C 18,Stampa e riproduzione di supporti registrati                ,45,7,3,0,55,2023
TOS,  ,C 19,Fabbricazione di coke e prodotti derivanti dalla raffinaz...,1,0,0,0,1,2023
TOS,  ,C 20,Fabbricazione di prodotti chimici                           ,29,1,0,0,30,2023
TOS,  ,C 21,Fabbricazione di prodotti farmaceutici di base e di prepa...,3,1,0,0,4,2023
TOS,  ,C 22,Fabbricazione di articoli in gomma e materie plastiche      ,24,2,1,1,28,2023
TOS,  ,C 23,Fabbricazione di altri prodotti della lavorazione di miner..,81,6,5,1,93,2023
TOS,  ,C 24,Metallurgia                                                 ,8,4,1,0,13,2023
TOS,  ,C 25,Fabbricazione di prodotti in metallo (esclusi macchinari ...,115,9,11,0,135,2023
TOS,  ,C 26,Fabbricazione di computer e prodotti di elettronica e ott...,38,5,0,0,43,2023
TOS,  ,C 27,Fabbricazione di apparecchiature elettriche ed apparecchi...,27,1,1,0,29,2023
TOS,  ,C 28,Fabbricazione di macchinari ed apparecchiature nca          ,60,3,3,0,66,2023
TOS,  ,C 29,"Fabbricazione di autoveicoli, rimorchi e semirimorchi       ",4,2,0,0,6,2023
TOS,  ,C 30,Fabbricazione di altri mezzi di trasporto                   ,19,1,4,0,24,2023
TOS,  ,C 31,Fabbricazione di mobili                                     ,98,9,0,1,108,2023
TOS,  ,C 32,Altre industrie manifatturiere                              ,76,19,11,0,106,2023
TOS,  ,C 33,"Riparazione, manutenzione ed installazione di macchine ed...",15,1,9,0,25,2023
TOS,  ,D   ,"Fornitura di energia elettrica, gas, vapore e aria condiz...",3,0,0,0,3,2023
TOS,  ,D 35,"Fornitura di energia elettrica, gas, vapore e aria condiz...",3,0,0,0,3,2023
TOS,  ,E   ,"Fornitura di acqua; reti fognarie, attività di gestione d...",17,2,1,1,21,2023
TOS,  ,E 36,"Raccolta, trattamento e fornitura di acqua                  ",0,0,0,0,0,2023
TOS,  ,E 37,Gestione delle reti fognarie                                ,1,0,0,0,1,2023
TOS,  ,E 38,"Attività di raccolta, trattamento e smaltimento dei rifiu...",12,2,1,1,16,2023
TOS,  ,E 39,Attività di risanamento e altri servizi di gestione dei r...,4,0,0,0,4,2023
TOS,  ,F   ,Costruzioni                                                 ,685,86,192,29,992,2023
TOS,  ,F 41,Costruzione di edifici                                      ,486,39,65,21,611,2023
TOS,  ,F 42,Ingegneria civile                                           ,11,2,3,4,20,2023
TOS,  ,F 43,Lavori di costruzione specializzati                         ,188,45,124,4,361,2023
TOS,  ,G   ,Commercio all'ingrosso e al dettaglio; riparazione di aut...,1608,297,414,11,2330,2023
TOS,  ,G 45,Commercio all'ingrosso e al dettaglio e riparazione di au...,161,23,28,1,213,2023
TOS,  ,G 46,Commercio all'ingrosso (escluso quello di autoveicoli e d...,917,96,90,6,1109,2023
TOS,  ,G 47,Commercio al dettaglio (escluso quello di autoveicoli e d...,530,178,296,4,1008,2023
TOS,  ,H   ,Trasporto e magazzinaggio                                   ,113,20,28,14,175,2023
TOS,  ,H 49,Trasporto terrestre e mediante condotte                     ,59,13,21,5,98,2023
TOS,  ,H 50,Trasporto marittimo e per vie d'acqua                       ,1,0,0,0,1,2023
TOS,  ,H 51,Trasporto aereo                                             ,1,0,0,0,1,2023
TOS,  ,H 52,Magazzinaggio e attività di supporto ai trasporti           ,44,6,7,9,66,2023
TOS,  ,H 53,Servizi postali e attività di corriere                      ,8,1,0,0,9,2023
TOS,  ,I   ,Attività dei servizi alloggio e ristorazione                ,484,253,86,0,823,2023
TOS,  ,I 55,Alloggio                                                    ,49,16,12,0,77,2023
TOS,  ,I 56,Attività dei servizi di ristorazione                        ,435,237,74,0,746,2023
TOS,  ,J   ,Servizi di informazione e comunicazione                     ,191,16,16,4,227,2023
TOS,  ,J 58,Attività editoriali                                         ,38,2,3,1,44,2023
TOS,  ,J 59,"Attività di produzione cinematografica, di video e di pro...",14,0,0,0,14,2023
TOS,  ,J 60,Attività di programmazione e trasmissione                   ,9,1,0,0,10,2023
TOS,  ,J 61,Telecomunicazioni                                           ,9,1,2,0,12,2023
TOS,  ,J 62,"Produzione di software, consulenza informatica e attività...",70,2,7,1,80,2023
TOS,  ,J 63,Attività dei servizi d'informazione e altri servizi infor...,51,10,4,2,67,2023
TOS,  ,K   ,Attività finanziarie e assicurative                         ,89,12,14,1,116,2023
TOS,  ,K 64,Attività di servizi finanziari (escluse le assicurazioni ...,63,5,0,1,69,2023
TOS,  ,K 65,"Assicurazioni, riassicurazioni e fondi pensione (escluse ...",0,1,0,0,1,2023
TOS,  ,K 66,Attività ausiliarie dei servizi finanziari e delle attivi...,26,6,14,0,46,2023
TOS,  ,L   ,Attivita' immobiliari                                       ,510,55,19,0,584,2023
TOS,  ,L 68,Attivita' immobiliari                                       ,510,55,19,0,584,2023
TOS,  ,M   ,"Attività professionali, scientifiche e tecniche             ",337,33,26,11,407,2023
TOS,  ,M 69,Attività legali e contabilità                               ,14,0,3,0,17,2023
TOS,  ,M 70,Attività di direzione aziendale e di consulenza gestional...,92,6,3,4,105,2023
TOS,  ,M 71,Attività degli studi di architettura e d'ingegneria; coll...,34,5,1,1,41,2023
TOS,  ,M 72,Ricerca scientifica e sviluppo                              ,9,0,0,2,11,2023
TOS,  ,M 73,Pubblicità e ricerche di mercato                            ,85,14,10,2,111,2023
TOS,  ,M 74,"Altre attività professionali, scientifiche e tecniche       ",103,8,9,2,122,2023
TOS,  ,M 75,Servizi veterinari                                          ,0,0,0,0,0,2023
TOS,  ,N   ,"Noleggio, agenzie di viaggio, servizi di supporto alle im...",161,32,38,16,247,2023
TOS,  ,N 77,Attività di noleggio e leasing operativo                    ,27,7,3,0,37,2023
TOS,  ,N 78,"Attività di ricerca, selezione, fornitura di personale      ",2,0,0,0,2,2023
TOS,  ,N 79,"Attività dei servizi delle agenzie di viaggio, dei tour o...",37,5,1,1,44,2023
TOS,  ,N 80,Servizi di vigilanza e investigazione                       ,3,0,0,0,3,2023
TOS,  ,N 81,Attività di servizi per edifici e paesaggio                 ,24,13,12,9,58,2023
TOS,  ,N 82,Attività di supporto per le funzioni d'ufficio e altri se...,68,7,22,6,103,2023
TOS,  ,O   ,Amministrazione pubblica e difesa; assicurazione sociale ...,0,0,0,0,0,2023
TOS,  ,O 84,Amministrazione pubblica e difesa; assicurazione sociale ...,0,0,0,0,0,2023
TOS,  ,P   ,Istruzione                                                  ,28,6,1,2,37,2023
TOS,  ,P 85,Istruzione                                                  ,28,6,1,2,37,2023
TOS,  ,Q   ,Sanita' e assistenza sociale                                ,16,3,1,2,22,2023
TOS,  ,Q 86,Assistenza sanitaria                                        ,12,3,0,0,15,2023
TOS,  ,Q 87,Servizi di assistenza sociale residenziale                  ,3,0,1,0,4,2023
TOS,  ,Q 88,Assistenza sociale non residenziale                         ,1,0,0,2,3,2023
TOS,  ,R   ,"Attività artistiche, sportive, di intrattenimento e diver...",149,17,25,3,194,2023
TOS,  ,R 90,"Attività creative, artistiche e di intrattenimento          ",44,3,20,0,67,2023
TOS,  ,R 91,"Attività di biblioteche, archivi, musei ed altre attività...",1,0,0,0,1,2023
TOS,  ,R 92,"Attività riguardanti le lotterie, le scommesse, le case d...",7,2,0,0,9,2023
TOS,  ,R 93,"Attività sportive, di intrattenimento e di divertimento     ",97,12,5,3,117,2023
TOS,  ,S   ,Altre attività di servizi                                   ,72,39,26,0,137,2023
TOS,  ,S 94,Attività di organizzazioni associative                      ,0,0,0,0,0,2023
TOS,  ,S 95,Riparazione di computer e di beni per uso personale e per...,15,9,7,0,31,2023
TOS,  ,S 96,Altre attività di servizi per la persona                    ,57,30,19,0,106,2023
TOS,  ,T   ,Attività di famiglie e convivenze come datori di lavoro p...,0,0,0,0,0,2023
TOS,  ,T 97,Attività di famiglie e convivenze come datori di lavoro p...,0,0,0,0,0,2023
TOS,  ,T 98,Produzione di beni e servizi indifferenziati per uso prop...,0,0,0,0,0,2023
TOS,  ,U   ,Organizzazioni ed organismi extraterritoriali               ,0,0,0,0,0,2023
TOS,  ,U 99,Organizzazioni ed organismi extraterritoriali               ,0,0,0,0,0,2023
TOS,  ,XX  ,Imprese non classificate                                    ,933,117,71,26,1147,2023
TOS,  ,TOT ,TOTALE                                                      ,6931,1220,1479,136,9766,2023
TOS,MS,A   ,"Agricoltura, silvicoltura pesca                             ",0,0,0,0,0,2023
TOS,MS,A 01,"Coltivazioni agricole e produzione di prodotti animali, c...",0,0,0,0,0,2023
TOS,MS,A 02,Silvicoltura ed utilizzo di aree forestali                  ,0,0,0,0,0,2023
TOS,MS,A 03,Pesca e acquacoltura                                        ,0,0,0,0,0,2023
TOS,MS,B   ,Estrazione di minerali da cave e miniere                    ,4,0,0,0,4,2023
TOS,MS,B 05,Estrazione di carbone (esclusa torba)                       ,0,0,0,0,0,2023
TOS,MS,B 06,Estraz.di petrolio greggio e di gas naturale                ,0,0,0,0,0,2023
TOS,MS,B 07,Estrazione di minerali metalliferi                          ,0,0,0,0,0,2023
TOS,MS,B 08,Altre attività di estrazione di minerali da cave e miniere  ,4,0,0,0,4,2023
TOS,MS,B 09,Attività dei servizi di supporto all'estrazione             ,0,0,0,0,0,2023
TOS,MS,C   ,Attività manifatturiere                                     ,67,0,1,0,68,2023
TOS,MS,C 10,Industrie alimentari                                        ,3,0,0,0,3,2023
TOS,MS,C 11,Industria delle bevande                                     ,1,0,0,0,1,2023
TOS,MS,C 12,Industria del tabacco                                       ,0,0,0,0,0,2023
TOS,MS,C 13,Industrie tessili                                           ,2,0,0,0,2,2023
TOS,MS,C 14,Confezione di articoli di abbigliamento; confezione di ar...,1,0,0,0,1,2023
TOS,MS,C 15,Fabbricazione di articoli in pelle e simili                 ,0,0,0,0,0,2023
TOS,MS,C 16,Industria del legno e dei prodotti in legno e sughero (es...,3,0,0,0,3,2023
TOS,MS,C 17,Fabbricazione di carta e di prodotti di carta               ,0,0,0,0,0,2023
TOS,MS,C 18,Stampa e riproduzione di supporti registrati                ,2,0,0,0,2,2023
TOS,MS,C 19,Fabbricazione di coke e prodotti derivanti dalla raffinaz...,0,0,0,0,0,2023
TOS,MS,C 20,Fabbricazione di prodotti chimici                           ,1,0,0,0,1,2023
TOS,MS,C 21,Fabbricazione di prodotti farmaceutici di base e di prepa...,0,0,0,0,0,2023
TOS,MS,C 22,Fabbricazione di articoli in gomma e materie plastiche      ,2,0,0,0,2,2023
TOS,MS,C 23,Fabbricazione di altri prodotti della lavorazione di miner..,14,0,0,0,14,2023
TOS,MS,C 24,Metallurgia                                                 ,0,0,0,0,0,2023
TOS,MS,C 25,Fabbricazione di prodotti in metallo (esclusi macchinari ...,18,0,1,0,19,2023
TOS,MS,C 26,Fabbricazione di computer e prodotti di elettronica e ott...,0,0,0,0,0,2023
TOS,MS,C 27,Fabbricazione di apparecchiature elettriche ed apparecchi...,2,0,0,0,2,2023
TOS,MS,C 28,Fabbricazione di macchinari ed apparecchiature nca          ,5,0,0,0,5,2023
TOS,MS,C 29,"Fabbricazione di autoveicoli, rimorchi e semirimorchi       ",0,0,0,0,0,2023
TOS,MS,C 30,Fabbricazione di altri mezzi di trasporto                   ,6,0,0,0,6,2023
TOS,MS,C 31,Fabbricazione di mobili                                     ,1,0,0,0,1,2023
TOS,MS,C 32,Altre industrie manifatturiere                              ,1,0,0,0,1,2023
TOS,MS,C 33,"Riparazione, manutenzione ed installazione di macchine ed...",5,0,0,0,5,2023
TOS,MS,D   ,"Fornitura di energia elettrica, gas, vapore e aria condiz...",0,0,0,0,0,2023
TOS,MS,D 35,"Fornitura di energia elettrica, gas, vapore e aria condiz...",0,0,0,0,0,2023
TOS,MS,E   ,"Fornitura di acqua; reti fognarie, attività di gestione d...",2,0,0,0,2,2023
TOS,MS,E 36,"Raccolta, trattamento e fornitura di acqua                  ",0,0,0,0,0,2023
TOS,MS,E 37,Gestione delle reti fognarie                                ,0,0,0,0,0,2023
TOS,MS,E 38,"Attività di raccolta, trattamento e smaltimento dei rifiu...",2,0,0,0,2,2023
TOS,MS,E 39,Attività di risanamento e altri servizi di gestione dei r...,0,0,0,0,0,2023
TOS,MS,F   ,Costruzioni                                                 ,44,0,0,0,44,2023
TOS,MS,F 41,Costruzione di edifici                                      ,18,0,0,0,18,2023
TOS,MS,F 42,Ingegneria civile                                           ,2,0,0,0,2,2023
TOS,MS,F 43,Lavori di costruzione specializzati                         ,24,0,0,0,24,2023
TOS,MS,G   ,Commercio all'ingrosso e al dettaglio; riparazione di aut...,98,0,1,0,99,2023
TOS,MS,G 45,Commercio all'ingrosso e al dettaglio e riparazione di au...,9,0,0,0,9,2023
TOS,MS,G 46,Commercio all'ingrosso (escluso quello di autoveicoli e d...,57,0,0,0,57,2023
TOS,MS,G 47,Commercio al dettaglio (escluso quello di autoveicoli e d...,32,0,1,0,33,2023
TOS,MS,H   ,Trasporto e magazzinaggio                                   ,7,0,0,0,7,2023
TOS,MS,H 49,Trasporto terrestre e mediante condotte                     ,5,0,0,0,5,2023
TOS,MS,H 50,Trasporto marittimo e per vie d'acqua                       ,0,0,0,0,0,2023
TOS,MS,H 51,Trasporto aereo                                             ,0,0,0,0,0,2023
TOS,MS,H 52,Magazzinaggio e attività di supporto ai trasporti           ,2,0,0,0,2,2023
TOS,MS,H 53,Servizi postali e attività di corriere                      ,0,0,0,0,0,2023
TOS,MS,I   ,Attività dei servizi alloggio e ristorazione                ,27,0,0,0,27,2023
TOS,MS,I 55,Alloggio                                                    ,0,0,0,0,0,2023
TOS,MS,I 56,Attività dei servizi di ristorazione                        ,27,0,0,0,27,2023
TOS,MS,J   ,Servizi di informazione e comunicazione                     ,2,0,0,0,2,2023
TOS,MS,J 58,Attività editoriali                                         ,1,0,0,0,1,2023
TOS,MS,J 59,"Attività di produzione cinematografica, di video e di pro...",0,0,0,0,0,2023
TOS,MS,J 60,Attività di programmazione e trasmissione                   ,0,0,0,0,0,2023
TOS,MS,J 61,Telecomunicazioni                                           ,0,0,0,0,0,2023
TOS,MS,J 62,"Produzione di software, consulenza informatica e attività...",1,0,0,0,1,2023
TOS,MS,J 63,Attività dei servizi d'informazione e altri servizi infor...,0,0,0,0,0,2023
TOS,MS,K   ,Attività finanziarie e assicurative                         ,0,0,0,0,0,2023
TOS,MS,K 64,Attività di servizi finanziari (escluse le assicurazioni ...,0,0,0,0,0,2023
TOS,MS,K 65,"Assicurazioni, riassicurazioni e fondi pensione (escluse ...",0,0,0,0,0,2023
TOS,MS,K 66,Attività ausiliarie dei servizi finanziari e delle attivi...,0,0,0,0,0,2023
TOS,MS,L   ,Attivita' immobiliari                                       ,9,0,0,0,9,2023
TOS,MS,L 68,Attivita' immobiliari                                       ,9,0,0,0,9,2023
TOS,MS,M   ,"Attività professionali, scientifiche e tecniche             ",7,0,0,1,8,2023
TOS,MS,M 69,Attività legali e contabilità                               ,1,0,0,0,1,2023
TOS,MS,M 70,Attività di direzione aziendale e di consulenza gestional...,2,0,0,1,3,2023
TOS,MS,M 71,Attività degli studi di architettura e d'ingegneria; coll...,1,0,0,0,1,2023
TOS,MS,M 72,Ricerca scientifica e sviluppo                              ,2,0,0,0,2,2023
TOS,MS,M 73,Pubblicità e ricerche di mercato                            ,1,0,0,0,1,2023
TOS,MS,M 74,"Altre attività professionali, scientifiche e tecniche       ",0,0,0,0,0,2023
TOS,MS,M 75,Servizi veterinari                                          ,0,0,0,0,0,2023
TOS,MS,N   ,"Noleggio, agenzie di viaggio, servizi di supporto alle im...",11,0,0,0,11,2023
TOS,MS,N 77,Attività di noleggio e leasing operativo                    ,3,0,0,0,3,2023
TOS,MS,N 78,"Attività di ricerca, selezione, fornitura di personale      ",0,0,0,0,0,2023
TOS,MS,N 79,"Attività dei servizi delle agenzie di viaggio, dei tour o...",2,0,0,0,2,2023
TOS,MS,N 80,Servizi di vigilanza e investigazione                       ,1,0,0,0,1,2023
TOS,MS,N 81,Attività di servizi per edifici e paesaggio                 ,1,0,0,0,1,2023
TOS,MS,N 82,Attività di supporto per le funzioni d'ufficio e altri se...,4,0,0,0,4,2023
TOS,MS,O   ,Amministrazione pubblica e difesa; assicurazione sociale ...,0,0,0,0,0,2023
TOS,MS,O 84,Amministrazione pubblica e difesa; assicurazione sociale ...,0,0,0,0,0,2023
TOS,MS,P   ,Istruzione                                                  ,1,0,0,0,1,2023
TOS,MS,P 85,Istruzione                                                  ,1,0,0,0,1,2023
TOS,MS,Q   ,Sanita' e assistenza sociale                                ,2,0,0,0,2,2023
TOS,MS,Q 86,Assistenza sanitaria                                        ,1,0,0,0,1,2023
TOS,MS,Q 87,Servizi di assistenza sociale residenziale                  ,0,0,0,0,0,2023
TOS,MS,Q 88,Assistenza sociale non residenziale                         ,1,0,0,0,1,2023
TOS,MS,R   ,"Attività artistiche, sportive, di intrattenimento e diver...",8,0,0,0,8,2023
TOS,MS,R 90,"Attività creative, artistiche e di intrattenimento          ",2,0,0,0,2,2023
TOS,MS,R 91,"Attività di biblioteche, archivi, musei ed altre attività...",0,0,0,0,0,2023
TOS,MS,R 92,"Attività riguardanti le lotterie, le scommesse, le case d...",0,0,0,0,0,2023
TOS,MS,R 93,"Attività sportive, di intrattenimento e di divertimento     ",6,0,0,0,6,2023
TOS,MS,S   ,Altre attività di servizi                                   ,3,0,0,0,3,2023
TOS,MS,S 94,Attività di organizzazioni associative                      ,0,0,0,0,0,2023
TOS,MS,S 95,Riparazione di computer e di beni per uso personale e per...,0,0,0,0,0,2023
TOS,MS,S 96,Altre attività di servizi per la persona                    ,3,0,0,0,3,2023
TOS,MS,T   ,Attività di famiglie e convivenze come datori di lavoro p...,0,0,0,0,0,2023
TOS,MS,T 97,Attività di famiglie e convivenze come datori di lavoro p...,0,0,0,0,0,2023
TOS,MS,T 98,Produzione di beni e servizi indifferenziati per uso prop...,0,0,0,0,0,2023
TOS,MS,U   ,Organizzazioni ed organismi extraterritoriali               ,0,0,0,0,0,2023
TOS,MS,U 99,Organizzazioni ed organismi extraterritoriali               ,0,0,0,0,0,2023
TOS,MS,XX  ,Imprese non classificate                                    ,37,0,0,1,38,2023
TOS,MS,TOT ,TOTALE                                                      ,329,0,2,2,333,2023
TOS,LU,A   ,"Agricoltura, silvicoltura pesca                             ",0,0,13,0,13,2023
TOS,LU,A 01,"Coltivazioni agricole e produzione di prodotti animali, c...",0,0,8,0,8,2023
TOS,LU,A 02,Silvicoltura ed utilizzo di aree forestali                  ,0,0,0,0,0,2023
TOS,LU,A 03,Pesca e acquacoltura                                        ,0,0,5,0,5,2023
TOS,LU,B   ,Estrazione di minerali da cave e miniere                    ,0,0,0,0,0,2023
TOS,LU,B 05,Estrazione di carbone (esclusa torba)                       ,0,0,0,0,0,2023
TOS,LU,B 06,Estraz.di petrolio greggio e di gas naturale                ,0,0,0,0,0,2023
TOS,LU,B 07,Estrazione di minerali metalliferi                          ,0,0,0,0,0,2023
TOS,LU,B 08,Altre attività di estrazione di minerali da cave e miniere  ,0,0,0,0,0,2023
TOS,LU,B 09,Attività dei servizi di supporto all'estrazione             ,0,0,0,0,0,2023
TOS,LU,C   ,Attività manifatturiere                                     ,36,0,42,0,78,2023
TOS,LU,C 10,Industrie alimentari                                        ,1,0,2,0,3,2023
TOS,LU,C 11,Industria delle bevande                                     ,0,0,0,0,0,2023
TOS,LU,C 12,Industria del tabacco                                       ,0,0,0,0,0,2023
TOS,LU,C 13,Industrie tessili                                           ,0,0,1,0,1,2023
TOS,LU,C 14,Confezione di articoli di abbigliamento; confezione di ar...,0,0,4,0,4,2023
TOS,LU,C 15,Fabbricazione di articoli in pelle e simili                 ,1,0,5,0,6,2023
TOS,LU,C 16,Industria del legno e dei prodotti in legno e sughero (es...,7,0,2,0,9,2023
TOS,LU,C 17,Fabbricazione di carta e di prodotti di carta               ,2,0,2,0,4,2023
TOS,LU,C 18,Stampa e riproduzione di supporti registrati                ,1,0,0,0,1,2023
TOS,LU,C 19,Fabbricazione di coke e prodotti derivanti dalla raffinaz...,0,0,0,0,0,2023
TOS,LU,C 20,Fabbricazione di prodotti chimici                           ,0,0,0,0,0,2023
TOS,LU,C 21,Fabbricazione di prodotti farmaceutici di base e di prepa...,0,0,0,0,0,2023
TOS,LU,C 22,Fabbricazione di articoli in gomma e materie plastiche      ,0,0,1,0,1,2023
TOS,LU,C 23,Fabbricazione di altri prodotti della lavorazione di miner..,5,0,2,0,7,2023
TOS,LU,C 24,Metallurgia                                                 ,1,0,0,0,1,2023
TOS,LU,C 25,Fabbricazione di prodotti in metallo (esclusi macchinari ...,3,0,6,0,9,2023
TOS,LU,C 26,Fabbricazione di computer e prodotti di elettronica e ott...,1,0,0,0,1,2023
TOS,LU,C 27,Fabbricazione di apparecchiature elettriche ed apparecchi...,0,0,0,0,0,2023
TOS,LU,C 28,Fabbricazione di macchinari ed apparecchiature nca          ,1,0,1,0,2,2023
TOS,LU,C 29,"Fabbricazione di autoveicoli, rimorchi e semirimorchi       ",0,0,0,0,0,2023
TOS,LU,C 30,Fabbricazione di altri mezzi di trasporto                   ,4,0,4,0,8,2023
TOS,LU,C 31,Fabbricazione di mobili                                     ,3,0,0,0,3,2023
TOS,LU,C 32,Altre industrie manifatturiere                              ,2,0,4,0,6,2023
TOS,LU,C 33,"Riparazione, manutenzione ed installazione di macchine ed...",4,0,8,0,12,2023
TOS,LU,D   ,"Fornitura di energia elettrica, gas, vapore e aria condiz...",0,0,0,0,0,2023
TOS,LU,D 35,"Fornitura di energia elettrica, gas, vapore e aria condiz...",0,0,0,0,0,2023
TOS,LU,E   ,"Fornitura di acqua; reti fognarie, attività di gestione d...",1,0,0,0,1,2023
TOS,LU,E 36,"Raccolta, trattamento e fornitura di acqua                  ",0,0,0,0,0,2023
TOS,LU,E 37,Gestione delle reti fognarie                                ,0,0,0,0,0,2023
TOS,LU,E 38,"Attività di raccolta, trattamento e smaltimento dei rifiu...",1,0,0,0,1,2023
TOS,LU,E 39,Attività di risanamento e altri servizi di gestione dei r...,0,0,0,0,0,2023
TOS,LU,F   ,Costruzioni                                                 ,43,0,133,0,176,2023
TOS,LU,F 41,Costruzione di edifici                                      ,29,0,46,0,75,2023
TOS,LU,F 42,Ingegneria civile                                           ,0,0,0,0,0,2023
TOS,LU,F 43,Lavori di costruzione specializzati                         ,14,0,87,0,101,2023
TOS,LU,G   ,Commercio all'ingrosso e al dettaglio; riparazione di aut...,56,0,262,0,318,2023
TOS,LU,G 45,Commercio all'ingrosso e al dettaglio e riparazione di au...,9,0,13,0,22,2023
TOS,LU,G 46,Commercio all'ingrosso (escluso quello di autoveicoli e d...,14,0,50,0,64,2023
TOS,LU,G 47,Commercio al dettaglio (escluso quello di autoveicoli e d...,33,0,199,0,232,2023
TOS,LU,H   ,Trasporto e magazzinaggio                                   ,3,0,14,0,17,2023
TOS,LU,H 49,Trasporto terrestre e mediante condotte                     ,2,0,11,0,13,2023
TOS,LU,H 50,Trasporto marittimo e per vie d'acqua                       ,0,0,0,0,0,2023
TOS,LU,H 51,Trasporto aereo                                             ,0,0,0,0,0,2023
TOS,LU,H 52,Magazzinaggio e attività di supporto ai trasporti           ,1,0,3,0,4,2023
TOS,LU,H 53,Servizi postali e attività di corriere                      ,0,0,0,0,0,2023
TOS,LU,I   ,Attività dei servizi alloggio e ristorazione                ,29,0,51,0,80,2023
TOS,LU,I 55,Alloggio                                                    ,3,0,4,0,7,2023
TOS,LU,I 56,Attività dei servizi di ristorazione                        ,26,0,47,0,73,2023
TOS,LU,J   ,Servizi di informazione e comunicazione                     ,2,0,10,0,12,2023
TOS,LU,J 58,Attività editoriali                                         ,0,0,2,0,2,2023
TOS,LU,J 59,"Attività di produzione cinematografica, di video e di pro...",0,0,0,0,0,2023
TOS,LU,J 60,Attività di programmazione e trasmissione                   ,1,0,0,0,1,2023
TOS,LU,J 61,Telecomunicazioni                                           ,0,0,2,0,2,2023
TOS,LU,J 62,"Produzione di software, consulenza informatica e attività...",1,0,3,0,4,2023
TOS,LU,J 63,Attività dei servizi d'informazione e altri servizi infor...,0,0,3,0,3,2023
TOS,LU,K   ,Attività finanziarie e assicurative                         ,2,0,4,0,6,2023
TOS,LU,K 64,Attività di servizi finanziari (escluse le assicurazioni ...,0,0,0,0,0,2023
TOS,LU,K 65,"Assicurazioni, riassicurazioni e fondi pensione (escluse ...",0,0,0,0,0,2023
TOS,LU,K 66,Attività ausiliarie dei servizi finanziari e delle attivi...,2,0,4,0,6,2023
TOS,LU,L   ,Attivita' immobiliari                                       ,8,0,7,0,15,2023
TOS,LU,L 68,Attivita' immobiliari                                       ,8,0,7,0,15,2023
TOS,LU,M   ,"Attività professionali, scientifiche e tecniche             ",20,0,17,0,37,2023
TOS,LU,M 69,Attività legali e contabilità                               ,0,0,1,0,1,2023
TOS,LU,M 70,Attività di direzione aziendale e di consulenza gestional...,10,0,1,0,11,2023
TOS,LU,M 71,Attività degli studi di architettura e d'ingegneria; coll...,2,0,1,0,3,2023
TOS,LU,M 72,Ricerca scientifica e sviluppo                              ,0,0,0,0,0,2023
TOS,LU,M 73,Pubblicità e ricerche di mercato                            ,4,0,8,0,12,2023
TOS,LU,M 74,"Altre attività professionali, scientifiche e tecniche       ",4,0,6,0,10,2023
TOS,LU,M 75,Servizi veterinari                                          ,0,0,0,0,0,2023
TOS,LU,N   ,"Noleggio, agenzie di viaggio, servizi di supporto alle im...",7,0,29,0,36,2023
TOS,LU,N 77,Attività di noleggio e leasing operativo                    ,4,0,2,0,6,2023
TOS,LU,N 78,"Attività di ricerca, selezione, fornitura di personale      ",0,0,0,0,0,2023
TOS,LU,N 79,"Attività dei servizi delle agenzie di viaggio, dei tour o...",1,0,0,0,1,2023
TOS,LU,N 80,Servizi di vigilanza e investigazione                       ,0,0,0,0,0,2023
TOS,LU,N 81,Attività di servizi per edifici e paesaggio                 ,0,0,6,0,6,2023
TOS,LU,N 82,Attività di supporto per le funzioni d'ufficio e altri se...,2,0,21,0,23,2023
TOS,LU,O   ,Amministrazione pubblica e difesa; assicurazione sociale ...,0,0,0,0,0,2023
TOS,LU,O 84,Amministrazione pubblica e difesa; assicurazione sociale ...,0,0,0,0,0,2023
TOS,LU,P   ,Istruzione                                                  ,4,0,0,0,4,2023
TOS,LU,P 85,Istruzione                                                  ,4,0,0,0,4,2023
TOS,LU,Q   ,Sanita' e assistenza sociale                                ,1,0,0,0,1,2023
TOS,LU,Q 86,Assistenza sanitaria                                        ,1,0,0,0,1,2023
TOS,LU,Q 87,Servizi di assistenza sociale residenziale                  ,0,0,0,0,0,2023
TOS,LU,Q 88,Assistenza sociale non residenziale                         ,0,0,0,0,0,2023
TOS,LU,R   ,"Attività artistiche, sportive, di intrattenimento e diver...",7,0,21,0,28,2023
TOS,LU,R 90,"Attività creative, artistiche e di intrattenimento          ",0,0,18,0,18,2023
TOS,LU,R 91,"Attività di biblioteche, archivi, musei ed altre attività...",0,0,0,0,0,2023
TOS,LU,R 92,"Attività riguardanti le lotterie, le scommesse, le case d...",1,0,0,0,1,2023
TOS,LU,R 93,"Attività sportive, di intrattenimento e di divertimento     ",6,0,3,0,9,2023
TOS,LU,S   ,Altre attività di servizi                                   ,5,0,13,0,18,2023
TOS,LU,S 94,Attività di organizzazioni associative                      ,0,0,0,0,0,2023
TOS,LU,S 95,Riparazione di computer e di beni per uso personale e per...,1,0,4,0,5,2023
TOS,LU,S 96,Altre attività di servizi per la persona                    ,4,0,9,0,13,2023
TOS,LU,T   ,Attività di famiglie e convivenze come datori di lavoro p...,0,0,0,0,0,2023
TOS,LU,T 97,Attività di famiglie e convivenze come datori di lavoro p...,0,0,0,0,0,2023
TOS,LU,T 98,Produzione di beni e servizi indifferenziati per uso prop...,0,0,0,0,0,2023
TOS,LU,U   ,Organizzazioni ed organismi extraterritoriali               ,0,0,0,0,0,2023
TOS,LU,U 99,Organizzazioni ed organismi extraterritoriali               ,0,0,0,0,0,2023
TOS,LU,XX  ,Imprese non classificate                                    ,40,0,44,0,84,2023
TOS,LU,TOT ,TOTALE                                                      ,264,0,660,0,924,2023
TOS,PT,A   ,"Agricoltura, silvicoltura pesca                             ",6,0,0,0,6,2023
TOS,PT,A 01,"Coltivazioni agricole e produzione di prodotti animali, c...",6,0,0,0,6,2023
TOS,PT,A 02,Silvicoltura ed utilizzo di aree forestali                  ,0,0,0,0,0,2023
TOS,PT,A 03,Pesca e acquacoltura                                        ,0,0,0,0,0,2023
TOS,PT,B   ,Estrazione di minerali da cave e miniere                    ,1,0,0,0,1,2023
TOS,PT,B 05,Estrazione di carbone (esclusa torba)                       ,0,0,0,0,0,2023
TOS,PT,B 06,Estraz.di petrolio greggio e di gas naturale                ,0,0,0,0,0,2023
TOS,PT,B 07,Estrazione di minerali metalliferi                          ,0,0,0,0,0,2023
TOS,PT,B 08,Altre attività di estrazione di minerali da cave e miniere  ,1,0,0,0,1,2023
TOS,PT,B 09,Attività dei servizi di supporto all'estrazione             ,0,0,0,0,0,2023
TOS,PT,C   ,Attività manifatturiere                                     ,69,0,0,0,69,2023
TOS,PT,C 10,Industrie alimentari                                        ,5,0,0,0,5,2023
TOS,PT,C 11,Industria delle bevande                                     ,0,0,0,0,0,2023
TOS,PT,C 12,Industria del tabacco                                       ,0,0,0,0,0,2023
TOS,PT,C 13,Industrie tessili                                           ,11,0,0,0,11,2023
TOS,PT,C 14,Confezione di articoli di abbigliamento; confezione di ar...,15,0,0,0,15,2023
TOS,PT,C 15,Fabbricazione di articoli in pelle e simili                 ,12,0,0,0,12,2023
TOS,PT,C 16,Industria del legno e dei prodotti in legno e sughero (es...,3,0,0,0,3,2023
TOS,PT,C 17,Fabbricazione di carta e di prodotti di carta               ,0,0,0,0,0,2023
TOS,PT,C 18,Stampa e riproduzione di supporti registrati                ,0,0,0,0,0,2023
TOS,PT,C 19,Fabbricazione di coke e prodotti derivanti dalla raffinaz...,0,0,0,0,0,2023
TOS,PT,C 20,Fabbricazione di prodotti chimici                           ,1,0,0,0,1,2023
TOS,PT,C 21,Fabbricazione di prodotti farmaceutici di base e di prepa...,0,0,0,0,0,2023
TOS,PT,C 22,Fabbricazione di articoli in gomma e materie plastiche      ,0,0,0,0,0,2023
TOS,PT,C 23,Fabbricazione di altri prodotti della lavorazione di miner..,0,0,0,0,0,2023
TOS,PT,C 24,Metallurgia                                                 ,0,0,0,0,0,2023
TOS,PT,C 25,Fabbricazione di prodotti in metallo (esclusi macchinari ...,8,0,0,0,8,2023
TOS,PT,C 26,Fabbricazione di computer e prodotti di elettronica e ott...,0,0,0,0,0,2023
TOS,PT,C 27,Fabbricazione di apparecchiature elettriche ed apparecchi...,1,0,0,0,1,2023
TOS,PT,C 28,Fabbricazione di macchinari ed apparecchiature nca          ,1,0,0,0,1,2023
TOS,PT,C 29,"Fabbricazione di autoveicoli, rimorchi e semirimorchi       ",0,0,0,0,0,2023
TOS,PT,C 30,Fabbricazione di altri mezzi di trasporto                   ,0,0,0,0,0,2023
TOS,PT,C 31,Fabbricazione di mobili                                     ,10,0,0,0,10,2023
TOS,PT,C 32,Altre industrie manifatturiere                              ,2,0,0,0,2,2023
TOS,PT,C 33,"Riparazione, manutenzione ed installazione di macchine ed...",0,0,0,0,0,2023
TOS,PT,D   ,"Fornitura di energia elettrica, gas, vapore e aria condiz...",0,0,0,0,0,2023
TOS,PT,D 35,"Fornitura di energia elettrica, gas, vapore e aria condiz...",0,0,0,0,0,2023
TOS,PT,E   ,"Fornitura di acqua; reti fognarie, attività di gestione d...",3,0,0,0,3,2023
TOS,PT,E 36,"Raccolta, trattamento e fornitura di acqua                  ",0,0,0,0,0,2023
TOS,PT,E 37,Gestione delle reti fognarie                                ,0,0,0,0,0,2023
TOS,PT,E 38,"Attività di raccolta, trattamento e smaltimento dei rifiu...",1,0,0,0,1,2023
TOS,PT,E 39,Attività di risanamento e altri servizi di gestione dei r...,2,0,0,0,2,2023
TOS,PT,F   ,Costruzioni                                                 ,36,0,0,0,36,2023
TOS,PT,F 41,Costruzione di edifici                                      ,32,0,0,0,32,2023
TOS,PT,F 42,Ingegneria civile                                           ,1,0,0,0,1,2023
TOS,PT,F 43,Lavori di costruzione specializzati                         ,3,0,0,0,3,2023
TOS,PT,G   ,Commercio all'ingrosso e al dettaglio; riparazione di aut...,81,0,0,0,81,2023
TOS,PT,G 45,Commercio all'ingrosso e al dettaglio e riparazione di au...,9,0,0,0,9,2023
TOS,PT,G 46,Commercio all'ingrosso (escluso quello di autoveicoli e d...,50,0,0,0,50,2023
TOS,PT,G 47,Commercio al dettaglio (escluso quello di autoveicoli e d...,22,0,0,0,22,2023
TOS,PT,H   ,Trasporto e magazzinaggio                                   ,3,0,0,0,3,2023
TOS,PT,H 49,Trasporto terrestre e mediante condotte                     ,2,0,0,0,2,2023
TOS,PT,H 50,Trasporto marittimo e per vie d'acqua                       ,0,0,0,0,0,2023
TOS,PT,H 51,Trasporto aereo                                             ,0,0,0,0,0,2023
TOS,PT,H 52,Magazzinaggio e attività di supporto ai trasporti           ,1,0,0,0,1,2023
TOS,PT,H 53,Servizi postali e attività di corriere                      ,0,0,0,0,0,2023
TOS,PT,I   ,Attività dei servizi alloggio e ristorazione                ,19,0,0,0,19,2023
TOS,PT,I 55,Alloggio                                                    ,3,0,0,0,3,2023
TOS,PT,I 56,Attività dei servizi di ristorazione                        ,16,0,0,0,16,2023
TOS,PT,J   ,Servizi di informazione e comunicazione                     ,10,0,0,0,10,2023
TOS,PT,J 58,Attività editoriali                                         ,0,0,0,0,0,2023
TOS,PT,J 59,"Attività di produzione cinematografica, di video e di pro...",0,0,0,0,0,2023
TOS,PT,J 60,Attività di programmazione e trasmissione                   ,1,0,0,0,1,2023
TOS,PT,J 61,Telecomunicazioni                                           ,1,0,0,0,1,2023
TOS,PT,J 62,"Produzione di software, consulenza informatica e attività...",7,0,0,0,7,2023
TOS,PT,J 63,Attività dei servizi d'informazione e altri servizi infor...,1,0,0,0,1,2023
TOS,PT,K   ,Attività finanziarie e assicurative                         ,8,0,0,0,8,2023
TOS,PT,K 64,Attività di servizi finanziari (escluse le assicurazioni ...,5,0,0,0,5,2023
TOS,PT,K 65,"Assicurazioni, riassicurazioni e fondi pensione (escluse ...",0,0,0,0,0,2023
TOS,PT,K 66,Attività ausiliarie dei servizi finanziari e delle attivi...,3,0,0,0,3,2023
TOS,PT,L   ,Attivita' immobiliari                                       ,54,0,0,0,54,2023
TOS,PT,L 68,Attivita' immobiliari                                       ,54,0,0,0,54,2023
TOS,PT,M   ,"Attività professionali, scientifiche e tecniche             ",12,0,0,0,12,2023
TOS,PT,M 69,Attività legali e contabilità                               ,2,0,0,0,2,2023
TOS,PT,M 70,Attività di direzione aziendale e di consulenza gestional...,2,0,0,0,2,2023
TOS,PT,M 71,Attività degli studi di architettura e d'ingegneria; coll...,1,0,0,0,1,2023
TOS,PT,M 72,Ricerca scientifica e sviluppo                              ,0,0,0,0,0,2023
TOS,PT,M 73,Pubblicità e ricerche di mercato                            ,5,0,0,0,5,2023
TOS,PT,M 74,"Altre attività professionali, scientifiche e tecniche       ",2,0,0,0,2,2023
TOS,PT,M 75,Servizi veterinari                                          ,0,0,0,0,0,2023
TOS,PT,N   ,"Noleggio, agenzie di viaggio, servizi di supporto alle im...",11,0,0,0,11,2023
TOS,PT,N 77,Attività di noleggio e leasing operativo                    ,3,0,0,0,3,2023
TOS,PT,N 78,"Attività di ricerca, selezione, fornitura di personale      ",1,0,0,0,1,2023
TOS,PT,N 79,"Attività dei servizi delle agenzie di viaggio, dei tour o...",3,0,0,0,3,2023
TOS,PT,N 80,Servizi di vigilanza e investigazione                       ,0,0,0,0,0,2023
TOS,PT,N 81,Attività di servizi per edifici e paesaggio                 ,0,0,0,0,0,2023
TOS,PT,N 82,Attività di supporto per le funzioni d'ufficio e altri se...,4,0,0,0,4,2023
TOS,PT,O   ,Amministrazione pubblica e difesa; assicurazione sociale ...,0,0,0,0,0,2023
TOS,PT,O 84,Amministrazione pubblica e difesa; assicurazione sociale ...,0,0,0,0,0,2023
TOS,PT,P   ,Istruzione                                                  ,1,0,0,0,1,2023
TOS,PT,P 85,Istruzione                                                  ,1,0,0,0,1,2023
TOS,PT,Q   ,Sanita' e assistenza sociale                                ,0,0,0,0,0,2023
TOS,PT,Q 86,Assistenza sanitaria                                        ,0,0,0,0,0,2023
TOS,PT,Q 87,Servizi di assistenza sociale residenziale                  ,0,0,0,0,0,2023
TOS,PT,Q 88,Assistenza sociale non residenziale                         ,0,0,0,0,0,2023
TOS,PT,R   ,"Attività artistiche, sportive, di intrattenimento e diver...",12,0,0,0,12,2023
TOS,PT,R 90,"Attività creative, artistiche e di intrattenimento          ",2,0,0,0,2,2023
TOS,PT,R 91,"Attività di biblioteche, archivi, musei ed altre attività...",0,0,0,0,0,2023
TOS,PT,R 92,"Attività riguardanti le lotterie, le scommesse, le case d...",2,0,0,0,2,2023
TOS,PT,R 93,"Attività sportive, di intrattenimento e di divertimento     ",8,0,0,0,8,2023
TOS,PT,S   ,Altre attività di servizi                                   ,5,0,0,0,5,2023
TOS,PT,S 94,Attività di organizzazioni associative                      ,0,0,0,0,0,2023
TOS,PT,S 95,Riparazione di computer e di beni per uso personale e per...,1,0,0,0,1,2023
TOS,PT,S 96,Altre attività di servizi per la persona                    ,4,0,0,0,4,2023
TOS,PT,T   ,Attività di famiglie e convivenze come datori di lavoro p...,0,0,0,0,0,2023
TOS,PT,T 97,Attività di famiglie e convivenze come datori di lavoro p...,0,0,0,0,0,2023
TOS,PT,T 98,Produzione di beni e servizi indifferenziati per uso prop...,0,0,0,0,0,2023
TOS,PT,U   ,Organizzazioni ed organismi extraterritoriali               ,0,0,0,0,0,2023
TOS,PT,U 99,Organizzazioni ed organismi extraterritoriali               ,0,0,0,0,0,2023
TOS,PT,XX  ,Imprese non classificate                                    ,71,0,0,1,72,2023
TOS,PT,TOT ,TOTALE                                                      ,402,0,0,1,403,2023
TOS,FI,A   ,"Agricoltura, silvicoltura pesca                             ",11,8,109,1,129,2023
TOS,FI,A 01,"Coltivazioni agricole e produzione di prodotti animali, c...",10,7,106,1,124,2023
TOS,FI,A 02,Silvicoltura ed utilizzo di aree forestali                  ,1,1,3,0,5,2023
TOS,FI,A 03,Pesca e acquacoltura                                        ,0,0,0,0,0,2023
TOS,FI,B   ,Estrazione di minerali da cave e miniere                    ,5,0,0,0,5,2023
TOS,FI,B 05,Estrazione di carbone (esclusa torba)                       ,0,0,0,0,0,2023
TOS,FI,B 06,Estraz.di petrolio greggio e di gas naturale                ,0,0,0,0,0,2023
TOS,FI,B 07,Estrazione di minerali metalliferi                          ,0,0,0,0,0,2023
TOS,FI,B 08,Altre attività di estrazione di minerali da cave e miniere  ,5,0,0,0,5,2023
TOS,FI,B 09,Attività dei servizi di supporto all'estrazione             ,0,0,0,0,0,2023
TOS,FI,C   ,Attività manifatturiere                                     ,809,127,19,1,956,2023
TOS,FI,C 10,Industrie alimentari                                        ,19,6,1,0,26,2023
TOS,FI,C 11,Industria delle bevande                                     ,5,0,0,0,5,2023
TOS,FI,C 12,Industria del tabacco                                       ,0,0,0,0,0,2023
TOS,FI,C 13,Industrie tessili                                           ,42,17,1,0,60,2023
TOS,FI,C 14,Confezione di articoli di abbigliamento; confezione di ar...,221,34,4,0,259,2023
TOS,FI,C 15,Fabbricazione di articoli in pelle e simili                 ,156,21,6,0,183,2023
TOS,FI,C 16,Industria del legno e dei prodotti in legno e sughero (es...,14,3,3,0,20,2023
TOS,FI,C 17,Fabbricazione di carta e di prodotti di carta               ,9,2,0,0,11,2023
TOS,FI,C 18,Stampa e riproduzione di supporti registrati                ,35,5,0,0,40,2023
TOS,FI,C 19,Fabbricazione di coke e prodotti derivanti dalla raffinaz...,1,0,0,0,1,2023
TOS,FI,C 20,Fabbricazione di prodotti chimici                           ,20,1,0,0,21,2023
TOS,FI,C 21,Fabbricazione di prodotti farmaceutici di base e di prepa...,3,1,0,0,4,2023
TOS,FI,C 22,Fabbricazione di articoli in gomma e materie plastiche      ,16,2,0,0,18,2023
TOS,FI,C 23,Fabbricazione di altri prodotti della lavorazione di miner..,42,5,2,1,50,2023
TOS,FI,C 24,Metallurgia                                                 ,5,2,0,0,7,2023
TOS,FI,C 25,Fabbricazione di prodotti in metallo (esclusi macchinari ...,52,2,0,0,54,2023
TOS,FI,C 26,Fabbricazione di computer e prodotti di elettronica e ott...,26,5,0,0,31,2023
TOS,FI,C 27,Fabbricazione di apparecchiature elettriche ed apparecchi...,19,1,0,0,20,2023
TOS,FI,C 28,Fabbricazione di macchinari ed apparecchiature nca          ,30,1,0,0,31,2023
TOS,FI,C 29,"Fabbricazione di autoveicoli, rimorchi e semirimorchi       ",4,2,0,0,6,2023
TOS,FI,C 30,Fabbricazione di altri mezzi di trasporto                   ,5,0,0,0,5,2023
TOS,FI,C 31,Fabbricazione di mobili                                     ,50,5,0,0,55,2023
TOS,FI,C 32,Altre industrie manifatturiere                              ,33,12,2,0,47,2023
TOS,FI,C 33,"Riparazione, manutenzione ed installazione di macchine ed...",2,0,0,0,2,2023
TOS,FI,D   ,"Fornitura di energia elettrica, gas, vapore e aria condiz...",1,0,0,0,1,2023
TOS,FI,D 35,"Fornitura di energia elettrica, gas, vapore e aria condiz...",1,0,0,0,1,2023
TOS,FI,E   ,"Fornitura di acqua; reti fognarie, attività di gestione d...",5,2,0,0,7,2023
TOS,FI,E 36,"Raccolta, trattamento e fornitura di acqua                  ",0,0,0,0,0,2023
TOS,FI,E 37,Gestione delle reti fognarie                                ,1,0,0,0,1,2023
TOS,FI,E 38,"Attività di raccolta, trattamento e smaltimento dei rifiu...",2,2,0,0,4,2023
TOS,FI,E 39,Attività di risanamento e altri servizi di gestione dei r...,2,0,0,0,2,2023
TOS,FI,F   ,Costruzioni                                                 ,307,43,13,6,369,2023
TOS,FI,F 41,Costruzione di edifici                                      ,205,25,6,3,239,2023
TOS,FI,F 42,Ingegneria civile                                           ,8,1,0,2,11,2023
TOS,FI,F 43,Lavori di costruzione specializzati                         ,94,17,7,1,119,2023
TOS,FI,G   ,Commercio all'ingrosso e al dettaglio; riparazione di aut...,841,184,46,3,1074,2023
TOS,FI,G 45,Commercio all'ingrosso e al dettaglio e riparazione di au...,65,10,2,0,77,2023
TOS,FI,G 46,Commercio all'ingrosso (escluso quello di autoveicoli e d...,485,67,17,3,572,2023
TOS,FI,G 47,Commercio al dettaglio (escluso quello di autoveicoli e d...,291,107,27,0,425,2023
TOS,FI,H   ,Trasporto e magazzinaggio                                   ,62,13,4,3,82,2023
TOS,FI,H 49,Trasporto terrestre e mediante condotte                     ,34,8,4,1,47,2023
TOS,FI,H 50,Trasporto marittimo e per vie d'acqua                       ,0,0,0,0,0,2023
TOS,FI,H 51,Trasporto aereo                                             ,1,0,0,0,1,2023
TOS,FI,H 52,Magazzinaggio e attività di supporto ai trasporti           ,23,4,0,2,29,2023
TOS,FI,H 53,Servizi postali e attività di corriere                      ,4,1,0,0,5,2023
TOS,FI,I   ,Attività dei servizi alloggio e ristorazione                ,254,151,13,0,418,2023
TOS,FI,I 55,Alloggio                                                    ,22,7,4,0,33,2023
TOS,FI,I 56,Attività dei servizi di ristorazione                        ,232,144,9,0,385,2023
TOS,FI,J   ,Servizi di informazione e comunicazione                     ,119,13,2,1,135,2023
TOS,FI,J 58,Attività editoriali                                         ,26,2,1,0,29,2023
TOS,FI,J 59,"Attività di produzione cinematografica, di video e di pro...",12,0,0,0,12,2023
TOS,FI,J 60,Attività di programmazione e trasmissione                   ,4,1,0,0,5,2023
TOS,FI,J 61,Telecomunicazioni                                           ,7,1,0,0,8,2023
TOS,FI,J 62,"Produzione di software, consulenza informatica e attività...",38,2,1,0,41,2023
TOS,FI,J 63,Attività dei servizi d'informazione e altri servizi infor...,32,7,0,1,40,2023
TOS,FI,K   ,Attività finanziarie e assicurative                         ,51,7,4,0,62,2023
TOS,FI,K 64,Attività di servizi finanziari (escluse le assicurazioni ...,39,4,0,0,43,2023
TOS,FI,K 65,"Assicurazioni, riassicurazioni e fondi pensione (escluse ...",0,1,0,0,1,2023
TOS,FI,K 66,Attività ausiliarie dei servizi finanziari e delle attivi...,12,2,4,0,18,2023
TOS,FI,L   ,Attivita' immobiliari                                       ,283,25,5,0,313,2023
TOS,FI,L 68,Attivita' immobiliari                                       ,283,25,5,0,313,2023
TOS,FI,M   ,"Attività professionali, scientifiche e tecniche             ",218,25,5,3,251,2023
TOS,FI,M 69,Attività legali e contabilità                               ,7,0,1,0,8,2023
TOS,FI,M 70,Attività di direzione aziendale e di consulenza gestional...,59,6,1,0,66,2023
TOS,FI,M 71,Attività degli studi di architettura e d'ingegneria; coll...,23,2,0,0,25,2023
TOS,FI,M 72,Ricerca scientifica e sviluppo                              ,6,0,0,1,7,2023
TOS,FI,M 73,Pubblicità e ricerche di mercato                            ,61,10,1,1,73,2023
TOS,FI,M 74,"Altre attività professionali, scientifiche e tecniche       ",62,7,2,1,72,2023
TOS,FI,M 75,Servizi veterinari                                          ,0,0,0,0,0,2023
TOS,FI,N   ,"Noleggio, agenzie di viaggio, servizi di supporto alle im...",101,21,0,5,127,2023
TOS,FI,N 77,Attività di noleggio e leasing operativo                    ,10,5,0,0,15,2023
TOS,FI,N 78,"Attività di ricerca, selezione, fornitura di personale      ",1,0,0,0,1,2023
TOS,FI,N 79,"Attività dei servizi delle agenzie di viaggio, dei tour o...",26,3,0,0,29,2023
TOS,FI,N 80,Servizi di vigilanza e investigazione                       ,0,0,0,0,0,2023
TOS,FI,N 81,Attività di servizi per edifici e paesaggio                 ,17,7,0,2,26,2023
TOS,FI,N 82,Attività di supporto per le funzioni d'ufficio e altri se...,47,6,0,3,56,2023
TOS,FI,O   ,Amministrazione pubblica e difesa; assicurazione sociale ...,0,0,0,0,0,2023
TOS,FI,O 84,Amministrazione pubblica e difesa; assicurazione sociale ...,0,0,0,0,0,2023
TOS,FI,P   ,Istruzione                                                  ,16,4,1,1,22,2023
TOS,FI,P 85,Istruzione                                                  ,16,4,1,1,22,2023
TOS,FI,Q   ,Sanita' e assistenza sociale                                ,7,2,1,0,10,2023
TOS,FI,Q 86,Assistenza sanitaria                                        ,7,2,0,0,9,2023
TOS,FI,Q 87,Servizi di assistenza sociale residenziale                  ,0,0,1,0,1,2023
TOS,FI,Q 88,Assistenza sociale non residenziale                         ,0,0,0,0,0,2023
TOS,FI,R   ,"Attività artistiche, sportive, di intrattenimento e diver...",62,9,1,0,72,2023
TOS,FI,R 90,"Attività creative, artistiche e di intrattenimento          ",22,2,0,0,24,2023
TOS,FI,R 91,"Attività di biblioteche, archivi, musei ed altre attività...",1,0,0,0,1,2023
TOS,FI,R 92,"Attività riguardanti le lotterie, le scommesse, le case d...",1,0,0,0,1,2023
TOS,FI,R 93,"Attività sportive, di intrattenimento e di divertimento     ",38,7,1,0,46,2023
TOS,FI,S   ,Altre attività di servizi                                   ,39,20,5,0,64,2023
TOS,FI,S 94,Attività di organizzazioni associative                      ,0,0,0,0,0,2023
TOS,FI,S 95,Riparazione di computer e di beni per uso personale e per...,9,3,2,0,14,2023
TOS,FI,S 96,Altre attività di servizi per la persona                    ,30,17,3,0,50,2023
TOS,FI,T   ,Attività di famiglie e convivenze come datori di lavoro p...,0,0,0,0,0,2023
TOS,FI,T 97,Attività di famiglie e convivenze come datori di lavoro p...,0,0,0,0,0,2023
TOS,FI,T 98,Produzione di beni e servizi indifferenziati per uso prop...,0,0,0,0,0,2023
TOS,FI,U   ,Organizzazioni ed organismi extraterritoriali               ,0,0,0,0,0,2023
TOS,FI,U 99,Organizzazioni ed organismi extraterritoriali               ,0,0,0,0,0,2023
TOS,FI,XX  ,Imprese non classificate                                    ,591,96,4,2,693,2023
TOS,FI,TOT ,TOTALE                                                      ,3782,750,232,26,4790,2023
TOS,LI,A   ,"Agricoltura, silvicoltura pesca                             ",0,0,73,0,73,2023
TOS,LI,A 01,"Coltivazioni agricole e produzione di prodotti animali, c...",0,0,71,0,71,2023
TOS,LI,A 02,Silvicoltura ed utilizzo di aree forestali                  ,0,0,0,0,0,2023
TOS,LI,A 03,Pesca e acquacoltura                                        ,0,0,2,0,2,2023
TOS,LI,B   ,Estrazione di minerali da cave e miniere                    ,0,1,0,0,1,2023
TOS,LI,B 05,Estrazione di carbone (esclusa torba)                       ,0,0,0,0,0,2023
TOS,LI,B 06,Estraz.di petrolio greggio e di gas naturale                ,0,0,0,0,0,2023
TOS,LI,B 07,Estrazione di minerali metalliferi                          ,0,0,0,0,0,2023
TOS,LI,B 08,Altre attività di estrazione di minerali da cave e miniere  ,0,1,0,0,1,2023
TOS,LI,B 09,Attività dei servizi di supporto all'estrazione             ,0,0,0,0,0,2023
TOS,LI,C   ,Attività manifatturiere                                     ,7,5,7,0,19,2023
TOS,LI,C 10,Industrie alimentari                                        ,1,1,0,0,2,2023
TOS,LI,C 11,Industria delle bevande                                     ,0,0,0,0,0,2023
TOS,LI,C 12,Industria del tabacco                                       ,0,0,0,0,0,2023
TOS,LI,C 13,Industrie tessili                                           ,0,0,0,0,0,2023
TOS,LI,C 14,Confezione di articoli di abbigliamento; confezione di ar...,0,0,2,0,2,2023
TOS,LI,C 15,Fabbricazione di articoli in pelle e simili                 ,0,0,0,0,0,2023
TOS,LI,C 16,Industria del legno e dei prodotti in legno e sughero (es...,1,1,0,0,2,2023
TOS,LI,C 17,Fabbricazione di carta e di prodotti di carta               ,0,0,0,0,0,2023
TOS,LI,C 18,Stampa e riproduzione di supporti registrati                ,0,0,2,0,2,2023
TOS,LI,C 19,Fabbricazione di coke e prodotti derivanti dalla raffinaz...,0,0,0,0,0,2023
TOS,LI,C 20,Fabbricazione di prodotti chimici                           ,0,0,0,0,0,2023
TOS,LI,C 21,Fabbricazione di prodotti farmaceutici di base e di prepa...,0,0,0,0,0,2023
TOS,LI,C 22,Fabbricazione di articoli in gomma e materie plastiche      ,0,0,0,0,0,2023
TOS,LI,C 23,Fabbricazione di altri prodotti della lavorazione di miner..,0,0,0,0,0,2023
TOS,LI,C 24,Metallurgia                                                 ,0,1,0,0,1,2023
TOS,LI,C 25,Fabbricazione di prodotti in metallo (esclusi macchinari ...,2,1,2,0,5,2023
TOS,LI,C 26,Fabbricazione di computer e prodotti di elettronica e ott...,0,0,0,0,0,2023
TOS,LI,C 27,Fabbricazione di apparecchiature elettriche ed apparecchi...,1,0,0,0,1,2023
TOS,LI,C 28,Fabbricazione di macchinari ed apparecchiature nca          ,0,0,1,0,1,2023
TOS,LI,C 29,"Fabbricazione di autoveicoli, rimorchi e semirimorchi       ",0,0,0,0,0,2023
TOS,LI,C 30,Fabbricazione di altri mezzi di trasporto                   ,1,0,0,0,1,2023
TOS,LI,C 31,Fabbricazione di mobili                                     ,0,0,0,0,0,2023
TOS,LI,C 32,Altre industrie manifatturiere                              ,0,0,0,0,0,2023
TOS,LI,C 33,"Riparazione, manutenzione ed installazione di macchine ed...",1,1,0,0,2,2023
TOS,LI,D   ,"Fornitura di energia elettrica, gas, vapore e aria condiz...",0,0,0,0,0,2023
TOS,LI,D 35,"Fornitura di energia elettrica, gas, vapore e aria condiz...",0,0,0,0,0,2023
TOS,LI,E   ,"Fornitura di acqua; reti fognarie, attività di gestione d...",0,0,0,0,0,2023
TOS,LI,E 36,"Raccolta, trattamento e fornitura di acqua                  ",0,0,0,0,0,2023
TOS,LI,E 37,Gestione delle reti fognarie                                ,0,0,0,0,0,2023
TOS,LI,E 38,"Attività di raccolta, trattamento e smaltimento dei rifiu...",0,0,0,0,0,2023
TOS,LI,E 39,Attività di risanamento e altri servizi di gestione dei r...,0,0,0,0,0,2023
TOS,LI,F   ,Costruzioni                                                 ,18,13,11,2,44,2023
TOS,LI,F 41,Costruzione di edifici                                      ,14,4,3,2,23,2023
TOS,LI,F 42,Ingegneria civile                                           ,0,1,0,0,1,2023
TOS,LI,F 43,Lavori di costruzione specializzati                         ,4,8,8,0,20,2023
TOS,LI,G   ,Commercio all'ingrosso e al dettaglio; riparazione di aut...,12,21,22,0,55,2023
TOS,LI,G 45,Commercio all'ingrosso e al dettaglio e riparazione di au...,3,0,2,0,5,2023
TOS,LI,G 46,Commercio all'ingrosso (escluso quello di autoveicoli e d...,3,6,0,0,9,2023
TOS,LI,G 47,Commercio al dettaglio (escluso quello di autoveicoli e d...,6,15,20,0,41,2023
TOS,LI,H   ,Trasporto e magazzinaggio                                   ,4,1,4,2,11,2023
TOS,LI,H 49,Trasporto terrestre e mediante condotte                     ,0,0,3,0,3,2023
TOS,LI,H 50,Trasporto marittimo e per vie d'acqua                       ,0,0,0,0,0,2023
TOS,LI,H 51,Trasporto aereo                                             ,0,0,0,0,0,2023
TOS,LI,H 52,Magazzinaggio e attività di supporto ai trasporti           ,4,1,1,2,8,2023
TOS,LI,H 53,Servizi postali e attività di corriere                      ,0,0,0,0,0,2023
TOS,LI,I   ,Attività dei servizi alloggio e ristorazione                ,7,30,9,0,46,2023
TOS,LI,I 55,Alloggio                                                    ,1,1,4,0,6,2023
TOS,LI,I 56,Attività dei servizi di ristorazione                        ,6,29,5,0,40,2023
TOS,LI,J   ,Servizi di informazione e comunicazione                     ,3,1,1,0,5,2023
TOS,LI,J 58,Attività editoriali                                         ,1,0,0,0,1,2023
TOS,LI,J 59,"Attività di produzione cinematografica, di video e di pro...",0,0,0,0,0,2023
TOS,LI,J 60,Attività di programmazione e trasmissione                   ,0,0,0,0,0,2023
TOS,LI,J 61,Telecomunicazioni                                           ,0,0,0,0,0,2023
TOS,LI,J 62,"Produzione di software, consulenza informatica e attività...",1,0,0,0,1,2023
TOS,LI,J 63,Attività dei servizi d'informazione e altri servizi infor...,1,1,1,0,3,2023
TOS,LI,K   ,Attività finanziarie e assicurative                         ,1,0,2,0,3,2023
TOS,LI,K 64,Attività di servizi finanziari (escluse le assicurazioni ...,0,0,0,0,0,2023
TOS,LI,K 65,"Assicurazioni, riassicurazioni e fondi pensione (escluse ...",0,0,0,0,0,2023
TOS,LI,K 66,Attività ausiliarie dei servizi finanziari e delle attivi...,1,0,2,0,3,2023
TOS,LI,L   ,Attivita' immobiliari                                       ,9,4,0,0,13,2023
TOS,LI,L 68,Attivita' immobiliari                                       ,9,4,0,0,13,2023
TOS,LI,M   ,"Attività professionali, scientifiche e tecniche             ",5,4,1,1,11,2023
TOS,LI,M 69,Attività legali e contabilità                               ,0,0,0,0,0,2023
TOS,LI,M 70,Attività di direzione aziendale e di consulenza gestional...,1,0,0,1,2,2023
TOS,LI,M 71,Attività degli studi di architettura e d'ingegneria; coll...,1,2,0,0,3,2023
TOS,LI,M 72,Ricerca scientifica e sviluppo                              ,0,0,0,0,0,2023
TOS,LI,M 73,Pubblicità e ricerche di mercato                            ,1,2,1,0,4,2023
TOS,LI,M 74,"Altre attività professionali, scientifiche e tecniche       ",2,0,0,0,2,2023
TOS,LI,M 75,Servizi veterinari                                          ,0,0,0,0,0,2023
TOS,LI,N   ,"Noleggio, agenzie di viaggio, servizi di supporto alle im...",2,4,6,1,13,2023
TOS,LI,N 77,Attività di noleggio e leasing operativo                    ,0,0,1,0,1,2023
TOS,LI,N 78,"Attività di ricerca, selezione, fornitura di personale      ",0,0,0,0,0,2023
TOS,LI,N 79,"Attività dei servizi delle agenzie di viaggio, dei tour o...",1,1,0,0,2,2023
TOS,LI,N 80,Servizi di vigilanza e investigazione                       ,1,0,0,0,1,2023
TOS,LI,N 81,Attività di servizi per edifici e paesaggio                 ,0,2,5,1,8,2023
TOS,LI,N 82,Attività di supporto per le funzioni d'ufficio e altri se...,0,1,0,0,1,2023
TOS,LI,O   ,Amministrazione pubblica e difesa; assicurazione sociale ...,0,0,0,0,0,2023
TOS,LI,O 84,Amministrazione pubblica e difesa; assicurazione sociale ...,0,0,0,0,0,2023
TOS,LI,P   ,Istruzione                                                  ,1,2,0,0,3,2023
TOS,LI,P 85,Istruzione                                                  ,1,2,0,0,3,2023
TOS,LI,Q   ,Sanita' e assistenza sociale                                ,2,0,0,1,3,2023
TOS,LI,Q 86,Assistenza sanitaria                                        ,0,0,0,0,0,2023
TOS,LI,Q 87,Servizi di assistenza sociale residenziale                  ,2,0,0,0,2,2023
TOS,LI,Q 88,Assistenza sociale non residenziale                         ,0,0,0,1,1,2023
TOS,LI,R   ,"Attività artistiche, sportive, di intrattenimento e diver...",6,2,2,0,10,2023
TOS,LI,R 90,"Attività creative, artistiche e di intrattenimento          ",1,0,1,0,2,2023
TOS,LI,R 91,"Attività di biblioteche, archivi, musei ed altre attività...",0,0,0,0,0,2023
TOS,LI,R 92,"Attività riguardanti le lotterie, le scommesse, le case d...",0,0,0,0,0,2023
TOS,LI,R 93,"Attività sportive, di intrattenimento e di divertimento     ",5,2,1,0,8,2023
TOS,LI,S   ,Altre attività di servizi                                   ,1,5,3,0,9,2023
TOS,LI,S 94,Attività di organizzazioni associative                      ,0,0,0,0,0,2023
TOS,LI,S 95,Riparazione di computer e di beni per uso personale e per...,0,2,0,0,2,2023
TOS,LI,S 96,Altre attività di servizi per la persona                    ,1,3,3,0,7,2023
TOS,LI,T   ,Attività di famiglie e convivenze come datori di lavoro p...,0,0,0,0,0,2023
TOS,LI,T 97,Attività di famiglie e convivenze come datori di lavoro p...,0,0,0,0,0,2023
TOS,LI,T 98,Produzione di beni e servizi indifferenziati per uso prop...,0,0,0,0,0,2023
TOS,LI,U   ,Organizzazioni ed organismi extraterritoriali               ,0,0,0,0,0,2023
TOS,LI,U 99,Organizzazioni ed organismi extraterritoriali               ,0,0,0,0,0,2023
TOS,LI,XX  ,Imprese non classificate                                    ,13,5,0,6,24,2023
TOS,LI,TOT ,TOTALE                                                      ,91,98,141,13,343,2023
TOS,PI,A   ,"Agricoltura, silvicoltura pesca                             ",3,0,0,0,3,2023
TOS,PI,A 01,"Coltivazioni agricole e produzione di prodotti animali, c...",2,0,0,0,2,2023
TOS,PI,A 02,Silvicoltura ed utilizzo di aree forestali                  ,1,0,0,0,1,2023
TOS,PI,A 03,Pesca e acquacoltura                                        ,0,0,0,0,0,2023
TOS,PI,B   ,Estrazione di minerali da cave e miniere                    ,0,0,0,0,0,2023
TOS,PI,B 05,Estrazione di carbone (esclusa torba)                       ,0,0,0,0,0,2023
TOS,PI,B 06,Estraz.di petrolio greggio e di gas naturale                ,0,0,0,0,0,2023
TOS,PI,B 07,Estrazione di minerali metalliferi                          ,0,0,0,0,0,2023
TOS,PI,B 08,Altre attività di estrazione di minerali da cave e miniere  ,0,0,0,0,0,2023
TOS,PI,B 09,Attività dei servizi di supporto all'estrazione             ,0,0,0,0,0,2023
TOS,PI,C   ,Attività manifatturiere                                     ,139,0,0,0,139,2023
TOS,PI,C 10,Industrie alimentari                                        ,3,0,0,0,3,2023
TOS,PI,C 11,Industria delle bevande                                     ,2,0,0,0,2,2023
TOS,PI,C 12,Industria del tabacco                                       ,0,0,0,0,0,2023
TOS,PI,C 13,Industrie tessili                                           ,2,0,0,0,2,2023
TOS,PI,C 14,Confezione di articoli di abbigliamento; confezione di ar...,11,0,0,0,11,2023
TOS,PI,C 15,Fabbricazione di articoli in pelle e simili                 ,58,0,0,0,58,2023
TOS,PI,C 16,Industria del legno e dei prodotti in legno e sughero (es...,6,0,0,0,6,2023
TOS,PI,C 17,Fabbricazione di carta e di prodotti di carta               ,2,0,0,0,2,2023
TOS,PI,C 18,Stampa e riproduzione di supporti registrati                ,1,0,0,0,1,2023
TOS,PI,C 19,Fabbricazione di coke e prodotti derivanti dalla raffinaz...,0,0,0,0,0,2023
TOS,PI,C 20,Fabbricazione di prodotti chimici                           ,2,0,0,0,2,2023
TOS,PI,C 21,Fabbricazione di prodotti farmaceutici di base e di prepa...,0,0,0,0,0,2023
TOS,PI,C 22,Fabbricazione di articoli in gomma e materie plastiche      ,2,0,0,0,2,2023
TOS,PI,C 23,Fabbricazione di altri prodotti della lavorazione di miner..,6,0,0,0,6,2023
TOS,PI,C 24,Metallurgia                                                 ,1,0,0,0,1,2023
TOS,PI,C 25,Fabbricazione di prodotti in metallo (esclusi macchinari ...,11,0,0,0,11,2023
TOS,PI,C 26,Fabbricazione di computer e prodotti di elettronica e ott...,6,0,0,0,6,2023
TOS,PI,C 27,Fabbricazione di apparecchiature elettriche ed apparecchi...,3,0,0,0,3,2023
TOS,PI,C 28,Fabbricazione di macchinari ed apparecchiature nca          ,6,0,0,0,6,2023
TOS,PI,C 29,"Fabbricazione di autoveicoli, rimorchi e semirimorchi       ",0,0,0,0,0,2023
TOS,PI,C 30,Fabbricazione di altri mezzi di trasporto                   ,1,0,0,0,1,2023
TOS,PI,C 31,Fabbricazione di mobili                                     ,14,0,0,0,14,2023
TOS,PI,C 32,Altre industrie manifatturiere                              ,1,0,0,0,1,2023
TOS,PI,C 33,"Riparazione, manutenzione ed installazione di macchine ed...",1,0,0,0,1,2023
TOS,PI,D   ,"Fornitura di energia elettrica, gas, vapore e aria condiz...",1,0,0,0,1,2023
TOS,PI,D 35,"Fornitura di energia elettrica, gas, vapore e aria condiz...",1,0,0,0,1,2023
TOS,PI,E   ,"Fornitura di acqua; reti fognarie, attività di gestione d...",2,0,0,0,2,2023
TOS,PI,E 36,"Raccolta, trattamento e fornitura di acqua                  ",0,0,0,0,0,2023
TOS,PI,E 37,Gestione delle reti fognarie                                ,0,0,0,0,0,2023
TOS,PI,E 38,"Attività di raccolta, trattamento e smaltimento dei rifiu...",2,0,0,0,2,2023
TOS,PI,E 39,Attività di risanamento e altri servizi di gestione dei r...,0,0,0,0,0,2023
TOS,PI,F   ,Costruzioni                                                 ,36,0,0,0,36,2023
TOS,PI,F 41,Costruzione di edifici                                      ,25,0,0,0,25,2023
TOS,PI,F 42,Ingegneria civile                                           ,0,0,0,0,0,2023
TOS,PI,F 43,Lavori di costruzione specializzati                         ,11,0,0,0,11,2023
TOS,PI,G   ,Commercio all'ingrosso e al dettaglio; riparazione di aut...,124,0,1,0,125,2023
TOS,PI,G 45,Commercio all'ingrosso e al dettaglio e riparazione di au...,22,0,1,0,23,2023
TOS,PI,G 46,Commercio all'ingrosso (escluso quello di autoveicoli e d...,62,0,0,0,62,2023
TOS,PI,G 47,Commercio al dettaglio (escluso quello di autoveicoli e d...,40,0,0,0,40,2023
TOS,PI,H   ,Trasporto e magazzinaggio                                   ,5,0,0,0,5,2023
TOS,PI,H 49,Trasporto terrestre e mediante condotte                     ,2,0,0,0,2,2023
TOS,PI,H 50,Trasporto marittimo e per vie d'acqua                       ,0,0,0,0,0,2023
TOS,PI,H 51,Trasporto aereo                                             ,0,0,0,0,0,2023
TOS,PI,H 52,Magazzinaggio e attività di supporto ai trasporti           ,2,0,0,0,2,2023
TOS,PI,H 53,Servizi postali e attività di corriere                      ,1,0,0,0,1,2023
TOS,PI,I   ,Attività dei servizi alloggio e ristorazione                ,19,0,0,0,19,2023
TOS,PI,I 55,Alloggio                                                    ,5,0,0,0,5,2023
TOS,PI,I 56,Attività dei servizi di ristorazione                        ,14,0,0,0,14,2023
TOS,PI,J   ,Servizi di informazione e comunicazione                     ,16,0,0,0,16,2023
TOS,PI,J 58,Attività editoriali                                         ,1,0,0,0,1,2023
TOS,PI,J 59,"Attività di produzione cinematografica, di video e di pro...",0,0,0,0,0,2023
TOS,PI,J 60,Attività di programmazione e trasmissione                   ,0,0,0,0,0,2023
TOS,PI,J 61,Telecomunicazioni                                           ,0,0,0,0,0,2023
TOS,PI,J 62,"Produzione di software, consulenza informatica e attività...",10,0,0,0,10,2023
TOS,PI,J 63,Attività dei servizi d'informazione e altri servizi infor...,5,0,0,0,5,2023
TOS,PI,K   ,Attività finanziarie e assicurative                         ,0,0,0,0,0,2023
TOS,PI,K 64,Attività di servizi finanziari (escluse le assicurazioni ...,0,0,0,0,0,2023
TOS,PI,K 65,"Assicurazioni, riassicurazioni e fondi pensione (escluse ...",0,0,0,0,0,2023
TOS,PI,K 66,Attività ausiliarie dei servizi finanziari e delle attivi...,0,0,0,0,0,2023
TOS,PI,L   ,Attivita' immobiliari                                       ,15,0,0,0,15,2023
TOS,PI,L 68,Attivita' immobiliari                                       ,15,0,0,0,15,2023
TOS,PI,M   ,"Attività professionali, scientifiche e tecniche             ",13,0,0,0,13,2023
TOS,PI,M 69,Attività legali e contabilità                               ,1,0,0,0,1,2023
TOS,PI,M 70,Attività di direzione aziendale e di consulenza gestional...,3,0,0,0,3,2023
TOS,PI,M 71,Attività degli studi di architettura e d'ingegneria; coll...,3,0,0,0,3,2023
TOS,PI,M 72,Ricerca scientifica e sviluppo                              ,0,0,0,0,0,2023
TOS,PI,M 73,Pubblicità e ricerche di mercato                            ,1,0,0,0,1,2023
TOS,PI,M 74,"Altre attività professionali, scientifiche e tecniche       ",5,0,0,0,5,2023
TOS,PI,M 75,Servizi veterinari                                          ,0,0,0,0,0,2023
TOS,PI,N   ,"Noleggio, agenzie di viaggio, servizi di supporto alle im...",8,0,1,0,9,2023
TOS,PI,N 77,Attività di noleggio e leasing operativo                    ,2,0,0,0,2,2023
TOS,PI,N 78,"Attività di ricerca, selezione, fornitura di personale      ",0,0,0,0,0,2023
TOS,PI,N 79,"Attività dei servizi delle agenzie di viaggio, dei tour o...",2,0,0,0,2,2023
TOS,PI,N 80,Servizi di vigilanza e investigazione                       ,0,0,0,0,0,2023
TOS,PI,N 81,Attività di servizi per edifici e paesaggio                 ,3,0,0,0,3,2023
TOS,PI,N 82,Attività di supporto per le funzioni d'ufficio e altri se...,1,0,1,0,2,2023
TOS,PI,O   ,Amministrazione pubblica e difesa; assicurazione sociale ...,0,0,0,0,0,2023
TOS,PI,O 84,Amministrazione pubblica e difesa; assicurazione sociale ...,0,0,0,0,0,2023
TOS,PI,P   ,Istruzione                                                  ,2,0,0,0,2,2023
TOS,PI,P 85,Istruzione                                                  ,2,0,0,0,2,2023
TOS,PI,Q   ,Sanita' e assistenza sociale                                ,1,0,0,0,1,2023
TOS,PI,Q 86,Assistenza sanitaria                                        ,1,0,0,0,1,2023
TOS,PI,Q 87,Servizi di assistenza sociale residenziale                  ,0,0,0,0,0,2023
TOS,PI,Q 88,Assistenza sociale non residenziale                         ,0,0,0,0,0,2023
TOS,PI,R   ,"Attività artistiche, sportive, di intrattenimento e diver...",8,0,0,0,8,2023
TOS,PI,R 90,"Attività creative, artistiche e di intrattenimento          ",1,0,0,0,1,2023
TOS,PI,R 91,"Attività di biblioteche, archivi, musei ed altre attività...",0,0,0,0,0,2023
TOS,PI,R 92,"Attività riguardanti le lotterie, le scommesse, le case d...",0,0,0,0,0,2023
TOS,PI,R 93,"Attività sportive, di intrattenimento e di divertimento     ",7,0,0,0,7,2023
TOS,PI,S   ,Altre attività di servizi                                   ,4,0,0,0,4,2023
TOS,PI,S 94,Attività di organizzazioni associative                      ,0,0,0,0,0,2023
TOS,PI,S 95,Riparazione di computer e di beni per uso personale e per...,2,0,0,0,2,2023
TOS,PI,S 96,Altre attività di servizi per la persona                    ,2,0,0,0,2,2023
TOS,PI,T   ,Attività di famiglie e convivenze come datori di lavoro p...,0,0,0,0,0,2023
TOS,PI,T 97,Attività di famiglie e convivenze come datori di lavoro p...,0,0,0,0,0,2023
TOS,PI,T 98,Produzione di beni e servizi indifferenziati per uso prop...,0,0,0,0,0,2023
TOS,PI,U   ,Organizzazioni ed organismi extraterritoriali               ,0,0,0,0,0,2023
TOS,PI,U 99,Organizzazioni ed organismi extraterritoriali               ,0,0,0,0,0,2023
TOS,PI,XX  ,Imprese non classificate                                    ,59,0,0,0,59,2023
TOS,PI,TOT ,TOTALE                                                      ,455,0,2,0,457,2023
TOS,AR,A   ,"Agricoltura, silvicoltura pesca                             ",2,2,41,2,47,2023
TOS,AR,A 01,"Coltivazioni agricole e produzione di prodotti animali, c...",1,1,40,2,44,2023
TOS,AR,A 02,Silvicoltura ed utilizzo di aree forestali                  ,1,1,1,0,3,2023
TOS,AR,A 03,Pesca e acquacoltura                                        ,0,0,0,0,0,2023
TOS,AR,B   ,Estrazione di minerali da cave e miniere                    ,1,0,0,0,1,2023
TOS,AR,B 05,Estrazione di carbone (esclusa torba)                       ,0,0,0,0,0,2023
TOS,AR,B 06,Estraz.di petrolio greggio e di gas naturale                ,0,0,0,0,0,2023
TOS,AR,B 07,Estrazione di minerali metalliferi                          ,0,0,0,0,0,2023
TOS,AR,B 08,Altre attività di estrazione di minerali da cave e miniere  ,1,0,0,0,1,2023
TOS,AR,B 09,Attività dei servizi di supporto all'estrazione             ,0,0,0,0,0,2023
TOS,AR,C   ,Attività manifatturiere                                     ,193,31,26,3,253,2023
TOS,AR,C 10,Industrie alimentari                                        ,9,0,3,1,13,2023
TOS,AR,C 11,Industria delle bevande                                     ,2,0,0,0,2,2023
TOS,AR,C 12,Industria del tabacco                                       ,1,0,0,0,1,2023
TOS,AR,C 13,Industrie tessili                                           ,8,2,0,0,10,2023
TOS,AR,C 14,Confezione di articoli di abbigliamento; confezione di ar...,52,7,9,0,68,2023
TOS,AR,C 15,Fabbricazione di articoli in pelle e simili                 ,17,4,3,1,25,2023
TOS,AR,C 16,Industria del legno e dei prodotti in legno e sughero (es...,4,1,1,0,6,2023
TOS,AR,C 17,Fabbricazione di carta e di prodotti di carta               ,2,0,0,0,2,2023
TOS,AR,C 18,Stampa e riproduzione di supporti registrati                ,3,0,0,0,3,2023
TOS,AR,C 19,Fabbricazione di coke e prodotti derivanti dalla raffinaz...,0,0,0,0,0,2023
TOS,AR,C 20,Fabbricazione di prodotti chimici                           ,3,0,0,0,3,2023
TOS,AR,C 21,Fabbricazione di prodotti farmaceutici di base e di prepa...,0,0,0,0,0,2023
TOS,AR,C 22,Fabbricazione di articoli in gomma e materie plastiche      ,3,0,0,1,4,2023
TOS,AR,C 23,Fabbricazione di altri prodotti della lavorazione di miner..,10,1,1,0,12,2023
TOS,AR,C 24,Metallurgia                                                 ,0,1,1,0,2,2023
TOS,AR,C 25,Fabbricazione di prodotti in metallo (esclusi macchinari ...,14,4,2,0,20,2023
TOS,AR,C 26,Fabbricazione di computer e prodotti di elettronica e ott...,4,0,0,0,4,2023
TOS,AR,C 27,Fabbricazione di apparecchiature elettriche ed apparecchi...,0,0,0,0,0,2023
TOS,AR,C 28,Fabbricazione di macchinari ed apparecchiature nca          ,12,1,0,0,13,2023
TOS,AR,C 29,"Fabbricazione di autoveicoli, rimorchi e semirimorchi       ",0,0,0,0,0,2023
TOS,AR,C 30,Fabbricazione di altri mezzi di trasporto                   ,1,0,0,0,1,2023
TOS,AR,C 31,Fabbricazione di mobili                                     ,13,4,0,0,17,2023
TOS,AR,C 32,Altre industrie manifatturiere                              ,34,6,5,0,45,2023
TOS,AR,C 33,"Riparazione, manutenzione ed installazione di macchine ed...",1,0,1,0,2,2023
TOS,AR,D   ,"Fornitura di energia elettrica, gas, vapore e aria condiz...",0,0,0,0,0,2023
TOS,AR,D 35,"Fornitura di energia elettrica, gas, vapore e aria condiz...",0,0,0,0,0,2023
TOS,AR,E   ,"Fornitura di acqua; reti fognarie, attività di gestione d...",1,0,0,0,1,2023
TOS,AR,E 36,"Raccolta, trattamento e fornitura di acqua                  ",0,0,0,0,0,2023
TOS,AR,E 37,Gestione delle reti fognarie                                ,0,0,0,0,0,2023
TOS,AR,E 38,"Attività di raccolta, trattamento e smaltimento dei rifiu...",1,0,0,0,1,2023
TOS,AR,E 39,Attività di risanamento e altri servizi di gestione dei r...,0,0,0,0,0,2023
TOS,AR,F   ,Costruzioni                                                 ,87,10,25,3,125,2023
TOS,AR,F 41,Costruzione di edifici                                      ,64,5,5,2,76,2023
TOS,AR,F 42,Ingegneria civile                                           ,0,0,3,1,4,2023
TOS,AR,F 43,Lavori di costruzione specializzati                         ,23,5,17,0,45,2023
TOS,AR,G   ,Commercio all'ingrosso e al dettaglio; riparazione di aut...,213,36,38,3,290,2023
TOS,AR,G 45,Commercio all'ingrosso e al dettaglio e riparazione di au...,21,4,5,0,30,2023
TOS,AR,G 46,Commercio all'ingrosso (escluso quello di autoveicoli e d...,134,14,6,0,154,2023
TOS,AR,G 47,Commercio al dettaglio (escluso quello di autoveicoli e d...,58,18,27,3,106,2023
TOS,AR,H   ,Trasporto e magazzinaggio                                   ,14,5,3,1,23,2023
TOS,AR,H 49,Trasporto terrestre e mediante condotte                     ,8,4,2,1,15,2023
TOS,AR,H 50,Trasporto marittimo e per vie d'acqua                       ,0,0,0,0,0,2023
TOS,AR,H 51,Trasporto aereo                                             ,0,0,0,0,0,2023
TOS,AR,H 52,Magazzinaggio e attività di supporto ai trasporti           ,4,1,1,0,6,2023
TOS,AR,H 53,Servizi postali e attività di corriere                      ,2,0,0,0,2,2023
TOS,AR,I   ,Attività dei servizi alloggio e ristorazione                ,68,27,11,0,106,2023
TOS,AR,I 55,Alloggio                                                    ,7,2,0,0,9,2023
TOS,AR,I 56,Attività dei servizi di ristorazione                        ,61,25,11,0,97,2023
TOS,AR,J   ,Servizi di informazione e comunicazione                     ,17,0,2,1,20,2023
TOS,AR,J 58,Attività editoriali                                         ,3,0,0,0,3,2023
TOS,AR,J 59,"Attività di produzione cinematografica, di video e di pro...",0,0,0,0,0,2023
TOS,AR,J 60,Attività di programmazione e trasmissione                   ,1,0,0,0,1,2023
TOS,AR,J 61,Telecomunicazioni                                           ,1,0,0,0,1,2023
TOS,AR,J 62,"Produzione di software, consulenza informatica e attività...",7,0,2,0,9,2023
TOS,AR,J 63,Attività dei servizi d'informazione e altri servizi infor...,5,0,0,1,6,2023
TOS,AR,K   ,Attività finanziarie e assicurative                         ,10,2,3,0,15,2023
TOS,AR,K 64,Attività di servizi finanziari (escluse le assicurazioni ...,7,1,0,0,8,2023
TOS,AR,K 65,"Assicurazioni, riassicurazioni e fondi pensione (escluse ...",0,0,0,0,0,2023
TOS,AR,K 66,Attività ausiliarie dei servizi finanziari e delle attivi...,3,1,3,0,7,2023
TOS,AR,L   ,Attivita' immobiliari                                       ,38,4,3,0,45,2023
TOS,AR,L 68,Attivita' immobiliari                                       ,38,4,3,0,45,2023
TOS,AR,M   ,"Attività professionali, scientifiche e tecniche             ",28,0,2,1,31,2023
TOS,AR,M 69,Attività legali e contabilità                               ,1,0,1,0,2,2023
TOS,AR,M 70,Attività di direzione aziendale e di consulenza gestional...,5,0,0,1,6,2023
TOS,AR,M 71,Attività degli studi di architettura e d'ingegneria; coll...,2,0,0,0,2,2023
TOS,AR,M 72,Ricerca scientifica e sviluppo                              ,0,0,0,0,0,2023
TOS,AR,M 73,Pubblicità e ricerche di mercato                            ,7,0,0,0,7,2023
TOS,AR,M 74,"Altre attività professionali, scientifiche e tecniche       ",13,0,1,0,14,2023
TOS,AR,M 75,Servizi veterinari                                          ,0,0,0,0,0,2023
TOS,AR,N   ,"Noleggio, agenzie di viaggio, servizi di supporto alle im...",7,1,2,4,14,2023
TOS,AR,N 77,Attività di noleggio e leasing operativo                    ,3,1,0,0,4,2023
TOS,AR,N 78,"Attività di ricerca, selezione, fornitura di personale      ",0,0,0,0,0,2023
TOS,AR,N 79,"Attività dei servizi delle agenzie di viaggio, dei tour o...",1,0,1,1,3,2023
TOS,AR,N 80,Servizi di vigilanza e investigazione                       ,0,0,0,0,0,2023
TOS,AR,N 81,Attività di servizi per edifici e paesaggio                 ,0,0,1,2,3,2023
TOS,AR,N 82,Attività di supporto per le funzioni d'ufficio e altri se...,3,0,0,1,4,2023
TOS,AR,O   ,Amministrazione pubblica e difesa; assicurazione sociale ...,0,0,0,0,0,2023
TOS,AR,O 84,Amministrazione pubblica e difesa; assicurazione sociale ...,0,0,0,0,0,2023
TOS,AR,P   ,Istruzione                                                  ,1,0,0,0,1,2023
TOS,AR,P 85,Istruzione                                                  ,1,0,0,0,1,2023
TOS,AR,Q   ,Sanita' e assistenza sociale                                ,0,0,0,0,0,2023
TOS,AR,Q 86,Assistenza sanitaria                                        ,0,0,0,0,0,2023
TOS,AR,Q 87,Servizi di assistenza sociale residenziale                  ,0,0,0,0,0,2023
TOS,AR,Q 88,Assistenza sociale non residenziale                         ,0,0,0,0,0,2023
TOS,AR,R   ,"Attività artistiche, sportive, di intrattenimento e diver...",25,2,1,1,29,2023
TOS,AR,R 90,"Attività creative, artistiche e di intrattenimento          ",10,1,1,0,12,2023
TOS,AR,R 91,"Attività di biblioteche, archivi, musei ed altre attività...",0,0,0,0,0,2023
TOS,AR,R 92,"Attività riguardanti le lotterie, le scommesse, le case d...",0,1,0,0,1,2023
TOS,AR,R 93,"Attività sportive, di intrattenimento e di divertimento     ",15,0,0,1,16,2023
TOS,AR,S   ,Altre attività di servizi                                   ,7,1,3,0,11,2023
TOS,AR,S 94,Attività di organizzazioni associative                      ,0,0,0,0,0,2023
TOS,AR,S 95,Riparazione di computer e di beni per uso personale e per...,2,0,1,0,3,2023
TOS,AR,S 96,Altre attività di servizi per la persona                    ,5,1,2,0,8,2023
TOS,AR,T   ,Attività di famiglie e convivenze come datori di lavoro p...,0,0,0,0,0,2023
TOS,AR,T 97,Attività di famiglie e convivenze come datori di lavoro p...,0,0,0,0,0,2023
TOS,AR,T 98,Produzione di beni e servizi indifferenziati per uso prop...,0,0,0,0,0,2023
TOS,AR,U   ,Organizzazioni ed organismi extraterritoriali               ,0,0,0,0,0,2023
TOS,AR,U 99,Organizzazioni ed organismi extraterritoriali               ,0,0,0,0,0,2023
TOS,AR,XX  ,Imprese non classificate                                    ,55,6,22,3,86,2023
TOS,AR,TOT ,TOTALE                                                      ,767,127,182,22,1098,2023
TOS,SI,A   ,"Agricoltura, silvicoltura pesca                             ",1,4,0,2,7,2023
TOS,SI,A 01,"Coltivazioni agricole e produzione di prodotti animali, c...",1,3,0,1,5,2023
TOS,SI,A 02,Silvicoltura ed utilizzo di aree forestali                  ,0,1,0,0,1,2023
TOS,SI,A 03,Pesca e acquacoltura                                        ,0,0,0,1,1,2023
TOS,SI,B   ,Estrazione di minerali da cave e miniere                    ,2,0,0,0,2,2023
TOS,SI,B 05,Estrazione di carbone (esclusa torba)                       ,0,0,0,0,0,2023
TOS,SI,B 06,Estraz.di petrolio greggio e di gas naturale                ,0,0,0,0,0,2023
TOS,SI,B 07,Estrazione di minerali metalliferi                          ,0,0,0,0,0,2023
TOS,SI,B 08,Altre attività di estrazione di minerali da cave e miniere  ,2,0,0,0,2,2023
TOS,SI,B 09,Attività dei servizi di supporto all'estrazione             ,0,0,0,0,0,2023
TOS,SI,C   ,Attività manifatturiere                                     ,9,3,0,1,13,2023
TOS,SI,C 10,Industrie alimentari                                        ,2,1,0,0,3,2023
TOS,SI,C 11,Industria delle bevande                                     ,1,0,0,0,1,2023
TOS,SI,C 12,Industria del tabacco                                       ,0,0,0,0,0,2023
TOS,SI,C 13,Industrie tessili                                           ,0,0,0,0,0,2023
TOS,SI,C 14,Confezione di articoli di abbigliamento; confezione di ar...,1,0,0,0,1,2023
TOS,SI,C 15,Fabbricazione di articoli in pelle e simili                 ,0,0,0,0,0,2023
TOS,SI,C 16,Industria del legno e dei prodotti in legno e sughero (es...,0,0,0,0,0,2023
TOS,SI,C 17,Fabbricazione di carta e di prodotti di carta               ,0,0,0,0,0,2023
TOS,SI,C 18,Stampa e riproduzione di supporti registrati                ,0,0,0,0,0,2023
TOS,SI,C 19,Fabbricazione di coke e prodotti derivanti dalla raffinaz...,0,0,0,0,0,2023
TOS,SI,C 20,Fabbricazione di prodotti chimici                           ,0,0,0,0,0,2023
TOS,SI,C 21,Fabbricazione di prodotti farmaceutici di base e di prepa...,0,0,0,0,0,2023
TOS,SI,C 22,Fabbricazione di articoli in gomma e materie plastiche      ,0,0,0,0,0,2023
TOS,SI,C 23,Fabbricazione di altri prodotti della lavorazione di miner..,1,0,0,0,1,2023
TOS,SI,C 24,Metallurgia                                                 ,0,0,0,0,0,2023
TOS,SI,C 25,Fabbricazione di prodotti in metallo (esclusi macchinari ...,1,2,0,0,3,2023
TOS,SI,C 26,Fabbricazione di computer e prodotti di elettronica e ott...,0,0,0,0,0,2023
TOS,SI,C 27,Fabbricazione di apparecchiature elettriche ed apparecchi...,0,0,0,0,0,2023
TOS,SI,C 28,Fabbricazione di macchinari ed apparecchiature nca          ,1,0,0,0,1,2023
TOS,SI,C 29,"Fabbricazione di autoveicoli, rimorchi e semirimorchi       ",0,0,0,0,0,2023
TOS,SI,C 30,Fabbricazione di altri mezzi di trasporto                   ,0,0,0,0,0,2023
TOS,SI,C 31,Fabbricazione di mobili                                     ,2,0,0,1,3,2023
TOS,SI,C 32,Altre industrie manifatturiere                              ,0,0,0,0,0,2023
TOS,SI,C 33,"Riparazione, manutenzione ed installazione di macchine ed...",0,0,0,0,0,2023
TOS,SI,D   ,"Fornitura di energia elettrica, gas, vapore e aria condiz...",0,0,0,0,0,2023
TOS,SI,D 35,"Fornitura di energia elettrica, gas, vapore e aria condiz...",0,0,0,0,0,2023
TOS,SI,E   ,"Fornitura di acqua; reti fognarie, attività di gestione d...",0,0,0,0,0,2023
TOS,SI,E 36,"Raccolta, trattamento e fornitura di acqua                  ",0,0,0,0,0,2023
TOS,SI,E 37,Gestione delle reti fognarie                                ,0,0,0,0,0,2023
TOS,SI,E 38,"Attività di raccolta, trattamento e smaltimento dei rifiu...",0,0,0,0,0,2023
TOS,SI,E 39,Attività di risanamento e altri servizi di gestione dei r...,0,0,0,0,0,2023
TOS,SI,F   ,Costruzioni                                                 ,17,2,1,9,29,2023
TOS,SI,F 41,Costruzione di edifici                                      ,14,2,0,8,24,2023
TOS,SI,F 42,Ingegneria civile                                           ,0,0,0,0,0,2023
TOS,SI,F 43,Lavori di costruzione specializzati                         ,3,0,1,1,5,2023
TOS,SI,G   ,Commercio all'ingrosso e al dettaglio; riparazione di aut...,20,7,0,2,29,2023
TOS,SI,G 45,Commercio all'ingrosso e al dettaglio e riparazione di au...,1,1,0,1,3,2023
TOS,SI,G 46,Commercio all'ingrosso (escluso quello di autoveicoli e d...,10,1,0,1,12,2023
TOS,SI,G 47,Commercio al dettaglio (escluso quello di autoveicoli e d...,9,5,0,0,14,2023
TOS,SI,H   ,Trasporto e magazzinaggio                                   ,2,0,0,1,3,2023
TOS,SI,H 49,Trasporto terrestre e mediante condotte                     ,2,0,0,1,3,2023
TOS,SI,H 50,Trasporto marittimo e per vie d'acqua                       ,0,0,0,0,0,2023
TOS,SI,H 51,Trasporto aereo                                             ,0,0,0,0,0,2023
TOS,SI,H 52,Magazzinaggio e attività di supporto ai trasporti           ,0,0,0,0,0,2023
TOS,SI,H 53,Servizi postali e attività di corriere                      ,0,0,0,0,0,2023
TOS,SI,I   ,Attività dei servizi alloggio e ristorazione                ,11,1,0,0,12,2023
TOS,SI,I 55,Alloggio                                                    ,4,1,0,0,5,2023
TOS,SI,I 56,Attività dei servizi di ristorazione                        ,7,0,0,0,7,2023
TOS,SI,J   ,Servizi di informazione e comunicazione                     ,4,0,0,2,6,2023
TOS,SI,J 58,Attività editoriali                                         ,2,0,0,1,3,2023
TOS,SI,J 59,"Attività di produzione cinematografica, di video e di pro...",0,0,0,0,0,2023
TOS,SI,J 60,Attività di programmazione e trasmissione                   ,0,0,0,0,0,2023
TOS,SI,J 61,Telecomunicazioni                                           ,0,0,0,0,0,2023
TOS,SI,J 62,"Produzione di software, consulenza informatica e attività...",1,0,0,1,2,2023
TOS,SI,J 63,Attività dei servizi d'informazione e altri servizi infor...,1,0,0,0,1,2023
TOS,SI,K   ,Attività finanziarie e assicurative                         ,1,0,0,0,1,2023
TOS,SI,K 64,Attività di servizi finanziari (escluse le assicurazioni ...,1,0,0,0,1,2023
TOS,SI,K 65,"Assicurazioni, riassicurazioni e fondi pensione (escluse ...",0,0,0,0,0,2023
TOS,SI,K 66,Attività ausiliarie dei servizi finanziari e delle attivi...,0,0,0,0,0,2023
TOS,SI,L   ,Attivita' immobiliari                                       ,15,1,0,0,16,2023
TOS,SI,L 68,Attivita' immobiliari                                       ,15,1,0,0,16,2023
TOS,SI,M   ,"Attività professionali, scientifiche e tecniche             ",1,0,0,1,2,2023
TOS,SI,M 69,Attività legali e contabilità                               ,0,0,0,0,0,2023
TOS,SI,M 70,Attività di direzione aziendale e di consulenza gestional...,0,0,0,0,0,2023
TOS,SI,M 71,Attività degli studi di architettura e d'ingegneria; coll...,0,0,0,1,1,2023
TOS,SI,M 72,Ricerca scientifica e sviluppo                              ,0,0,0,0,0,2023
TOS,SI,M 73,Pubblicità e ricerche di mercato                            ,0,0,0,0,0,2023
TOS,SI,M 74,"Altre attività professionali, scientifiche e tecniche       ",1,0,0,0,1,2023
TOS,SI,M 75,Servizi veterinari                                          ,0,0,0,0,0,2023
TOS,SI,N   ,"Noleggio, agenzie di viaggio, servizi di supporto alle im...",2,0,0,1,3,2023
TOS,SI,N 77,Attività di noleggio e leasing operativo                    ,0,0,0,0,0,2023
TOS,SI,N 78,"Attività di ricerca, selezione, fornitura di personale      ",0,0,0,0,0,2023
TOS,SI,N 79,"Attività dei servizi delle agenzie di viaggio, dei tour o...",1,0,0,0,1,2023
TOS,SI,N 80,Servizi di vigilanza e investigazione                       ,0,0,0,0,0,2023
TOS,SI,N 81,Attività di servizi per edifici e paesaggio                 ,0,0,0,1,1,2023
TOS,SI,N 82,Attività di supporto per le funzioni d'ufficio e altri se...,1,0,0,0,1,2023
TOS,SI,O   ,Amministrazione pubblica e difesa; assicurazione sociale ...,0,0,0,0,0,2023
TOS,SI,O 84,Amministrazione pubblica e difesa; assicurazione sociale ...,0,0,0,0,0,2023
TOS,SI,P   ,Istruzione                                                  ,1,0,0,1,2,2023
TOS,SI,P 85,Istruzione                                                  ,1,0,0,1,2,2023
TOS,SI,Q   ,Sanita' e assistenza sociale                                ,0,0,0,0,0,2023
TOS,SI,Q 86,Assistenza sanitaria                                        ,0,0,0,0,0,2023
TOS,SI,Q 87,Servizi di assistenza sociale residenziale                  ,0,0,0,0,0,2023
TOS,SI,Q 88,Assistenza sociale non residenziale                         ,0,0,0,0,0,2023
TOS,SI,R   ,"Attività artistiche, sportive, di intrattenimento e diver...",2,2,0,1,5,2023
TOS,SI,R 90,"Attività creative, artistiche e di intrattenimento          ",0,0,0,0,0,2023
TOS,SI,R 91,"Attività di biblioteche, archivi, musei ed altre attività...",0,0,0,0,0,2023
TOS,SI,R 92,"Attività riguardanti le lotterie, le scommesse, le case d...",1,0,0,0,1,2023
TOS,SI,R 93,"Attività sportive, di intrattenimento e di divertimento     ",1,2,0,1,4,2023
TOS,SI,S   ,Altre attività di servizi                                   ,1,2,0,0,3,2023
TOS,SI,S 94,Attività di organizzazioni associative                      ,0,0,0,0,0,2023
TOS,SI,S 95,Riparazione di computer e di beni per uso personale e per...,0,0,0,0,0,2023
TOS,SI,S 96,Altre attività di servizi per la persona                    ,1,2,0,0,3,2023
TOS,SI,T   ,Attività di famiglie e convivenze come datori di lavoro p...,0,0,0,0,0,2023
TOS,SI,T 97,Attività di famiglie e convivenze come datori di lavoro p...,0,0,0,0,0,2023
TOS,SI,T 98,Produzione di beni e servizi indifferenziati per uso prop...,0,0,0,0,0,2023
TOS,SI,U   ,Organizzazioni ed organismi extraterritoriali               ,0,0,0,0,0,2023
TOS,SI,U 99,Organizzazioni ed organismi extraterritoriali               ,0,0,0,0,0,2023
TOS,SI,XX  ,Imprese non classificate                                    ,12,2,0,0,14,2023
TOS,SI,TOT ,TOTALE                                                      ,101,24,1,21,147,2023
TOS,GR,A   ,"Agricoltura, silvicoltura pesca                             ",9,37,148,5,199,2023
TOS,GR,A 01,"Coltivazioni agricole e produzione di prodotti animali, c...",7,34,146,5,192,2023
TOS,GR,A 02,Silvicoltura ed utilizzo di aree forestali                  ,2,2,0,0,4,2023
TOS,GR,A 03,Pesca e acquacoltura                                        ,0,1,2,0,3,2023
TOS,GR,B   ,Estrazione di minerali da cave e miniere                    ,0,0,0,0,0,2023
TOS,GR,B 05,Estrazione di carbone (esclusa torba)                       ,0,0,0,0,0,2023
TOS,GR,B 06,Estraz.di petrolio greggio e di gas naturale                ,0,0,0,0,0,2023
TOS,GR,B 07,Estrazione di minerali metalliferi                          ,0,0,0,0,0,2023
TOS,GR,B 08,Altre attività di estrazione di minerali da cave e miniere  ,0,0,0,0,0,2023
TOS,GR,B 09,Attività dei servizi di supporto all'estrazione             ,0,0,0,0,0,2023
TOS,GR,C   ,Attività manifatturiere                                     ,9,13,2,0,24,2023
TOS,GR,C 10,Industrie alimentari                                        ,3,5,1,0,9,2023
TOS,GR,C 11,Industria delle bevande                                     ,0,0,0,0,0,2023
TOS,GR,C 12,Industria del tabacco                                       ,0,0,0,0,0,2023
TOS,GR,C 13,Industrie tessili                                           ,0,1,0,0,1,2023
TOS,GR,C 14,Confezione di articoli di abbigliamento; confezione di ar...,0,1,0,0,1,2023
TOS,GR,C 15,Fabbricazione di articoli in pelle e simili                 ,0,1,0,0,1,2023
TOS,GR,C 16,Industria del legno e dei prodotti in legno e sughero (es...,0,1,0,0,1,2023
TOS,GR,C 17,Fabbricazione di carta e di prodotti di carta               ,0,0,0,0,0,2023
TOS,GR,C 18,Stampa e riproduzione di supporti registrati                ,0,2,0,0,2,2023
TOS,GR,C 19,Fabbricazione di coke e prodotti derivanti dalla raffinaz...,0,0,0,0,0,2023
TOS,GR,C 20,Fabbricazione di prodotti chimici                           ,0,0,0,0,0,2023
TOS,GR,C 21,Fabbricazione di prodotti farmaceutici di base e di prepa...,0,0,0,0,0,2023
TOS,GR,C 22,Fabbricazione di articoli in gomma e materie plastiche      ,0,0,0,0,0,2023
TOS,GR,C 23,Fabbricazione di altri prodotti della lavorazione di miner..,1,0,0,0,1,2023
TOS,GR,C 24,Metallurgia                                                 ,1,0,0,0,1,2023
TOS,GR,C 25,Fabbricazione di prodotti in metallo (esclusi macchinari ...,0,0,0,0,0,2023
TOS,GR,C 26,Fabbricazione di computer e prodotti di elettronica e ott...,0,0,0,0,0,2023
TOS,GR,C 27,Fabbricazione di apparecchiature elettriche ed apparecchi...,1,0,1,0,2,2023
TOS,GR,C 28,Fabbricazione di macchinari ed apparecchiature nca          ,0,1,0,0,1,2023
TOS,GR,C 29,"Fabbricazione di autoveicoli, rimorchi e semirimorchi       ",0,0,0,0,0,2023
TOS,GR,C 30,Fabbricazione di altri mezzi di trasporto                   ,1,1,0,0,2,2023
TOS,GR,C 31,Fabbricazione di mobili                                     ,2,0,0,0,2,2023
TOS,GR,C 32,Altre industrie manifatturiere                              ,0,0,0,0,0,2023
TOS,GR,C 33,"Riparazione, manutenzione ed installazione di macchine ed...",0,0,0,0,0,2023
TOS,GR,D   ,"Fornitura di energia elettrica, gas, vapore e aria condiz...",0,0,0,0,0,2023
TOS,GR,D 35,"Fornitura di energia elettrica, gas, vapore e aria condiz...",0,0,0,0,0,2023
TOS,GR,E   ,"Fornitura di acqua; reti fognarie, attività di gestione d...",0,0,0,0,0,2023
TOS,GR,E 36,"Raccolta, trattamento e fornitura di acqua                  ",0,0,0,0,0,2023
TOS,GR,E 37,Gestione delle reti fognarie                                ,0,0,0,0,0,2023
TOS,GR,E 38,"Attività di raccolta, trattamento e smaltimento dei rifiu...",0,0,0,0,0,2023
TOS,GR,E 39,Attività di risanamento e altri servizi di gestione dei r...,0,0,0,0,0,2023
TOS,GR,F   ,Costruzioni                                                 ,49,16,4,3,72,2023
TOS,GR,F 41,Costruzione di edifici                                      ,42,3,4,2,51,2023
TOS,GR,F 42,Ingegneria civile                                           ,0,0,0,1,1,2023
TOS,GR,F 43,Lavori di costruzione specializzati                         ,7,13,0,0,20,2023
TOS,GR,G   ,Commercio all'ingrosso e al dettaglio; riparazione di aut...,34,48,11,1,94,2023
TOS,GR,G 45,Commercio all'ingrosso e al dettaglio e riparazione di au...,6,8,1,0,15,2023
TOS,GR,G 46,Commercio all'ingrosso (escluso quello di autoveicoli e d...,10,8,4,1,23,2023
TOS,GR,G 47,Commercio al dettaglio (escluso quello di autoveicoli e d...,18,32,6,0,56,2023
TOS,GR,H   ,Trasporto e magazzinaggio                                   ,4,1,1,0,6,2023
TOS,GR,H 49,Trasporto terrestre e mediante condotte                     ,0,1,1,0,2,2023
TOS,GR,H 50,Trasporto marittimo e per vie d'acqua                       ,1,0,0,0,1,2023
TOS,GR,H 51,Trasporto aereo                                             ,0,0,0,0,0,2023
TOS,GR,H 52,Magazzinaggio e attività di supporto ai trasporti           ,3,0,0,0,3,2023
TOS,GR,H 53,Servizi postali e attività di corriere                      ,0,0,0,0,0,2023
TOS,GR,I   ,Attività dei servizi alloggio e ristorazione                ,24,44,0,0,68,2023
TOS,GR,I 55,Alloggio                                                    ,3,5,0,0,8,2023
TOS,GR,I 56,Attività dei servizi di ristorazione                        ,21,39,0,0,60,2023
TOS,GR,J   ,Servizi di informazione e comunicazione                     ,4,2,1,0,7,2023
TOS,GR,J 58,Attività editoriali                                         ,1,0,0,0,1,2023
TOS,GR,J 59,"Attività di produzione cinematografica, di video e di pro...",0,0,0,0,0,2023
TOS,GR,J 60,Attività di programmazione e trasmissione                   ,1,0,0,0,1,2023
TOS,GR,J 61,Telecomunicazioni                                           ,0,0,0,0,0,2023
TOS,GR,J 62,"Produzione di software, consulenza informatica e attività...",2,0,1,0,3,2023
TOS,GR,J 63,Attività dei servizi d'informazione e altri servizi infor...,0,2,0,0,2,2023
TOS,GR,K   ,Attività finanziarie e assicurative                         ,5,3,1,0,9,2023
TOS,GR,K 64,Attività di servizi finanziari (escluse le assicurazioni ...,2,0,0,0,2,2023
TOS,GR,K 65,"Assicurazioni, riassicurazioni e fondi pensione (escluse ...",0,0,0,0,0,2023
TOS,GR,K 66,Attività ausiliarie dei servizi finanziari e delle attivi...,3,3,1,0,7,2023
TOS,GR,L   ,Attivita' immobiliari                                       ,19,21,2,0,42,2023
TOS,GR,L 68,Attivita' immobiliari                                       ,19,21,2,0,42,2023
TOS,GR,M   ,"Attività professionali, scientifiche e tecniche             ",15,4,1,1,21,2023
TOS,GR,M 69,Attività legali e contabilità                               ,1,0,0,0,1,2023
TOS,GR,M 70,Attività di direzione aziendale e di consulenza gestional...,6,0,1,1,8,2023
TOS,GR,M 71,Attività degli studi di architettura e d'ingegneria; coll...,0,1,0,0,1,2023
TOS,GR,M 72,Ricerca scientifica e sviluppo                              ,1,0,0,0,1,2023
TOS,GR,M 73,Pubblicità e ricerche di mercato                            ,4,2,0,0,6,2023
TOS,GR,M 74,"Altre attività professionali, scientifiche e tecniche       ",3,1,0,0,4,2023
TOS,GR,M 75,Servizi veterinari                                          ,0,0,0,0,0,2023
TOS,GR,N   ,"Noleggio, agenzie di viaggio, servizi di supporto alle im...",6,6,0,4,16,2023
TOS,GR,N 77,Attività di noleggio e leasing operativo                    ,1,1,0,0,2,2023
TOS,GR,N 78,"Attività di ricerca, selezione, fornitura di personale      ",0,0,0,0,0,2023
TOS,GR,N 79,"Attività dei servizi delle agenzie di viaggio, dei tour o...",0,1,0,0,1,2023
TOS,GR,N 80,Servizi di vigilanza e investigazione                       ,0,0,0,0,0,2023
TOS,GR,N 81,Attività di servizi per edifici e paesaggio                 ,2,4,0,2,8,2023
TOS,GR,N 82,Attività di supporto per le funzioni d'ufficio e altri se...,3,0,0,2,5,2023
TOS,GR,O   ,Amministrazione pubblica e difesa; assicurazione sociale ...,0,0,0,0,0,2023
TOS,GR,O 84,Amministrazione pubblica e difesa; assicurazione sociale ...,0,0,0,0,0,2023
TOS,GR,P   ,Istruzione                                                  ,0,0,0,0,0,2023
TOS,GR,P 85,Istruzione                                                  ,0,0,0,0,0,2023
TOS,GR,Q   ,Sanita' e assistenza sociale                                ,1,1,0,0,2,2023
TOS,GR,Q 86,Assistenza sanitaria                                        ,0,1,0,0,1,2023
TOS,GR,Q 87,Servizi di assistenza sociale residenziale                  ,1,0,0,0,1,2023
TOS,GR,Q 88,Assistenza sociale non residenziale                         ,0,0,0,0,0,2023
TOS,GR,R   ,"Attività artistiche, sportive, di intrattenimento e diver...",6,2,0,0,8,2023
TOS,GR,R 90,"Attività creative, artistiche e di intrattenimento          ",1,0,0,0,1,2023
TOS,GR,R 91,"Attività di biblioteche, archivi, musei ed altre attività...",0,0,0,0,0,2023
TOS,GR,R 92,"Attività riguardanti le lotterie, le scommesse, le case d...",1,1,0,0,2,2023
TOS,GR,R 93,"Attività sportive, di intrattenimento e di divertimento     ",4,1,0,0,5,2023
TOS,GR,S   ,Altre attività di servizi                                   ,0,11,1,0,12,2023
TOS,GR,S 94,Attività di organizzazioni associative                      ,0,0,0,0,0,2023
TOS,GR,S 95,Riparazione di computer e di beni per uso personale e per...,0,4,0,0,4,2023
TOS,GR,S 96,Altre attività di servizi per la persona                    ,0,7,1,0,8,2023
TOS,GR,T   ,Attività di famiglie e convivenze come datori di lavoro p...,0,0,0,0,0,2023
TOS,GR,T 97,Attività di famiglie e convivenze come datori di lavoro p...,0,0,0,0,0,2023
TOS,GR,T 98,Produzione di beni e servizi indifferenziati per uso prop...,0,0,0,0,0,2023
TOS,GR,U   ,Organizzazioni ed organismi extraterritoriali               ,0,0,0,0,0,2023
TOS,GR,U 99,Organizzazioni ed organismi extraterritoriali               ,0,0,0,0,0,2023
TOS,GR,XX  ,Imprese non classificate                                    ,31,8,0,4,43,2023
TOS,GR,TOT ,TOTALE                                                      ,216,217,172,18,623,2023
TOS,PO,A   ,"Agricoltura, silvicoltura pesca                             ",4,0,4,0,8,2023
TOS,PO,A 01,"Coltivazioni agricole e produzione di prodotti animali, c...",3,0,4,0,7,2023
TOS,PO,A 02,Silvicoltura ed utilizzo di aree forestali                  ,1,0,0,0,1,2023
TOS,PO,A 03,Pesca e acquacoltura                                        ,0,0,0,0,0,2023
TOS,PO,B   ,Estrazione di minerali da cave e miniere                    ,0,0,0,0,0,2023
TOS,PO,B 05,Estrazione di carbone (esclusa torba)                       ,0,0,0,0,0,2023
TOS,PO,B 06,Estraz.di petrolio greggio e di gas naturale                ,0,0,0,0,0,2023
TOS,PO,B 07,Estrazione di minerali metalliferi                          ,0,0,0,0,0,2023
TOS,PO,B 08,Altre attività di estrazione di minerali da cave e miniere  ,0,0,0,0,0,2023
TOS,PO,B 09,Attività dei servizi di supporto all'estrazione             ,0,0,0,0,0,2023
TOS,PO,C   ,Attività manifatturiere                                     ,148,1,36,1,186,2023
TOS,PO,C 10,Industrie alimentari                                        ,2,0,0,1,3,2023
TOS,PO,C 11,Industria delle bevande                                     ,0,0,0,0,0,2023
TOS,PO,C 12,Industria del tabacco                                       ,0,0,0,0,0,2023
TOS,PO,C 13,Industrie tessili                                           ,68,0,10,0,78,2023
TOS,PO,C 14,Confezione di articoli di abbigliamento; confezione di ar...,47,0,20,0,67,2023
TOS,PO,C 15,Fabbricazione di articoli in pelle e simili                 ,3,0,4,0,7,2023
TOS,PO,C 16,Industria del legno e dei prodotti in legno e sughero (es...,1,0,0,0,1,2023
TOS,PO,C 17,Fabbricazione di carta e di prodotti di carta               ,1,0,0,0,1,2023
TOS,PO,C 18,Stampa e riproduzione di supporti registrati                ,3,0,1,0,4,2023
TOS,PO,C 19,Fabbricazione di coke e prodotti derivanti dalla raffinaz...,0,0,0,0,0,2023
TOS,PO,C 20,Fabbricazione di prodotti chimici                           ,2,0,0,0,2,2023
TOS,PO,C 21,Fabbricazione di prodotti farmaceutici di base e di prepa...,0,0,0,0,0,2023
TOS,PO,C 22,Fabbricazione di articoli in gomma e materie plastiche      ,1,0,0,0,1,2023
TOS,PO,C 23,Fabbricazione di altri prodotti della lavorazione di miner..,2,0,0,0,2,2023
TOS,PO,C 24,Metallurgia                                                 ,0,0,0,0,0,2023
TOS,PO,C 25,Fabbricazione di prodotti in metallo (esclusi macchinari ...,6,0,0,0,6,2023
TOS,PO,C 26,Fabbricazione di computer e prodotti di elettronica e ott...,1,0,0,0,1,2023
TOS,PO,C 27,Fabbricazione di apparecchiature elettriche ed apparecchi...,0,0,0,0,0,2023
TOS,PO,C 28,Fabbricazione di macchinari ed apparecchiature nca          ,4,0,1,0,5,2023
TOS,PO,C 29,"Fabbricazione di autoveicoli, rimorchi e semirimorchi       ",0,0,0,0,0,2023
TOS,PO,C 30,Fabbricazione di altri mezzi di trasporto                   ,0,0,0,0,0,2023
TOS,PO,C 31,Fabbricazione di mobili                                     ,3,0,0,0,3,2023
TOS,PO,C 32,Altre industrie manifatturiere                              ,3,1,0,0,4,2023
TOS,PO,C 33,"Riparazione, manutenzione ed installazione di macchine ed...",1,0,0,0,1,2023
TOS,PO,D   ,"Fornitura di energia elettrica, gas, vapore e aria condiz...",1,0,0,0,1,2023
TOS,PO,D 35,"Fornitura di energia elettrica, gas, vapore e aria condiz...",1,0,0,0,1,2023
TOS,PO,E   ,"Fornitura di acqua; reti fognarie, attività di gestione d...",3,0,1,1,5,2023
TOS,PO,E 36,"Raccolta, trattamento e fornitura di acqua                  ",0,0,0,0,0,2023
TOS,PO,E 37,Gestione delle reti fognarie                                ,0,0,0,0,0,2023
TOS,PO,E 38,"Attività di raccolta, trattamento e smaltimento dei rifiu...",3,0,1,1,5,2023
TOS,PO,E 39,Attività di risanamento e altri servizi di gestione dei r...,0,0,0,0,0,2023
TOS,PO,F   ,Costruzioni                                                 ,48,2,5,6,61,2023
TOS,PO,F 41,Costruzione di edifici                                      ,43,0,1,4,48,2023
TOS,PO,F 42,Ingegneria civile                                           ,0,0,0,0,0,2023
TOS,PO,F 43,Lavori di costruzione specializzati                         ,5,2,4,2,13,2023
TOS,PO,G   ,Commercio all'ingrosso e al dettaglio; riparazione di aut...,129,1,33,2,165,2023
TOS,PO,G 45,Commercio all'ingrosso e al dettaglio e riparazione di au...,16,0,4,0,20,2023
TOS,PO,G 46,Commercio all'ingrosso (escluso quello di autoveicoli e d...,92,0,13,1,106,2023
TOS,PO,G 47,Commercio al dettaglio (escluso quello di autoveicoli e d...,21,1,16,1,39,2023
TOS,PO,H   ,Trasporto e magazzinaggio                                   ,9,0,2,7,18,2023
TOS,PO,H 49,Trasporto terrestre e mediante condotte                     ,4,0,0,2,6,2023
TOS,PO,H 50,Trasporto marittimo e per vie d'acqua                       ,0,0,0,0,0,2023
TOS,PO,H 51,Trasporto aereo                                             ,0,0,0,0,0,2023
TOS,PO,H 52,Magazzinaggio e attività di supporto ai trasporti           ,4,0,2,5,11,2023
TOS,PO,H 53,Servizi postali e attività di corriere                      ,1,0,0,0,1,2023
TOS,PO,I   ,Attività dei servizi alloggio e ristorazione                ,26,0,2,0,28,2023
TOS,PO,I 55,Alloggio                                                    ,1,0,0,0,1,2023
TOS,PO,I 56,Attività dei servizi di ristorazione                        ,25,0,2,0,27,2023
TOS,PO,J   ,Servizi di informazione e comunicazione                     ,14,0,0,0,14,2023
TOS,PO,J 58,Attività editoriali                                         ,3,0,0,0,3,2023
TOS,PO,J 59,"Attività di produzione cinematografica, di video e di pro...",2,0,0,0,2,2023
TOS,PO,J 60,Attività di programmazione e trasmissione                   ,1,0,0,0,1,2023
TOS,PO,J 61,Telecomunicazioni                                           ,0,0,0,0,0,2023
TOS,PO,J 62,"Produzione di software, consulenza informatica e attività...",2,0,0,0,2,2023
TOS,PO,J 63,Attività dei servizi d'informazione e altri servizi infor...,6,0,0,0,6,2023
TOS,PO,K   ,Attività finanziarie e assicurative                         ,11,0,0,1,12,2023
TOS,PO,K 64,Attività di servizi finanziari (escluse le assicurazioni ...,9,0,0,1,10,2023
TOS,PO,K 65,"Assicurazioni, riassicurazioni e fondi pensione (escluse ...",0,0,0,0,0,2023
TOS,PO,K 66,Attività ausiliarie dei servizi finanziari e delle attivi...,2,0,0,0,2,2023
TOS,PO,L   ,Attivita' immobiliari                                       ,60,0,2,0,62,2023
TOS,PO,L 68,Attivita' immobiliari                                       ,60,0,2,0,62,2023
TOS,PO,M   ,"Attività professionali, scientifiche e tecniche             ",18,0,0,3,21,2023
TOS,PO,M 69,Attività legali e contabilità                               ,1,0,0,0,1,2023
TOS,PO,M 70,Attività di direzione aziendale e di consulenza gestional...,4,0,0,0,4,2023
TOS,PO,M 71,Attività degli studi di architettura e d'ingegneria; coll...,1,0,0,0,1,2023
TOS,PO,M 72,Ricerca scientifica e sviluppo                              ,0,0,0,1,1,2023
TOS,PO,M 73,Pubblicità e ricerche di mercato                            ,1,0,0,1,2,2023
TOS,PO,M 74,"Altre attività professionali, scientifiche e tecniche       ",11,0,0,1,12,2023
TOS,PO,M 75,Servizi veterinari                                          ,0,0,0,0,0,2023
TOS,PO,N   ,"Noleggio, agenzie di viaggio, servizi di supporto alle im...",6,0,0,1,7,2023
TOS,PO,N 77,Attività di noleggio e leasing operativo                    ,1,0,0,0,1,2023
TOS,PO,N 78,"Attività di ricerca, selezione, fornitura di personale      ",0,0,0,0,0,2023
TOS,PO,N 79,"Attività dei servizi delle agenzie di viaggio, dei tour o...",0,0,0,0,0,2023
TOS,PO,N 80,Servizi di vigilanza e investigazione                       ,1,0,0,0,1,2023
TOS,PO,N 81,Attività di servizi per edifici e paesaggio                 ,1,0,0,1,2,2023
TOS,PO,N 82,Attività di supporto per le funzioni d'ufficio e altri se...,3,0,0,0,3,2023
TOS,PO,O   ,Amministrazione pubblica e difesa; assicurazione sociale ...,0,0,0,0,0,2023
TOS,PO,O 84,Amministrazione pubblica e difesa; assicurazione sociale ...,0,0,0,0,0,2023
TOS,PO,P   ,Istruzione                                                  ,1,0,0,0,1,2023
TOS,PO,P 85,Istruzione                                                  ,1,0,0,0,1,2023
TOS,PO,Q   ,Sanita' e assistenza sociale                                ,2,0,0,1,3,2023
TOS,PO,Q 86,Assistenza sanitaria                                        ,2,0,0,0,2,2023
TOS,PO,Q 87,Servizi di assistenza sociale residenziale                  ,0,0,0,0,0,2023
TOS,PO,Q 88,Assistenza sociale non residenziale                         ,0,0,0,1,1,2023
TOS,PO,R   ,"Attività artistiche, sportive, di intrattenimento e diver...",13,0,0,1,14,2023
TOS,PO,R 90,"Attività creative, artistiche e di intrattenimento          ",5,0,0,0,5,2023
TOS,PO,R 91,"Attività di biblioteche, archivi, musei ed altre attività...",0,0,0,0,0,2023
TOS,PO,R 92,"Attività riguardanti le lotterie, le scommesse, le case d...",1,0,0,0,1,2023
TOS,PO,R 93,"Attività sportive, di intrattenimento e di divertimento     ",7,0,0,1,8,2023
TOS,PO,S   ,Altre attività di servizi                                   ,7,0,1,0,8,2023
TOS,PO,S 94,Attività di organizzazioni associative                      ,0,0,0,0,0,2023
TOS,PO,S 95,Riparazione di computer e di beni per uso personale e per...,0,0,0,0,0,2023
TOS,PO,S 96,Altre attività di servizi per la persona                    ,7,0,1,0,8,2023
TOS,PO,T   ,Attività di famiglie e convivenze come datori di lavoro p...,0,0,0,0,0,2023
TOS,PO,T 97,Attività di famiglie e convivenze come datori di lavoro p...,0,0,0,0,0,2023
TOS,PO,T 98,Produzione di beni e servizi indifferenziati per uso prop...,0,0,0,0,0,2023
TOS,PO,U   ,Organizzazioni ed organismi extraterritoriali               ,0,0,0,0,0,2023
TOS,PO,U 99,Organizzazioni ed organismi extraterritoriali               ,0,0,0,0,0,2023
TOS,PO,XX  ,Imprese non classificate                                    ,24,0,1,9,34,2023
TOS,PO,TOT ,TOTALE                                                      ,524,4,87,33,648,2023
UMB,  ,A   ,"Agricoltura, silvicoltura pesca                             ",17,20,340,0,377,2023
UMB,  ,A 01,"Coltivazioni agricole e produzione di prodotti animali, c...",17,20,338,0,375,2023
UMB,  ,A 02,Silvicoltura ed utilizzo di aree forestali                  ,0,0,2,0,2,2023
UMB,  ,A 03,Pesca e acquacoltura                                        ,0,0,0,0,0,2023
UMB,  ,B   ,Estrazione di minerali da cave e miniere                    ,0,0,0,0,0,2023
UMB,  ,B 05,Estrazione di carbone (esclusa torba)                       ,0,0,0,0,0,2023
UMB,  ,B 06,Estraz.di petrolio greggio e di gas naturale                ,0,0,0,0,0,2023
UMB,  ,B 07,Estrazione di minerali metalliferi                          ,0,0,0,0,0,2023
UMB,  ,B 08,Altre attività di estrazione di minerali da cave e miniere  ,0,0,0,0,0,2023
UMB,  ,B 09,Attività dei servizi di supporto all'estrazione             ,0,0,0,0,0,2023
UMB,  ,C   ,Attività manifatturiere                                     ,86,47,19,1,153,2023
UMB,  ,C 10,Industrie alimentari                                        ,4,10,4,0,18,2023
UMB,  ,C 11,Industria delle bevande                                     ,0,0,0,0,0,2023
UMB,  ,C 12,Industria del tabacco                                       ,0,0,0,0,0,2023
UMB,  ,C 13,Industrie tessili                                           ,4,3,0,0,7,2023
UMB,  ,C 14,Confezione di articoli di abbigliamento; confezione di ar...,24,7,2,0,33,2023
UMB,  ,C 15,Fabbricazione di articoli in pelle e simili                 ,4,0,1,0,5,2023
UMB,  ,C 16,Industria del legno e dei prodotti in legno e sughero (es...,4,2,2,0,8,2023
UMB,  ,C 17,Fabbricazione di carta e di prodotti di carta               ,1,0,0,0,1,2023
UMB,  ,C 18,Stampa e riproduzione di supporti registrati                ,3,0,0,1,4,2023
UMB,  ,C 19,Fabbricazione di coke e prodotti derivanti dalla raffinaz...,0,0,0,0,0,2023
UMB,  ,C 20,Fabbricazione di prodotti chimici                           ,2,0,0,0,2,2023
UMB,  ,C 21,Fabbricazione di prodotti farmaceutici di base e di prepa...,0,0,0,0,0,2023
UMB,  ,C 22,Fabbricazione di articoli in gomma e materie plastiche      ,5,0,0,0,5,2023
UMB,  ,C 23,Fabbricazione di altri prodotti della lavorazione di miner..,5,4,2,0,11,2023
UMB,  ,C 24,Metallurgia                                                 ,0,0,0,0,0,2023
UMB,  ,C 25,Fabbricazione di prodotti in metallo (esclusi macchinari ...,10,11,5,0,26,2023
UMB,  ,C 26,Fabbricazione di computer e prodotti di elettronica e ott...,3,0,0,0,3,2023
UMB,  ,C 27,Fabbricazione di apparecchiature elettriche ed apparecchi...,2,2,0,0,4,2023
UMB,  ,C 28,Fabbricazione di macchinari ed apparecchiature nca          ,4,3,0,0,7,2023
UMB,  ,C 29,"Fabbricazione di autoveicoli, rimorchi e semirimorchi       ",3,0,0,0,3,2023
UMB,  ,C 30,Fabbricazione di altri mezzi di trasporto                   ,0,0,0,0,0,2023
UMB,  ,C 31,Fabbricazione di mobili                                     ,4,4,2,0,10,2023
UMB,  ,C 32,Altre industrie manifatturiere                              ,2,1,1,0,4,2023
UMB,  ,C 33,"Riparazione, manutenzione ed installazione di macchine ed...",2,0,0,0,2,2023
UMB,  ,D   ,"Fornitura di energia elettrica, gas, vapore e aria condiz...",1,0,0,0,1,2023
UMB,  ,D 35,"Fornitura di energia elettrica, gas, vapore e aria condiz...",1,0,0,0,1,2023
UMB,  ,E   ,"Fornitura di acqua; reti fognarie, attività di gestione d...",0,0,0,0,0,2023
UMB,  ,E 36,"Raccolta, trattamento e fornitura di acqua                  ",0,0,0,0,0,2023
UMB,  ,E 37,Gestione delle reti fognarie                                ,0,0,0,0,0,2023
UMB,  ,E 38,"Attività di raccolta, trattamento e smaltimento dei rifiu...",0,0,0,0,0,2023
UMB,  ,E 39,Attività di risanamento e altri servizi di gestione dei r...,0,0,0,0,0,2023
UMB,  ,F   ,Costruzioni                                                 ,81,55,11,2,149,2023
UMB,  ,F 41,Costruzione di edifici                                      ,68,29,9,1,107,2023
UMB,  ,F 42,Ingegneria civile                                           ,0,2,0,0,2,2023
UMB,  ,F 43,Lavori di costruzione specializzati                         ,13,24,2,1,40,2023
UMB,  ,G   ,Commercio all'ingrosso e al dettaglio; riparazione di aut...,148,131,45,1,325,2023
UMB,  ,G 45,Commercio all'ingrosso e al dettaglio e riparazione di au...,13,7,6,0,26,2023
UMB,  ,G 46,Commercio all'ingrosso (escluso quello di autoveicoli e d...,84,42,13,1,140,2023
UMB,  ,G 47,Commercio al dettaglio (escluso quello di autoveicoli e d...,51,82,26,0,159,2023
UMB,  ,H   ,Trasporto e magazzinaggio                                   ,12,13,6,1,32,2023
UMB,  ,H 49,Trasporto terrestre e mediante condotte                     ,9,12,6,1,28,2023
UMB,  ,H 50,Trasporto marittimo e per vie d'acqua                       ,0,0,0,0,0,2023
UMB,  ,H 51,Trasporto aereo                                             ,0,0,0,0,0,2023
UMB,  ,H 52,Magazzinaggio e attività di supporto ai trasporti           ,3,0,0,0,3,2023
UMB,  ,H 53,Servizi postali e attività di corriere                      ,0,1,0,0,1,2023
UMB,  ,I   ,Attività dei servizi alloggio e ristorazione                ,35,128,8,0,171,2023
UMB,  ,I 55,Alloggio                                                    ,4,5,2,0,11,2023
UMB,  ,I 56,Attività dei servizi di ristorazione                        ,31,123,6,0,160,2023
UMB,  ,J   ,Servizi di informazione e comunicazione                     ,30,12,0,0,42,2023
UMB,  ,J 58,Attività editoriali                                         ,6,0,0,0,6,2023
UMB,  ,J 59,"Attività di produzione cinematografica, di video e di pro...",6,1,0,0,7,2023
UMB,  ,J 60,Attività di programmazione e trasmissione                   ,1,0,0,0,1,2023
UMB,  ,J 61,Telecomunicazioni                                           ,2,1,0,0,3,2023
UMB,  ,J 62,"Produzione di software, consulenza informatica e attività...",10,6,0,0,16,2023
UMB,  ,J 63,Attività dei servizi d'informazione e altri servizi infor...,5,4,0,0,9,2023
UMB,  ,K   ,Attività finanziarie e assicurative                         ,11,5,0,0,16,2023
UMB,  ,K 64,Attività di servizi finanziari (escluse le assicurazioni ...,4,0,0,0,4,2023
UMB,  ,K 65,"Assicurazioni, riassicurazioni e fondi pensione (escluse ...",1,0,0,0,1,2023
UMB,  ,K 66,Attività ausiliarie dei servizi finanziari e delle attivi...,6,5,0,0,11,2023
UMB,  ,L   ,Attivita' immobiliari                                       ,33,13,1,0,47,2023
UMB,  ,L 68,Attivita' immobiliari                                       ,33,13,1,0,47,2023
UMB,  ,M   ,"Attività professionali, scientifiche e tecniche             ",35,9,0,1,45,2023
UMB,  ,M 69,Attività legali e contabilità                               ,1,0,0,0,1,2023
UMB,  ,M 70,Attività di direzione aziendale e di consulenza gestional...,11,1,0,1,13,2023
UMB,  ,M 71,Attività degli studi di architettura e d'ingegneria; coll...,5,1,0,0,6,2023
UMB,  ,M 72,Ricerca scientifica e sviluppo                              ,2,0,0,0,2,2023
UMB,  ,M 73,Pubblicità e ricerche di mercato                            ,13,4,0,0,17,2023
UMB,  ,M 74,"Altre attività professionali, scientifiche e tecniche       ",3,3,0,0,6,2023
UMB,  ,M 75,Servizi veterinari                                          ,0,0,0,0,0,2023
UMB,  ,N   ,"Noleggio, agenzie di viaggio, servizi di supporto alle im...",33,7,0,2,42,2023
UMB,  ,N 77,Attività di noleggio e leasing operativo                    ,2,1,0,0,3,2023
UMB,  ,N 78,"Attività di ricerca, selezione, fornitura di personale      ",0,0,0,0,0,2023
UMB,  ,N 79,"Attività dei servizi delle agenzie di viaggio, dei tour o...",5,2,0,0,7,2023
UMB,  ,N 80,Servizi di vigilanza e investigazione                       ,1,0,0,0,1,2023
UMB,  ,N 81,Attività di servizi per edifici e paesaggio                 ,3,0,0,2,5,2023
UMB,  ,N 82,Attività di supporto per le funzioni d'ufficio e altri se...,22,4,0,0,26,2023
UMB,  ,O   ,Amministrazione pubblica e difesa; assicurazione sociale ...,0,0,0,0,0,2023
UMB,  ,O 84,Amministrazione pubblica e difesa; assicurazione sociale ...,0,0,0,0,0,2023
UMB,  ,P   ,Istruzione                                                  ,5,2,0,0,7,2023
UMB,  ,P 85,Istruzione                                                  ,5,2,0,0,7,2023
UMB,  ,Q   ,Sanita' e assistenza sociale                                ,3,2,0,1,6,2023
UMB,  ,Q 86,Assistenza sanitaria                                        ,2,2,0,0,4,2023
UMB,  ,Q 87,Servizi di assistenza sociale residenziale                  ,1,0,0,1,2,2023
UMB,  ,Q 88,Assistenza sociale non residenziale                         ,0,0,0,0,0,2023
UMB,  ,R   ,"Attività artistiche, sportive, di intrattenimento e diver...",24,10,0,0,34,2023
UMB,  ,R 90,"Attività creative, artistiche e di intrattenimento          ",3,1,0,0,4,2023
UMB,  ,R 91,"Attività di biblioteche, archivi, musei ed altre attività...",1,2,0,0,3,2023
UMB,  ,R 92,"Attività riguardanti le lotterie, le scommesse, le case d...",0,2,0,0,2,2023
UMB,  ,R 93,"Attività sportive, di intrattenimento e di divertimento     ",20,5,0,0,25,2023
UMB,  ,S   ,Altre attività di servizi                                   ,8,22,0,0,30,2023
UMB,  ,S 94,Attività di organizzazioni associative                      ,0,0,0,0,0,2023
UMB,  ,S 95,Riparazione di computer e di beni per uso personale e per...,2,2,0,0,4,2023
UMB,  ,S 96,Altre attività di servizi per la persona                    ,6,20,0,0,26,2023
UMB,  ,T   ,Attività di famiglie e convivenze come datori di lavoro p...,0,0,0,0,0,2023
UMB,  ,T 97,Attività di famiglie e convivenze come datori di lavoro p...,0,0,0,0,0,2023
UMB,  ,T 98,Produzione di beni e servizi indifferenziati per uso prop...,0,0,0,0,0,2023
UMB,  ,U   ,Organizzazioni ed organismi extraterritoriali               ,0,0,0,0,0,2023
UMB,  ,U 99,Organizzazioni ed organismi extraterritoriali               ,0,0,0,0,0,2023
UMB,  ,XX  ,Imprese non classificate                                    ,307,74,2,9,392,2023
UMB,  ,TOT ,TOTALE                                                      ,869,550,432,18,1869,2023
UMB,PG,A   ,"Agricoltura, silvicoltura pesca                             ",12,17,232,0,261,2023
UMB,PG,A 01,"Coltivazioni agricole e produzione di prodotti animali, c...",12,17,231,0,260,2023
UMB,PG,A 02,Silvicoltura ed utilizzo di aree forestali                  ,0,0,1,0,1,2023
UMB,PG,A 03,Pesca e acquacoltura                                        ,0,0,0,0,0,2023
UMB,PG,B   ,Estrazione di minerali da cave e miniere                    ,0,0,0,0,0,2023
UMB,PG,B 05,Estrazione di carbone (esclusa torba)                       ,0,0,0,0,0,2023
UMB,PG,B 06,Estraz.di petrolio greggio e di gas naturale                ,0,0,0,0,0,2023
UMB,PG,B 07,Estrazione di minerali metalliferi                          ,0,0,0,0,0,2023
UMB,PG,B 08,Altre attività di estrazione di minerali da cave e miniere  ,0,0,0,0,0,2023
UMB,PG,B 09,Attività dei servizi di supporto all'estrazione             ,0,0,0,0,0,2023
UMB,PG,C   ,Attività manifatturiere                                     ,64,39,16,1,120,2023
UMB,PG,C 10,Industrie alimentari                                        ,3,7,3,0,13,2023
UMB,PG,C 11,Industria delle bevande                                     ,0,0,0,0,0,2023
UMB,PG,C 12,Industria del tabacco                                       ,0,0,0,0,0,2023
UMB,PG,C 13,Industrie tessili                                           ,3,3,0,0,6,2023
UMB,PG,C 14,Confezione di articoli di abbigliamento; confezione di ar...,20,6,2,0,28,2023
UMB,PG,C 15,Fabbricazione di articoli in pelle e simili                 ,4,0,1,0,5,2023
UMB,PG,C 16,Industria del legno e dei prodotti in legno e sughero (es...,4,0,1,0,5,2023
UMB,PG,C 17,Fabbricazione di carta e di prodotti di carta               ,1,0,0,0,1,2023
UMB,PG,C 18,Stampa e riproduzione di supporti registrati                ,3,0,0,1,4,2023
UMB,PG,C 19,Fabbricazione di coke e prodotti derivanti dalla raffinaz...,0,0,0,0,0,2023
UMB,PG,C 20,Fabbricazione di prodotti chimici                           ,1,0,0,0,1,2023
UMB,PG,C 21,Fabbricazione di prodotti farmaceutici di base e di prepa...,0,0,0,0,0,2023
UMB,PG,C 22,Fabbricazione di articoli in gomma e materie plastiche      ,3,0,0,0,3,2023
UMB,PG,C 23,Fabbricazione di altri prodotti della lavorazione di miner..,4,2,2,0,8,2023
UMB,PG,C 24,Metallurgia                                                 ,0,0,0,0,0,2023
UMB,PG,C 25,Fabbricazione di prodotti in metallo (esclusi macchinari ...,4,11,5,0,20,2023
UMB,PG,C 26,Fabbricazione di computer e prodotti di elettronica e ott...,3,0,0,0,3,2023
UMB,PG,C 27,Fabbricazione di apparecchiature elettriche ed apparecchi...,1,2,0,0,3,2023
UMB,PG,C 28,Fabbricazione di macchinari ed apparecchiature nca          ,3,3,0,0,6,2023
UMB,PG,C 29,"Fabbricazione di autoveicoli, rimorchi e semirimorchi       ",3,0,0,0,3,2023
UMB,PG,C 30,Fabbricazione di altri mezzi di trasporto                   ,0,0,0,0,0,2023
UMB,PG,C 31,Fabbricazione di mobili                                     ,2,4,1,0,7,2023
UMB,PG,C 32,Altre industrie manifatturiere                              ,1,1,1,0,3,2023
UMB,PG,C 33,"Riparazione, manutenzione ed installazione di macchine ed...",1,0,0,0,1,2023
UMB,PG,D   ,"Fornitura di energia elettrica, gas, vapore e aria condiz...",1,0,0,0,1,2023
UMB,PG,D 35,"Fornitura di energia elettrica, gas, vapore e aria condiz...",1,0,0,0,1,2023
UMB,PG,E   ,"Fornitura di acqua; reti fognarie, attività di gestione d...",0,0,0,0,0,2023
UMB,PG,E 36,"Raccolta, trattamento e fornitura di acqua                  ",0,0,0,0,0,2023
UMB,PG,E 37,Gestione delle reti fognarie                                ,0,0,0,0,0,2023
UMB,PG,E 38,"Attività di raccolta, trattamento e smaltimento dei rifiu...",0,0,0,0,0,2023
UMB,PG,E 39,Attività di risanamento e altri servizi di gestione dei r...,0,0,0,0,0,2023
UMB,PG,F   ,Costruzioni                                                 ,49,41,7,2,99,2023
UMB,PG,F 41,Costruzione di edifici                                      ,42,23,6,1,72,2023
UMB,PG,F 42,Ingegneria civile                                           ,0,1,0,0,1,2023
UMB,PG,F 43,Lavori di costruzione specializzati                         ,7,17,1,1,26,2023
UMB,PG,G   ,Commercio all'ingrosso e al dettaglio; riparazione di aut...,101,102,29,1,233,2023
UMB,PG,G 45,Commercio all'ingrosso e al dettaglio e riparazione di au...,7,5,3,0,15,2023
UMB,PG,G 46,Commercio all'ingrosso (escluso quello di autoveicoli e d...,60,35,8,1,104,2023
UMB,PG,G 47,Commercio al dettaglio (escluso quello di autoveicoli e d...,34,62,18,0,114,2023
UMB,PG,H   ,Trasporto e magazzinaggio                                   ,8,9,3,1,21,2023
UMB,PG,H 49,Trasporto terrestre e mediante condotte                     ,6,9,3,1,19,2023
UMB,PG,H 50,Trasporto marittimo e per vie d'acqua                       ,0,0,0,0,0,2023
UMB,PG,H 51,Trasporto aereo                                             ,0,0,0,0,0,2023
UMB,PG,H 52,Magazzinaggio e attività di supporto ai trasporti           ,2,0,0,0,2,2023
UMB,PG,H 53,Servizi postali e attività di corriere                      ,0,0,0,0,0,2023
UMB,PG,I   ,Attività dei servizi alloggio e ristorazione                ,27,96,6,0,129,2023
UMB,PG,I 55,Alloggio                                                    ,3,5,1,0,9,2023
UMB,PG,I 56,Attività dei servizi di ristorazione                        ,24,91,5,0,120,2023
UMB,PG,J   ,Servizi di informazione e comunicazione                     ,21,9,0,0,30,2023
UMB,PG,J 58,Attività editoriali                                         ,4,0,0,0,4,2023
UMB,PG,J 59,"Attività di produzione cinematografica, di video e di pro...",3,1,0,0,4,2023
UMB,PG,J 60,Attività di programmazione e trasmissione                   ,1,0,0,0,1,2023
UMB,PG,J 61,Telecomunicazioni                                           ,2,1,0,0,3,2023
UMB,PG,J 62,"Produzione di software, consulenza informatica e attività...",8,5,0,0,13,2023
UMB,PG,J 63,Attività dei servizi d'informazione e altri servizi infor...,3,2,0,0,5,2023
UMB,PG,K   ,Attività finanziarie e assicurative                         ,7,3,0,0,10,2023
UMB,PG,K 64,Attività di servizi finanziari (escluse le assicurazioni ...,3,0,0,0,3,2023
UMB,PG,K 65,"Assicurazioni, riassicurazioni e fondi pensione (escluse ...",0,0,0,0,0,2023
UMB,PG,K 66,Attività ausiliarie dei servizi finanziari e delle attivi...,4,3,0,0,7,2023
UMB,PG,L   ,Attivita' immobiliari                                       ,21,13,1,0,35,2023
UMB,PG,L 68,Attivita' immobiliari                                       ,21,13,1,0,35,2023
UMB,PG,M   ,"Attività professionali, scientifiche e tecniche             ",27,8,0,0,35,2023
UMB,PG,M 69,Attività legali e contabilità                               ,1,0,0,0,1,2023
UMB,PG,M 70,Attività di direzione aziendale e di consulenza gestional...,8,1,0,0,9,2023
UMB,PG,M 71,Attività degli studi di architettura e d'ingegneria; coll...,5,1,0,0,6,2023
UMB,PG,M 72,Ricerca scientifica e sviluppo                              ,2,0,0,0,2,2023
UMB,PG,M 73,Pubblicità e ricerche di mercato                            ,9,4,0,0,13,2023
UMB,PG,M 74,"Altre attività professionali, scientifiche e tecniche       ",2,2,0,0,4,2023
UMB,PG,M 75,Servizi veterinari                                          ,0,0,0,0,0,2023
UMB,PG,N   ,"Noleggio, agenzie di viaggio, servizi di supporto alle im...",29,7,0,1,37,2023
UMB,PG,N 77,Attività di noleggio e leasing operativo                    ,2,1,0,0,3,2023
UMB,PG,N 78,"Attività di ricerca, selezione, fornitura di personale      ",0,0,0,0,0,2023
UMB,PG,N 79,"Attività dei servizi delle agenzie di viaggio, dei tour o...",4,2,0,0,6,2023
UMB,PG,N 80,Servizi di vigilanza e investigazione                       ,1,0,0,0,1,2023
UMB,PG,N 81,Attività di servizi per edifici e paesaggio                 ,1,0,0,1,2,2023
UMB,PG,N 82,Attività di supporto per le funzioni d'ufficio e altri se...,21,4,0,0,25,2023
UMB,PG,O   ,Amministrazione pubblica e difesa; assicurazione sociale ...,0,0,0,0,0,2023
UMB,PG,O 84,Amministrazione pubblica e difesa; assicurazione sociale ...,0,0,0,0,0,2023
UMB,PG,P   ,Istruzione                                                  ,3,2,0,0,5,2023
UMB,PG,P 85,Istruzione                                                  ,3,2,0,0,5,2023
UMB,PG,Q   ,Sanita' e assistenza sociale                                ,3,2,0,1,6,2023
UMB,PG,Q 86,Assistenza sanitaria                                        ,2,2,0,0,4,2023
UMB,PG,Q 87,Servizi di assistenza sociale residenziale                  ,1,0,0,1,2,2023
UMB,PG,Q 88,Assistenza sociale non residenziale                         ,0,0,0,0,0,2023
UMB,PG,R   ,"Attività artistiche, sportive, di intrattenimento e diver...",16,6,0,0,22,2023
UMB,PG,R 90,"Attività creative, artistiche e di intrattenimento          ",2,1,0,0,3,2023
UMB,PG,R 91,"Attività di biblioteche, archivi, musei ed altre attività...",1,0,0,0,1,2023
UMB,PG,R 92,"Attività riguardanti le lotterie, le scommesse, le case d...",0,1,0,0,1,2023
UMB,PG,R 93,"Attività sportive, di intrattenimento e di divertimento     ",13,4,0,0,17,2023
UMB,PG,S   ,Altre attività di servizi                                   ,7,14,0,0,21,2023
UMB,PG,S 94,Attività di organizzazioni associative                      ,0,0,0,0,0,2023
UMB,PG,S 95,Riparazione di computer e di beni per uso personale e per...,2,1,0,0,3,2023
UMB,PG,S 96,Altre attività di servizi per la persona                    ,5,13,0,0,18,2023
UMB,PG,T   ,Attività di famiglie e convivenze come datori di lavoro p...,0,0,0,0,0,2023
UMB,PG,T 97,Attività di famiglie e convivenze come datori di lavoro p...,0,0,0,0,0,2023
UMB,PG,T 98,Produzione di beni e servizi indifferenziati per uso prop...,0,0,0,0,0,2023
UMB,PG,U   ,Organizzazioni ed organismi extraterritoriali               ,0,0,0,0,0,2023
UMB,PG,U 99,Organizzazioni ed organismi extraterritoriali               ,0,0,0,0,0,2023
UMB,PG,XX  ,Imprese non classificate                                    ,241,65,2,6,314,2023
UMB,PG,TOT ,TOTALE                                                      ,637,433,296,13,1379,2023
UMB,TR,A   ,"Agricoltura, silvicoltura pesca                             ",5,3,108,0,116,2023
UMB,TR,A 01,"Coltivazioni agricole e produzione di prodotti animali, c...",5,3,107,0,115,2023
UMB,TR,A 02,Silvicoltura ed utilizzo di aree forestali                  ,0,0,1,0,1,2023
UMB,TR,A 03,Pesca e acquacoltura                                        ,0,0,0,0,0,2023
UMB,TR,B   ,Estrazione di minerali da cave e miniere                    ,0,0,0,0,0,2023
UMB,TR,B 05,Estrazione di carbone (esclusa torba)                       ,0,0,0,0,0,2023
UMB,TR,B 06,Estraz.di petrolio greggio e di gas naturale                ,0,0,0,0,0,2023
UMB,TR,B 07,Estrazione di minerali metalliferi                          ,0,0,0,0,0,2023
UMB,TR,B 08,Altre attività di estrazione di minerali da cave e miniere  ,0,0,0,0,0,2023
UMB,TR,B 09,Attività dei servizi di supporto all'estrazione             ,0,0,0,0,0,2023
UMB,TR,C   ,Attività manifatturiere                                     ,22,8,3,0,33,2023
UMB,TR,C 10,Industrie alimentari                                        ,1,3,1,0,5,2023
UMB,TR,C 11,Industria delle bevande                                     ,0,0,0,0,0,2023
UMB,TR,C 12,Industria del tabacco                                       ,0,0,0,0,0,2023
UMB,TR,C 13,Industrie tessili                                           ,1,0,0,0,1,2023
UMB,TR,C 14,Confezione di articoli di abbigliamento; confezione di ar...,4,1,0,0,5,2023
UMB,TR,C 15,Fabbricazione di articoli in pelle e simili                 ,0,0,0,0,0,2023
UMB,TR,C 16,Industria del legno e dei prodotti in legno e sughero (es...,0,2,1,0,3,2023
UMB,TR,C 17,Fabbricazione di carta e di prodotti di carta               ,0,0,0,0,0,2023
UMB,TR,C 18,Stampa e riproduzione di supporti registrati                ,0,0,0,0,0,2023
UMB,TR,C 19,Fabbricazione di coke e prodotti derivanti dalla raffinaz...,0,0,0,0,0,2023
UMB,TR,C 20,Fabbricazione di prodotti chimici                           ,1,0,0,0,1,2023
UMB,TR,C 21,Fabbricazione di prodotti farmaceutici di base e di prepa...,0,0,0,0,0,2023
UMB,TR,C 22,Fabbricazione di articoli in gomma e materie plastiche      ,2,0,0,0,2,2023
UMB,TR,C 23,Fabbricazione di altri prodotti della lavorazione di miner..,1,2,0,0,3,2023
UMB,TR,C 24,Metallurgia                                                 ,0,0,0,0,0,2023
UMB,TR,C 25,Fabbricazione di prodotti in metallo (esclusi macchinari ...,6,0,0,0,6,2023
UMB,TR,C 26,Fabbricazione di computer e prodotti di elettronica e ott...,0,0,0,0,0,2023
UMB,TR,C 27,Fabbricazione di apparecchiature elettriche ed apparecchi...,1,0,0,0,1,2023
UMB,TR,C 28,Fabbricazione di macchinari ed apparecchiature nca          ,1,0,0,0,1,2023
UMB,TR,C 29,"Fabbricazione di autoveicoli, rimorchi e semirimorchi       ",0,0,0,0,0,2023
UMB,TR,C 30,Fabbricazione di altri mezzi di trasporto                   ,0,0,0,0,0,2023
UMB,TR,C 31,Fabbricazione di mobili                                     ,2,0,1,0,3,2023
UMB,TR,C 32,Altre industrie manifatturiere                              ,1,0,0,0,1,2023
UMB,TR,C 33,"Riparazione, manutenzione ed installazione di macchine ed...",1,0,0,0,1,2023
UMB,TR,D   ,"Fornitura di energia elettrica, gas, vapore e aria condiz...",0,0,0,0,0,2023
UMB,TR,D 35,"Fornitura di energia elettrica, gas, vapore e aria condiz...",0,0,0,0,0,2023
UMB,TR,E   ,"Fornitura di acqua; reti fognarie, attività di gestione d...",0,0,0,0,0,2023
UMB,TR,E 36,"Raccolta, trattamento e fornitura di acqua                  ",0,0,0,0,0,2023
UMB,TR,E 37,Gestione delle reti fognarie                                ,0,0,0,0,0,2023
UMB,TR,E 38,"Attività di raccolta, trattamento e smaltimento dei rifiu...",0,0,0,0,0,2023
UMB,TR,E 39,Attività di risanamento e altri servizi di gestione dei r...,0,0,0,0,0,2023
UMB,TR,F   ,Costruzioni                                                 ,32,14,4,0,50,2023
UMB,TR,F 41,Costruzione di edifici                                      ,26,6,3,0,35,2023
UMB,TR,F 42,Ingegneria civile                                           ,0,1,0,0,1,2023
UMB,TR,F 43,Lavori di costruzione specializzati                         ,6,7,1,0,14,2023
UMB,TR,G   ,Commercio all'ingrosso e al dettaglio; riparazione di aut...,47,29,16,0,92,2023
UMB,TR,G 45,Commercio all'ingrosso e al dettaglio e riparazione di au...,6,2,3,0,11,2023
UMB,TR,G 46,Commercio all'ingrosso (escluso quello di autoveicoli e d...,24,7,5,0,36,2023
UMB,TR,G 47,Commercio al dettaglio (escluso quello di autoveicoli e d...,17,20,8,0,45,2023
UMB,TR,H   ,Trasporto e magazzinaggio                                   ,4,4,3,0,11,2023
UMB,TR,H 49,Trasporto terrestre e mediante condotte                     ,3,3,3,0,9,2023
UMB,TR,H 50,Trasporto marittimo e per vie d'acqua                       ,0,0,0,0,0,2023
UMB,TR,H 51,Trasporto aereo                                             ,0,0,0,0,0,2023
UMB,TR,H 52,Magazzinaggio e attività di supporto ai trasporti           ,1,0,0,0,1,2023
UMB,TR,H 53,Servizi postali e attività di corriere                      ,0,1,0,0,1,2023
UMB,TR,I   ,Attività dei servizi alloggio e ristorazione                ,8,32,2,0,42,2023
UMB,TR,I 55,Alloggio                                                    ,1,0,1,0,2,2023
UMB,TR,I 56,Attività dei servizi di ristorazione                        ,7,32,1,0,40,2023
UMB,TR,J   ,Servizi di informazione e comunicazione                     ,9,3,0,0,12,2023
UMB,TR,J 58,Attività editoriali                                         ,2,0,0,0,2,2023
UMB,TR,J 59,"Attività di produzione cinematografica, di video e di pro...",3,0,0,0,3,2023
UMB,TR,J 60,Attività di programmazione e trasmissione                   ,0,0,0,0,0,2023
UMB,TR,J 61,Telecomunicazioni                                           ,0,0,0,0,0,2023
UMB,TR,J 62,"Produzione di software, consulenza informatica e attività...",2,1,0,0,3,2023
UMB,TR,J 63,Attività dei servizi d'informazione e altri servizi infor...,2,2,0,0,4,2023
UMB,TR,K   ,Attività finanziarie e assicurative                         ,4,2,0,0,6,2023
UMB,TR,K 64,Attività di servizi finanziari (escluse le assicurazioni ...,1,0,0,0,1,2023
UMB,TR,K 65,"Assicurazioni, riassicurazioni e fondi pensione (escluse ...",1,0,0,0,1,2023
UMB,TR,K 66,Attività ausiliarie dei servizi finanziari e delle attivi...,2,2,0,0,4,2023
UMB,TR,L   ,Attivita' immobiliari                                       ,12,0,0,0,12,2023
UMB,TR,L 68,Attivita' immobiliari                                       ,12,0,0,0,12,2023
UMB,TR,M   ,"Attività professionali, scientifiche e tecniche             ",8,1,0,1,10,2023
UMB,TR,M 69,Attività legali e contabilità                               ,0,0,0,0,0,2023
UMB,TR,M 70,Attività di direzione aziendale e di consulenza gestional...,3,0,0,1,4,2023
UMB,TR,M 71,Attività degli studi di architettura e d'ingegneria; coll...,0,0,0,0,0,2023
UMB,TR,M 72,Ricerca scientifica e sviluppo                              ,0,0,0,0,0,2023
UMB,TR,M 73,Pubblicità e ricerche di mercato                            ,4,0,0,0,4,2023
UMB,TR,M 74,"Altre attività professionali, scientifiche e tecniche       ",1,1,0,0,2,2023
UMB,TR,M 75,Servizi veterinari                                          ,0,0,0,0,0,2023
UMB,TR,N   ,"Noleggio, agenzie di viaggio, servizi di supporto alle im...",4,0,0,1,5,2023
UMB,TR,N 77,Attività di noleggio e leasing operativo                    ,0,0,0,0,0,2023
UMB,TR,N 78,"Attività di ricerca, selezione, fornitura di personale      ",0,0,0,0,0,2023
UMB,TR,N 79,"Attività dei servizi delle agenzie di viaggio, dei tour o...",1,0,0,0,1,2023
UMB,TR,N 80,Servizi di vigilanza e investigazione                       ,0,0,0,0,0,2023
UMB,TR,N 81,Attività di servizi per edifici e paesaggio                 ,2,0,0,1,3,2023
UMB,TR,N 82,Attività di supporto per le funzioni d'ufficio e altri se...,1,0,0,0,1,2023
UMB,TR,O   ,Amministrazione pubblica e difesa; assicurazione sociale ...,0,0,0,0,0,2023
UMB,TR,O 84,Amministrazione pubblica e difesa; assicurazione sociale ...,0,0,0,0,0,2023
UMB,TR,P   ,Istruzione                                                  ,2,0,0,0,2,2023
UMB,TR,P 85,Istruzione                                                  ,2,0,0,0,2,2023
UMB,TR,Q   ,Sanita' e assistenza sociale                                ,0,0,0,0,0,2023
UMB,TR,Q 86,Assistenza sanitaria                                        ,0,0,0,0,0,2023
UMB,TR,Q 87,Servizi di assistenza sociale residenziale                  ,0,0,0,0,0,2023
UMB,TR,Q 88,Assistenza sociale non residenziale                         ,0,0,0,0,0,2023
UMB,TR,R   ,"Attività artistiche, sportive, di intrattenimento e diver...",8,4,0,0,12,2023
UMB,TR,R 90,"Attività creative, artistiche e di intrattenimento          ",1,0,0,0,1,2023
UMB,TR,R 91,"Attività di biblioteche, archivi, musei ed altre attività...",0,2,0,0,2,2023
UMB,TR,R 92,"Attività riguardanti le lotterie, le scommesse, le case d...",0,1,0,0,1,2023
UMB,TR,R 93,"Attività sportive, di intrattenimento e di divertimento     ",7,1,0,0,8,2023
UMB,TR,S   ,Altre attività di servizi                                   ,1,8,0,0,9,2023
UMB,TR,S 94,Attività di organizzazioni associative                      ,0,0,0,0,0,2023
UMB,TR,S 95,Riparazione di computer e di beni per uso personale e per...,0,1,0,0,1,2023
UMB,TR,S 96,Altre attività di servizi per la persona                    ,1,7,0,0,8,2023
UMB,TR,T   ,Attività di famiglie e convivenze come datori di lavoro p...,0,0,0,0,0,2023
UMB,TR,T 97,Attività di famiglie e convivenze come datori di lavoro p...,0,0,0,0,0,2023
UMB,TR,T 98,Produzione di beni e servizi indifferenziati per uso prop...,0,0,0,0,0,2023
UMB,TR,U   ,Organizzazioni ed organismi extraterritoriali               ,0,0,0,0,0,2023
UMB,TR,U 99,Organizzazioni ed organismi extraterritoriali               ,0,0,0,0,0,2023
UMB,TR,XX  ,Imprese non classificate                                    ,66,9,0,3,78,2023
UMB,TR,TOT ,TOTALE                                                      ,232,117,136,5,490,2023
MAR,  ,A   ,"Agricoltura, silvicoltura pesca                             ",2,14,816,4,836,2023
MAR,  ,A 01,"Coltivazioni agricole e produzione di prodotti animali, c...",1,13,787,1,802,2023
MAR,  ,A 02,Silvicoltura ed utilizzo di aree forestali                  ,0,1,11,2,14,2023
MAR,  ,A 03,Pesca e acquacoltura                                        ,1,0,18,1,20,2023
MAR,  ,B   ,Estrazione di minerali da cave e miniere                    ,0,0,0,0,0,2023
MAR,  ,B 05,Estrazione di carbone (esclusa torba)                       ,0,0,0,0,0,2023
MAR,  ,B 06,Estraz.di petrolio greggio e di gas naturale                ,0,0,0,0,0,2023
MAR,  ,B 07,Estrazione di minerali metalliferi                          ,0,0,0,0,0,2023
MAR,  ,B 08,Altre attività di estrazione di minerali da cave e miniere  ,0,0,0,0,0,2023
MAR,  ,B 09,Attività dei servizi di supporto all'estrazione             ,0,0,0,0,0,2023
MAR,  ,C   ,Attività manifatturiere                                     ,53,48,403,1,505,2023
MAR,  ,C 10,Industrie alimentari                                        ,2,3,11,0,16,2023
MAR,  ,C 11,Industria delle bevande                                     ,0,0,0,0,0,2023
MAR,  ,C 12,Industria del tabacco                                       ,0,0,0,0,0,2023
MAR,  ,C 13,Industrie tessili                                           ,0,0,12,0,12,2023
MAR,  ,C 14,Confezione di articoli di abbigliamento; confezione di ar...,10,6,153,0,169,2023
MAR,  ,C 15,Fabbricazione di articoli in pelle e simili                 ,11,11,54,0,76,2023
MAR,  ,C 16,Industria del legno e dei prodotti in legno e sughero (es...,0,3,19,0,22,2023
MAR,  ,C 17,Fabbricazione di carta e di prodotti di carta               ,1,1,1,0,3,2023
MAR,  ,C 18,Stampa e riproduzione di supporti registrati                ,0,1,4,0,5,2023
MAR,  ,C 19,Fabbricazione di coke e prodotti derivanti dalla raffinaz...,0,0,0,0,0,2023
MAR,  ,C 20,Fabbricazione di prodotti chimici                           ,1,1,1,0,3,2023
MAR,  ,C 21,Fabbricazione di prodotti farmaceutici di base e di prepa...,0,0,0,0,0,2023
MAR,  ,C 22,Fabbricazione di articoli in gomma e materie plastiche      ,4,2,5,0,11,2023
MAR,  ,C 23,Fabbricazione di altri prodotti della lavorazione di miner..,2,1,4,0,7,2023
MAR,  ,C 24,Metallurgia                                                 ,1,0,1,0,2,2023
MAR,  ,C 25,Fabbricazione di prodotti in metallo (esclusi macchinari ...,7,5,51,0,63,2023
MAR,  ,C 26,Fabbricazione di computer e prodotti di elettronica e ott...,1,1,5,0,7,2023
MAR,  ,C 27,Fabbricazione di apparecchiature elettriche ed apparecchi...,2,1,7,0,10,2023
MAR,  ,C 28,Fabbricazione di macchinari ed apparecchiature nca          ,4,2,5,0,11,2023
MAR,  ,C 29,"Fabbricazione di autoveicoli, rimorchi e semirimorchi       ",1,1,0,0,2,2023
MAR,  ,C 30,Fabbricazione di altri mezzi di trasporto                   ,1,1,10,0,12,2023
MAR,  ,C 31,Fabbricazione di mobili                                     ,1,4,17,0,22,2023
MAR,  ,C 32,Altre industrie manifatturiere                              ,3,4,20,1,28,2023
MAR,  ,C 33,"Riparazione, manutenzione ed installazione di macchine ed...",1,0,23,0,24,2023
MAR,  ,D   ,"Fornitura di energia elettrica, gas, vapore e aria condiz...",0,0,5,0,5,2023
MAR,  ,D 35,"Fornitura di energia elettrica, gas, vapore e aria condiz...",0,0,5,0,5,2023
MAR,  ,E   ,"Fornitura di acqua; reti fognarie, attività di gestione d...",0,0,3,0,3,2023
MAR,  ,E 36,"Raccolta, trattamento e fornitura di acqua                  ",0,0,0,0,0,2023
MAR,  ,E 37,Gestione delle reti fognarie                                ,0,0,0,0,0,2023
MAR,  ,E 38,"Attività di raccolta, trattamento e smaltimento dei rifiu...",0,0,3,0,3,2023
MAR,  ,E 39,Attività di risanamento e altri servizi di gestione dei r...,0,0,0,0,0,2023
MAR,  ,F   ,Costruzioni                                                 ,49,40,760,3,852,2023
MAR,  ,F 41,Costruzione di edifici                                      ,41,21,130,2,194,2023
MAR,  ,F 42,Ingegneria civile                                           ,1,1,1,0,3,2023
MAR,  ,F 43,Lavori di costruzione specializzati                         ,7,18,629,1,655,2023
MAR,  ,G   ,Commercio all'ingrosso e al dettaglio; riparazione di aut...,69,93,1133,4,1299,2023
MAR,  ,G 45,Commercio all'ingrosso e al dettaglio e riparazione di au...,7,7,132,0,146,2023
MAR,  ,G 46,Commercio all'ingrosso (escluso quello di autoveicoli e d...,38,34,282,2,356,2023
MAR,  ,G 47,Commercio al dettaglio (escluso quello di autoveicoli e d...,24,52,719,2,797,2023
MAR,  ,H   ,Trasporto e magazzinaggio                                   ,6,6,89,8,109,2023
MAR,  ,H 49,Trasporto terrestre e mediante condotte                     ,4,6,73,3,86,2023
MAR,  ,H 50,Trasporto marittimo e per vie d'acqua                       ,0,0,0,0,0,2023
MAR,  ,H 51,Trasporto aereo                                             ,0,0,0,0,0,2023
MAR,  ,H 52,Magazzinaggio e attività di supporto ai trasporti           ,2,0,11,5,18,2023
MAR,  ,H 53,Servizi postali e attività di corriere                      ,0,0,5,0,5,2023
MAR,  ,I   ,Attività dei servizi alloggio e ristorazione                ,14,71,222,1,308,2023
MAR,  ,I 55,Alloggio                                                    ,1,3,13,0,17,2023
MAR,  ,I 56,Attività dei servizi di ristorazione                        ,13,68,209,1,291,2023
MAR,  ,J   ,Servizi di informazione e comunicazione                     ,6,3,42,0,51,2023
MAR,  ,J 58,Attività editoriali                                         ,1,0,7,0,8,2023
MAR,  ,J 59,"Attività di produzione cinematografica, di video e di pro...",2,1,7,0,10,2023
MAR,  ,J 60,Attività di programmazione e trasmissione                   ,1,0,0,0,1,2023
MAR,  ,J 61,Telecomunicazioni                                           ,0,0,9,0,9,2023
MAR,  ,J 62,"Produzione di software, consulenza informatica e attività...",0,0,7,0,7,2023
MAR,  ,J 63,Attività dei servizi d'informazione e altri servizi infor...,2,2,12,0,16,2023
MAR,  ,K   ,Attività finanziarie e assicurative                         ,2,3,73,0,78,2023
MAR,  ,K 64,Attività di servizi finanziari (escluse le assicurazioni ...,1,0,0,0,1,2023
MAR,  ,K 65,"Assicurazioni, riassicurazioni e fondi pensione (escluse ...",0,0,0,0,0,2023
MAR,  ,K 66,Attività ausiliarie dei servizi finanziari e delle attivi...,1,3,73,0,77,2023
MAR,  ,L   ,Attivita' immobiliari                                       ,14,11,30,0,55,2023
MAR,  ,L 68,Attivita' immobiliari                                       ,14,11,30,0,55,2023
MAR,  ,M   ,"Attività professionali, scientifiche e tecniche             ",13,3,83,2,101,2023
MAR,  ,M 69,Attività legali e contabilità                               ,0,0,0,0,0,2023
MAR,  ,M 70,Attività di direzione aziendale e di consulenza gestional...,5,1,12,1,19,2023
MAR,  ,M 71,Attività degli studi di architettura e d'ingegneria; coll...,0,0,3,0,3,2023
MAR,  ,M 72,Ricerca scientifica e sviluppo                              ,1,0,0,0,1,2023
MAR,  ,M 73,Pubblicità e ricerche di mercato                            ,5,1,28,1,35,2023
MAR,  ,M 74,"Altre attività professionali, scientifiche e tecniche       ",2,1,39,0,42,2023
MAR,  ,M 75,Servizi veterinari                                          ,0,0,1,0,1,2023
MAR,  ,N   ,"Noleggio, agenzie di viaggio, servizi di supporto alle im...",10,8,134,5,157,2023
MAR,  ,N 77,Attività di noleggio e leasing operativo                    ,2,0,6,0,8,2023
MAR,  ,N 78,"Attività di ricerca, selezione, fornitura di personale      ",0,0,0,0,0,2023
MAR,  ,N 79,"Attività dei servizi delle agenzie di viaggio, dei tour o...",3,1,4,0,8,2023
MAR,  ,N 80,Servizi di vigilanza e investigazione                       ,0,0,2,0,2,2023
MAR,  ,N 81,Attività di servizi per edifici e paesaggio                 ,3,3,78,3,87,2023
MAR,  ,N 82,Attività di supporto per le funzioni d'ufficio e altri se...,2,4,44,2,52,2023
MAR,  ,O   ,Amministrazione pubblica e difesa; assicurazione sociale ...,0,0,0,0,0,2023
MAR,  ,O 84,Amministrazione pubblica e difesa; assicurazione sociale ...,0,0,0,0,0,2023
MAR,  ,P   ,Istruzione                                                  ,2,0,4,0,6,2023
MAR,  ,P 85,Istruzione                                                  ,2,0,4,0,6,2023
MAR,  ,Q   ,Sanita' e assistenza sociale                                ,0,0,12,2,14,2023
MAR,  ,Q 86,Assistenza sanitaria                                        ,0,0,0,0,0,2023
MAR,  ,Q 87,Servizi di assistenza sociale residenziale                  ,0,0,0,0,0,2023
MAR,  ,Q 88,Assistenza sociale non residenziale                         ,0,0,12,2,14,2023
MAR,  ,R   ,"Attività artistiche, sportive, di intrattenimento e diver...",10,7,38,0,55,2023
MAR,  ,R 90,"Attività creative, artistiche e di intrattenimento          ",0,3,7,0,10,2023
MAR,  ,R 91,"Attività di biblioteche, archivi, musei ed altre attività...",0,0,0,0,0,2023
MAR,  ,R 92,"Attività riguardanti le lotterie, le scommesse, le case d...",0,0,3,0,3,2023
MAR,  ,R 93,"Attività sportive, di intrattenimento e di divertimento     ",10,4,28,0,42,2023
MAR,  ,S   ,Altre attività di servizi                                   ,2,8,88,0,98,2023
MAR,  ,S 94,Attività di organizzazioni associative                      ,0,0,0,0,0,2023
MAR,  ,S 95,Riparazione di computer e di beni per uso personale e per...,2,0,28,0,30,2023
MAR,  ,S 96,Altre attività di servizi per la persona                    ,0,8,60,0,68,2023
MAR,  ,T   ,Attività di famiglie e convivenze come datori di lavoro p...,0,0,0,0,0,2023
MAR,  ,T 97,Attività di famiglie e convivenze come datori di lavoro p...,0,0,0,0,0,2023
MAR,  ,T 98,Produzione di beni e servizi indifferenziati per uso prop...,0,0,0,0,0,2023
MAR,  ,U   ,Organizzazioni ed organismi extraterritoriali               ,0,0,0,0,0,2023
MAR,  ,U 99,Organizzazioni ed organismi extraterritoriali               ,0,0,0,0,0,2023
MAR,  ,XX  ,Imprese non classificate                                    ,91,71,171,3,336,2023
MAR,  ,TOT ,TOTALE                                                      ,343,386,4106,33,4868,2023
MAR,PS,A   ,"Agricoltura, silvicoltura pesca                             ",0,7,155,1,163,2023
MAR,PS,A 01,"Coltivazioni agricole e produzione di prodotti animali, c...",0,7,154,0,161,2023
MAR,PS,A 02,Silvicoltura ed utilizzo di aree forestali                  ,0,0,1,1,2,2023
MAR,PS,A 03,Pesca e acquacoltura                                        ,0,0,0,0,0,2023
MAR,PS,B   ,Estrazione di minerali da cave e miniere                    ,0,0,0,0,0,2023
MAR,PS,B 05,Estrazione di carbone (esclusa torba)                       ,0,0,0,0,0,2023
MAR,PS,B 06,Estraz.di petrolio greggio e di gas naturale                ,0,0,0,0,0,2023
MAR,PS,B 07,Estrazione di minerali metalliferi                          ,0,0,0,0,0,2023
MAR,PS,B 08,Altre attività di estrazione di minerali da cave e miniere  ,0,0,0,0,0,2023
MAR,PS,B 09,Attività dei servizi di supporto all'estrazione             ,0,0,0,0,0,2023
MAR,PS,C   ,Attività manifatturiere                                     ,1,16,23,0,40,2023
MAR,PS,C 10,Industrie alimentari                                        ,1,2,0,0,3,2023
MAR,PS,C 11,Industria delle bevande                                     ,0,0,0,0,0,2023
MAR,PS,C 12,Industria del tabacco                                       ,0,0,0,0,0,2023
MAR,PS,C 13,Industrie tessili                                           ,0,0,1,0,1,2023
MAR,PS,C 14,Confezione di articoli di abbigliamento; confezione di ar...,0,4,2,0,6,2023
MAR,PS,C 15,Fabbricazione di articoli in pelle e simili                 ,0,1,0,0,1,2023
MAR,PS,C 16,Industria del legno e dei prodotti in legno e sughero (es...,0,0,3,0,3,2023
MAR,PS,C 17,Fabbricazione di carta e di prodotti di carta               ,0,0,0,0,0,2023
MAR,PS,C 18,Stampa e riproduzione di supporti registrati                ,0,0,0,0,0,2023
MAR,PS,C 19,Fabbricazione di coke e prodotti derivanti dalla raffinaz...,0,0,0,0,0,2023
MAR,PS,C 20,Fabbricazione di prodotti chimici                           ,0,0,0,0,0,2023
MAR,PS,C 21,Fabbricazione di prodotti farmaceutici di base e di prepa...,0,0,0,0,0,2023
MAR,PS,C 22,Fabbricazione di articoli in gomma e materie plastiche      ,0,0,1,0,1,2023
MAR,PS,C 23,Fabbricazione di altri prodotti della lavorazione di miner..,0,0,0,0,0,2023
MAR,PS,C 24,Metallurgia                                                 ,0,0,0,0,0,2023
MAR,PS,C 25,Fabbricazione di prodotti in metallo (esclusi macchinari ...,0,0,4,0,4,2023
MAR,PS,C 26,Fabbricazione di computer e prodotti di elettronica e ott...,0,1,0,0,1,2023
MAR,PS,C 27,Fabbricazione di apparecchiature elettriche ed apparecchi...,0,0,0,0,0,2023
MAR,PS,C 28,Fabbricazione di macchinari ed apparecchiature nca          ,0,1,1,0,2,2023
MAR,PS,C 29,"Fabbricazione di autoveicoli, rimorchi e semirimorchi       ",0,0,0,0,0,2023
MAR,PS,C 30,Fabbricazione di altri mezzi di trasporto                   ,0,1,2,0,3,2023
MAR,PS,C 31,Fabbricazione di mobili                                     ,0,3,7,0,10,2023
MAR,PS,C 32,Altre industrie manifatturiere                              ,0,3,1,0,4,2023
MAR,PS,C 33,"Riparazione, manutenzione ed installazione di macchine ed...",0,0,1,0,1,2023
MAR,PS,D   ,"Fornitura di energia elettrica, gas, vapore e aria condiz...",0,0,0,0,0,2023
MAR,PS,D 35,"Fornitura di energia elettrica, gas, vapore e aria condiz...",0,0,0,0,0,2023
MAR,PS,E   ,"Fornitura di acqua; reti fognarie, attività di gestione d...",0,0,0,0,0,2023
MAR,PS,E 36,"Raccolta, trattamento e fornitura di acqua                  ",0,0,0,0,0,2023
MAR,PS,E 37,Gestione delle reti fognarie                                ,0,0,0,0,0,2023
MAR,PS,E 38,"Attività di raccolta, trattamento e smaltimento dei rifiu...",0,0,0,0,0,2023
MAR,PS,E 39,Attività di risanamento e altri servizi di gestione dei r...,0,0,0,0,0,2023
MAR,PS,F   ,Costruzioni                                                 ,0,13,23,0,36,2023
MAR,PS,F 41,Costruzione di edifici                                      ,0,5,6,0,11,2023
MAR,PS,F 42,Ingegneria civile                                           ,0,1,0,0,1,2023
MAR,PS,F 43,Lavori di costruzione specializzati                         ,0,7,17,0,24,2023
MAR,PS,G   ,Commercio all'ingrosso e al dettaglio; riparazione di aut...,1,30,51,0,82,2023
MAR,PS,G 45,Commercio all'ingrosso e al dettaglio e riparazione di au...,0,1,7,0,8,2023
MAR,PS,G 46,Commercio all'ingrosso (escluso quello di autoveicoli e d...,0,10,17,0,27,2023
MAR,PS,G 47,Commercio al dettaglio (escluso quello di autoveicoli e d...,1,19,27,0,47,2023
MAR,PS,H   ,Trasporto e magazzinaggio                                   ,0,2,10,3,15,2023
MAR,PS,H 49,Trasporto terrestre e mediante condotte                     ,0,2,10,1,13,2023
MAR,PS,H 50,Trasporto marittimo e per vie d'acqua                       ,0,0,0,0,0,2023
MAR,PS,H 51,Trasporto aereo                                             ,0,0,0,0,0,2023
MAR,PS,H 52,Magazzinaggio e attività di supporto ai trasporti           ,0,0,0,2,2,2023
MAR,PS,H 53,Servizi postali e attività di corriere                      ,0,0,0,0,0,2023
MAR,PS,I   ,Attività dei servizi alloggio e ristorazione                ,0,24,11,0,35,2023
MAR,PS,I 55,Alloggio                                                    ,0,2,3,0,5,2023
MAR,PS,I 56,Attività dei servizi di ristorazione                        ,0,22,8,0,30,2023
MAR,PS,J   ,Servizi di informazione e comunicazione                     ,0,1,0,0,1,2023
MAR,PS,J 58,Attività editoriali                                         ,0,0,0,0,0,2023
MAR,PS,J 59,"Attività di produzione cinematografica, di video e di pro...",0,1,0,0,1,2023
MAR,PS,J 60,Attività di programmazione e trasmissione                   ,0,0,0,0,0,2023
MAR,PS,J 61,Telecomunicazioni                                           ,0,0,0,0,0,2023
MAR,PS,J 62,"Produzione di software, consulenza informatica e attività...",0,0,0,0,0,2023
MAR,PS,J 63,Attività dei servizi d'informazione e altri servizi infor...,0,0,0,0,0,2023
MAR,PS,K   ,Attività finanziarie e assicurative                         ,0,2,3,0,5,2023
MAR,PS,K 64,Attività di servizi finanziari (escluse le assicurazioni ...,0,0,0,0,0,2023
MAR,PS,K 65,"Assicurazioni, riassicurazioni e fondi pensione (escluse ...",0,0,0,0,0,2023
MAR,PS,K 66,Attività ausiliarie dei servizi finanziari e delle attivi...,0,2,3,0,5,2023
MAR,PS,L   ,Attivita' immobiliari                                       ,1,2,3,0,6,2023
MAR,PS,L 68,Attivita' immobiliari                                       ,1,2,3,0,6,2023
MAR,PS,M   ,"Attività professionali, scientifiche e tecniche             ",0,0,1,0,1,2023
MAR,PS,M 69,Attività legali e contabilità                               ,0,0,0,0,0,2023
MAR,PS,M 70,Attività di direzione aziendale e di consulenza gestional...,0,0,0,0,0,2023
MAR,PS,M 71,Attività degli studi di architettura e d'ingegneria; coll...,0,0,0,0,0,2023
MAR,PS,M 72,Ricerca scientifica e sviluppo                              ,0,0,0,0,0,2023
MAR,PS,M 73,Pubblicità e ricerche di mercato                            ,0,0,0,0,0,2023
MAR,PS,M 74,"Altre attività professionali, scientifiche e tecniche       ",0,0,1,0,1,2023
MAR,PS,M 75,Servizi veterinari                                          ,0,0,0,0,0,2023
MAR,PS,N   ,"Noleggio, agenzie di viaggio, servizi di supporto alle im...",0,2,1,0,3,2023
MAR,PS,N 77,Attività di noleggio e leasing operativo                    ,0,0,0,0,0,2023
MAR,PS,N 78,"Attività di ricerca, selezione, fornitura di personale      ",0,0,0,0,0,2023
MAR,PS,N 79,"Attività dei servizi delle agenzie di viaggio, dei tour o...",0,0,0,0,0,2023
MAR,PS,N 80,Servizi di vigilanza e investigazione                       ,0,0,0,0,0,2023
MAR,PS,N 81,Attività di servizi per edifici e paesaggio                 ,0,1,1,0,2,2023
MAR,PS,N 82,Attività di supporto per le funzioni d'ufficio e altri se...,0,1,0,0,1,2023
MAR,PS,O   ,Amministrazione pubblica e difesa; assicurazione sociale ...,0,0,0,0,0,2023
MAR,PS,O 84,Amministrazione pubblica e difesa; assicurazione sociale ...,0,0,0,0,0,2023
MAR,PS,P   ,Istruzione                                                  ,0,0,0,0,0,2023
MAR,PS,P 85,Istruzione                                                  ,0,0,0,0,0,2023
MAR,PS,Q   ,Sanita' e assistenza sociale                                ,0,0,0,0,0,2023
MAR,PS,Q 86,Assistenza sanitaria                                        ,0,0,0,0,0,2023
MAR,PS,Q 87,Servizi di assistenza sociale residenziale                  ,0,0,0,0,0,2023
MAR,PS,Q 88,Assistenza sociale non residenziale                         ,0,0,0,0,0,2023
MAR,PS,R   ,"Attività artistiche, sportive, di intrattenimento e diver...",0,3,0,0,3,2023
MAR,PS,R 90,"Attività creative, artistiche e di intrattenimento          ",0,1,0,0,1,2023
MAR,PS,R 91,"Attività di biblioteche, archivi, musei ed altre attività...",0,0,0,0,0,2023
MAR,PS,R 92,"Attività riguardanti le lotterie, le scommesse, le case d...",0,0,0,0,0,2023
MAR,PS,R 93,"Attività sportive, di intrattenimento e di divertimento     ",0,2,0,0,2,2023
MAR,PS,S   ,Altre attività di servizi                                   ,1,4,5,0,10,2023
MAR,PS,S 94,Attività di organizzazioni associative                      ,0,0,0,0,0,2023
MAR,PS,S 95,Riparazione di computer e di beni per uso personale e per...,1,0,3,0,4,2023
MAR,PS,S 96,Altre attività di servizi per la persona                    ,0,4,2,0,6,2023
MAR,PS,T   ,Attività di famiglie e convivenze come datori di lavoro p...,0,0,0,0,0,2023
MAR,PS,T 97,Attività di famiglie e convivenze come datori di lavoro p...,0,0,0,0,0,2023
MAR,PS,T 98,Produzione di beni e servizi indifferenziati per uso prop...,0,0,0,0,0,2023
MAR,PS,U   ,Organizzazioni ed organismi extraterritoriali               ,0,0,0,0,0,2023
MAR,PS,U 99,Organizzazioni ed organismi extraterritoriali               ,0,0,0,0,0,2023
MAR,PS,XX  ,Imprese non classificate                                    ,0,35,3,1,39,2023
MAR,PS,TOT ,TOTALE                                                      ,4,141,289,5,439,2023
MAR,AN,A   ,"Agricoltura, silvicoltura pesca                             ",0,6,397,1,404,2023
MAR,AN,A 01,"Coltivazioni agricole e produzione di prodotti animali, c...",0,5,381,0,386,2023
MAR,AN,A 02,Silvicoltura ed utilizzo di aree forestali                  ,0,1,2,1,4,2023
MAR,AN,A 03,Pesca e acquacoltura                                        ,0,0,14,0,14,2023
MAR,AN,B   ,Estrazione di minerali da cave e miniere                    ,0,0,0,0,0,2023
MAR,AN,B 05,Estrazione di carbone (esclusa torba)                       ,0,0,0,0,0,2023
MAR,AN,B 06,Estraz.di petrolio greggio e di gas naturale                ,0,0,0,0,0,2023
MAR,AN,B 07,Estrazione di minerali metalliferi                          ,0,0,0,0,0,2023
MAR,AN,B 08,Altre attività di estrazione di minerali da cave e miniere  ,0,0,0,0,0,2023
MAR,AN,B 09,Attività dei servizi di supporto all'estrazione             ,0,0,0,0,0,2023
MAR,AN,C   ,Attività manifatturiere                                     ,5,15,195,0,215,2023
MAR,AN,C 10,Industrie alimentari                                        ,0,1,7,0,8,2023
MAR,AN,C 11,Industria delle bevande                                     ,0,0,0,0,0,2023
MAR,AN,C 12,Industria del tabacco                                       ,0,0,0,0,0,2023
MAR,AN,C 13,Industrie tessili                                           ,0,0,4,0,4,2023
MAR,AN,C 14,Confezione di articoli di abbigliamento; confezione di ar...,0,2,85,0,87,2023
MAR,AN,C 15,Fabbricazione di articoli in pelle e simili                 ,0,0,6,0,6,2023
MAR,AN,C 16,Industria del legno e dei prodotti in legno e sughero (es...,0,2,7,0,9,2023
MAR,AN,C 17,Fabbricazione di carta e di prodotti di carta               ,0,0,1,0,1,2023
MAR,AN,C 18,Stampa e riproduzione di supporti registrati                ,0,1,3,0,4,2023
MAR,AN,C 19,Fabbricazione di coke e prodotti derivanti dalla raffinaz...,0,0,0,0,0,2023
MAR,AN,C 20,Fabbricazione di prodotti chimici                           ,0,1,1,0,2,2023
MAR,AN,C 21,Fabbricazione di prodotti farmaceutici di base e di prepa...,0,0,0,0,0,2023
MAR,AN,C 22,Fabbricazione di articoli in gomma e materie plastiche      ,1,0,1,0,2,2023
MAR,AN,C 23,Fabbricazione di altri prodotti della lavorazione di miner..,1,1,2,0,4,2023
MAR,AN,C 24,Metallurgia                                                 ,0,0,1,0,1,2023
MAR,AN,C 25,Fabbricazione di prodotti in metallo (esclusi macchinari ...,1,2,26,0,29,2023
MAR,AN,C 26,Fabbricazione di computer e prodotti di elettronica e ott...,0,0,4,0,4,2023
MAR,AN,C 27,Fabbricazione di apparecchiature elettriche ed apparecchi...,1,1,4,0,6,2023
MAR,AN,C 28,Fabbricazione di macchinari ed apparecchiature nca          ,0,1,1,0,2,2023
MAR,AN,C 29,"Fabbricazione di autoveicoli, rimorchi e semirimorchi       ",0,1,0,0,1,2023
MAR,AN,C 30,Fabbricazione di altri mezzi di trasporto                   ,0,0,7,0,7,2023
MAR,AN,C 31,Fabbricazione di mobili                                     ,0,1,6,0,7,2023
MAR,AN,C 32,Altre industrie manifatturiere                              ,1,1,15,0,17,2023
MAR,AN,C 33,"Riparazione, manutenzione ed installazione di macchine ed...",0,0,14,0,14,2023
MAR,AN,D   ,"Fornitura di energia elettrica, gas, vapore e aria condiz...",0,0,4,0,4,2023
MAR,AN,D 35,"Fornitura di energia elettrica, gas, vapore e aria condiz...",0,0,4,0,4,2023
MAR,AN,E   ,"Fornitura di acqua; reti fognarie, attività di gestione d...",0,0,1,0,1,2023
MAR,AN,E 36,"Raccolta, trattamento e fornitura di acqua                  ",0,0,0,0,0,2023
MAR,AN,E 37,Gestione delle reti fognarie                                ,0,0,0,0,0,2023
MAR,AN,E 38,"Attività di raccolta, trattamento e smaltimento dei rifiu...",0,0,1,0,1,2023
MAR,AN,E 39,Attività di risanamento e altri servizi di gestione dei r...,0,0,0,0,0,2023
MAR,AN,F   ,Costruzioni                                                 ,1,22,438,3,464,2023
MAR,AN,F 41,Costruzione di edifici                                      ,1,12,69,2,84,2023
MAR,AN,F 42,Ingegneria civile                                           ,0,0,1,0,1,2023
MAR,AN,F 43,Lavori di costruzione specializzati                         ,0,10,368,1,379,2023
MAR,AN,G   ,Commercio all'ingrosso e al dettaglio; riparazione di aut...,2,45,626,1,674,2023
MAR,AN,G 45,Commercio all'ingrosso e al dettaglio e riparazione di au...,0,6,72,0,78,2023
MAR,AN,G 46,Commercio all'ingrosso (escluso quello di autoveicoli e d...,1,14,155,1,171,2023
MAR,AN,G 47,Commercio al dettaglio (escluso quello di autoveicoli e d...,1,25,399,0,425,2023
MAR,AN,H   ,Trasporto e magazzinaggio                                   ,0,1,48,3,52,2023
MAR,AN,H 49,Trasporto terrestre e mediante condotte                     ,0,1,35,0,36,2023
MAR,AN,H 50,Trasporto marittimo e per vie d'acqua                       ,0,0,0,0,0,2023
MAR,AN,H 51,Trasporto aereo                                             ,0,0,0,0,0,2023
MAR,AN,H 52,Magazzinaggio e attività di supporto ai trasporti           ,0,0,8,3,11,2023
MAR,AN,H 53,Servizi postali e attività di corriere                      ,0,0,5,0,5,2023
MAR,AN,I   ,Attività dei servizi alloggio e ristorazione                ,0,32,106,0,138,2023
MAR,AN,I 55,Alloggio                                                    ,0,1,4,0,5,2023
MAR,AN,I 56,Attività dei servizi di ristorazione                        ,0,31,102,0,133,2023
MAR,AN,J   ,Servizi di informazione e comunicazione                     ,1,2,17,0,20,2023
MAR,AN,J 58,Attività editoriali                                         ,0,0,1,0,1,2023
MAR,AN,J 59,"Attività di produzione cinematografica, di video e di pro...",0,0,1,0,1,2023
MAR,AN,J 60,Attività di programmazione e trasmissione                   ,0,0,0,0,0,2023
MAR,AN,J 61,Telecomunicazioni                                           ,0,0,6,0,6,2023
MAR,AN,J 62,"Produzione di software, consulenza informatica e attività...",0,0,5,0,5,2023
MAR,AN,J 63,Attività dei servizi d'informazione e altri servizi infor...,1,2,4,0,7,2023
MAR,AN,K   ,Attività finanziarie e assicurative                         ,0,1,41,0,42,2023
MAR,AN,K 64,Attività di servizi finanziari (escluse le assicurazioni ...,0,0,0,0,0,2023
MAR,AN,K 65,"Assicurazioni, riassicurazioni e fondi pensione (escluse ...",0,0,0,0,0,2023
MAR,AN,K 66,Attività ausiliarie dei servizi finanziari e delle attivi...,0,1,41,0,42,2023
MAR,AN,L   ,Attivita' immobiliari                                       ,0,9,22,0,31,2023
MAR,AN,L 68,Attivita' immobiliari                                       ,0,9,22,0,31,2023
MAR,AN,M   ,"Attività professionali, scientifiche e tecniche             ",0,2,43,1,46,2023
MAR,AN,M 69,Attività legali e contabilità                               ,0,0,0,0,0,2023
MAR,AN,M 70,Attività di direzione aziendale e di consulenza gestional...,0,1,7,0,8,2023
MAR,AN,M 71,Attività degli studi di architettura e d'ingegneria; coll...,0,0,2,0,2,2023
MAR,AN,M 72,Ricerca scientifica e sviluppo                              ,0,0,0,0,0,2023
MAR,AN,M 73,Pubblicità e ricerche di mercato                            ,0,1,15,1,17,2023
MAR,AN,M 74,"Altre attività professionali, scientifiche e tecniche       ",0,0,18,0,18,2023
MAR,AN,M 75,Servizi veterinari                                          ,0,0,1,0,1,2023
MAR,AN,N   ,"Noleggio, agenzie di viaggio, servizi di supporto alle im...",0,5,75,3,83,2023
MAR,AN,N 77,Attività di noleggio e leasing operativo                    ,0,0,2,0,2,2023
MAR,AN,N 78,"Attività di ricerca, selezione, fornitura di personale      ",0,0,0,0,0,2023
MAR,AN,N 79,"Attività dei servizi delle agenzie di viaggio, dei tour o...",0,1,3,0,4,2023
MAR,AN,N 80,Servizi di vigilanza e investigazione                       ,0,0,0,0,0,2023
MAR,AN,N 81,Attività di servizi per edifici e paesaggio                 ,0,2,48,1,51,2023
MAR,AN,N 82,Attività di supporto per le funzioni d'ufficio e altri se...,0,2,22,2,26,2023
MAR,AN,O   ,Amministrazione pubblica e difesa; assicurazione sociale ...,0,0,0,0,0,2023
MAR,AN,O 84,Amministrazione pubblica e difesa; assicurazione sociale ...,0,0,0,0,0,2023
MAR,AN,P   ,Istruzione                                                  ,0,0,1,0,1,2023
MAR,AN,P 85,Istruzione                                                  ,0,0,1,0,1,2023
MAR,AN,Q   ,Sanita' e assistenza sociale                                ,0,0,10,1,11,2023
MAR,AN,Q 86,Assistenza sanitaria                                        ,0,0,0,0,0,2023
MAR,AN,Q 87,Servizi di assistenza sociale residenziale                  ,0,0,0,0,0,2023
MAR,AN,Q 88,Assistenza sociale non residenziale                         ,0,0,10,1,11,2023
MAR,AN,R   ,"Attività artistiche, sportive, di intrattenimento e diver...",1,1,21,0,23,2023
MAR,AN,R 90,"Attività creative, artistiche e di intrattenimento          ",0,1,3,0,4,2023
MAR,AN,R 91,"Attività di biblioteche, archivi, musei ed altre attività...",0,0,0,0,0,2023
MAR,AN,R 92,"Attività riguardanti le lotterie, le scommesse, le case d...",0,0,1,0,1,2023
MAR,AN,R 93,"Attività sportive, di intrattenimento e di divertimento     ",1,0,17,0,18,2023
MAR,AN,S   ,Altre attività di servizi                                   ,0,3,46,0,49,2023
MAR,AN,S 94,Attività di organizzazioni associative                      ,0,0,0,0,0,2023
MAR,AN,S 95,Riparazione di computer e di beni per uso personale e per...,0,0,10,0,10,2023
MAR,AN,S 96,Altre attività di servizi per la persona                    ,0,3,36,0,39,2023
MAR,AN,T   ,Attività di famiglie e convivenze come datori di lavoro p...,0,0,0,0,0,2023
MAR,AN,T 97,Attività di famiglie e convivenze come datori di lavoro p...,0,0,0,0,0,2023
MAR,AN,T 98,Produzione di beni e servizi indifferenziati per uso prop...,0,0,0,0,0,2023
MAR,AN,U   ,Organizzazioni ed organismi extraterritoriali               ,0,0,0,0,0,2023
MAR,AN,U 99,Organizzazioni ed organismi extraterritoriali               ,0,0,0,0,0,2023
MAR,AN,XX  ,Imprese non classificate                                    ,0,32,125,0,157,2023
MAR,AN,TOT ,TOTALE                                                      ,10,176,2216,13,2415,2023
MAR,MC,A   ,"Agricoltura, silvicoltura pesca                             ",0,0,31,2,33,2023
MAR,MC,A 01,"Coltivazioni agricole e produzione di prodotti animali, c...",0,0,30,1,31,2023
MAR,MC,A 02,Silvicoltura ed utilizzo di aree forestali                  ,0,0,1,0,1,2023
MAR,MC,A 03,Pesca e acquacoltura                                        ,0,0,0,1,1,2023
MAR,MC,B   ,Estrazione di minerali da cave e miniere                    ,0,0,0,0,0,2023
MAR,MC,B 05,Estrazione di carbone (esclusa torba)                       ,0,0,0,0,0,2023
MAR,MC,B 06,Estraz.di petrolio greggio e di gas naturale                ,0,0,0,0,0,2023
MAR,MC,B 07,Estrazione di minerali metalliferi                          ,0,0,0,0,0,2023
MAR,MC,B 08,Altre attività di estrazione di minerali da cave e miniere  ,0,0,0,0,0,2023
MAR,MC,B 09,Attività dei servizi di supporto all'estrazione             ,0,0,0,0,0,2023
MAR,MC,C   ,Attività manifatturiere                                     ,16,6,29,0,51,2023
MAR,MC,C 10,Industrie alimentari                                        ,1,0,0,0,1,2023
MAR,MC,C 11,Industria delle bevande                                     ,0,0,0,0,0,2023
MAR,MC,C 12,Industria del tabacco                                       ,0,0,0,0,0,2023
MAR,MC,C 13,Industrie tessili                                           ,0,0,0,0,0,2023
MAR,MC,C 14,Confezione di articoli di abbigliamento; confezione di ar...,3,0,7,0,10,2023
MAR,MC,C 15,Fabbricazione di articoli in pelle e simili                 ,7,1,13,0,21,2023
MAR,MC,C 16,Industria del legno e dei prodotti in legno e sughero (es...,0,1,0,0,1,2023
MAR,MC,C 17,Fabbricazione di carta e di prodotti di carta               ,1,0,0,0,1,2023
MAR,MC,C 18,Stampa e riproduzione di supporti registrati                ,0,0,0,0,0,2023
MAR,MC,C 19,Fabbricazione di coke e prodotti derivanti dalla raffinaz...,0,0,0,0,0,2023
MAR,MC,C 20,Fabbricazione di prodotti chimici                           ,0,0,0,0,0,2023
MAR,MC,C 21,Fabbricazione di prodotti farmaceutici di base e di prepa...,0,0,0,0,0,2023
MAR,MC,C 22,Fabbricazione di articoli in gomma e materie plastiche      ,1,1,1,0,3,2023
MAR,MC,C 23,Fabbricazione di altri prodotti della lavorazione di miner..,0,0,0,0,0,2023
MAR,MC,C 24,Metallurgia                                                 ,0,0,0,0,0,2023
MAR,MC,C 25,Fabbricazione di prodotti in metallo (esclusi macchinari ...,0,3,3,0,6,2023
MAR,MC,C 26,Fabbricazione di computer e prodotti di elettronica e ott...,0,0,0,0,0,2023
MAR,MC,C 27,Fabbricazione di apparecchiature elettriche ed apparecchi...,1,0,1,0,2,2023
MAR,MC,C 28,Fabbricazione di macchinari ed apparecchiature nca          ,1,0,1,0,2,2023
MAR,MC,C 29,"Fabbricazione di autoveicoli, rimorchi e semirimorchi       ",0,0,0,0,0,2023
MAR,MC,C 30,Fabbricazione di altri mezzi di trasporto                   ,0,0,0,0,0,2023
MAR,MC,C 31,Fabbricazione di mobili                                     ,1,0,0,0,1,2023
MAR,MC,C 32,Altre industrie manifatturiere                              ,0,0,1,0,1,2023
MAR,MC,C 33,"Riparazione, manutenzione ed installazione di macchine ed...",0,0,2,0,2,2023
MAR,MC,D   ,"Fornitura di energia elettrica, gas, vapore e aria condiz...",0,0,0,0,0,2023
MAR,MC,D 35,"Fornitura di energia elettrica, gas, vapore e aria condiz...",0,0,0,0,0,2023
MAR,MC,E   ,"Fornitura di acqua; reti fognarie, attività di gestione d...",0,0,0,0,0,2023
MAR,MC,E 36,"Raccolta, trattamento e fornitura di acqua                  ",0,0,0,0,0,2023
MAR,MC,E 37,Gestione delle reti fognarie                                ,0,0,0,0,0,2023
MAR,MC,E 38,"Attività di raccolta, trattamento e smaltimento dei rifiu...",0,0,0,0,0,2023
MAR,MC,E 39,Attività di risanamento e altri servizi di gestione dei r...,0,0,0,0,0,2023
MAR,MC,F   ,Costruzioni                                                 ,11,2,28,0,41,2023
MAR,MC,F 41,Costruzione di edifici                                      ,7,2,5,0,14,2023
MAR,MC,F 42,Ingegneria civile                                           ,1,0,0,0,1,2023
MAR,MC,F 43,Lavori di costruzione specializzati                         ,3,0,23,0,26,2023
MAR,MC,G   ,Commercio all'ingrosso e al dettaglio; riparazione di aut...,7,10,74,2,93,2023
MAR,MC,G 45,Commercio all'ingrosso e al dettaglio e riparazione di au...,1,0,5,0,6,2023
MAR,MC,G 46,Commercio all'ingrosso (escluso quello di autoveicoli e d...,3,6,10,1,20,2023
MAR,MC,G 47,Commercio al dettaglio (escluso quello di autoveicoli e d...,3,4,59,1,67,2023
MAR,MC,H   ,Trasporto e magazzinaggio                                   ,0,0,3,0,3,2023
MAR,MC,H 49,Trasporto terrestre e mediante condotte                     ,0,0,2,0,2,2023
MAR,MC,H 50,Trasporto marittimo e per vie d'acqua                       ,0,0,0,0,0,2023
MAR,MC,H 51,Trasporto aereo                                             ,0,0,0,0,0,2023
MAR,MC,H 52,Magazzinaggio e attività di supporto ai trasporti           ,0,0,1,0,1,2023
MAR,MC,H 53,Servizi postali e attività di corriere                      ,0,0,0,0,0,2023
MAR,MC,I   ,Attività dei servizi alloggio e ristorazione                ,3,7,6,0,16,2023
MAR,MC,I 55,Alloggio                                                    ,1,0,0,0,1,2023
MAR,MC,I 56,Attività dei servizi di ristorazione                        ,2,7,6,0,15,2023
MAR,MC,J   ,Servizi di informazione e comunicazione                     ,0,0,2,0,2,2023
MAR,MC,J 58,Attività editoriali                                         ,0,0,0,0,0,2023
MAR,MC,J 59,"Attività di produzione cinematografica, di video e di pro...",0,0,0,0,0,2023
MAR,MC,J 60,Attività di programmazione e trasmissione                   ,0,0,0,0,0,2023
MAR,MC,J 61,Telecomunicazioni                                           ,0,0,1,0,1,2023
MAR,MC,J 62,"Produzione di software, consulenza informatica e attività...",0,0,0,0,0,2023
MAR,MC,J 63,Attività dei servizi d'informazione e altri servizi infor...,0,0,1,0,1,2023
MAR,MC,K   ,Attività finanziarie e assicurative                         ,0,0,4,0,4,2023
MAR,MC,K 64,Attività di servizi finanziari (escluse le assicurazioni ...,0,0,0,0,0,2023
MAR,MC,K 65,"Assicurazioni, riassicurazioni e fondi pensione (escluse ...",0,0,0,0,0,2023
MAR,MC,K 66,Attività ausiliarie dei servizi finanziari e delle attivi...,0,0,4,0,4,2023
MAR,MC,L   ,Attivita' immobiliari                                       ,4,0,0,0,4,2023
MAR,MC,L 68,Attivita' immobiliari                                       ,4,0,0,0,4,2023
MAR,MC,M   ,"Attività professionali, scientifiche e tecniche             ",1,1,6,1,9,2023
MAR,MC,M 69,Attività legali e contabilità                               ,0,0,0,0,0,2023
MAR,MC,M 70,Attività di direzione aziendale e di consulenza gestional...,0,0,1,1,2,2023
MAR,MC,M 71,Attività degli studi di architettura e d'ingegneria; coll...,0,0,0,0,0,2023
MAR,MC,M 72,Ricerca scientifica e sviluppo                              ,0,0,0,0,0,2023
MAR,MC,M 73,Pubblicità e ricerche di mercato                            ,0,0,2,0,2,2023
MAR,MC,M 74,"Altre attività professionali, scientifiche e tecniche       ",1,1,3,0,5,2023
MAR,MC,M 75,Servizi veterinari                                          ,0,0,0,0,0,2023
MAR,MC,N   ,"Noleggio, agenzie di viaggio, servizi di supporto alle im...",1,1,10,1,13,2023
MAR,MC,N 77,Attività di noleggio e leasing operativo                    ,0,0,1,0,1,2023
MAR,MC,N 78,"Attività di ricerca, selezione, fornitura di personale      ",0,0,0,0,0,2023
MAR,MC,N 79,"Attività dei servizi delle agenzie di viaggio, dei tour o...",0,0,0,0,0,2023
MAR,MC,N 80,Servizi di vigilanza e investigazione                       ,0,0,0,0,0,2023
MAR,MC,N 81,Attività di servizi per edifici e paesaggio                 ,0,0,3,1,4,2023
MAR,MC,N 82,Attività di supporto per le funzioni d'ufficio e altri se...,1,1,6,0,8,2023
MAR,MC,O   ,Amministrazione pubblica e difesa; assicurazione sociale ...,0,0,0,0,0,2023
MAR,MC,O 84,Amministrazione pubblica e difesa; assicurazione sociale ...,0,0,0,0,0,2023
MAR,MC,P   ,Istruzione                                                  ,1,0,1,0,2,2023
MAR,MC,P 85,Istruzione                                                  ,1,0,1,0,2,2023
MAR,MC,Q   ,Sanita' e assistenza sociale                                ,0,0,1,0,1,2023
MAR,MC,Q 86,Assistenza sanitaria                                        ,0,0,0,0,0,2023
MAR,MC,Q 87,Servizi di assistenza sociale residenziale                  ,0,0,0,0,0,2023
MAR,MC,Q 88,Assistenza sociale non residenziale                         ,0,0,1,0,1,2023
MAR,MC,R   ,"Attività artistiche, sportive, di intrattenimento e diver...",0,2,0,0,2,2023
MAR,MC,R 90,"Attività creative, artistiche e di intrattenimento          ",0,0,0,0,0,2023
MAR,MC,R 91,"Attività di biblioteche, archivi, musei ed altre attività...",0,0,0,0,0,2023
MAR,MC,R 92,"Attività riguardanti le lotterie, le scommesse, le case d...",0,0,0,0,0,2023
MAR,MC,R 93,"Attività sportive, di intrattenimento e di divertimento     ",0,2,0,0,2,2023
MAR,MC,S   ,Altre attività di servizi                                   ,0,0,7,0,7,2023
MAR,MC,S 94,Attività di organizzazioni associative                      ,0,0,0,0,0,2023
MAR,MC,S 95,Riparazione di computer e di beni per uso personale e per...,0,0,1,0,1,2023
MAR,MC,S 96,Altre attività di servizi per la persona                    ,0,0,6,0,6,2023
MAR,MC,T   ,Attività di famiglie e convivenze come datori di lavoro p...,0,0,0,0,0,2023
MAR,MC,T 97,Attività di famiglie e convivenze come datori di lavoro p...,0,0,0,0,0,2023
MAR,MC,T 98,Produzione di beni e servizi indifferenziati per uso prop...,0,0,0,0,0,2023
MAR,MC,U   ,Organizzazioni ed organismi extraterritoriali               ,0,0,0,0,0,2023
MAR,MC,U 99,Organizzazioni ed organismi extraterritoriali               ,0,0,0,0,0,2023
MAR,MC,XX  ,Imprese non classificate                                    ,0,1,8,2,11,2023
MAR,MC,TOT ,TOTALE                                                      ,44,30,210,8,292,2023
MAR,AP,A   ,"Agricoltura, silvicoltura pesca                             ",2,0,228,0,230,2023
MAR,AP,A 01,"Coltivazioni agricole e produzione di prodotti animali, c...",1,0,217,0,218,2023
MAR,AP,A 02,Silvicoltura ed utilizzo di aree forestali                  ,0,0,7,0,7,2023
MAR,AP,A 03,Pesca e acquacoltura                                        ,1,0,4,0,5,2023
MAR,AP,B   ,Estrazione di minerali da cave e miniere                    ,0,0,0,0,0,2023
MAR,AP,B 05,Estrazione di carbone (esclusa torba)                       ,0,0,0,0,0,2023
MAR,AP,B 06,Estraz.di petrolio greggio e di gas naturale                ,0,0,0,0,0,2023
MAR,AP,B 07,Estrazione di minerali metalliferi                          ,0,0,0,0,0,2023
MAR,AP,B 08,Altre attività di estrazione di minerali da cave e miniere  ,0,0,0,0,0,2023
MAR,AP,B 09,Attività dei servizi di supporto all'estrazione             ,0,0,0,0,0,2023
MAR,AP,C   ,Attività manifatturiere                                     ,30,0,128,1,159,2023
MAR,AP,C 10,Industrie alimentari                                        ,0,0,3,0,3,2023
MAR,AP,C 11,Industria delle bevande                                     ,0,0,0,0,0,2023
MAR,AP,C 12,Industria del tabacco                                       ,0,0,0,0,0,2023
MAR,AP,C 13,Industrie tessili                                           ,0,0,7,0,7,2023
MAR,AP,C 14,Confezione di articoli di abbigliamento; confezione di ar...,7,0,58,0,65,2023
MAR,AP,C 15,Fabbricazione di articoli in pelle e simili                 ,3,0,11,0,14,2023
MAR,AP,C 16,Industria del legno e dei prodotti in legno e sughero (es...,0,0,8,0,8,2023
MAR,AP,C 17,Fabbricazione di carta e di prodotti di carta               ,0,0,0,0,0,2023
MAR,AP,C 18,Stampa e riproduzione di supporti registrati                ,0,0,1,0,1,2023
MAR,AP,C 19,Fabbricazione di coke e prodotti derivanti dalla raffinaz...,0,0,0,0,0,2023
MAR,AP,C 20,Fabbricazione di prodotti chimici                           ,1,0,0,0,1,2023
MAR,AP,C 21,Fabbricazione di prodotti farmaceutici di base e di prepa...,0,0,0,0,0,2023
MAR,AP,C 22,Fabbricazione di articoli in gomma e materie plastiche      ,2,0,2,0,4,2023
MAR,AP,C 23,Fabbricazione di altri prodotti della lavorazione di miner..,1,0,2,0,3,2023
MAR,AP,C 24,Metallurgia                                                 ,1,0,0,0,1,2023
MAR,AP,C 25,Fabbricazione di prodotti in metallo (esclusi macchinari ...,6,0,17,0,23,2023
MAR,AP,C 26,Fabbricazione di computer e prodotti di elettronica e ott...,1,0,1,0,2,2023
MAR,AP,C 27,Fabbricazione di apparecchiature elettriche ed apparecchi...,0,0,2,0,2,2023
MAR,AP,C 28,Fabbricazione di macchinari ed apparecchiature nca          ,3,0,2,0,5,2023
MAR,AP,C 29,"Fabbricazione di autoveicoli, rimorchi e semirimorchi       ",1,0,0,0,1,2023
MAR,AP,C 30,Fabbricazione di altri mezzi di trasporto                   ,1,0,1,0,2,2023
MAR,AP,C 31,Fabbricazione di mobili                                     ,0,0,4,0,4,2023
MAR,AP,C 32,Altre industrie manifatturiere                              ,2,0,3,1,6,2023
MAR,AP,C 33,"Riparazione, manutenzione ed installazione di macchine ed...",1,0,6,0,7,2023
MAR,AP,D   ,"Fornitura di energia elettrica, gas, vapore e aria condiz...",0,0,1,0,1,2023
MAR,AP,D 35,"Fornitura di energia elettrica, gas, vapore e aria condiz...",0,0,1,0,1,2023
MAR,AP,E   ,"Fornitura di acqua; reti fognarie, attività di gestione d...",0,0,2,0,2,2023
MAR,AP,E 36,"Raccolta, trattamento e fornitura di acqua                  ",0,0,0,0,0,2023
MAR,AP,E 37,Gestione delle reti fognarie                                ,0,0,0,0,0,2023
MAR,AP,E 38,"Attività di raccolta, trattamento e smaltimento dei rifiu...",0,0,2,0,2,2023
MAR,AP,E 39,Attività di risanamento e altri servizi di gestione dei r...,0,0,0,0,0,2023
MAR,AP,F   ,Costruzioni                                                 ,37,0,261,0,298,2023
MAR,AP,F 41,Costruzione di edifici                                      ,33,0,47,0,80,2023
MAR,AP,F 42,Ingegneria civile                                           ,0,0,0,0,0,2023
MAR,AP,F 43,Lavori di costruzione specializzati                         ,4,0,214,0,218,2023
MAR,AP,G   ,Commercio all'ingrosso e al dettaglio; riparazione di aut...,59,0,362,1,422,2023
MAR,AP,G 45,Commercio all'ingrosso e al dettaglio e riparazione di au...,6,0,46,0,52,2023
MAR,AP,G 46,Commercio all'ingrosso (escluso quello di autoveicoli e d...,34,0,95,0,129,2023
MAR,AP,G 47,Commercio al dettaglio (escluso quello di autoveicoli e d...,19,0,221,1,241,2023
MAR,AP,H   ,Trasporto e magazzinaggio                                   ,5,0,27,1,33,2023
MAR,AP,H 49,Trasporto terrestre e mediante condotte                     ,3,0,25,1,29,2023
MAR,AP,H 50,Trasporto marittimo e per vie d'acqua                       ,0,0,0,0,0,2023
MAR,AP,H 51,Trasporto aereo                                             ,0,0,0,0,0,2023
MAR,AP,H 52,Magazzinaggio e attività di supporto ai trasporti           ,2,0,2,0,4,2023
MAR,AP,H 53,Servizi postali e attività di corriere                      ,0,0,0,0,0,2023
MAR,AP,I   ,Attività dei servizi alloggio e ristorazione                ,11,0,98,0,109,2023
MAR,AP,I 55,Alloggio                                                    ,0,0,6,0,6,2023
MAR,AP,I 56,Attività dei servizi di ristorazione                        ,11,0,92,0,103,2023
MAR,AP,J   ,Servizi di informazione e comunicazione                     ,5,0,23,0,28,2023
MAR,AP,J 58,Attività editoriali                                         ,1,0,6,0,7,2023
MAR,AP,J 59,"Attività di produzione cinematografica, di video e di pro...",2,0,6,0,8,2023
MAR,AP,J 60,Attività di programmazione e trasmissione                   ,1,0,0,0,1,2023
MAR,AP,J 61,Telecomunicazioni                                           ,0,0,2,0,2,2023
MAR,AP,J 62,"Produzione di software, consulenza informatica e attività...",0,0,2,0,2,2023
MAR,AP,J 63,Attività dei servizi d'informazione e altri servizi infor...,1,0,7,0,8,2023
MAR,AP,K   ,Attività finanziarie e assicurative                         ,2,0,22,0,24,2023
MAR,AP,K 64,Attività di servizi finanziari (escluse le assicurazioni ...,1,0,0,0,1,2023
MAR,AP,K 65,"Assicurazioni, riassicurazioni e fondi pensione (escluse ...",0,0,0,0,0,2023
MAR,AP,K 66,Attività ausiliarie dei servizi finanziari e delle attivi...,1,0,22,0,23,2023
MAR,AP,L   ,Attivita' immobiliari                                       ,9,0,5,0,14,2023
MAR,AP,L 68,Attivita' immobiliari                                       ,9,0,5,0,14,2023
MAR,AP,M   ,"Attività professionali, scientifiche e tecniche             ",12,0,33,0,45,2023
MAR,AP,M 69,Attività legali e contabilità                               ,0,0,0,0,0,2023
MAR,AP,M 70,Attività di direzione aziendale e di consulenza gestional...,5,0,4,0,9,2023
MAR,AP,M 71,Attività degli studi di architettura e d'ingegneria; coll...,0,0,1,0,1,2023
MAR,AP,M 72,Ricerca scientifica e sviluppo                              ,1,0,0,0,1,2023
MAR,AP,M 73,Pubblicità e ricerche di mercato                            ,5,0,11,0,16,2023
MAR,AP,M 74,"Altre attività professionali, scientifiche e tecniche       ",1,0,17,0,18,2023
MAR,AP,M 75,Servizi veterinari                                          ,0,0,0,0,0,2023
MAR,AP,N   ,"Noleggio, agenzie di viaggio, servizi di supporto alle im...",9,0,48,0,57,2023
MAR,AP,N 77,Attività di noleggio e leasing operativo                    ,2,0,3,0,5,2023
MAR,AP,N 78,"Attività di ricerca, selezione, fornitura di personale      ",0,0,0,0,0,2023
MAR,AP,N 79,"Attività dei servizi delle agenzie di viaggio, dei tour o...",3,0,1,0,4,2023
MAR,AP,N 80,Servizi di vigilanza e investigazione                       ,0,0,2,0,2,2023
MAR,AP,N 81,Attività di servizi per edifici e paesaggio                 ,3,0,26,0,29,2023
MAR,AP,N 82,Attività di supporto per le funzioni d'ufficio e altri se...,1,0,16,0,17,2023
MAR,AP,O   ,Amministrazione pubblica e difesa; assicurazione sociale ...,0,0,0,0,0,2023
MAR,AP,O 84,Amministrazione pubblica e difesa; assicurazione sociale ...,0,0,0,0,0,2023
MAR,AP,P   ,Istruzione                                                  ,1,0,1,0,2,2023
MAR,AP,P 85,Istruzione                                                  ,1,0,1,0,2,2023
MAR,AP,Q   ,Sanita' e assistenza sociale                                ,0,0,1,1,2,2023
MAR,AP,Q 86,Assistenza sanitaria                                        ,0,0,0,0,0,2023
MAR,AP,Q 87,Servizi di assistenza sociale residenziale                  ,0,0,0,0,0,2023
MAR,AP,Q 88,Assistenza sociale non residenziale                         ,0,0,1,1,2,2023
MAR,AP,R   ,"Attività artistiche, sportive, di intrattenimento e diver...",9,0,17,0,26,2023
MAR,AP,R 90,"Attività creative, artistiche e di intrattenimento          ",0,0,4,0,4,2023
MAR,AP,R 91,"Attività di biblioteche, archivi, musei ed altre attività...",0,0,0,0,0,2023
MAR,AP,R 92,"Attività riguardanti le lotterie, le scommesse, le case d...",0,0,2,0,2,2023
MAR,AP,R 93,"Attività sportive, di intrattenimento e di divertimento     ",9,0,11,0,20,2023
MAR,AP,S   ,Altre attività di servizi                                   ,0,0,29,0,29,2023
MAR,AP,S 94,Attività di organizzazioni associative                      ,0,0,0,0,0,2023
MAR,AP,S 95,Riparazione di computer e di beni per uso personale e per...,0,0,14,0,14,2023
MAR,AP,S 96,Altre attività di servizi per la persona                    ,0,0,15,0,15,2023
MAR,AP,T   ,Attività di famiglie e convivenze come datori di lavoro p...,0,0,0,0,0,2023
MAR,AP,T 97,Attività di famiglie e convivenze come datori di lavoro p...,0,0,0,0,0,2023
MAR,AP,T 98,Produzione di beni e servizi indifferenziati per uso prop...,0,0,0,0,0,2023
MAR,AP,U   ,Organizzazioni ed organismi extraterritoriali               ,0,0,0,0,0,2023
MAR,AP,U 99,Organizzazioni ed organismi extraterritoriali               ,0,0,0,0,0,2023
MAR,AP,XX  ,Imprese non classificate                                    ,90,0,35,0,125,2023
MAR,AP,TOT ,TOTALE                                                      ,281,0,1321,4,1606,2023
MAR,FM,A   ,"Agricoltura, silvicoltura pesca                             ",0,1,5,0,6,2023
MAR,FM,A 01,"Coltivazioni agricole e produzione di prodotti animali, c...",0,1,5,0,6,2023
MAR,FM,A 02,Silvicoltura ed utilizzo di aree forestali                  ,0,0,0,0,0,2023
MAR,FM,A 03,Pesca e acquacoltura                                        ,0,0,0,0,0,2023
MAR,FM,B   ,Estrazione di minerali da cave e miniere                    ,0,0,0,0,0,2023
MAR,FM,B 05,Estrazione di carbone (esclusa torba)                       ,0,0,0,0,0,2023
MAR,FM,B 06,Estraz.di petrolio greggio e di gas naturale                ,0,0,0,0,0,2023
MAR,FM,B 07,Estrazione di minerali metalliferi                          ,0,0,0,0,0,2023
MAR,FM,B 08,Altre attività di estrazione di minerali da cave e miniere  ,0,0,0,0,0,2023
MAR,FM,B 09,Attività dei servizi di supporto all'estrazione             ,0,0,0,0,0,2023
MAR,FM,C   ,Attività manifatturiere                                     ,1,11,28,0,40,2023
MAR,FM,C 10,Industrie alimentari                                        ,0,0,1,0,1,2023
MAR,FM,C 11,Industria delle bevande                                     ,0,0,0,0,0,2023
MAR,FM,C 12,Industria del tabacco                                       ,0,0,0,0,0,2023
MAR,FM,C 13,Industrie tessili                                           ,0,0,0,0,0,2023
MAR,FM,C 14,Confezione di articoli di abbigliamento; confezione di ar...,0,0,1,0,1,2023
MAR,FM,C 15,Fabbricazione di articoli in pelle e simili                 ,1,9,24,0,34,2023
MAR,FM,C 16,Industria del legno e dei prodotti in legno e sughero (es...,0,0,1,0,1,2023
MAR,FM,C 17,Fabbricazione di carta e di prodotti di carta               ,0,1,0,0,1,2023
MAR,FM,C 18,Stampa e riproduzione di supporti registrati                ,0,0,0,0,0,2023
MAR,FM,C 19,Fabbricazione di coke e prodotti derivanti dalla raffinaz...,0,0,0,0,0,2023
MAR,FM,C 20,Fabbricazione di prodotti chimici                           ,0,0,0,0,0,2023
MAR,FM,C 21,Fabbricazione di prodotti farmaceutici di base e di prepa...,0,0,0,0,0,2023
MAR,FM,C 22,Fabbricazione di articoli in gomma e materie plastiche      ,0,1,0,0,1,2023
MAR,FM,C 23,Fabbricazione di altri prodotti della lavorazione di miner..,0,0,0,0,0,2023
MAR,FM,C 24,Metallurgia                                                 ,0,0,0,0,0,2023
MAR,FM,C 25,Fabbricazione di prodotti in metallo (esclusi macchinari ...,0,0,1,0,1,2023
MAR,FM,C 26,Fabbricazione di computer e prodotti di elettronica e ott...,0,0,0,0,0,2023
MAR,FM,C 27,Fabbricazione di apparecchiature elettriche ed apparecchi...,0,0,0,0,0,2023
MAR,FM,C 28,Fabbricazione di macchinari ed apparecchiature nca          ,0,0,0,0,0,2023
MAR,FM,C 29,"Fabbricazione di autoveicoli, rimorchi e semirimorchi       ",0,0,0,0,0,2023
MAR,FM,C 30,Fabbricazione di altri mezzi di trasporto                   ,0,0,0,0,0,2023
MAR,FM,C 31,Fabbricazione di mobili                                     ,0,0,0,0,0,2023
MAR,FM,C 32,Altre industrie manifatturiere                              ,0,0,0,0,0,2023
MAR,FM,C 33,"Riparazione, manutenzione ed installazione di macchine ed...",0,0,0,0,0,2023
MAR,FM,D   ,"Fornitura di energia elettrica, gas, vapore e aria condiz...",0,0,0,0,0,2023
MAR,FM,D 35,"Fornitura di energia elettrica, gas, vapore e aria condiz...",0,0,0,0,0,2023
MAR,FM,E   ,"Fornitura di acqua; reti fognarie, attività di gestione d...",0,0,0,0,0,2023
MAR,FM,E 36,"Raccolta, trattamento e fornitura di acqua                  ",0,0,0,0,0,2023
MAR,FM,E 37,Gestione delle reti fognarie                                ,0,0,0,0,0,2023
MAR,FM,E 38,"Attività di raccolta, trattamento e smaltimento dei rifiu...",0,0,0,0,0,2023
MAR,FM,E 39,Attività di risanamento e altri servizi di gestione dei r...,0,0,0,0,0,2023
MAR,FM,F   ,Costruzioni                                                 ,0,3,10,0,13,2023
MAR,FM,F 41,Costruzione di edifici                                      ,0,2,3,0,5,2023
MAR,FM,F 42,Ingegneria civile                                           ,0,0,0,0,0,2023
MAR,FM,F 43,Lavori di costruzione specializzati                         ,0,1,7,0,8,2023
MAR,FM,G   ,Commercio all'ingrosso e al dettaglio; riparazione di aut...,0,8,20,0,28,2023
MAR,FM,G 45,Commercio all'ingrosso e al dettaglio e riparazione di au...,0,0,2,0,2,2023
MAR,FM,G 46,Commercio all'ingrosso (escluso quello di autoveicoli e d...,0,4,5,0,9,2023
MAR,FM,G 47,Commercio al dettaglio (escluso quello di autoveicoli e d...,0,4,13,0,17,2023
MAR,FM,H   ,Trasporto e magazzinaggio                                   ,1,3,1,1,6,2023
MAR,FM,H 49,Trasporto terrestre e mediante condotte                     ,1,3,1,1,6,2023
MAR,FM,H 50,Trasporto marittimo e per vie d'acqua                       ,0,0,0,0,0,2023
MAR,FM,H 51,Trasporto aereo                                             ,0,0,0,0,0,2023
MAR,FM,H 52,Magazzinaggio e attività di supporto ai trasporti           ,0,0,0,0,0,2023
MAR,FM,H 53,Servizi postali e attività di corriere                      ,0,0,0,0,0,2023
MAR,FM,I   ,Attività dei servizi alloggio e ristorazione                ,0,8,1,1,10,2023
MAR,FM,I 55,Alloggio                                                    ,0,0,0,0,0,2023
MAR,FM,I 56,Attività dei servizi di ristorazione                        ,0,8,1,1,10,2023
MAR,FM,J   ,Servizi di informazione e comunicazione                     ,0,0,0,0,0,2023
MAR,FM,J 58,Attività editoriali                                         ,0,0,0,0,0,2023
MAR,FM,J 59,"Attività di produzione cinematografica, di video e di pro...",0,0,0,0,0,2023
MAR,FM,J 60,Attività di programmazione e trasmissione                   ,0,0,0,0,0,2023
MAR,FM,J 61,Telecomunicazioni                                           ,0,0,0,0,0,2023
MAR,FM,J 62,"Produzione di software, consulenza informatica e attività...",0,0,0,0,0,2023
MAR,FM,J 63,Attività dei servizi d'informazione e altri servizi infor...,0,0,0,0,0,2023
MAR,FM,K   ,Attività finanziarie e assicurative                         ,0,0,3,0,3,2023
MAR,FM,K 64,Attività di servizi finanziari (escluse le assicurazioni ...,0,0,0,0,0,2023
MAR,FM,K 65,"Assicurazioni, riassicurazioni e fondi pensione (escluse ...",0,0,0,0,0,2023
MAR,FM,K 66,Attività ausiliarie dei servizi finanziari e delle attivi...,0,0,3,0,3,2023
MAR,FM,L   ,Attivita' immobiliari                                       ,0,0,0,0,0,2023
MAR,FM,L 68,Attivita' immobiliari                                       ,0,0,0,0,0,2023
MAR,FM,M   ,"Attività professionali, scientifiche e tecniche             ",0,0,0,0,0,2023
MAR,FM,M 69,Attività legali e contabilità                               ,0,0,0,0,0,2023
MAR,FM,M 70,Attività di direzione aziendale e di consulenza gestional...,0,0,0,0,0,2023
MAR,FM,M 71,Attività degli studi di architettura e d'ingegneria; coll...,0,0,0,0,0,2023
MAR,FM,M 72,Ricerca scientifica e sviluppo                              ,0,0,0,0,0,2023
MAR,FM,M 73,Pubblicità e ricerche di mercato                            ,0,0,0,0,0,2023
MAR,FM,M 74,"Altre attività professionali, scientifiche e tecniche       ",0,0,0,0,0,2023
MAR,FM,M 75,Servizi veterinari                                          ,0,0,0,0,0,2023
MAR,FM,N   ,"Noleggio, agenzie di viaggio, servizi di supporto alle im...",0,0,0,1,1,2023
MAR,FM,N 77,Attività di noleggio e leasing operativo                    ,0,0,0,0,0,2023
MAR,FM,N 78,"Attività di ricerca, selezione, fornitura di personale      ",0,0,0,0,0,2023
MAR,FM,N 79,"Attività dei servizi delle agenzie di viaggio, dei tour o...",0,0,0,0,0,2023
MAR,FM,N 80,Servizi di vigilanza e investigazione                       ,0,0,0,0,0,2023
MAR,FM,N 81,Attività di servizi per edifici e paesaggio                 ,0,0,0,1,1,2023
MAR,FM,N 82,Attività di supporto per le funzioni d'ufficio e altri se...,0,0,0,0,0,2023
MAR,FM,O   ,Amministrazione pubblica e difesa; assicurazione sociale ...,0,0,0,0,0,2023
MAR,FM,O 84,Amministrazione pubblica e difesa; assicurazione sociale ...,0,0,0,0,0,2023
MAR,FM,P   ,Istruzione                                                  ,0,0,1,0,1,2023
MAR,FM,P 85,Istruzione                                                  ,0,0,1,0,1,2023
MAR,FM,Q   ,Sanita' e assistenza sociale                                ,0,0,0,0,0,2023
MAR,FM,Q 86,Assistenza sanitaria                                        ,0,0,0,0,0,2023
MAR,FM,Q 87,Servizi di assistenza sociale residenziale                  ,0,0,0,0,0,2023
MAR,FM,Q 88,Assistenza sociale non residenziale                         ,0,0,0,0,0,2023
MAR,FM,R   ,"Attività artistiche, sportive, di intrattenimento e diver...",0,1,0,0,1,2023
MAR,FM,R 90,"Attività creative, artistiche e di intrattenimento          ",0,1,0,0,1,2023
MAR,FM,R 91,"Attività di biblioteche, archivi, musei ed altre attività...",0,0,0,0,0,2023
MAR,FM,R 92,"Attività riguardanti le lotterie, le scommesse, le case d...",0,0,0,0,0,2023
MAR,FM,R 93,"Attività sportive, di intrattenimento e di divertimento     ",0,0,0,0,0,2023
MAR,FM,S   ,Altre attività di servizi                                   ,1,1,1,0,3,2023
MAR,FM,S 94,Attività di organizzazioni associative                      ,0,0,0,0,0,2023
MAR,FM,S 95,Riparazione di computer e di beni per uso personale e per...,1,0,0,0,1,2023
MAR,FM,S 96,Altre attività di servizi per la persona                    ,0,1,1,0,2,2023
MAR,FM,T   ,Attività di famiglie e convivenze come datori di lavoro p...,0,0,0,0,0,2023
MAR,FM,T 97,Attività di famiglie e convivenze come datori di lavoro p...,0,0,0,0,0,2023
MAR,FM,T 98,Produzione di beni e servizi indifferenziati per uso prop...,0,0,0,0,0,2023
MAR,FM,U   ,Organizzazioni ed organismi extraterritoriali               ,0,0,0,0,0,2023
MAR,FM,U 99,Organizzazioni ed organismi extraterritoriali               ,0,0,0,0,0,2023
MAR,FM,XX  ,Imprese non classificate                                    ,1,3,0,0,4,2023
MAR,FM,TOT ,TOTALE                                                      ,4,39,70,3,116,2023
LAZ,  ,A   ,"Agricoltura, silvicoltura pesca                             ",23,43,715,19,800,2023
LAZ,  ,A 01,"Coltivazioni agricole e produzione di prodotti animali, c...",20,41,700,15,776,2023
LAZ,  ,A 02,Silvicoltura ed utilizzo di aree forestali                  ,3,1,12,2,18,2023
LAZ,  ,A 03,Pesca e acquacoltura                                        ,0,1,3,2,6,2023
LAZ,  ,B   ,Estrazione di minerali da cave e miniere                    ,4,5,8,0,17,2023
LAZ,  ,B 05,Estrazione di carbone (esclusa torba)                       ,0,0,0,0,0,2023
LAZ,  ,B 06,Estraz.di petrolio greggio e di gas naturale                ,0,0,0,0,0,2023
LAZ,  ,B 07,Estrazione di minerali metalliferi                          ,0,2,0,0,2,2023
LAZ,  ,B 08,Altre attività di estrazione di minerali da cave e miniere  ,4,3,8,0,15,2023
LAZ,  ,B 09,Attività dei servizi di supporto all'estrazione             ,0,0,0,0,0,2023
LAZ,  ,C   ,Attività manifatturiere                                     ,232,477,407,20,1136,2023
LAZ,  ,C 10,Industrie alimentari                                        ,23,73,41,2,139,2023
LAZ,  ,C 11,Industria delle bevande                                     ,1,2,0,1,4,2023
LAZ,  ,C 12,Industria del tabacco                                       ,0,0,0,0,0,2023
LAZ,  ,C 13,Industrie tessili                                           ,8,6,5,1,20,2023
LAZ,  ,C 14,Confezione di articoli di abbigliamento; confezione di ar...,43,54,47,2,146,2023
LAZ,  ,C 15,Fabbricazione di articoli in pelle e simili                 ,1,9,16,0,26,2023
LAZ,  ,C 16,Industria del legno e dei prodotti in legno e sughero (es...,5,15,49,2,71,2023
LAZ,  ,C 17,Fabbricazione di carta e di prodotti di carta               ,2,6,2,0,10,2023
LAZ,  ,C 18,Stampa e riproduzione di supporti registrati                ,13,56,14,0,83,2023
LAZ,  ,C 19,Fabbricazione di coke e prodotti derivanti dalla raffinaz...,1,2,0,0,3,2023
LAZ,  ,C 20,Fabbricazione di prodotti chimici                           ,3,12,1,0,16,2023
LAZ,  ,C 21,Fabbricazione di prodotti farmaceutici di base e di prepa...,2,1,0,0,3,2023
LAZ,  ,C 22,Fabbricazione di articoli in gomma e materie plastiche      ,9,11,3,1,24,2023
LAZ,  ,C 23,Fabbricazione di altri prodotti della lavorazione di miner..,15,16,14,1,46,2023
LAZ,  ,C 24,Metallurgia                                                 ,3,4,1,0,8,2023
LAZ,  ,C 25,Fabbricazione di prodotti in metallo (esclusi macchinari ...,41,69,74,3,187,2023
LAZ,  ,C 26,Fabbricazione di computer e prodotti di elettronica e ott...,8,43,4,0,55,2023
LAZ,  ,C 27,Fabbricazione di apparecchiature elettriche ed apparecchi...,10,16,5,0,31,2023
LAZ,  ,C 28,Fabbricazione di macchinari ed apparecchiature nca          ,11,14,7,1,33,2023
LAZ,  ,C 29,"Fabbricazione di autoveicoli, rimorchi e semirimorchi       ",4,2,1,1,8,2023
LAZ,  ,C 30,Fabbricazione di altri mezzi di trasporto                   ,5,8,3,0,16,2023
LAZ,  ,C 31,Fabbricazione di mobili                                     ,12,20,8,0,40,2023
LAZ,  ,C 32,Altre industrie manifatturiere                              ,6,23,90,3,122,2023
LAZ,  ,C 33,"Riparazione, manutenzione ed installazione di macchine ed...",6,15,22,2,45,2023
LAZ,  ,D   ,"Fornitura di energia elettrica, gas, vapore e aria condiz...",3,2,1,0,6,2023
LAZ,  ,D 35,"Fornitura di energia elettrica, gas, vapore e aria condiz...",3,2,1,0,6,2023
LAZ,  ,E   ,"Fornitura di acqua; reti fognarie, attività di gestione d...",5,9,6,6,26,2023
LAZ,  ,E 36,"Raccolta, trattamento e fornitura di acqua                  ",0,0,0,0,0,2023
LAZ,  ,E 37,Gestione delle reti fognarie                                ,0,0,0,0,0,2023
LAZ,  ,E 38,"Attività di raccolta, trattamento e smaltimento dei rifiu...",5,7,6,3,21,2023
LAZ,  ,E 39,Attività di risanamento e altri servizi di gestione dei r...,0,2,0,3,5,2023
LAZ,  ,F   ,Costruzioni                                                 ,405,683,908,205,2201,2023
LAZ,  ,F 41,Costruzione di edifici                                      ,269,359,169,146,943,2023
LAZ,  ,F 42,Ingegneria civile                                           ,4,20,7,3,34,2023
LAZ,  ,F 43,Lavori di costruzione specializzati                         ,132,304,732,56,1224,2023
LAZ,  ,G   ,Commercio all'ingrosso e al dettaglio; riparazione di aut...,584,2416,2678,49,5727,2023
LAZ,  ,G 45,Commercio all'ingrosso e al dettaglio e riparazione di au...,76,289,191,6,562,2023
LAZ,  ,G 46,Commercio all'ingrosso (escluso quello di autoveicoli e d...,243,893,757,15,1908,2023
LAZ,  ,G 47,Commercio al dettaglio (escluso quello di autoveicoli e d...,265,1234,1730,28,3257,2023
LAZ,  ,H   ,Trasporto e magazzinaggio                                   ,64,203,178,150,595,2023
LAZ,  ,H 49,Trasporto terrestre e mediante condotte                     ,41,150,142,78,411,2023
LAZ,  ,H 50,Trasporto marittimo e per vie d'acqua                       ,1,3,0,0,4,2023
LAZ,  ,H 51,Trasporto aereo                                             ,0,0,0,0,0,2023
LAZ,  ,H 52,Magazzinaggio e attività di supporto ai trasporti           ,19,42,26,72,159,2023
LAZ,  ,H 53,Servizi postali e attività di corriere                      ,3,8,10,0,21,2023
LAZ,  ,I   ,Attività dei servizi alloggio e ristorazione                ,232,1348,376,37,1993,2023
LAZ,  ,I 55,Alloggio                                                    ,25,39,26,2,92,2023
LAZ,  ,I 56,Attività dei servizi di ristorazione                        ,207,1309,350,35,1901,2023
LAZ,  ,J   ,Servizi di informazione e comunicazione                     ,106,266,186,21,579,2023
LAZ,  ,J 58,Attività editoriali                                         ,6,51,10,5,72,2023
LAZ,  ,J 59,"Attività di produzione cinematografica, di video e di pro...",8,48,21,3,80,2023
LAZ,  ,J 60,Attività di programmazione e trasmissione                   ,2,6,1,0,9,2023
LAZ,  ,J 61,Telecomunicazioni                                           ,10,69,80,1,160,2023
LAZ,  ,J 62,"Produzione di software, consulenza informatica e attività...",43,53,46,5,147,2023
LAZ,  ,J 63,Attività dei servizi d'informazione e altri servizi infor...,37,39,28,7,111,2023
LAZ,  ,K   ,Attività finanziarie e assicurative                         ,30,147,185,2,364,2023
LAZ,  ,K 64,Attività di servizi finanziari (escluse le assicurazioni ...,12,32,2,1,47,2023
LAZ,  ,K 65,"Assicurazioni, riassicurazioni e fondi pensione (escluse ...",2,8,0,0,10,2023
LAZ,  ,K 66,Attività ausiliarie dei servizi finanziari e delle attivi...,16,107,183,1,307,2023
LAZ,  ,L   ,Attivita' immobiliari                                       ,115,200,34,7,356,2023
LAZ,  ,L 68,Attivita' immobiliari                                       ,115,200,34,7,356,2023
LAZ,  ,M   ,"Attività professionali, scientifiche e tecniche             ",132,236,121,39,528,2023
LAZ,  ,M 69,Attività legali e contabilità                               ,8,26,0,2,36,2023
LAZ,  ,M 70,Attività di direzione aziendale e di consulenza gestional...,42,27,15,17,101,2023
LAZ,  ,M 71,Attività degli studi di architettura e d'ingegneria; coll...,18,18,2,2,40,2023
LAZ,  ,M 72,Ricerca scientifica e sviluppo                              ,1,7,1,1,10,2023
LAZ,  ,M 73,Pubblicità e ricerche di mercato                            ,37,72,45,7,161,2023
LAZ,  ,M 74,"Altre attività professionali, scientifiche e tecniche       ",26,84,58,10,178,2023
LAZ,  ,M 75,Servizi veterinari                                          ,0,2,0,0,2,2023
LAZ,  ,N   ,"Noleggio, agenzie di viaggio, servizi di supporto alle im...",116,276,385,142,919,2023
LAZ,  ,N 77,Attività di noleggio e leasing operativo                    ,17,49,29,2,97,2023
LAZ,  ,N 78,"Attività di ricerca, selezione, fornitura di personale      ",1,4,0,0,5,2023
LAZ,  ,N 79,"Attività dei servizi delle agenzie di viaggio, dei tour o...",16,31,11,3,61,2023
LAZ,  ,N 80,Servizi di vigilanza e investigazione                       ,4,7,1,2,14,2023
LAZ,  ,N 81,Attività di servizi per edifici e paesaggio                 ,26,77,106,86,295,2023
LAZ,  ,N 82,Attività di supporto per le funzioni d'ufficio e altri se...,52,108,238,49,447,2023
LAZ,  ,O   ,Amministrazione pubblica e difesa; assicurazione sociale ...,0,0,0,0,0,2023
LAZ,  ,O 84,Amministrazione pubblica e difesa; assicurazione sociale ...,0,0,0,0,0,2023
LAZ,  ,P   ,Istruzione                                                  ,13,22,8,13,56,2023
LAZ,  ,P 85,Istruzione                                                  ,13,22,8,13,56,2023
LAZ,  ,Q   ,Sanita' e assistenza sociale                                ,22,44,5,41,112,2023
LAZ,  ,Q 86,Assistenza sanitaria                                        ,17,41,2,5,65,2023
LAZ,  ,Q 87,Servizi di assistenza sociale residenziale                  ,4,1,1,8,14,2023
LAZ,  ,Q 88,Assistenza sociale non residenziale                         ,1,2,2,28,33,2023
LAZ,  ,R   ,"Attività artistiche, sportive, di intrattenimento e diver...",42,138,74,19,273,2023
LAZ,  ,R 90,"Attività creative, artistiche e di intrattenimento          ",7,41,32,4,84,2023
LAZ,  ,R 91,"Attività di biblioteche, archivi, musei ed altre attività...",1,3,0,1,5,2023
LAZ,  ,R 92,"Attività riguardanti le lotterie, le scommesse, le case d...",8,4,5,0,17,2023
LAZ,  ,R 93,"Attività sportive, di intrattenimento e di divertimento     ",26,90,37,14,167,2023
LAZ,  ,S   ,Altre attività di servizi                                   ,46,419,228,25,718,2023
LAZ,  ,S 94,Attività di organizzazioni associative                      ,0,3,0,2,5,2023
LAZ,  ,S 95,Riparazione di computer e di beni per uso personale e per...,3,21,58,1,83,2023
LAZ,  ,S 96,Altre attività di servizi per la persona                    ,43,395,170,22,630,2023
LAZ,  ,T   ,Attività di famiglie e convivenze come datori di lavoro p...,0,0,0,0,0,2023
LAZ,  ,T 97,Attività di famiglie e convivenze come datori di lavoro p...,0,0,0,0,0,2023
LAZ,  ,T 98,Produzione di beni e servizi indifferenziati per uso prop...,0,0,0,0,0,2023
LAZ,  ,U   ,Organizzazioni ed organismi extraterritoriali               ,0,0,0,0,0,2023
LAZ,  ,U 99,Organizzazioni ed organismi extraterritoriali               ,0,0,0,0,0,2023
LAZ,  ,XX  ,Imprese non classificate                                    ,691,259,200,287,1437,2023
LAZ,  ,TOT ,TOTALE                                                      ,2865,7193,6703,1082,17843,2023
LAZ,VT,A   ,"Agricoltura, silvicoltura pesca                             ",0,0,216,2,218,2023
LAZ,VT,A 01,"Coltivazioni agricole e produzione di prodotti animali, c...",0,0,215,2,217,2023
LAZ,VT,A 02,Silvicoltura ed utilizzo di aree forestali                  ,0,0,1,0,1,2023
LAZ,VT,A 03,Pesca e acquacoltura                                        ,0,0,0,0,0,2023
LAZ,VT,B   ,Estrazione di minerali da cave e miniere                    ,0,1,6,0,7,2023
LAZ,VT,B 05,Estrazione di carbone (esclusa torba)                       ,0,0,0,0,0,2023
LAZ,VT,B 06,Estraz.di petrolio greggio e di gas naturale                ,0,0,0,0,0,2023
LAZ,VT,B 07,Estrazione di minerali metalliferi                          ,0,0,0,0,0,2023
LAZ,VT,B 08,Altre attività di estrazione di minerali da cave e miniere  ,0,1,6,0,7,2023
LAZ,VT,B 09,Attività dei servizi di supporto all'estrazione             ,0,0,0,0,0,2023
LAZ,VT,C   ,Attività manifatturiere                                     ,6,1,35,1,43,2023
LAZ,VT,C 10,Industrie alimentari                                        ,1,0,8,0,9,2023
LAZ,VT,C 11,Industria delle bevande                                     ,0,0,0,0,0,2023
LAZ,VT,C 12,Industria del tabacco                                       ,0,0,0,0,0,2023
LAZ,VT,C 13,Industrie tessili                                           ,0,0,0,0,0,2023
LAZ,VT,C 14,Confezione di articoli di abbigliamento; confezione di ar...,0,0,3,0,3,2023
LAZ,VT,C 15,Fabbricazione di articoli in pelle e simili                 ,0,0,1,0,1,2023
LAZ,VT,C 16,Industria del legno e dei prodotti in legno e sughero (es...,0,1,10,0,11,2023
LAZ,VT,C 17,Fabbricazione di carta e di prodotti di carta               ,0,0,1,0,1,2023
LAZ,VT,C 18,Stampa e riproduzione di supporti registrati                ,0,0,1,0,1,2023
LAZ,VT,C 19,Fabbricazione di coke e prodotti derivanti dalla raffinaz...,0,0,0,0,0,2023
LAZ,VT,C 20,Fabbricazione di prodotti chimici                           ,0,0,0,0,0,2023
LAZ,VT,C 21,Fabbricazione di prodotti farmaceutici di base e di prepa...,0,0,0,0,0,2023
LAZ,VT,C 22,Fabbricazione di articoli in gomma e materie plastiche      ,0,0,1,0,1,2023
LAZ,VT,C 23,Fabbricazione di altri prodotti della lavorazione di miner..,0,0,3,0,3,2023
LAZ,VT,C 24,Metallurgia                                                 ,0,0,1,0,1,2023
LAZ,VT,C 25,Fabbricazione di prodotti in metallo (esclusi macchinari ...,1,0,2,1,4,2023
LAZ,VT,C 26,Fabbricazione di computer e prodotti di elettronica e ott...,0,0,0,0,0,2023
LAZ,VT,C 27,Fabbricazione di apparecchiature elettriche ed apparecchi...,1,0,0,0,1,2023
LAZ,VT,C 28,Fabbricazione di macchinari ed apparecchiature nca          ,1,0,2,0,3,2023
LAZ,VT,C 29,"Fabbricazione di autoveicoli, rimorchi e semirimorchi       ",0,0,0,0,0,2023
LAZ,VT,C 30,Fabbricazione di altri mezzi di trasporto                   ,0,0,0,0,0,2023
LAZ,VT,C 31,Fabbricazione di mobili                                     ,2,0,0,0,2,2023
LAZ,VT,C 32,Altre industrie manifatturiere                              ,0,0,0,0,0,2023
LAZ,VT,C 33,"Riparazione, manutenzione ed installazione di macchine ed...",0,0,2,0,2,2023
LAZ,VT,D   ,"Fornitura di energia elettrica, gas, vapore e aria condiz...",0,0,0,0,0,2023
LAZ,VT,D 35,"Fornitura di energia elettrica, gas, vapore e aria condiz...",0,0,0,0,0,2023
LAZ,VT,E   ,"Fornitura di acqua; reti fognarie, attività di gestione d...",0,0,0,1,1,2023
LAZ,VT,E 36,"Raccolta, trattamento e fornitura di acqua                  ",0,0,0,0,0,2023
LAZ,VT,E 37,Gestione delle reti fognarie                                ,0,0,0,0,0,2023
LAZ,VT,E 38,"Attività di raccolta, trattamento e smaltimento dei rifiu...",0,0,0,1,1,2023
LAZ,VT,E 39,Attività di risanamento e altri servizi di gestione dei r...,0,0,0,0,0,2023
LAZ,VT,F   ,Costruzioni                                                 ,9,0,12,12,33,2023
LAZ,VT,F 41,Costruzione di edifici                                      ,6,0,11,5,22,2023
LAZ,VT,F 42,Ingegneria civile                                           ,0,0,0,0,0,2023
LAZ,VT,F 43,Lavori di costruzione specializzati                         ,3,0,1,7,11,2023
LAZ,VT,G   ,Commercio all'ingrosso e al dettaglio; riparazione di aut...,9,0,109,0,118,2023
LAZ,VT,G 45,Commercio all'ingrosso e al dettaglio e riparazione di au...,2,0,9,0,11,2023
LAZ,VT,G 46,Commercio all'ingrosso (escluso quello di autoveicoli e d...,1,0,18,0,19,2023
LAZ,VT,G 47,Commercio al dettaglio (escluso quello di autoveicoli e d...,6,0,82,0,88,2023
LAZ,VT,H   ,Trasporto e magazzinaggio                                   ,1,0,7,1,9,2023
LAZ,VT,H 49,Trasporto terrestre e mediante condotte                     ,1,0,7,0,8,2023
LAZ,VT,H 50,Trasporto marittimo e per vie d'acqua                       ,0,0,0,0,0,2023
LAZ,VT,H 51,Trasporto aereo                                             ,0,0,0,0,0,2023
LAZ,VT,H 52,Magazzinaggio e attività di supporto ai trasporti           ,0,0,0,1,1,2023
LAZ,VT,H 53,Servizi postali e attività di corriere                      ,0,0,0,0,0,2023
LAZ,VT,I   ,Attività dei servizi alloggio e ristorazione                ,2,0,5,2,9,2023
LAZ,VT,I 55,Alloggio                                                    ,0,0,0,0,0,2023
LAZ,VT,I 56,Attività dei servizi di ristorazione                        ,2,0,5,2,9,2023
LAZ,VT,J   ,Servizi di informazione e comunicazione                     ,2,0,0,0,2,2023
LAZ,VT,J 58,Attività editoriali                                         ,1,0,0,0,1,2023
LAZ,VT,J 59,"Attività di produzione cinematografica, di video e di pro...",0,0,0,0,0,2023
LAZ,VT,J 60,Attività di programmazione e trasmissione                   ,0,0,0,0,0,2023
LAZ,VT,J 61,Telecomunicazioni                                           ,0,0,0,0,0,2023
LAZ,VT,J 62,"Produzione di software, consulenza informatica e attività...",0,0,0,0,0,2023
LAZ,VT,J 63,Attività dei servizi d'informazione e altri servizi infor...,1,0,0,0,1,2023
LAZ,VT,K   ,Attività finanziarie e assicurative                         ,2,0,0,0,2,2023
LAZ,VT,K 64,Attività di servizi finanziari (escluse le assicurazioni ...,0,0,0,0,0,2023
LAZ,VT,K 65,"Assicurazioni, riassicurazioni e fondi pensione (escluse ...",0,0,0,0,0,2023
LAZ,VT,K 66,Attività ausiliarie dei servizi finanziari e delle attivi...,2,0,0,0,2,2023
LAZ,VT,L   ,Attivita' immobiliari                                       ,3,0,0,0,3,2023
LAZ,VT,L 68,Attivita' immobiliari                                       ,3,0,0,0,3,2023
LAZ,VT,M   ,"Attività professionali, scientifiche e tecniche             ",3,0,1,2,6,2023
LAZ,VT,M 69,Attività legali e contabilità                               ,0,0,0,0,0,2023
LAZ,VT,M 70,Attività di direzione aziendale e di consulenza gestional...,2,0,0,1,3,2023
LAZ,VT,M 71,Attività degli studi di architettura e d'ingegneria; coll...,0,0,0,0,0,2023
LAZ,VT,M 72,Ricerca scientifica e sviluppo                              ,0,0,0,1,1,2023
LAZ,VT,M 73,Pubblicità e ricerche di mercato                            ,0,0,0,0,0,2023
LAZ,VT,M 74,"Altre attività professionali, scientifiche e tecniche       ",1,0,1,0,2,2023
LAZ,VT,M 75,Servizi veterinari                                          ,0,0,0,0,0,2023
LAZ,VT,N   ,"Noleggio, agenzie di viaggio, servizi di supporto alle im...",1,0,0,2,3,2023
LAZ,VT,N 77,Attività di noleggio e leasing operativo                    ,0,0,0,0,0,2023
LAZ,VT,N 78,"Attività di ricerca, selezione, fornitura di personale      ",0,0,0,0,0,2023
LAZ,VT,N 79,"Attività dei servizi delle agenzie di viaggio, dei tour o...",0,0,0,0,0,2023
LAZ,VT,N 80,Servizi di vigilanza e investigazione                       ,0,0,0,0,0,2023
LAZ,VT,N 81,Attività di servizi per edifici e paesaggio                 ,0,0,0,0,0,2023
LAZ,VT,N 82,Attività di supporto per le funzioni d'ufficio e altri se...,1,0,0,2,3,2023
LAZ,VT,O   ,Amministrazione pubblica e difesa; assicurazione sociale ...,0,0,0,0,0,2023
LAZ,VT,O 84,Amministrazione pubblica e difesa; assicurazione sociale ...,0,0,0,0,0,2023
LAZ,VT,P   ,Istruzione                                                  ,0,0,0,3,3,2023
LAZ,VT,P 85,Istruzione                                                  ,0,0,0,3,3,2023
LAZ,VT,Q   ,Sanita' e assistenza sociale                                ,0,0,0,2,2,2023
LAZ,VT,Q 86,Assistenza sanitaria                                        ,0,0,0,0,0,2023
LAZ,VT,Q 87,Servizi di assistenza sociale residenziale                  ,0,0,0,0,0,2023
LAZ,VT,Q 88,Assistenza sociale non residenziale                         ,0,0,0,2,2,2023
LAZ,VT,R   ,"Attività artistiche, sportive, di intrattenimento e diver...",1,0,0,1,2,2023
LAZ,VT,R 90,"Attività creative, artistiche e di intrattenimento          ",0,0,0,0,0,2023
LAZ,VT,R 91,"Attività di biblioteche, archivi, musei ed altre attività...",0,0,0,0,0,2023
LAZ,VT,R 92,"Attività riguardanti le lotterie, le scommesse, le case d...",0,0,0,0,0,2023
LAZ,VT,R 93,"Attività sportive, di intrattenimento e di divertimento     ",1,0,0,1,2,2023
LAZ,VT,S   ,Altre attività di servizi                                   ,0,0,1,0,1,2023
LAZ,VT,S 94,Attività di organizzazioni associative                      ,0,0,0,0,0,2023
LAZ,VT,S 95,Riparazione di computer e di beni per uso personale e per...,0,0,1,0,1,2023
LAZ,VT,S 96,Altre attività di servizi per la persona                    ,0,0,0,0,0,2023
LAZ,VT,T   ,Attività di famiglie e convivenze come datori di lavoro p...,0,0,0,0,0,2023
LAZ,VT,T 97,Attività di famiglie e convivenze come datori di lavoro p...,0,0,0,0,0,2023
LAZ,VT,T 98,Produzione di beni e servizi indifferenziati per uso prop...,0,0,0,0,0,2023
LAZ,VT,U   ,Organizzazioni ed organismi extraterritoriali               ,0,0,0,0,0,2023
LAZ,VT,U 99,Organizzazioni ed organismi extraterritoriali               ,0,0,0,0,0,2023
LAZ,VT,XX  ,Imprese non classificate                                    ,17,0,0,7,24,2023
LAZ,VT,TOT ,TOTALE                                                      ,56,2,392,36,486,2023
LAZ,RI,A   ,"Agricoltura, silvicoltura pesca                             ",0,0,77,1,78,2023
LAZ,RI,A 01,"Coltivazioni agricole e produzione di prodotti animali, c...",0,0,76,1,77,2023
LAZ,RI,A 02,Silvicoltura ed utilizzo di aree forestali                  ,0,0,1,0,1,2023
LAZ,RI,A 03,Pesca e acquacoltura                                        ,0,0,0,0,0,2023
LAZ,RI,B   ,Estrazione di minerali da cave e miniere                    ,0,0,0,0,0,2023
LAZ,RI,B 05,Estrazione di carbone (esclusa torba)                       ,0,0,0,0,0,2023
LAZ,RI,B 06,Estraz.di petrolio greggio e di gas naturale                ,0,0,0,0,0,2023
LAZ,RI,B 07,Estrazione di minerali metalliferi                          ,0,0,0,0,0,2023
LAZ,RI,B 08,Altre attività di estrazione di minerali da cave e miniere  ,0,0,0,0,0,2023
LAZ,RI,B 09,Attività dei servizi di supporto all'estrazione             ,0,0,0,0,0,2023
LAZ,RI,C   ,Attività manifatturiere                                     ,0,0,1,1,2,2023
LAZ,RI,C 10,Industrie alimentari                                        ,0,0,0,1,1,2023
LAZ,RI,C 11,Industria delle bevande                                     ,0,0,0,0,0,2023
LAZ,RI,C 12,Industria del tabacco                                       ,0,0,0,0,0,2023
LAZ,RI,C 13,Industrie tessili                                           ,0,0,1,0,1,2023
LAZ,RI,C 14,Confezione di articoli di abbigliamento; confezione di ar...,0,0,0,0,0,2023
LAZ,RI,C 15,Fabbricazione di articoli in pelle e simili                 ,0,0,0,0,0,2023
LAZ,RI,C 16,Industria del legno e dei prodotti in legno e sughero (es...,0,0,0,0,0,2023
LAZ,RI,C 17,Fabbricazione di carta e di prodotti di carta               ,0,0,0,0,0,2023
LAZ,RI,C 18,Stampa e riproduzione di supporti registrati                ,0,0,0,0,0,2023
LAZ,RI,C 19,Fabbricazione di coke e prodotti derivanti dalla raffinaz...,0,0,0,0,0,2023
LAZ,RI,C 20,Fabbricazione di prodotti chimici                           ,0,0,0,0,0,2023
LAZ,RI,C 21,Fabbricazione di prodotti farmaceutici di base e di prepa...,0,0,0,0,0,2023
LAZ,RI,C 22,Fabbricazione di articoli in gomma e materie plastiche      ,0,0,0,0,0,2023
LAZ,RI,C 23,Fabbricazione di altri prodotti della lavorazione di miner..,0,0,0,0,0,2023
LAZ,RI,C 24,Metallurgia                                                 ,0,0,0,0,0,2023
LAZ,RI,C 25,Fabbricazione di prodotti in metallo (esclusi macchinari ...,0,0,0,0,0,2023
LAZ,RI,C 26,Fabbricazione di computer e prodotti di elettronica e ott...,0,0,0,0,0,2023
LAZ,RI,C 27,Fabbricazione di apparecchiature elettriche ed apparecchi...,0,0,0,0,0,2023
LAZ,RI,C 28,Fabbricazione di macchinari ed apparecchiature nca          ,0,0,0,0,0,2023
LAZ,RI,C 29,"Fabbricazione di autoveicoli, rimorchi e semirimorchi       ",0,0,0,0,0,2023
LAZ,RI,C 30,Fabbricazione di altri mezzi di trasporto                   ,0,0,0,0,0,2023
LAZ,RI,C 31,Fabbricazione di mobili                                     ,0,0,0,0,0,2023
LAZ,RI,C 32,Altre industrie manifatturiere                              ,0,0,0,0,0,2023
LAZ,RI,C 33,"Riparazione, manutenzione ed installazione di macchine ed...",0,0,0,0,0,2023
LAZ,RI,D   ,"Fornitura di energia elettrica, gas, vapore e aria condiz...",0,0,0,0,0,2023
LAZ,RI,D 35,"Fornitura di energia elettrica, gas, vapore e aria condiz...",0,0,0,0,0,2023
LAZ,RI,E   ,"Fornitura di acqua; reti fognarie, attività di gestione d...",0,0,0,0,0,2023
LAZ,RI,E 36,"Raccolta, trattamento e fornitura di acqua                  ",0,0,0,0,0,2023
LAZ,RI,E 37,Gestione delle reti fognarie                                ,0,0,0,0,0,2023
LAZ,RI,E 38,"Attività di raccolta, trattamento e smaltimento dei rifiu...",0,0,0,0,0,2023
LAZ,RI,E 39,Attività di risanamento e altri servizi di gestione dei r...,0,0,0,0,0,2023
LAZ,RI,F   ,Costruzioni                                                 ,2,0,8,0,10,2023
LAZ,RI,F 41,Costruzione di edifici                                      ,2,0,6,0,8,2023
LAZ,RI,F 42,Ingegneria civile                                           ,0,0,0,0,0,2023
LAZ,RI,F 43,Lavori di costruzione specializzati                         ,0,0,2,0,2,2023
LAZ,RI,G   ,Commercio all'ingrosso e al dettaglio; riparazione di aut...,6,0,13,0,19,2023
LAZ,RI,G 45,Commercio all'ingrosso e al dettaglio e riparazione di au...,1,0,2,0,3,2023
LAZ,RI,G 46,Commercio all'ingrosso (escluso quello di autoveicoli e d...,3,0,3,0,6,2023
LAZ,RI,G 47,Commercio al dettaglio (escluso quello di autoveicoli e d...,2,0,8,0,10,2023
LAZ,RI,H   ,Trasporto e magazzinaggio                                   ,0,0,2,0,2,2023
LAZ,RI,H 49,Trasporto terrestre e mediante condotte                     ,0,0,2,0,2,2023
LAZ,RI,H 50,Trasporto marittimo e per vie d'acqua                       ,0,0,0,0,0,2023
LAZ,RI,H 51,Trasporto aereo                                             ,0,0,0,0,0,2023
LAZ,RI,H 52,Magazzinaggio e attività di supporto ai trasporti           ,0,0,0,0,0,2023
LAZ,RI,H 53,Servizi postali e attività di corriere                      ,0,0,0,0,0,2023
LAZ,RI,I   ,Attività dei servizi alloggio e ristorazione                ,0,0,3,0,3,2023
LAZ,RI,I 55,Alloggio                                                    ,0,0,1,0,1,2023
LAZ,RI,I 56,Attività dei servizi di ristorazione                        ,0,0,2,0,2,2023
LAZ,RI,J   ,Servizi di informazione e comunicazione                     ,0,0,0,0,0,2023
LAZ,RI,J 58,Attività editoriali                                         ,0,0,0,0,0,2023
LAZ,RI,J 59,"Attività di produzione cinematografica, di video e di pro...",0,0,0,0,0,2023
LAZ,RI,J 60,Attività di programmazione e trasmissione                   ,0,0,0,0,0,2023
LAZ,RI,J 61,Telecomunicazioni                                           ,0,0,0,0,0,2023
LAZ,RI,J 62,"Produzione di software, consulenza informatica e attività...",0,0,0,0,0,2023
LAZ,RI,J 63,Attività dei servizi d'informazione e altri servizi infor...,0,0,0,0,0,2023
LAZ,RI,K   ,Attività finanziarie e assicurative                         ,0,0,0,0,0,2023
LAZ,RI,K 64,Attività di servizi finanziari (escluse le assicurazioni ...,0,0,0,0,0,2023
LAZ,RI,K 65,"Assicurazioni, riassicurazioni e fondi pensione (escluse ...",0,0,0,0,0,2023
LAZ,RI,K 66,Attività ausiliarie dei servizi finanziari e delle attivi...,0,0,0,0,0,2023
LAZ,RI,L   ,Attivita' immobiliari                                       ,2,0,0,0,2,2023
LAZ,RI,L 68,Attivita' immobiliari                                       ,2,0,0,0,2,2023
LAZ,RI,M   ,"Attività professionali, scientifiche e tecniche             ",0,0,0,0,0,2023
LAZ,RI,M 69,Attività legali e contabilità                               ,0,0,0,0,0,2023
LAZ,RI,M 70,Attività di direzione aziendale e di consulenza gestional...,0,0,0,0,0,2023
LAZ,RI,M 71,Attività degli studi di architettura e d'ingegneria; coll...,0,0,0,0,0,2023
LAZ,RI,M 72,Ricerca scientifica e sviluppo                              ,0,0,0,0,0,2023
LAZ,RI,M 73,Pubblicità e ricerche di mercato                            ,0,0,0,0,0,2023
LAZ,RI,M 74,"Altre attività professionali, scientifiche e tecniche       ",0,0,0,0,0,2023
LAZ,RI,M 75,Servizi veterinari                                          ,0,0,0,0,0,2023
LAZ,RI,N   ,"Noleggio, agenzie di viaggio, servizi di supporto alle im...",1,0,1,0,2,2023
LAZ,RI,N 77,Attività di noleggio e leasing operativo                    ,0,0,0,0,0,2023
LAZ,RI,N 78,"Attività di ricerca, selezione, fornitura di personale      ",0,0,0,0,0,2023
LAZ,RI,N 79,"Attività dei servizi delle agenzie di viaggio, dei tour o...",0,0,0,0,0,2023
LAZ,RI,N 80,Servizi di vigilanza e investigazione                       ,1,0,0,0,1,2023
LAZ,RI,N 81,Attività di servizi per edifici e paesaggio                 ,0,0,1,0,1,2023
LAZ,RI,N 82,Attività di supporto per le funzioni d'ufficio e altri se...,0,0,0,0,0,2023
LAZ,RI,O   ,Amministrazione pubblica e difesa; assicurazione sociale ...,0,0,0,0,0,2023
LAZ,RI,O 84,Amministrazione pubblica e difesa; assicurazione sociale ...,0,0,0,0,0,2023
LAZ,RI,P   ,Istruzione                                                  ,0,0,0,0,0,2023
LAZ,RI,P 85,Istruzione                                                  ,0,0,0,0,0,2023
LAZ,RI,Q   ,Sanita' e assistenza sociale                                ,1,0,0,0,1,2023
LAZ,RI,Q 86,Assistenza sanitaria                                        ,0,0,0,0,0,2023
LAZ,RI,Q 87,Servizi di assistenza sociale residenziale                  ,1,0,0,0,1,2023
LAZ,RI,Q 88,Assistenza sociale non residenziale                         ,0,0,0,0,0,2023
LAZ,RI,R   ,"Attività artistiche, sportive, di intrattenimento e diver...",0,0,0,0,0,2023
LAZ,RI,R 90,"Attività creative, artistiche e di intrattenimento          ",0,0,0,0,0,2023
LAZ,RI,R 91,"Attività di biblioteche, archivi, musei ed altre attività...",0,0,0,0,0,2023
LAZ,RI,R 92,"Attività riguardanti le lotterie, le scommesse, le case d...",0,0,0,0,0,2023
LAZ,RI,R 93,"Attività sportive, di intrattenimento e di divertimento     ",0,0,0,0,0,2023
LAZ,RI,S   ,Altre attività di servizi                                   ,0,0,0,0,0,2023
LAZ,RI,S 94,Attività di organizzazioni associative                      ,0,0,0,0,0,2023
LAZ,RI,S 95,Riparazione di computer e di beni per uso personale e per...,0,0,0,0,0,2023
LAZ,RI,S 96,Altre attività di servizi per la persona                    ,0,0,0,0,0,2023
LAZ,RI,T   ,Attività di famiglie e convivenze come datori di lavoro p...,0,0,0,0,0,2023
LAZ,RI,T 97,Attività di famiglie e convivenze come datori di lavoro p...,0,0,0,0,0,2023
LAZ,RI,T 98,Produzione di beni e servizi indifferenziati per uso prop...,0,0,0,0,0,2023
LAZ,RI,U   ,Organizzazioni ed organismi extraterritoriali               ,0,0,0,0,0,2023
LAZ,RI,U 99,Organizzazioni ed organismi extraterritoriali               ,0,0,0,0,0,2023
LAZ,RI,XX  ,Imprese non classificate                                    ,3,1,0,0,4,2023
LAZ,RI,TOT ,TOTALE                                                      ,15,1,105,2,123,2023
LAZ,RM,A   ,"Agricoltura, silvicoltura pesca                             ",8,37,265,12,322,2023
LAZ,RM,A 01,"Coltivazioni agricole e produzione di prodotti animali, c...",8,35,259,10,312,2023
LAZ,RM,A 02,Silvicoltura ed utilizzo di aree forestali                  ,0,1,6,1,8,2023
LAZ,RM,A 03,Pesca e acquacoltura                                        ,0,1,0,1,2,2023
LAZ,RM,B   ,Estrazione di minerali da cave e miniere                    ,1,2,0,0,3,2023
LAZ,RM,B 05,Estrazione di carbone (esclusa torba)                       ,0,0,0,0,0,2023
LAZ,RM,B 06,Estraz.di petrolio greggio e di gas naturale                ,0,0,0,0,0,2023
LAZ,RM,B 07,Estrazione di minerali metalliferi                          ,0,1,0,0,1,2023
LAZ,RM,B 08,Altre attività di estrazione di minerali da cave e miniere  ,1,1,0,0,2,2023
LAZ,RM,B 09,Attività dei servizi di supporto all'estrazione             ,0,0,0,0,0,2023
LAZ,RM,C   ,Attività manifatturiere                                     ,58,448,301,8,815,2023
LAZ,RM,C 10,Industrie alimentari                                        ,11,69,24,0,104,2023
LAZ,RM,C 11,Industria delle bevande                                     ,0,2,0,1,3,2023
LAZ,RM,C 12,Industria del tabacco                                       ,0,0,0,0,0,2023
LAZ,RM,C 13,Industrie tessili                                           ,0,6,3,0,9,2023
LAZ,RM,C 14,Confezione di articoli di abbigliamento; confezione di ar...,6,52,39,1,98,2023
LAZ,RM,C 15,Fabbricazione di articoli in pelle e simili                 ,0,8,14,0,22,2023
LAZ,RM,C 16,Industria del legno e dei prodotti in legno e sughero (es...,0,13,32,0,45,2023
LAZ,RM,C 17,Fabbricazione di carta e di prodotti di carta               ,1,6,1,0,8,2023
LAZ,RM,C 18,Stampa e riproduzione di supporti registrati                ,6,52,13,0,71,2023
LAZ,RM,C 19,Fabbricazione di coke e prodotti derivanti dalla raffinaz...,0,2,0,0,2,2023
LAZ,RM,C 20,Fabbricazione di prodotti chimici                           ,1,11,0,0,12,2023
LAZ,RM,C 21,Fabbricazione di prodotti farmaceutici di base e di prepa...,1,1,0,0,2,2023
LAZ,RM,C 22,Fabbricazione di articoli in gomma e materie plastiche      ,1,11,0,0,12,2023
LAZ,RM,C 23,Fabbricazione di altri prodotti della lavorazione di miner..,4,15,8,0,27,2023
LAZ,RM,C 24,Metallurgia                                                 ,1,4,0,0,5,2023
LAZ,RM,C 25,Fabbricazione di prodotti in metallo (esclusi macchinari ...,10,58,51,1,120,2023
LAZ,RM,C 26,Fabbricazione di computer e prodotti di elettronica e ott...,2,43,4,0,49,2023
LAZ,RM,C 27,Fabbricazione di apparecchiature elettriche ed apparecchi...,4,16,5,0,25,2023
LAZ,RM,C 28,Fabbricazione di macchinari ed apparecchiature nca          ,3,14,1,0,18,2023
LAZ,RM,C 29,"Fabbricazione di autoveicoli, rimorchi e semirimorchi       ",0,2,0,1,3,2023
LAZ,RM,C 30,Fabbricazione di altri mezzi di trasporto                   ,0,7,2,0,9,2023
LAZ,RM,C 31,Fabbricazione di mobili                                     ,0,19,7,0,26,2023
LAZ,RM,C 32,Altre industrie manifatturiere                              ,4,22,84,2,112,2023
LAZ,RM,C 33,"Riparazione, manutenzione ed installazione di macchine ed...",3,15,13,2,33,2023
LAZ,RM,D   ,"Fornitura di energia elettrica, gas, vapore e aria condiz...",2,2,0,0,4,2023
LAZ,RM,D 35,"Fornitura di energia elettrica, gas, vapore e aria condiz...",2,2,0,0,4,2023
LAZ,RM,E   ,"Fornitura di acqua; reti fognarie, attività di gestione d...",1,8,5,4,18,2023
LAZ,RM,E 36,"Raccolta, trattamento e fornitura di acqua                  ",0,0,0,0,0,2023
LAZ,RM,E 37,Gestione delle reti fognarie                                ,0,0,0,0,0,2023
LAZ,RM,E 38,"Attività di raccolta, trattamento e smaltimento dei rifiu...",1,6,5,1,13,2023
LAZ,RM,E 39,Attività di risanamento e altri servizi di gestione dei r...,0,2,0,3,5,2023
LAZ,RM,F   ,Costruzioni                                                 ,171,646,754,175,1746,2023
LAZ,RM,F 41,Costruzione di edifici                                      ,95,333,114,127,669,2023
LAZ,RM,F 42,Ingegneria civile                                           ,2,20,5,2,29,2023
LAZ,RM,F 43,Lavori di costruzione specializzati                         ,74,293,635,46,1048,2023
LAZ,RM,G   ,Commercio all'ingrosso e al dettaglio; riparazione di aut...,283,2325,2350,42,5000,2023
LAZ,RM,G 45,Commercio all'ingrosso e al dettaglio e riparazione di au...,31,270,160,4,465,2023
LAZ,RM,G 46,Commercio all'ingrosso (escluso quello di autoveicoli e d...,105,872,686,12,1675,2023
LAZ,RM,G 47,Commercio al dettaglio (escluso quello di autoveicoli e d...,147,1183,1504,26,2860,2023
LAZ,RM,H   ,Trasporto e magazzinaggio                                   ,29,184,135,144,492,2023
LAZ,RM,H 49,Trasporto terrestre e mediante condotte                     ,12,134,101,75,322,2023
LAZ,RM,H 50,Trasporto marittimo e per vie d'acqua                       ,1,3,0,0,4,2023
LAZ,RM,H 51,Trasporto aereo                                             ,0,0,0,0,0,2023
LAZ,RM,H 52,Magazzinaggio e attività di supporto ai trasporti           ,14,39,24,69,146,2023
LAZ,RM,H 53,Servizi postali e attività di corriere                      ,2,8,10,0,20,2023
LAZ,RM,I   ,Attività dei servizi alloggio e ristorazione                ,145,1272,308,27,1752,2023
LAZ,RM,I 55,Alloggio                                                    ,18,36,17,2,73,2023
LAZ,RM,I 56,Attività dei servizi di ristorazione                        ,127,1236,291,25,1679,2023
LAZ,RM,J   ,Servizi di informazione e comunicazione                     ,68,262,179,19,528,2023
LAZ,RM,J 58,Attività editoriali                                         ,2,51,9,5,67,2023
LAZ,RM,J 59,"Attività di produzione cinematografica, di video e di pro...",4,48,21,3,76,2023
LAZ,RM,J 60,Attività di programmazione e trasmissione                   ,0,6,1,0,7,2023
LAZ,RM,J 61,Telecomunicazioni                                           ,9,66,77,1,153,2023
LAZ,RM,J 62,"Produzione di software, consulenza informatica e attività...",30,53,46,4,133,2023
LAZ,RM,J 63,Attività dei servizi d'informazione e altri servizi infor...,23,38,25,6,92,2023
LAZ,RM,K   ,Attività finanziarie e assicurative                         ,15,143,176,2,336,2023
LAZ,RM,K 64,Attività di servizi finanziari (escluse le assicurazioni ...,6,32,2,1,41,2023
LAZ,RM,K 65,"Assicurazioni, riassicurazioni e fondi pensione (escluse ...",0,8,0,0,8,2023
LAZ,RM,K 66,Attività ausiliarie dei servizi finanziari e delle attivi...,9,103,174,1,287,2023
LAZ,RM,L   ,Attivita' immobiliari                                       ,73,194,32,6,305,2023
LAZ,RM,L 68,Attivita' immobiliari                                       ,73,194,32,6,305,2023
LAZ,RM,M   ,"Attività professionali, scientifiche e tecniche             ",90,225,116,34,465,2023
LAZ,RM,M 69,Attività legali e contabilità                               ,6,25,0,2,33,2023
LAZ,RM,M 70,Attività di direzione aziendale e di consulenza gestional...,30,25,15,14,84,2023
LAZ,RM,M 71,Attività degli studi di architettura e d'ingegneria; coll...,15,17,2,2,36,2023
LAZ,RM,M 72,Ricerca scientifica e sviluppo                              ,1,6,1,0,8,2023
LAZ,RM,M 73,Pubblicità e ricerche di mercato                            ,23,68,44,6,141,2023
LAZ,RM,M 74,"Altre attività professionali, scientifiche e tecniche       ",15,82,54,10,161,2023
LAZ,RM,M 75,Servizi veterinari                                          ,0,2,0,0,2,2023
LAZ,RM,N   ,"Noleggio, agenzie di viaggio, servizi di supporto alle im...",88,274,363,130,855,2023
LAZ,RM,N 77,Attività di noleggio e leasing operativo                    ,11,48,25,2,86,2023
LAZ,RM,N 78,"Attività di ricerca, selezione, fornitura di personale      ",1,4,0,0,5,2023
LAZ,RM,N 79,"Attività dei servizi delle agenzie di viaggio, dei tour o...",11,31,10,3,55,2023
LAZ,RM,N 80,Servizi di vigilanza e investigazione                       ,3,7,1,1,12,2023
LAZ,RM,N 81,Attività di servizi per edifici e paesaggio                 ,22,76,92,80,270,2023
LAZ,RM,N 82,Attività di supporto per le funzioni d'ufficio e altri se...,40,108,235,44,427,2023
LAZ,RM,O   ,Amministrazione pubblica e difesa; assicurazione sociale ...,0,0,0,0,0,2023
LAZ,RM,O 84,Amministrazione pubblica e difesa; assicurazione sociale ...,0,0,0,0,0,2023
LAZ,RM,P   ,Istruzione                                                  ,10,21,8,7,46,2023
LAZ,RM,P 85,Istruzione                                                  ,10,21,8,7,46,2023
LAZ,RM,Q   ,Sanita' e assistenza sociale                                ,11,43,5,29,88,2023
LAZ,RM,Q 86,Assistenza sanitaria                                        ,7,41,2,5,55,2023
LAZ,RM,Q 87,Servizi di assistenza sociale residenziale                  ,3,0,1,4,8,2023
LAZ,RM,Q 88,Assistenza sociale non residenziale                         ,1,2,2,20,25,2023
LAZ,RM,R   ,"Attività artistiche, sportive, di intrattenimento e diver...",28,135,65,14,242,2023
LAZ,RM,R 90,"Attività creative, artistiche e di intrattenimento          ",4,40,31,4,79,2023
LAZ,RM,R 91,"Attività di biblioteche, archivi, musei ed altre attività...",1,3,0,1,5,2023
LAZ,RM,R 92,"Attività riguardanti le lotterie, le scommesse, le case d...",6,4,4,0,14,2023
LAZ,RM,R 93,"Attività sportive, di intrattenimento e di divertimento     ",17,88,30,9,144,2023
LAZ,RM,S   ,Altre attività di servizi                                   ,34,414,198,20,666,2023
LAZ,RM,S 94,Attività di organizzazioni associative                      ,0,3,0,2,5,2023
LAZ,RM,S 95,Riparazione di computer e di beni per uso personale e per...,0,19,52,0,71,2023
LAZ,RM,S 96,Altre attività di servizi per la persona                    ,34,392,146,18,590,2023
LAZ,RM,T   ,Attività di famiglie e convivenze come datori di lavoro p...,0,0,0,0,0,2023
LAZ,RM,T 97,Attività di famiglie e convivenze come datori di lavoro p...,0,0,0,0,0,2023
LAZ,RM,T 98,Produzione di beni e servizi indifferenziati per uso prop...,0,0,0,0,0,2023
LAZ,RM,U   ,Organizzazioni ed organismi extraterritoriali               ,0,0,0,0,0,2023
LAZ,RM,U 99,Organizzazioni ed organismi extraterritoriali               ,0,0,0,0,0,2023
LAZ,RM,XX  ,Imprese non classificate                                    ,482,235,176,268,1161,2023
LAZ,RM,TOT ,TOTALE                                                      ,1597,6870,5436,941,14844,2023
LAZ,LT,A   ,"Agricoltura, silvicoltura pesca                             ",9,6,62,2,79,2023
LAZ,LT,A 01,"Coltivazioni agricole e produzione di prodotti animali, c...",8,6,59,1,74,2023
LAZ,LT,A 02,Silvicoltura ed utilizzo di aree forestali                  ,1,0,0,0,1,2023
LAZ,LT,A 03,Pesca e acquacoltura                                        ,0,0,3,1,4,2023
LAZ,LT,B   ,Estrazione di minerali da cave e miniere                    ,1,1,0,0,2,2023
LAZ,LT,B 05,Estrazione di carbone (esclusa torba)                       ,0,0,0,0,0,2023
LAZ,LT,B 06,Estraz.di petrolio greggio e di gas naturale                ,0,0,0,0,0,2023
LAZ,LT,B 07,Estrazione di minerali metalliferi                          ,0,1,0,0,1,2023
LAZ,LT,B 08,Altre attività di estrazione di minerali da cave e miniere  ,1,0,0,0,1,2023
LAZ,LT,B 09,Attività dei servizi di supporto all'estrazione             ,0,0,0,0,0,2023
LAZ,LT,C   ,Attività manifatturiere                                     ,82,23,37,7,149,2023
LAZ,LT,C 10,Industrie alimentari                                        ,7,2,6,1,16,2023
LAZ,LT,C 11,Industria delle bevande                                     ,1,0,0,0,1,2023
LAZ,LT,C 12,Industria del tabacco                                       ,0,0,0,0,0,2023
LAZ,LT,C 13,Industrie tessili                                           ,4,0,0,1,5,2023
LAZ,LT,C 14,Confezione di articoli di abbigliamento; confezione di ar...,7,2,3,1,13,2023
LAZ,LT,C 15,Fabbricazione di articoli in pelle e simili                 ,0,1,1,0,2,2023
LAZ,LT,C 16,Industria del legno e dei prodotti in legno e sughero (es...,4,1,3,1,9,2023
LAZ,LT,C 17,Fabbricazione di carta e di prodotti di carta               ,0,0,0,0,0,2023
LAZ,LT,C 18,Stampa e riproduzione di supporti registrati                ,6,4,0,0,10,2023
LAZ,LT,C 19,Fabbricazione di coke e prodotti derivanti dalla raffinaz...,0,0,0,0,0,2023
LAZ,LT,C 20,Fabbricazione di prodotti chimici                           ,2,0,0,0,2,2023
LAZ,LT,C 21,Fabbricazione di prodotti farmaceutici di base e di prepa...,1,0,0,0,1,2023
LAZ,LT,C 22,Fabbricazione di articoli in gomma e materie plastiche      ,2,0,2,0,4,2023
LAZ,LT,C 23,Fabbricazione di altri prodotti della lavorazione di miner..,5,0,0,0,5,2023
LAZ,LT,C 24,Metallurgia                                                 ,1,0,0,0,1,2023
LAZ,LT,C 25,Fabbricazione di prodotti in metallo (esclusi macchinari ...,15,11,9,1,36,2023
LAZ,LT,C 26,Fabbricazione di computer e prodotti di elettronica e ott...,3,0,0,0,3,2023
LAZ,LT,C 27,Fabbricazione di apparecchiature elettriche ed apparecchi...,3,0,0,0,3,2023
LAZ,LT,C 28,Fabbricazione di macchinari ed apparecchiature nca          ,2,0,3,1,6,2023
LAZ,LT,C 29,"Fabbricazione di autoveicoli, rimorchi e semirimorchi       ",2,0,1,0,3,2023
LAZ,LT,C 30,Fabbricazione di altri mezzi di trasporto                   ,5,1,1,0,7,2023
LAZ,LT,C 31,Fabbricazione di mobili                                     ,8,0,0,0,8,2023
LAZ,LT,C 32,Altre industrie manifatturiere                              ,2,1,3,1,7,2023
LAZ,LT,C 33,"Riparazione, manutenzione ed installazione di macchine ed...",2,0,5,0,7,2023
LAZ,LT,D   ,"Fornitura di energia elettrica, gas, vapore e aria condiz...",1,0,1,0,2,2023
LAZ,LT,D 35,"Fornitura di energia elettrica, gas, vapore e aria condiz...",1,0,1,0,2,2023
LAZ,LT,E   ,"Fornitura di acqua; reti fognarie, attività di gestione d...",4,1,0,1,6,2023
LAZ,LT,E 36,"Raccolta, trattamento e fornitura di acqua                  ",0,0,0,0,0,2023
LAZ,LT,E 37,Gestione delle reti fognarie                                ,0,0,0,0,0,2023
LAZ,LT,E 38,"Attività di raccolta, trattamento e smaltimento dei rifiu...",4,1,0,1,6,2023
LAZ,LT,E 39,Attività di risanamento e altri servizi di gestione dei r...,0,0,0,0,0,2023
LAZ,LT,F   ,Costruzioni                                                 ,127,27,76,10,240,2023
LAZ,LT,F 41,Costruzione di edifici                                      ,92,18,16,8,134,2023
LAZ,LT,F 42,Ingegneria civile                                           ,2,0,1,0,3,2023
LAZ,LT,F 43,Lavori di costruzione specializzati                         ,33,9,59,2,103,2023
LAZ,LT,G   ,Commercio all'ingrosso e al dettaglio; riparazione di aut...,180,81,108,3,372,2023
LAZ,LT,G 45,Commercio all'ingrosso e al dettaglio e riparazione di au...,23,16,14,1,54,2023
LAZ,LT,G 46,Commercio all'ingrosso (escluso quello di autoveicoli e d...,92,20,29,2,143,2023
LAZ,LT,G 47,Commercio al dettaglio (escluso quello di autoveicoli e d...,65,45,65,0,175,2023
LAZ,LT,H   ,Trasporto e magazzinaggio                                   ,19,12,14,3,48,2023
LAZ,LT,H 49,Trasporto terrestre e mediante condotte                     ,15,10,13,1,39,2023
LAZ,LT,H 50,Trasporto marittimo e per vie d'acqua                       ,0,0,0,0,0,2023
LAZ,LT,H 51,Trasporto aereo                                             ,0,0,0,0,0,2023
LAZ,LT,H 52,Magazzinaggio e attività di supporto ai trasporti           ,4,2,1,2,9,2023
LAZ,LT,H 53,Servizi postali e attività di corriere                      ,0,0,0,0,0,2023
LAZ,LT,I   ,Attività dei servizi alloggio e ristorazione                ,65,69,38,3,175,2023
LAZ,LT,I 55,Alloggio                                                    ,3,2,4,0,9,2023
LAZ,LT,I 56,Attività dei servizi di ristorazione                        ,62,67,34,3,166,2023
LAZ,LT,J   ,Servizi di informazione e comunicazione                     ,25,4,7,1,37,2023
LAZ,LT,J 58,Attività editoriali                                         ,3,0,1,0,4,2023
LAZ,LT,J 59,"Attività di produzione cinematografica, di video e di pro...",4,0,0,0,4,2023
LAZ,LT,J 60,Attività di programmazione e trasmissione                   ,1,0,0,0,1,2023
LAZ,LT,J 61,Telecomunicazioni                                           ,1,3,3,0,7,2023
LAZ,LT,J 62,"Produzione di software, consulenza informatica e attività...",9,0,0,0,9,2023
LAZ,LT,J 63,Attività dei servizi d'informazione e altri servizi infor...,7,1,3,1,12,2023
LAZ,LT,K   ,Attività finanziarie e assicurative                         ,10,4,3,0,17,2023
LAZ,LT,K 64,Attività di servizi finanziari (escluse le assicurazioni ...,5,0,0,0,5,2023
LAZ,LT,K 65,"Assicurazioni, riassicurazioni e fondi pensione (escluse ...",2,0,0,0,2,2023
LAZ,LT,K 66,Attività ausiliarie dei servizi finanziari e delle attivi...,3,4,3,0,10,2023
LAZ,LT,L   ,Attivita' immobiliari                                       ,26,5,2,1,34,2023
LAZ,LT,L 68,Attivita' immobiliari                                       ,26,5,2,1,34,2023
LAZ,LT,M   ,"Attività professionali, scientifiche e tecniche             ",27,11,3,1,42,2023
LAZ,LT,M 69,Attività legali e contabilità                               ,2,1,0,0,3,2023
LAZ,LT,M 70,Attività di direzione aziendale e di consulenza gestional...,4,2,0,1,7,2023
LAZ,LT,M 71,Attività degli studi di architettura e d'ingegneria; coll...,2,1,0,0,3,2023
LAZ,LT,M 72,Ricerca scientifica e sviluppo                              ,0,1,0,0,1,2023
LAZ,LT,M 73,Pubblicità e ricerche di mercato                            ,12,4,0,0,16,2023
LAZ,LT,M 74,"Altre attività professionali, scientifiche e tecniche       ",7,2,3,0,12,2023
LAZ,LT,M 75,Servizi veterinari                                          ,0,0,0,0,0,2023
LAZ,LT,N   ,"Noleggio, agenzie di viaggio, servizi di supporto alle im...",17,2,13,9,41,2023
LAZ,LT,N 77,Attività di noleggio e leasing operativo                    ,5,1,2,0,8,2023
LAZ,LT,N 78,"Attività di ricerca, selezione, fornitura di personale      ",0,0,0,0,0,2023
LAZ,LT,N 79,"Attività dei servizi delle agenzie di viaggio, dei tour o...",2,0,1,0,3,2023
LAZ,LT,N 80,Servizi di vigilanza e investigazione                       ,0,0,0,1,1,2023
LAZ,LT,N 81,Attività di servizi per edifici e paesaggio                 ,2,1,8,6,17,2023
LAZ,LT,N 82,Attività di supporto per le funzioni d'ufficio e altri se...,8,0,2,2,12,2023
LAZ,LT,O   ,Amministrazione pubblica e difesa; assicurazione sociale ...,0,0,0,0,0,2023
LAZ,LT,O 84,Amministrazione pubblica e difesa; assicurazione sociale ...,0,0,0,0,0,2023
LAZ,LT,P   ,Istruzione                                                  ,2,1,0,2,5,2023
LAZ,LT,P 85,Istruzione                                                  ,2,1,0,2,5,2023
LAZ,LT,Q   ,Sanita' e assistenza sociale                                ,6,1,0,4,11,2023
LAZ,LT,Q 86,Assistenza sanitaria                                        ,6,0,0,0,6,2023
LAZ,LT,Q 87,Servizi di assistenza sociale residenziale                  ,0,1,0,2,3,2023
LAZ,LT,Q 88,Assistenza sociale non residenziale                         ,0,0,0,2,2,2023
LAZ,LT,R   ,"Attività artistiche, sportive, di intrattenimento e diver...",6,3,5,1,15,2023
LAZ,LT,R 90,"Attività creative, artistiche e di intrattenimento          ",1,1,1,0,3,2023
LAZ,LT,R 91,"Attività di biblioteche, archivi, musei ed altre attività...",0,0,0,0,0,2023
LAZ,LT,R 92,"Attività riguardanti le lotterie, le scommesse, le case d...",0,0,0,0,0,2023
LAZ,LT,R 93,"Attività sportive, di intrattenimento e di divertimento     ",5,2,4,1,12,2023
LAZ,LT,S   ,Altre attività di servizi                                   ,9,4,23,5,41,2023
LAZ,LT,S 94,Attività di organizzazioni associative                      ,0,0,0,0,0,2023
LAZ,LT,S 95,Riparazione di computer e di beni per uso personale e per...,2,2,3,1,8,2023
LAZ,LT,S 96,Altre attività di servizi per la persona                    ,7,2,20,4,33,2023
LAZ,LT,T   ,Attività di famiglie e convivenze come datori di lavoro p...,0,0,0,0,0,2023
LAZ,LT,T 97,Attività di famiglie e convivenze come datori di lavoro p...,0,0,0,0,0,2023
LAZ,LT,T 98,Produzione di beni e servizi indifferenziati per uso prop...,0,0,0,0,0,2023
LAZ,LT,U   ,Organizzazioni ed organismi extraterritoriali               ,0,0,0,0,0,2023
LAZ,LT,U 99,Organizzazioni ed organismi extraterritoriali               ,0,0,0,0,0,2023
LAZ,LT,XX  ,Imprese non classificate                                    ,7,10,23,3,43,2023
LAZ,LT,TOT ,TOTALE                                                      ,623,265,415,56,1359,2023
LAZ,FR,A   ,"Agricoltura, silvicoltura pesca                             ",6,0,95,2,103,2023
LAZ,FR,A 01,"Coltivazioni agricole e produzione di prodotti animali, c...",4,0,91,1,96,2023
LAZ,FR,A 02,Silvicoltura ed utilizzo di aree forestali                  ,2,0,4,1,7,2023
LAZ,FR,A 03,Pesca e acquacoltura                                        ,0,0,0,0,0,2023
LAZ,FR,B   ,Estrazione di minerali da cave e miniere                    ,2,1,2,0,5,2023
LAZ,FR,B 05,Estrazione di carbone (esclusa torba)                       ,0,0,0,0,0,2023
LAZ,FR,B 06,Estraz.di petrolio greggio e di gas naturale                ,0,0,0,0,0,2023
LAZ,FR,B 07,Estrazione di minerali metalliferi                          ,0,0,0,0,0,2023
LAZ,FR,B 08,Altre attività di estrazione di minerali da cave e miniere  ,2,1,2,0,5,2023
LAZ,FR,B 09,Attività dei servizi di supporto all'estrazione             ,0,0,0,0,0,2023
LAZ,FR,C   ,Attività manifatturiere                                     ,86,5,33,3,127,2023
LAZ,FR,C 10,Industrie alimentari                                        ,4,2,3,0,9,2023
LAZ,FR,C 11,Industria delle bevande                                     ,0,0,0,0,0,2023
LAZ,FR,C 12,Industria del tabacco                                       ,0,0,0,0,0,2023
LAZ,FR,C 13,Industrie tessili                                           ,4,0,1,0,5,2023
LAZ,FR,C 14,Confezione di articoli di abbigliamento; confezione di ar...,30,0,2,0,32,2023
LAZ,FR,C 15,Fabbricazione di articoli in pelle e simili                 ,1,0,0,0,1,2023
LAZ,FR,C 16,Industria del legno e dei prodotti in legno e sughero (es...,1,0,4,1,6,2023
LAZ,FR,C 17,Fabbricazione di carta e di prodotti di carta               ,1,0,0,0,1,2023
LAZ,FR,C 18,Stampa e riproduzione di supporti registrati                ,1,0,0,0,1,2023
LAZ,FR,C 19,Fabbricazione di coke e prodotti derivanti dalla raffinaz...,1,0,0,0,1,2023
LAZ,FR,C 20,Fabbricazione di prodotti chimici                           ,0,1,1,0,2,2023
LAZ,FR,C 21,Fabbricazione di prodotti farmaceutici di base e di prepa...,0,0,0,0,0,2023
LAZ,FR,C 22,Fabbricazione di articoli in gomma e materie plastiche      ,6,0,0,1,7,2023
LAZ,FR,C 23,Fabbricazione di altri prodotti della lavorazione di miner..,6,1,3,1,11,2023
LAZ,FR,C 24,Metallurgia                                                 ,1,0,0,0,1,2023
LAZ,FR,C 25,Fabbricazione di prodotti in metallo (esclusi macchinari ...,15,0,12,0,27,2023
LAZ,FR,C 26,Fabbricazione di computer e prodotti di elettronica e ott...,3,0,0,0,3,2023
LAZ,FR,C 27,Fabbricazione di apparecchiature elettriche ed apparecchi...,2,0,0,0,2,2023
LAZ,FR,C 28,Fabbricazione di macchinari ed apparecchiature nca          ,5,0,1,0,6,2023
LAZ,FR,C 29,"Fabbricazione di autoveicoli, rimorchi e semirimorchi       ",2,0,0,0,2,2023
LAZ,FR,C 30,Fabbricazione di altri mezzi di trasporto                   ,0,0,0,0,0,2023
LAZ,FR,C 31,Fabbricazione di mobili                                     ,2,1,1,0,4,2023
LAZ,FR,C 32,Altre industrie manifatturiere                              ,0,0,3,0,3,2023
LAZ,FR,C 33,"Riparazione, manutenzione ed installazione di macchine ed...",1,0,2,0,3,2023
LAZ,FR,D   ,"Fornitura di energia elettrica, gas, vapore e aria condiz...",0,0,0,0,0,2023
LAZ,FR,D 35,"Fornitura di energia elettrica, gas, vapore e aria condiz...",0,0,0,0,0,2023
LAZ,FR,E   ,"Fornitura di acqua; reti fognarie, attività di gestione d...",0,0,1,0,1,2023
LAZ,FR,E 36,"Raccolta, trattamento e fornitura di acqua                  ",0,0,0,0,0,2023
LAZ,FR,E 37,Gestione delle reti fognarie                                ,0,0,0,0,0,2023
LAZ,FR,E 38,"Attività di raccolta, trattamento e smaltimento dei rifiu...",0,0,1,0,1,2023
LAZ,FR,E 39,Attività di risanamento e altri servizi di gestione dei r...,0,0,0,0,0,2023
LAZ,FR,F   ,Costruzioni                                                 ,96,10,58,8,172,2023
LAZ,FR,F 41,Costruzione di edifici                                      ,74,8,22,6,110,2023
LAZ,FR,F 42,Ingegneria civile                                           ,0,0,1,1,2,2023
LAZ,FR,F 43,Lavori di costruzione specializzati                         ,22,2,35,1,60,2023
LAZ,FR,G   ,Commercio all'ingrosso e al dettaglio; riparazione di aut...,106,10,98,4,218,2023
LAZ,FR,G 45,Commercio all'ingrosso e al dettaglio e riparazione di au...,19,3,6,1,29,2023
LAZ,FR,G 46,Commercio all'ingrosso (escluso quello di autoveicoli e d...,42,1,21,1,65,2023
LAZ,FR,G 47,Commercio al dettaglio (escluso quello di autoveicoli e d...,45,6,71,2,124,2023
LAZ,FR,H   ,Trasporto e magazzinaggio                                   ,15,7,20,2,44,2023
LAZ,FR,H 49,Trasporto terrestre e mediante condotte                     ,13,6,19,2,40,2023
LAZ,FR,H 50,Trasporto marittimo e per vie d'acqua                       ,0,0,0,0,0,2023
LAZ,FR,H 51,Trasporto aereo                                             ,0,0,0,0,0,2023
LAZ,FR,H 52,Magazzinaggio e attività di supporto ai trasporti           ,1,1,1,0,3,2023
LAZ,FR,H 53,Servizi postali e attività di corriere                      ,1,0,0,0,1,2023
LAZ,FR,I   ,Attività dei servizi alloggio e ristorazione                ,20,7,22,5,54,2023
LAZ,FR,I 55,Alloggio                                                    ,4,1,4,0,9,2023
LAZ,FR,I 56,Attività dei servizi di ristorazione                        ,16,6,18,5,45,2023
LAZ,FR,J   ,Servizi di informazione e comunicazione                     ,11,0,0,1,12,2023
LAZ,FR,J 58,Attività editoriali                                         ,0,0,0,0,0,2023
LAZ,FR,J 59,"Attività di produzione cinematografica, di video e di pro...",0,0,0,0,0,2023
LAZ,FR,J 60,Attività di programmazione e trasmissione                   ,1,0,0,0,1,2023
LAZ,FR,J 61,Telecomunicazioni                                           ,0,0,0,0,0,2023
LAZ,FR,J 62,"Produzione di software, consulenza informatica e attività...",4,0,0,1,5,2023
LAZ,FR,J 63,Attività dei servizi d'informazione e altri servizi infor...,6,0,0,0,6,2023
LAZ,FR,K   ,Attività finanziarie e assicurative                         ,3,0,6,0,9,2023
LAZ,FR,K 64,Attività di servizi finanziari (escluse le assicurazioni ...,1,0,0,0,1,2023
LAZ,FR,K 65,"Assicurazioni, riassicurazioni e fondi pensione (escluse ...",0,0,0,0,0,2023
LAZ,FR,K 66,Attività ausiliarie dei servizi finanziari e delle attivi...,2,0,6,0,8,2023
LAZ,FR,L   ,Attivita' immobiliari                                       ,11,1,0,0,12,2023
LAZ,FR,L 68,Attivita' immobiliari                                       ,11,1,0,0,12,2023
LAZ,FR,M   ,"Attività professionali, scientifiche e tecniche             ",12,0,1,2,15,2023
LAZ,FR,M 69,Attività legali e contabilità                               ,0,0,0,0,0,2023
LAZ,FR,M 70,Attività di direzione aziendale e di consulenza gestional...,6,0,0,1,7,2023
LAZ,FR,M 71,Attività degli studi di architettura e d'ingegneria; coll...,1,0,0,0,1,2023
LAZ,FR,M 72,Ricerca scientifica e sviluppo                              ,0,0,0,0,0,2023
LAZ,FR,M 73,Pubblicità e ricerche di mercato                            ,2,0,1,1,4,2023
LAZ,FR,M 74,"Altre attività professionali, scientifiche e tecniche       ",3,0,0,0,3,2023
LAZ,FR,M 75,Servizi veterinari                                          ,0,0,0,0,0,2023
LAZ,FR,N   ,"Noleggio, agenzie di viaggio, servizi di supporto alle im...",9,0,8,1,18,2023
LAZ,FR,N 77,Attività di noleggio e leasing operativo                    ,1,0,2,0,3,2023
LAZ,FR,N 78,"Attività di ricerca, selezione, fornitura di personale      ",0,0,0,0,0,2023
LAZ,FR,N 79,"Attività dei servizi delle agenzie di viaggio, dei tour o...",3,0,0,0,3,2023
LAZ,FR,N 80,Servizi di vigilanza e investigazione                       ,0,0,0,0,0,2023
LAZ,FR,N 81,Attività di servizi per edifici e paesaggio                 ,2,0,5,0,7,2023
LAZ,FR,N 82,Attività di supporto per le funzioni d'ufficio e altri se...,3,0,1,1,5,2023
LAZ,FR,O   ,Amministrazione pubblica e difesa; assicurazione sociale ...,0,0,0,0,0,2023
LAZ,FR,O 84,Amministrazione pubblica e difesa; assicurazione sociale ...,0,0,0,0,0,2023
LAZ,FR,P   ,Istruzione                                                  ,1,0,0,1,2,2023
LAZ,FR,P 85,Istruzione                                                  ,1,0,0,1,2,2023
LAZ,FR,Q   ,Sanita' e assistenza sociale                                ,4,0,0,6,10,2023
LAZ,FR,Q 86,Assistenza sanitaria                                        ,4,0,0,0,4,2023
LAZ,FR,Q 87,Servizi di assistenza sociale residenziale                  ,0,0,0,2,2,2023
LAZ,FR,Q 88,Assistenza sociale non residenziale                         ,0,0,0,4,4,2023
LAZ,FR,R   ,"Attività artistiche, sportive, di intrattenimento e diver...",7,0,4,3,14,2023
LAZ,FR,R 90,"Attività creative, artistiche e di intrattenimento          ",2,0,0,0,2,2023
LAZ,FR,R 91,"Attività di biblioteche, archivi, musei ed altre attività...",0,0,0,0,0,2023
LAZ,FR,R 92,"Attività riguardanti le lotterie, le scommesse, le case d...",2,0,1,0,3,2023
LAZ,FR,R 93,"Attività sportive, di intrattenimento e di divertimento     ",3,0,3,3,9,2023
LAZ,FR,S   ,Altre attività di servizi                                   ,3,1,6,0,10,2023
LAZ,FR,S 94,Attività di organizzazioni associative                      ,0,0,0,0,0,2023
LAZ,FR,S 95,Riparazione di computer e di beni per uso personale e per...,1,0,2,0,3,2023
LAZ,FR,S 96,Altre attività di servizi per la persona                    ,2,1,4,0,7,2023
LAZ,FR,T   ,Attività di famiglie e convivenze come datori di lavoro p...,0,0,0,0,0,2023
LAZ,FR,T 97,Attività di famiglie e convivenze come datori di lavoro p...,0,0,0,0,0,2023
LAZ,FR,T 98,Produzione di beni e servizi indifferenziati per uso prop...,0,0,0,0,0,2023
LAZ,FR,U   ,Organizzazioni ed organismi extraterritoriali               ,0,0,0,0,0,2023
LAZ,FR,U 99,Organizzazioni ed organismi extraterritoriali               ,0,0,0,0,0,2023
LAZ,FR,XX  ,Imprese non classificate                                    ,182,13,1,9,205,2023
LAZ,FR,TOT ,TOTALE                                                      ,574,55,355,47,1031,2023
ABR,  ,A   ,"Agricoltura, silvicoltura pesca                             ",2,4,679,4,689,2023
ABR,  ,A 01,"Coltivazioni agricole e produzione di prodotti animali, c...",2,3,662,3,670,2023
ABR,  ,A 02,Silvicoltura ed utilizzo di aree forestali                  ,0,0,10,1,11,2023
ABR,  ,A 03,Pesca e acquacoltura                                        ,0,1,7,0,8,2023
ABR,  ,B   ,Estrazione di minerali da cave e miniere                    ,0,0,2,0,2,2023
ABR,  ,B 05,Estrazione di carbone (esclusa torba)                       ,0,0,0,0,0,2023
ABR,  ,B 06,Estraz.di petrolio greggio e di gas naturale                ,0,0,0,0,0,2023
ABR,  ,B 07,Estrazione di minerali metalliferi                          ,0,0,0,0,0,2023
ABR,  ,B 08,Altre attività di estrazione di minerali da cave e miniere  ,0,0,2,0,2,2023
ABR,  ,B 09,Attività dei servizi di supporto all'estrazione             ,0,0,0,0,0,2023
ABR,  ,C   ,Attività manifatturiere                                     ,22,39,243,5,309,2023
ABR,  ,C 10,Industrie alimentari                                        ,0,3,24,1,28,2023
ABR,  ,C 11,Industria delle bevande                                     ,1,0,3,0,4,2023
ABR,  ,C 12,Industria del tabacco                                       ,0,0,0,0,0,2023
ABR,  ,C 13,Industrie tessili                                           ,1,2,13,0,16,2023
ABR,  ,C 14,Confezione di articoli di abbigliamento; confezione di ar...,3,6,70,1,80,2023
ABR,  ,C 15,Fabbricazione di articoli in pelle e simili                 ,2,3,32,1,38,2023
ABR,  ,C 16,Industria del legno e dei prodotti in legno e sughero (es...,0,4,18,0,22,2023
ABR,  ,C 17,Fabbricazione di carta e di prodotti di carta               ,1,0,3,0,4,2023
ABR,  ,C 18,Stampa e riproduzione di supporti registrati                ,1,3,6,0,10,2023
ABR,  ,C 19,Fabbricazione di coke e prodotti derivanti dalla raffinaz...,1,0,0,0,1,2023
ABR,  ,C 20,Fabbricazione di prodotti chimici                           ,2,0,0,0,2,2023
ABR,  ,C 21,Fabbricazione di prodotti farmaceutici di base e di prepa...,0,0,0,0,0,2023
ABR,  ,C 22,Fabbricazione di articoli in gomma e materie plastiche      ,2,2,3,0,7,2023
ABR,  ,C 23,Fabbricazione di altri prodotti della lavorazione di miner..,1,2,6,0,9,2023
ABR,  ,C 24,Metallurgia                                                 ,3,0,2,0,5,2023
ABR,  ,C 25,Fabbricazione di prodotti in metallo (esclusi macchinari ...,1,4,28,0,33,2023
ABR,  ,C 26,Fabbricazione di computer e prodotti di elettronica e ott...,0,1,4,0,5,2023
ABR,  ,C 27,Fabbricazione di apparecchiature elettriche ed apparecchi...,2,0,5,0,7,2023
ABR,  ,C 28,Fabbricazione di macchinari ed apparecchiature nca          ,0,2,5,0,7,2023
ABR,  ,C 29,"Fabbricazione di autoveicoli, rimorchi e semirimorchi       ",0,0,1,0,1,2023
ABR,  ,C 30,Fabbricazione di altri mezzi di trasporto                   ,1,0,1,0,2,2023
ABR,  ,C 31,Fabbricazione di mobili                                     ,0,3,2,0,5,2023
ABR,  ,C 32,Altre industrie manifatturiere                              ,0,2,10,2,14,2023
ABR,  ,C 33,"Riparazione, manutenzione ed installazione di macchine ed...",0,2,7,0,9,2023
ABR,  ,D   ,"Fornitura di energia elettrica, gas, vapore e aria condiz...",0,0,0,0,0,2023
ABR,  ,D 35,"Fornitura di energia elettrica, gas, vapore e aria condiz...",0,0,0,0,0,2023
ABR,  ,E   ,"Fornitura di acqua; reti fognarie, attività di gestione d...",0,0,5,0,5,2023
ABR,  ,E 36,"Raccolta, trattamento e fornitura di acqua                  ",0,0,0,0,0,2023
ABR,  ,E 37,Gestione delle reti fognarie                                ,0,0,1,0,1,2023
ABR,  ,E 38,"Attività di raccolta, trattamento e smaltimento dei rifiu...",0,0,3,0,3,2023
ABR,  ,E 39,Attività di risanamento e altri servizi di gestione dei r...,0,0,1,0,1,2023
ABR,  ,F   ,Costruzioni                                                 ,5,38,518,19,580,2023
ABR,  ,F 41,Costruzione di edifici                                      ,4,22,183,17,226,2023
ABR,  ,F 42,Ingegneria civile                                           ,1,0,7,0,8,2023
ABR,  ,F 43,Lavori di costruzione specializzati                         ,0,16,328,2,346,2023
ABR,  ,G   ,Commercio all'ingrosso e al dettaglio; riparazione di aut...,9,111,782,3,905,2023
ABR,  ,G 45,Commercio all'ingrosso e al dettaglio e riparazione di au...,0,10,59,0,69,2023
ABR,  ,G 46,Commercio all'ingrosso (escluso quello di autoveicoli e d...,3,36,156,1,196,2023
ABR,  ,G 47,Commercio al dettaglio (escluso quello di autoveicoli e d...,6,65,567,2,640,2023
ABR,  ,H   ,Trasporto e magazzinaggio                                   ,2,6,51,2,61,2023
ABR,  ,H 49,Trasporto terrestre e mediante condotte                     ,1,4,45,1,51,2023
ABR,  ,H 50,Trasporto marittimo e per vie d'acqua                       ,0,0,0,0,0,2023
ABR,  ,H 51,Trasporto aereo                                             ,0,0,0,0,0,2023
ABR,  ,H 52,Magazzinaggio e attività di supporto ai trasporti           ,1,2,5,1,9,2023
ABR,  ,H 53,Servizi postali e attività di corriere                      ,0,0,1,0,1,2023
ABR,  ,I   ,Attività dei servizi alloggio e ristorazione                ,0,92,178,4,274,2023
ABR,  ,I 55,Alloggio                                                    ,0,7,15,1,23,2023
ABR,  ,I 56,Attività dei servizi di ristorazione                        ,0,85,163,3,251,2023
ABR,  ,J   ,Servizi di informazione e comunicazione                     ,1,9,41,2,53,2023
ABR,  ,J 58,Attività editoriali                                         ,0,0,3,1,4,2023
ABR,  ,J 59,"Attività di produzione cinematografica, di video e di pro...",0,1,4,0,5,2023
ABR,  ,J 60,Attività di programmazione e trasmissione                   ,0,0,0,0,0,2023
ABR,  ,J 61,Telecomunicazioni                                           ,0,2,9,1,12,2023
ABR,  ,J 62,"Produzione di software, consulenza informatica e attività...",0,0,8,0,8,2023
ABR,  ,J 63,Attività dei servizi d'informazione e altri servizi infor...,1,6,17,0,24,2023
ABR,  ,K   ,Attività finanziarie e assicurative                         ,1,1,25,1,28,2023
ABR,  ,K 64,Attività di servizi finanziari (escluse le assicurazioni ...,1,0,0,0,1,2023
ABR,  ,K 65,"Assicurazioni, riassicurazioni e fondi pensione (escluse ...",0,0,0,0,0,2023
ABR,  ,K 66,Attività ausiliarie dei servizi finanziari e delle attivi...,0,1,25,1,27,2023
ABR,  ,L   ,Attivita' immobiliari                                       ,1,2,13,0,16,2023
ABR,  ,L 68,Attivita' immobiliari                                       ,1,2,13,0,16,2023
ABR,  ,M   ,"Attività professionali, scientifiche e tecniche             ",0,4,48,5,57,2023
ABR,  ,M 69,Attività legali e contabilità                               ,0,0,2,0,2,2023
ABR,  ,M 70,Attività di direzione aziendale e di consulenza gestional...,0,2,6,3,11,2023
ABR,  ,M 71,Attività degli studi di architettura e d'ingegneria; coll...,0,0,1,1,2,2023
ABR,  ,M 72,Ricerca scientifica e sviluppo                              ,0,0,0,0,0,2023
ABR,  ,M 73,Pubblicità e ricerche di mercato                            ,0,1,15,0,16,2023
ABR,  ,M 74,"Altre attività professionali, scientifiche e tecniche       ",0,1,24,1,26,2023
ABR,  ,M 75,Servizi veterinari                                          ,0,0,0,0,0,2023
ABR,  ,N   ,"Noleggio, agenzie di viaggio, servizi di supporto alle im...",1,6,82,15,104,2023
ABR,  ,N 77,Attività di noleggio e leasing operativo                    ,0,0,14,1,15,2023
ABR,  ,N 78,"Attività di ricerca, selezione, fornitura di personale      ",0,0,0,0,0,2023
ABR,  ,N 79,"Attività dei servizi delle agenzie di viaggio, dei tour o...",0,1,4,2,7,2023
ABR,  ,N 80,Servizi di vigilanza e investigazione                       ,0,0,2,0,2,2023
ABR,  ,N 81,Attività di servizi per edifici e paesaggio                 ,0,1,25,10,36,2023
ABR,  ,N 82,Attività di supporto per le funzioni d'ufficio e altri se...,1,4,37,2,44,2023
ABR,  ,O   ,Amministrazione pubblica e difesa; assicurazione sociale ...,0,0,0,0,0,2023
ABR,  ,O 84,Amministrazione pubblica e difesa; assicurazione sociale ...,0,0,0,0,0,2023
ABR,  ,P   ,Istruzione                                                  ,1,3,2,1,7,2023
ABR,  ,P 85,Istruzione                                                  ,1,3,2,1,7,2023
ABR,  ,Q   ,Sanita' e assistenza sociale                                ,0,3,9,11,23,2023
ABR,  ,Q 86,Assistenza sanitaria                                        ,0,0,5,1,6,2023
ABR,  ,Q 87,Servizi di assistenza sociale residenziale                  ,0,1,0,0,1,2023
ABR,  ,Q 88,Assistenza sociale non residenziale                         ,0,2,4,10,16,2023
ABR,  ,R   ,"Attività artistiche, sportive, di intrattenimento e diver...",0,4,27,5,36,2023
ABR,  ,R 90,"Attività creative, artistiche e di intrattenimento          ",0,0,7,0,7,2023
ABR,  ,R 91,"Attività di biblioteche, archivi, musei ed altre attività...",0,0,0,1,1,2023
ABR,  ,R 92,"Attività riguardanti le lotterie, le scommesse, le case d...",0,1,2,1,4,2023
ABR,  ,R 93,"Attività sportive, di intrattenimento e di divertimento     ",0,3,18,3,24,2023
ABR,  ,S   ,Altre attività di servizi                                   ,0,8,58,5,71,2023
ABR,  ,S 94,Attività di organizzazioni associative                      ,0,0,0,1,1,2023
ABR,  ,S 95,Riparazione di computer e di beni per uso personale e per...,0,2,24,1,27,2023
ABR,  ,S 96,Altre attività di servizi per la persona                    ,0,6,34,3,43,2023
ABR,  ,T   ,Attività di famiglie e convivenze come datori di lavoro p...,0,0,0,0,0,2023
ABR,  ,T 97,Attività di famiglie e convivenze come datori di lavoro p...,0,0,0,0,0,2023
ABR,  ,T 98,Produzione di beni e servizi indifferenziati per uso prop...,0,0,0,0,0,2023
ABR,  ,U   ,Organizzazioni ed organismi extraterritoriali               ,0,0,0,0,0,2023
ABR,  ,U 99,Organizzazioni ed organismi extraterritoriali               ,0,0,0,0,0,2023
ABR,  ,XX  ,Imprese non classificate                                    ,5,58,138,12,213,2023
ABR,  ,TOT ,TOTALE                                                      ,50,388,2901,94,3433,2023
ABR,AQ,A   ,"Agricoltura, silvicoltura pesca                             ",0,1,117,2,120,2023
ABR,AQ,A 01,"Coltivazioni agricole e produzione di prodotti animali, c...",0,1,111,1,113,2023
ABR,AQ,A 02,Silvicoltura ed utilizzo di aree forestali                  ,0,0,6,1,7,2023
ABR,AQ,A 03,Pesca e acquacoltura                                        ,0,0,0,0,0,2023
ABR,AQ,B   ,Estrazione di minerali da cave e miniere                    ,0,0,1,0,1,2023
ABR,AQ,B 05,Estrazione di carbone (esclusa torba)                       ,0,0,0,0,0,2023
ABR,AQ,B 06,Estraz.di petrolio greggio e di gas naturale                ,0,0,0,0,0,2023
ABR,AQ,B 07,Estrazione di minerali metalliferi                          ,0,0,0,0,0,2023
ABR,AQ,B 08,Altre attività di estrazione di minerali da cave e miniere  ,0,0,1,0,1,2023
ABR,AQ,B 09,Attività dei servizi di supporto all'estrazione             ,0,0,0,0,0,2023
ABR,AQ,C   ,Attività manifatturiere                                     ,0,8,61,0,69,2023
ABR,AQ,C 10,Industrie alimentari                                        ,0,0,15,0,15,2023
ABR,AQ,C 11,Industria delle bevande                                     ,0,0,1,0,1,2023
ABR,AQ,C 12,Industria del tabacco                                       ,0,0,0,0,0,2023
ABR,AQ,C 13,Industrie tessili                                           ,0,0,0,0,0,2023
ABR,AQ,C 14,Confezione di articoli di abbigliamento; confezione di ar...,0,1,1,0,2,2023
ABR,AQ,C 15,Fabbricazione di articoli in pelle e simili                 ,0,0,0,0,0,2023
ABR,AQ,C 16,Industria del legno e dei prodotti in legno e sughero (es...,0,3,15,0,18,2023
ABR,AQ,C 17,Fabbricazione di carta e di prodotti di carta               ,0,0,0,0,0,2023
ABR,AQ,C 18,Stampa e riproduzione di supporti registrati                ,0,0,4,0,4,2023
ABR,AQ,C 19,Fabbricazione di coke e prodotti derivanti dalla raffinaz...,0,0,0,0,0,2023
ABR,AQ,C 20,Fabbricazione di prodotti chimici                           ,0,0,0,0,0,2023
ABR,AQ,C 21,Fabbricazione di prodotti farmaceutici di base e di prepa...,0,0,0,0,0,2023
ABR,AQ,C 22,Fabbricazione di articoli in gomma e materie plastiche      ,0,0,0,0,0,2023
ABR,AQ,C 23,Fabbricazione di altri prodotti della lavorazione di miner..,0,1,3,0,4,2023
ABR,AQ,C 24,Metallurgia                                                 ,0,0,1,0,1,2023
ABR,AQ,C 25,Fabbricazione di prodotti in metallo (esclusi macchinari ...,0,1,9,0,10,2023
ABR,AQ,C 26,Fabbricazione di computer e prodotti di elettronica e ott...,0,0,1,0,1,2023
ABR,AQ,C 27,Fabbricazione di apparecchiature elettriche ed apparecchi...,0,0,0,0,0,2023
ABR,AQ,C 28,Fabbricazione di macchinari ed apparecchiature nca          ,0,0,1,0,1,2023
ABR,AQ,C 29,"Fabbricazione di autoveicoli, rimorchi e semirimorchi       ",0,0,0,0,0,2023
ABR,AQ,C 30,Fabbricazione di altri mezzi di trasporto                   ,0,0,1,0,1,2023
ABR,AQ,C 31,Fabbricazione di mobili                                     ,0,0,1,0,1,2023
ABR,AQ,C 32,Altre industrie manifatturiere                              ,0,2,4,0,6,2023
ABR,AQ,C 33,"Riparazione, manutenzione ed installazione di macchine ed...",0,0,4,0,4,2023
ABR,AQ,D   ,"Fornitura di energia elettrica, gas, vapore e aria condiz...",0,0,0,0,0,2023
ABR,AQ,D 35,"Fornitura di energia elettrica, gas, vapore e aria condiz...",0,0,0,0,0,2023
ABR,AQ,E   ,"Fornitura di acqua; reti fognarie, attività di gestione d...",0,0,2,0,2,2023
ABR,AQ,E 36,"Raccolta, trattamento e fornitura di acqua                  ",0,0,0,0,0,2023
ABR,AQ,E 37,Gestione delle reti fognarie                                ,0,0,1,0,1,2023
ABR,AQ,E 38,"Attività di raccolta, trattamento e smaltimento dei rifiu...",0,0,0,0,0,2023
ABR,AQ,E 39,Attività di risanamento e altri servizi di gestione dei r...,0,0,1,0,1,2023
ABR,AQ,F   ,Costruzioni                                                 ,0,12,237,15,264,2023
ABR,AQ,F 41,Costruzione di edifici                                      ,0,8,80,14,102,2023
ABR,AQ,F 42,Ingegneria civile                                           ,0,0,4,0,4,2023
ABR,AQ,F 43,Lavori di costruzione specializzati                         ,0,4,153,1,158,2023
ABR,AQ,G   ,Commercio all'ingrosso e al dettaglio; riparazione di aut...,0,32,281,1,314,2023
ABR,AQ,G 45,Commercio all'ingrosso e al dettaglio e riparazione di au...,0,4,26,0,30,2023
ABR,AQ,G 46,Commercio all'ingrosso (escluso quello di autoveicoli e d...,0,3,46,1,50,2023
ABR,AQ,G 47,Commercio al dettaglio (escluso quello di autoveicoli e d...,0,25,209,0,234,2023
ABR,AQ,H   ,Trasporto e magazzinaggio                                   ,0,1,25,0,26,2023
ABR,AQ,H 49,Trasporto terrestre e mediante condotte                     ,0,1,22,0,23,2023
ABR,AQ,H 50,Trasporto marittimo e per vie d'acqua                       ,0,0,0,0,0,2023
ABR,AQ,H 51,Trasporto aereo                                             ,0,0,0,0,0,2023
ABR,AQ,H 52,Magazzinaggio e attività di supporto ai trasporti           ,0,0,2,0,2,2023
ABR,AQ,H 53,Servizi postali e attività di corriere                      ,0,0,1,0,1,2023
ABR,AQ,I   ,Attività dei servizi alloggio e ristorazione                ,0,33,75,0,108,2023
ABR,AQ,I 55,Alloggio                                                    ,0,3,7,0,10,2023
ABR,AQ,I 56,Attività dei servizi di ristorazione                        ,0,30,68,0,98,2023
ABR,AQ,J   ,Servizi di informazione e comunicazione                     ,0,6,19,0,25,2023
ABR,AQ,J 58,Attività editoriali                                         ,0,0,0,0,0,2023
ABR,AQ,J 59,"Attività di produzione cinematografica, di video e di pro...",0,0,2,0,2,2023
ABR,AQ,J 60,Attività di programmazione e trasmissione                   ,0,0,0,0,0,2023
ABR,AQ,J 61,Telecomunicazioni                                           ,0,2,7,0,9,2023
ABR,AQ,J 62,"Produzione di software, consulenza informatica e attività...",0,0,2,0,2,2023
ABR,AQ,J 63,Attività dei servizi d'informazione e altri servizi infor...,0,4,8,0,12,2023
ABR,AQ,K   ,Attività finanziarie e assicurative                         ,0,1,16,0,17,2023
ABR,AQ,K 64,Attività di servizi finanziari (escluse le assicurazioni ...,0,0,0,0,0,2023
ABR,AQ,K 65,"Assicurazioni, riassicurazioni e fondi pensione (escluse ...",0,0,0,0,0,2023
ABR,AQ,K 66,Attività ausiliarie dei servizi finanziari e delle attivi...,0,1,16,0,17,2023
ABR,AQ,L   ,Attivita' immobiliari                                       ,0,0,3,0,3,2023
ABR,AQ,L 68,Attivita' immobiliari                                       ,0,0,3,0,3,2023
ABR,AQ,M   ,"Attività professionali, scientifiche e tecniche             ",0,3,19,2,24,2023
ABR,AQ,M 69,Attività legali e contabilità                               ,0,0,0,0,0,2023
ABR,AQ,M 70,Attività di direzione aziendale e di consulenza gestional...,0,2,1,1,4,2023
ABR,AQ,M 71,Attività degli studi di architettura e d'ingegneria; coll...,0,0,1,0,1,2023
ABR,AQ,M 72,Ricerca scientifica e sviluppo                              ,0,0,0,0,0,2023
ABR,AQ,M 73,Pubblicità e ricerche di mercato                            ,0,1,8,0,9,2023
ABR,AQ,M 74,"Altre attività professionali, scientifiche e tecniche       ",0,0,9,1,10,2023
ABR,AQ,M 75,Servizi veterinari                                          ,0,0,0,0,0,2023
ABR,AQ,N   ,"Noleggio, agenzie di viaggio, servizi di supporto alle im...",0,0,34,4,38,2023
ABR,AQ,N 77,Attività di noleggio e leasing operativo                    ,0,0,4,0,4,2023
ABR,AQ,N 78,"Attività di ricerca, selezione, fornitura di personale      ",0,0,0,0,0,2023
ABR,AQ,N 79,"Attività dei servizi delle agenzie di viaggio, dei tour o...",0,0,1,1,2,2023
ABR,AQ,N 80,Servizi di vigilanza e investigazione                       ,0,0,1,0,1,2023
ABR,AQ,N 81,Attività di servizi per edifici e paesaggio                 ,0,0,12,3,15,2023
ABR,AQ,N 82,Attività di supporto per le funzioni d'ufficio e altri se...,0,0,16,0,16,2023
ABR,AQ,O   ,Amministrazione pubblica e difesa; assicurazione sociale ...,0,0,0,0,0,2023
ABR,AQ,O 84,Amministrazione pubblica e difesa; assicurazione sociale ...,0,0,0,0,0,2023
ABR,AQ,P   ,Istruzione                                                  ,0,3,1,0,4,2023
ABR,AQ,P 85,Istruzione                                                  ,0,3,1,0,4,2023
ABR,AQ,Q   ,Sanita' e assistenza sociale                                ,0,2,2,2,6,2023
ABR,AQ,Q 86,Assistenza sanitaria                                        ,0,0,1,0,1,2023
ABR,AQ,Q 87,Servizi di assistenza sociale residenziale                  ,0,1,0,0,1,2023
ABR,AQ,Q 88,Assistenza sociale non residenziale                         ,0,1,1,2,4,2023
ABR,AQ,R   ,"Attività artistiche, sportive, di intrattenimento e diver...",0,2,11,1,14,2023
ABR,AQ,R 90,"Attività creative, artistiche e di intrattenimento          ",0,0,5,0,5,2023
ABR,AQ,R 91,"Attività di biblioteche, archivi, musei ed altre attività...",0,0,0,0,0,2023
ABR,AQ,R 92,"Attività riguardanti le lotterie, le scommesse, le case d...",0,1,1,0,2,2023
ABR,AQ,R 93,"Attività sportive, di intrattenimento e di divertimento     ",0,1,5,1,7,2023
ABR,AQ,S   ,Altre attività di servizi                                   ,0,5,29,1,35,2023
ABR,AQ,S 94,Attività di organizzazioni associative                      ,0,0,0,0,0,2023
ABR,AQ,S 95,Riparazione di computer e di beni per uso personale e per...,0,1,17,0,18,2023
ABR,AQ,S 96,Altre attività di servizi per la persona                    ,0,4,12,1,17,2023
ABR,AQ,T   ,Attività di famiglie e convivenze come datori di lavoro p...,0,0,0,0,0,2023
ABR,AQ,T 97,Attività di famiglie e convivenze come datori di lavoro p...,0,0,0,0,0,2023
ABR,AQ,T 98,Produzione di beni e servizi indifferenziati per uso prop...,0,0,0,0,0,2023
ABR,AQ,U   ,Organizzazioni ed organismi extraterritoriali               ,0,0,0,0,0,2023
ABR,AQ,U 99,Organizzazioni ed organismi extraterritoriali               ,0,0,0,0,0,2023
ABR,AQ,XX  ,Imprese non classificate                                    ,0,25,36,0,61,2023
ABR,AQ,TOT ,TOTALE                                                      ,0,134,969,28,1131,2023
ABR,TE,A   ,"Agricoltura, silvicoltura pesca                             ",0,1,189,1,191,2023
ABR,TE,A 01,"Coltivazioni agricole e produzione di prodotti animali, c...",0,1,181,1,183,2023
ABR,TE,A 02,Silvicoltura ed utilizzo di aree forestali                  ,0,0,2,0,2,2023
ABR,TE,A 03,Pesca e acquacoltura                                        ,0,0,6,0,6,2023
ABR,TE,B   ,Estrazione di minerali da cave e miniere                    ,0,0,1,0,1,2023
ABR,TE,B 05,Estrazione di carbone (esclusa torba)                       ,0,0,0,0,0,2023
ABR,TE,B 06,Estraz.di petrolio greggio e di gas naturale                ,0,0,0,0,0,2023
ABR,TE,B 07,Estrazione di minerali metalliferi                          ,0,0,0,0,0,2023
ABR,TE,B 08,Altre attività di estrazione di minerali da cave e miniere  ,0,0,1,0,1,2023
ABR,TE,B 09,Attività dei servizi di supporto all'estrazione             ,0,0,0,0,0,2023
ABR,TE,C   ,Attività manifatturiere                                     ,0,17,154,2,173,2023
ABR,TE,C 10,Industrie alimentari                                        ,0,2,5,0,7,2023
ABR,TE,C 11,Industria delle bevande                                     ,0,0,2,0,2,2023
ABR,TE,C 12,Industria del tabacco                                       ,0,0,0,0,0,2023
ABR,TE,C 13,Industrie tessili                                           ,0,2,12,0,14,2023
ABR,TE,C 14,Confezione di articoli di abbigliamento; confezione di ar...,0,3,62,0,65,2023
ABR,TE,C 15,Fabbricazione di articoli in pelle e simili                 ,0,3,32,0,35,2023
ABR,TE,C 16,Industria del legno e dei prodotti in legno e sughero (es...,0,0,2,0,2,2023
ABR,TE,C 17,Fabbricazione di carta e di prodotti di carta               ,0,0,3,0,3,2023
ABR,TE,C 18,Stampa e riproduzione di supporti registrati                ,0,2,2,0,4,2023
ABR,TE,C 19,Fabbricazione di coke e prodotti derivanti dalla raffinaz...,0,0,0,0,0,2023
ABR,TE,C 20,Fabbricazione di prodotti chimici                           ,0,0,0,0,0,2023
ABR,TE,C 21,Fabbricazione di prodotti farmaceutici di base e di prepa...,0,0,0,0,0,2023
ABR,TE,C 22,Fabbricazione di articoli in gomma e materie plastiche      ,0,2,2,0,4,2023
ABR,TE,C 23,Fabbricazione di altri prodotti della lavorazione di miner..,0,1,2,0,3,2023
ABR,TE,C 24,Metallurgia                                                 ,0,0,1,0,1,2023
ABR,TE,C 25,Fabbricazione di prodotti in metallo (esclusi macchinari ...,0,1,14,0,15,2023
ABR,TE,C 26,Fabbricazione di computer e prodotti di elettronica e ott...,0,0,1,0,1,2023
ABR,TE,C 27,Fabbricazione di apparecchiature elettriche ed apparecchi...,0,0,4,0,4,2023
ABR,TE,C 28,Fabbricazione di macchinari ed apparecchiature nca          ,0,0,3,0,3,2023
ABR,TE,C 29,"Fabbricazione di autoveicoli, rimorchi e semirimorchi       ",0,0,1,0,1,2023
ABR,TE,C 30,Fabbricazione di altri mezzi di trasporto                   ,0,0,0,0,0,2023
ABR,TE,C 31,Fabbricazione di mobili                                     ,0,0,1,0,1,2023
ABR,TE,C 32,Altre industrie manifatturiere                              ,0,0,4,2,6,2023
ABR,TE,C 33,"Riparazione, manutenzione ed installazione di macchine ed...",0,1,1,0,2,2023
ABR,TE,D   ,"Fornitura di energia elettrica, gas, vapore e aria condiz...",0,0,0,0,0,2023
ABR,TE,D 35,"Fornitura di energia elettrica, gas, vapore e aria condiz...",0,0,0,0,0,2023
ABR,TE,E   ,"Fornitura di acqua; reti fognarie, attività di gestione d...",0,0,1,0,1,2023
ABR,TE,E 36,"Raccolta, trattamento e fornitura di acqua                  ",0,0,0,0,0,2023
ABR,TE,E 37,Gestione delle reti fognarie                                ,0,0,0,0,0,2023
ABR,TE,E 38,"Attività di raccolta, trattamento e smaltimento dei rifiu...",0,0,1,0,1,2023
ABR,TE,E 39,Attività di risanamento e altri servizi di gestione dei r...,0,0,0,0,0,2023
ABR,TE,F   ,Costruzioni                                                 ,0,14,226,1,241,2023
ABR,TE,F 41,Costruzione di edifici                                      ,0,4,76,1,81,2023
ABR,TE,F 42,Ingegneria civile                                           ,0,0,2,0,2,2023
ABR,TE,F 43,Lavori di costruzione specializzati                         ,0,10,148,0,158,2023
ABR,TE,G   ,Commercio all'ingrosso e al dettaglio; riparazione di aut...,0,29,348,0,377,2023
ABR,TE,G 45,Commercio all'ingrosso e al dettaglio e riparazione di au...,0,3,18,0,21,2023
ABR,TE,G 46,Commercio all'ingrosso (escluso quello di autoveicoli e d...,0,9,65,0,74,2023
ABR,TE,G 47,Commercio al dettaglio (escluso quello di autoveicoli e d...,0,17,265,0,282,2023
ABR,TE,H   ,Trasporto e magazzinaggio                                   ,0,3,14,0,17,2023
ABR,TE,H 49,Trasporto terrestre e mediante condotte                     ,0,3,12,0,15,2023
ABR,TE,H 50,Trasporto marittimo e per vie d'acqua                       ,0,0,0,0,0,2023
ABR,TE,H 51,Trasporto aereo                                             ,0,0,0,0,0,2023
ABR,TE,H 52,Magazzinaggio e attività di supporto ai trasporti           ,0,0,2,0,2,2023
ABR,TE,H 53,Servizi postali e attività di corriere                      ,0,0,0,0,0,2023
ABR,TE,I   ,Attività dei servizi alloggio e ristorazione                ,0,44,65,1,110,2023
ABR,TE,I 55,Alloggio                                                    ,0,3,4,0,7,2023
ABR,TE,I 56,Attività dei servizi di ristorazione                        ,0,41,61,1,103,2023
ABR,TE,J   ,Servizi di informazione e comunicazione                     ,0,1,13,2,16,2023
ABR,TE,J 58,Attività editoriali                                         ,0,0,1,1,2,2023
ABR,TE,J 59,"Attività di produzione cinematografica, di video e di pro...",0,0,1,0,1,2023
ABR,TE,J 60,Attività di programmazione e trasmissione                   ,0,0,0,0,0,2023
ABR,TE,J 61,Telecomunicazioni                                           ,0,0,2,1,3,2023
ABR,TE,J 62,"Produzione di software, consulenza informatica e attività...",0,0,5,0,5,2023
ABR,TE,J 63,Attività dei servizi d'informazione e altri servizi infor...,0,1,4,0,5,2023
ABR,TE,K   ,Attività finanziarie e assicurative                         ,0,0,4,0,4,2023
ABR,TE,K 64,Attività di servizi finanziari (escluse le assicurazioni ...,0,0,0,0,0,2023
ABR,TE,K 65,"Assicurazioni, riassicurazioni e fondi pensione (escluse ...",0,0,0,0,0,2023
ABR,TE,K 66,Attività ausiliarie dei servizi finanziari e delle attivi...,0,0,4,0,4,2023
ABR,TE,L   ,Attivita' immobiliari                                       ,0,2,5,0,7,2023
ABR,TE,L 68,Attivita' immobiliari                                       ,0,2,5,0,7,2023
ABR,TE,M   ,"Attività professionali, scientifiche e tecniche             ",0,0,19,1,20,2023
ABR,TE,M 69,Attività legali e contabilità                               ,0,0,0,0,0,2023
ABR,TE,M 70,Attività di direzione aziendale e di consulenza gestional...,0,0,4,1,5,2023
ABR,TE,M 71,Attività degli studi di architettura e d'ingegneria; coll...,0,0,0,0,0,2023
ABR,TE,M 72,Ricerca scientifica e sviluppo                              ,0,0,0,0,0,2023
ABR,TE,M 73,Pubblicità e ricerche di mercato                            ,0,0,4,0,4,2023
ABR,TE,M 74,"Altre attività professionali, scientifiche e tecniche       ",0,0,11,0,11,2023
ABR,TE,M 75,Servizi veterinari                                          ,0,0,0,0,0,2023
ABR,TE,N   ,"Noleggio, agenzie di viaggio, servizi di supporto alle im...",0,3,27,5,35,2023
ABR,TE,N 77,Attività di noleggio e leasing operativo                    ,0,0,6,1,7,2023
ABR,TE,N 78,"Attività di ricerca, selezione, fornitura di personale      ",0,0,0,0,0,2023
ABR,TE,N 79,"Attività dei servizi delle agenzie di viaggio, dei tour o...",0,1,1,0,2,2023
ABR,TE,N 80,Servizi di vigilanza e investigazione                       ,0,0,0,0,0,2023
ABR,TE,N 81,Attività di servizi per edifici e paesaggio                 ,0,1,8,3,12,2023
ABR,TE,N 82,Attività di supporto per le funzioni d'ufficio e altri se...,0,1,12,1,14,2023
ABR,TE,O   ,Amministrazione pubblica e difesa; assicurazione sociale ...,0,0,0,0,0,2023
ABR,TE,O 84,Amministrazione pubblica e difesa; assicurazione sociale ...,0,0,0,0,0,2023
ABR,TE,P   ,Istruzione                                                  ,0,0,0,0,0,2023
ABR,TE,P 85,Istruzione                                                  ,0,0,0,0,0,2023
ABR,TE,Q   ,Sanita' e assistenza sociale                                ,0,0,4,4,8,2023
ABR,TE,Q 86,Assistenza sanitaria                                        ,0,0,2,0,2,2023
ABR,TE,Q 87,Servizi di assistenza sociale residenziale                  ,0,0,0,0,0,2023
ABR,TE,Q 88,Assistenza sociale non residenziale                         ,0,0,2,4,6,2023
ABR,TE,R   ,"Attività artistiche, sportive, di intrattenimento e diver...",0,2,7,2,11,2023
ABR,TE,R 90,"Attività creative, artistiche e di intrattenimento          ",0,0,1,0,1,2023
ABR,TE,R 91,"Attività di biblioteche, archivi, musei ed altre attività...",0,0,0,0,0,2023
ABR,TE,R 92,"Attività riguardanti le lotterie, le scommesse, le case d...",0,0,0,1,1,2023
ABR,TE,R 93,"Attività sportive, di intrattenimento e di divertimento     ",0,2,6,1,9,2023
ABR,TE,S   ,Altre attività di servizi                                   ,0,3,21,1,25,2023
ABR,TE,S 94,Attività di organizzazioni associative                      ,0,0,0,0,0,2023
ABR,TE,S 95,Riparazione di computer e di beni per uso personale e per...,0,1,4,0,5,2023
ABR,TE,S 96,Altre attività di servizi per la persona                    ,0,2,17,1,20,2023
ABR,TE,T   ,Attività di famiglie e convivenze come datori di lavoro p...,0,0,0,0,0,2023
ABR,TE,T 97,Attività di famiglie e convivenze come datori di lavoro p...,0,0,0,0,0,2023
ABR,TE,T 98,Produzione di beni e servizi indifferenziati per uso prop...,0,0,0,0,0,2023
ABR,TE,U   ,Organizzazioni ed organismi extraterritoriali               ,0,0,0,0,0,2023
ABR,TE,U 99,Organizzazioni ed organismi extraterritoriali               ,0,0,0,0,0,2023
ABR,TE,XX  ,Imprese non classificate                                    ,0,23,35,1,59,2023
ABR,TE,TOT ,TOTALE                                                      ,0,142,1133,21,1296,2023
ABR,PE,A   ,"Agricoltura, silvicoltura pesca                             ",1,2,98,0,101,2023
ABR,PE,A 01,"Coltivazioni agricole e produzione di prodotti animali, c...",1,1,97,0,99,2023
ABR,PE,A 02,Silvicoltura ed utilizzo di aree forestali                  ,0,0,1,0,1,2023
ABR,PE,A 03,Pesca e acquacoltura                                        ,0,1,0,0,1,2023
ABR,PE,B   ,Estrazione di minerali da cave e miniere                    ,0,0,0,0,0,2023
ABR,PE,B 05,Estrazione di carbone (esclusa torba)                       ,0,0,0,0,0,2023
ABR,PE,B 06,Estraz.di petrolio greggio e di gas naturale                ,0,0,0,0,0,2023
ABR,PE,B 07,Estrazione di minerali metalliferi                          ,0,0,0,0,0,2023
ABR,PE,B 08,Altre attività di estrazione di minerali da cave e miniere  ,0,0,0,0,0,2023
ABR,PE,B 09,Attività dei servizi di supporto all'estrazione             ,0,0,0,0,0,2023
ABR,PE,C   ,Attività manifatturiere                                     ,3,14,18,1,36,2023
ABR,PE,C 10,Industrie alimentari                                        ,0,1,2,1,4,2023
ABR,PE,C 11,Industria delle bevande                                     ,0,0,0,0,0,2023
ABR,PE,C 12,Industria del tabacco                                       ,0,0,0,0,0,2023
ABR,PE,C 13,Industrie tessili                                           ,0,0,0,0,0,2023
ABR,PE,C 14,Confezione di articoli di abbigliamento; confezione di ar...,0,2,6,0,8,2023
ABR,PE,C 15,Fabbricazione di articoli in pelle e simili                 ,0,0,0,0,0,2023
ABR,PE,C 16,Industria del legno e dei prodotti in legno e sughero (es...,0,1,0,0,1,2023
ABR,PE,C 17,Fabbricazione di carta e di prodotti di carta               ,1,0,0,0,1,2023
ABR,PE,C 18,Stampa e riproduzione di supporti registrati                ,0,1,0,0,1,2023
ABR,PE,C 19,Fabbricazione di coke e prodotti derivanti dalla raffinaz...,0,0,0,0,0,2023
ABR,PE,C 20,Fabbricazione di prodotti chimici                           ,1,0,0,0,1,2023
ABR,PE,C 21,Fabbricazione di prodotti farmaceutici di base e di prepa...,0,0,0,0,0,2023
ABR,PE,C 22,Fabbricazione di articoli in gomma e materie plastiche      ,0,0,1,0,1,2023
ABR,PE,C 23,Fabbricazione di altri prodotti della lavorazione di miner..,0,0,1,0,1,2023
ABR,PE,C 24,Metallurgia                                                 ,0,0,0,0,0,2023
ABR,PE,C 25,Fabbricazione di prodotti in metallo (esclusi macchinari ...,0,2,3,0,5,2023
ABR,PE,C 26,Fabbricazione di computer e prodotti di elettronica e ott...,0,1,1,0,2,2023
ABR,PE,C 27,Fabbricazione di apparecchiature elettriche ed apparecchi...,1,0,1,0,2,2023
ABR,PE,C 28,Fabbricazione di macchinari ed apparecchiature nca          ,0,2,1,0,3,2023
ABR,PE,C 29,"Fabbricazione di autoveicoli, rimorchi e semirimorchi       ",0,0,0,0,0,2023
ABR,PE,C 30,Fabbricazione di altri mezzi di trasporto                   ,0,0,0,0,0,2023
ABR,PE,C 31,Fabbricazione di mobili                                     ,0,3,0,0,3,2023
ABR,PE,C 32,Altre industrie manifatturiere                              ,0,0,2,0,2,2023
ABR,PE,C 33,"Riparazione, manutenzione ed installazione di macchine ed...",0,1,0,0,1,2023
ABR,PE,D   ,"Fornitura di energia elettrica, gas, vapore e aria condiz...",0,0,0,0,0,2023
ABR,PE,D 35,"Fornitura di energia elettrica, gas, vapore e aria condiz...",0,0,0,0,0,2023
ABR,PE,E   ,"Fornitura di acqua; reti fognarie, attività di gestione d...",0,0,1,0,1,2023
ABR,PE,E 36,"Raccolta, trattamento e fornitura di acqua                  ",0,0,0,0,0,2023
ABR,PE,E 37,Gestione delle reti fognarie                                ,0,0,0,0,0,2023
ABR,PE,E 38,"Attività di raccolta, trattamento e smaltimento dei rifiu...",0,0,1,0,1,2023
ABR,PE,E 39,Attività di risanamento e altri servizi di gestione dei r...,0,0,0,0,0,2023
ABR,PE,F   ,Costruzioni                                                 ,1,12,31,2,46,2023
ABR,PE,F 41,Costruzione di edifici                                      ,1,10,11,1,23,2023
ABR,PE,F 42,Ingegneria civile                                           ,0,0,1,0,1,2023
ABR,PE,F 43,Lavori di costruzione specializzati                         ,0,2,19,1,22,2023
ABR,PE,G   ,Commercio all'ingrosso e al dettaglio; riparazione di aut...,2,50,110,1,163,2023
ABR,PE,G 45,Commercio all'ingrosso e al dettaglio e riparazione di au...,0,3,11,0,14,2023
ABR,PE,G 46,Commercio all'ingrosso (escluso quello di autoveicoli e d...,0,24,38,0,62,2023
ABR,PE,G 47,Commercio al dettaglio (escluso quello di autoveicoli e d...,2,23,61,1,87,2023
ABR,PE,H   ,Trasporto e magazzinaggio                                   ,1,2,8,1,12,2023
ABR,PE,H 49,Trasporto terrestre e mediante condotte                     ,1,0,7,0,8,2023
ABR,PE,H 50,Trasporto marittimo e per vie d'acqua                       ,0,0,0,0,0,2023
ABR,PE,H 51,Trasporto aereo                                             ,0,0,0,0,0,2023
ABR,PE,H 52,Magazzinaggio e attività di supporto ai trasporti           ,0,2,1,1,4,2023
ABR,PE,H 53,Servizi postali e attività di corriere                      ,0,0,0,0,0,2023
ABR,PE,I   ,Attività dei servizi alloggio e ristorazione                ,0,15,24,2,41,2023
ABR,PE,I 55,Alloggio                                                    ,0,1,2,0,3,2023
ABR,PE,I 56,Attività dei servizi di ristorazione                        ,0,14,22,2,38,2023
ABR,PE,J   ,Servizi di informazione e comunicazione                     ,1,2,8,0,11,2023
ABR,PE,J 58,Attività editoriali                                         ,0,0,1,0,1,2023
ABR,PE,J 59,"Attività di produzione cinematografica, di video e di pro...",0,1,1,0,2,2023
ABR,PE,J 60,Attività di programmazione e trasmissione                   ,0,0,0,0,0,2023
ABR,PE,J 61,Telecomunicazioni                                           ,0,0,0,0,0,2023
ABR,PE,J 62,"Produzione di software, consulenza informatica e attività...",0,0,1,0,1,2023
ABR,PE,J 63,Attività dei servizi d'informazione e altri servizi infor...,1,1,5,0,7,2023
ABR,PE,K   ,Attività finanziarie e assicurative                         ,0,0,4,1,5,2023
ABR,PE,K 64,Attività di servizi finanziari (escluse le assicurazioni ...,0,0,0,0,0,2023
ABR,PE,K 65,"Assicurazioni, riassicurazioni e fondi pensione (escluse ...",0,0,0,0,0,2023
ABR,PE,K 66,Attività ausiliarie dei servizi finanziari e delle attivi...,0,0,4,1,5,2023
ABR,PE,L   ,Attivita' immobiliari                                       ,0,0,3,0,3,2023
ABR,PE,L 68,Attivita' immobiliari                                       ,0,0,3,0,3,2023
ABR,PE,M   ,"Attività professionali, scientifiche e tecniche             ",0,1,6,1,8,2023
ABR,PE,M 69,Attività legali e contabilità                               ,0,0,2,0,2,2023
ABR,PE,M 70,Attività di direzione aziendale e di consulenza gestional...,0,0,1,1,2,2023
ABR,PE,M 71,Attività degli studi di architettura e d'ingegneria; coll...,0,0,0,0,0,2023
ABR,PE,M 72,Ricerca scientifica e sviluppo                              ,0,0,0,0,0,2023
ABR,PE,M 73,Pubblicità e ricerche di mercato                            ,0,0,2,0,2,2023
ABR,PE,M 74,"Altre attività professionali, scientifiche e tecniche       ",0,1,1,0,2,2023
ABR,PE,M 75,Servizi veterinari                                          ,0,0,0,0,0,2023
ABR,PE,N   ,"Noleggio, agenzie di viaggio, servizi di supporto alle im...",0,3,11,2,16,2023
ABR,PE,N 77,Attività di noleggio e leasing operativo                    ,0,0,1,0,1,2023
ABR,PE,N 78,"Attività di ricerca, selezione, fornitura di personale      ",0,0,0,0,0,2023
ABR,PE,N 79,"Attività dei servizi delle agenzie di viaggio, dei tour o...",0,0,2,0,2,2023
ABR,PE,N 80,Servizi di vigilanza e investigazione                       ,0,0,0,0,0,2023
ABR,PE,N 81,Attività di servizi per edifici e paesaggio                 ,0,0,4,2,6,2023
ABR,PE,N 82,Attività di supporto per le funzioni d'ufficio e altri se...,0,3,4,0,7,2023
ABR,PE,O   ,Amministrazione pubblica e difesa; assicurazione sociale ...,0,0,0,0,0,2023
ABR,PE,O 84,Amministrazione pubblica e difesa; assicurazione sociale ...,0,0,0,0,0,2023
ABR,PE,P   ,Istruzione                                                  ,1,0,0,1,2,2023
ABR,PE,P 85,Istruzione                                                  ,1,0,0,1,2,2023
ABR,PE,Q   ,Sanita' e assistenza sociale                                ,0,1,2,1,4,2023
ABR,PE,Q 86,Assistenza sanitaria                                        ,0,0,1,0,1,2023
ABR,PE,Q 87,Servizi di assistenza sociale residenziale                  ,0,0,0,0,0,2023
ABR,PE,Q 88,Assistenza sociale non residenziale                         ,0,1,1,1,3,2023
ABR,PE,R   ,"Attività artistiche, sportive, di intrattenimento e diver...",0,0,6,0,6,2023
ABR,PE,R 90,"Attività creative, artistiche e di intrattenimento          ",0,0,1,0,1,2023
ABR,PE,R 91,"Attività di biblioteche, archivi, musei ed altre attività...",0,0,0,0,0,2023
ABR,PE,R 92,"Attività riguardanti le lotterie, le scommesse, le case d...",0,0,0,0,0,2023
ABR,PE,R 93,"Attività sportive, di intrattenimento e di divertimento     ",0,0,5,0,5,2023
ABR,PE,S   ,Altre attività di servizi                                   ,0,0,5,1,6,2023
ABR,PE,S 94,Attività di organizzazioni associative                      ,0,0,0,0,0,2023
ABR,PE,S 95,Riparazione di computer e di beni per uso personale e per...,0,0,3,0,3,2023
ABR,PE,S 96,Altre attività di servizi per la persona                    ,0,0,2,1,3,2023
ABR,PE,T   ,Attività di famiglie e convivenze come datori di lavoro p...,0,0,0,0,0,2023
ABR,PE,T 97,Attività di famiglie e convivenze come datori di lavoro p...,0,0,0,0,0,2023
ABR,PE,T 98,Produzione di beni e servizi indifferenziati per uso prop...,0,0,0,0,0,2023
ABR,PE,U   ,Organizzazioni ed organismi extraterritoriali               ,0,0,0,0,0,2023
ABR,PE,U 99,Organizzazioni ed organismi extraterritoriali               ,0,0,0,0,0,2023
ABR,PE,XX  ,Imprese non classificate                                    ,0,10,43,6,59,2023
ABR,PE,TOT ,TOTALE                                                      ,10,112,378,20,520,2023
ABR,CH,A   ,"Agricoltura, silvicoltura pesca                             ",1,0,275,1,277,2023
ABR,CH,A 01,"Coltivazioni agricole e produzione di prodotti animali, c...",1,0,273,1,275,2023
ABR,CH,A 02,Silvicoltura ed utilizzo di aree forestali                  ,0,0,1,0,1,2023
ABR,CH,A 03,Pesca e acquacoltura                                        ,0,0,1,0,1,2023
ABR,CH,B   ,Estrazione di minerali da cave e miniere                    ,0,0,0,0,0,2023
ABR,CH,B 05,Estrazione di carbone (esclusa torba)                       ,0,0,0,0,0,2023
ABR,CH,B 06,Estraz.di petrolio greggio e di gas naturale                ,0,0,0,0,0,2023
ABR,CH,B 07,Estrazione di minerali metalliferi                          ,0,0,0,0,0,2023
ABR,CH,B 08,Altre attività di estrazione di minerali da cave e miniere  ,0,0,0,0,0,2023
ABR,CH,B 09,Attività dei servizi di supporto all'estrazione             ,0,0,0,0,0,2023
ABR,CH,C   ,Attività manifatturiere                                     ,19,0,10,2,31,2023
ABR,CH,C 10,Industrie alimentari                                        ,0,0,2,0,2,2023
ABR,CH,C 11,Industria delle bevande                                     ,1,0,0,0,1,2023
ABR,CH,C 12,Industria del tabacco                                       ,0,0,0,0,0,2023
ABR,CH,C 13,Industrie tessili                                           ,1,0,1,0,2,2023
ABR,CH,C 14,Confezione di articoli di abbigliamento; confezione di ar...,3,0,1,1,5,2023
ABR,CH,C 15,Fabbricazione di articoli in pelle e simili                 ,2,0,0,1,3,2023
ABR,CH,C 16,Industria del legno e dei prodotti in legno e sughero (es...,0,0,1,0,1,2023
ABR,CH,C 17,Fabbricazione di carta e di prodotti di carta               ,0,0,0,0,0,2023
ABR,CH,C 18,Stampa e riproduzione di supporti registrati                ,1,0,0,0,1,2023
ABR,CH,C 19,Fabbricazione di coke e prodotti derivanti dalla raffinaz...,1,0,0,0,1,2023
ABR,CH,C 20,Fabbricazione di prodotti chimici                           ,1,0,0,0,1,2023
ABR,CH,C 21,Fabbricazione di prodotti farmaceutici di base e di prepa...,0,0,0,0,0,2023
ABR,CH,C 22,Fabbricazione di articoli in gomma e materie plastiche      ,2,0,0,0,2,2023
ABR,CH,C 23,Fabbricazione di altri prodotti della lavorazione di miner..,1,0,0,0,1,2023
ABR,CH,C 24,Metallurgia                                                 ,3,0,0,0,3,2023
ABR,CH,C 25,Fabbricazione di prodotti in metallo (esclusi macchinari ...,1,0,2,0,3,2023
ABR,CH,C 26,Fabbricazione di computer e prodotti di elettronica e ott...,0,0,1,0,1,2023
ABR,CH,C 27,Fabbricazione di apparecchiature elettriche ed apparecchi...,1,0,0,0,1,2023
ABR,CH,C 28,Fabbricazione di macchinari ed apparecchiature nca          ,0,0,0,0,0,2023
ABR,CH,C 29,"Fabbricazione di autoveicoli, rimorchi e semirimorchi       ",0,0,0,0,0,2023
ABR,CH,C 30,Fabbricazione di altri mezzi di trasporto                   ,1,0,0,0,1,2023
ABR,CH,C 31,Fabbricazione di mobili                                     ,0,0,0,0,0,2023
ABR,CH,C 32,Altre industrie manifatturiere                              ,0,0,0,0,0,2023
ABR,CH,C 33,"Riparazione, manutenzione ed installazione di macchine ed...",0,0,2,0,2,2023
ABR,CH,D   ,"Fornitura di energia elettrica, gas, vapore e aria condiz...",0,0,0,0,0,2023
ABR,CH,D 35,"Fornitura di energia elettrica, gas, vapore e aria condiz...",0,0,0,0,0,2023
ABR,CH,E   ,"Fornitura di acqua; reti fognarie, attività di gestione d...",0,0,1,0,1,2023
ABR,CH,E 36,"Raccolta, trattamento e fornitura di acqua                  ",0,0,0,0,0,2023
ABR,CH,E 37,Gestione delle reti fognarie                                ,0,0,0,0,0,2023
ABR,CH,E 38,"Attività di raccolta, trattamento e smaltimento dei rifiu...",0,0,1,0,1,2023
ABR,CH,E 39,Attività di risanamento e altri servizi di gestione dei r...,0,0,0,0,0,2023
ABR,CH,F   ,Costruzioni                                                 ,4,0,24,1,29,2023
ABR,CH,F 41,Costruzione di edifici                                      ,3,0,16,1,20,2023
ABR,CH,F 42,Ingegneria civile                                           ,1,0,0,0,1,2023
ABR,CH,F 43,Lavori di costruzione specializzati                         ,0,0,8,0,8,2023
ABR,CH,G   ,Commercio all'ingrosso e al dettaglio; riparazione di aut...,7,0,43,1,51,2023
ABR,CH,G 45,Commercio all'ingrosso e al dettaglio e riparazione di au...,0,0,4,0,4,2023
ABR,CH,G 46,Commercio all'ingrosso (escluso quello di autoveicoli e d...,3,0,7,0,10,2023
ABR,CH,G 47,Commercio al dettaglio (escluso quello di autoveicoli e d...,4,0,32,1,37,2023
ABR,CH,H   ,Trasporto e magazzinaggio                                   ,1,0,4,1,6,2023
ABR,CH,H 49,Trasporto terrestre e mediante condotte                     ,0,0,4,1,5,2023
ABR,CH,H 50,Trasporto marittimo e per vie d'acqua                       ,0,0,0,0,0,2023
ABR,CH,H 51,Trasporto aereo                                             ,0,0,0,0,0,2023
ABR,CH,H 52,Magazzinaggio e attività di supporto ai trasporti           ,1,0,0,0,1,2023
ABR,CH,H 53,Servizi postali e attività di corriere                      ,0,0,0,0,0,2023
ABR,CH,I   ,Attività dei servizi alloggio e ristorazione                ,0,0,14,1,15,2023
ABR,CH,I 55,Alloggio                                                    ,0,0,2,1,3,2023
ABR,CH,I 56,Attività dei servizi di ristorazione                        ,0,0,12,0,12,2023
ABR,CH,J   ,Servizi di informazione e comunicazione                     ,0,0,1,0,1,2023
ABR,CH,J 58,Attività editoriali                                         ,0,0,1,0,1,2023
ABR,CH,J 59,"Attività di produzione cinematografica, di video e di pro...",0,0,0,0,0,2023
ABR,CH,J 60,Attività di programmazione e trasmissione                   ,0,0,0,0,0,2023
ABR,CH,J 61,Telecomunicazioni                                           ,0,0,0,0,0,2023
ABR,CH,J 62,"Produzione di software, consulenza informatica e attività...",0,0,0,0,0,2023
ABR,CH,J 63,Attività dei servizi d'informazione e altri servizi infor...,0,0,0,0,0,2023
ABR,CH,K   ,Attività finanziarie e assicurative                         ,1,0,1,0,2,2023
ABR,CH,K 64,Attività di servizi finanziari (escluse le assicurazioni ...,1,0,0,0,1,2023
ABR,CH,K 65,"Assicurazioni, riassicurazioni e fondi pensione (escluse ...",0,0,0,0,0,2023
ABR,CH,K 66,Attività ausiliarie dei servizi finanziari e delle attivi...,0,0,1,0,1,2023
ABR,CH,L   ,Attivita' immobiliari                                       ,1,0,2,0,3,2023
ABR,CH,L 68,Attivita' immobiliari                                       ,1,0,2,0,3,2023
ABR,CH,M   ,"Attività professionali, scientifiche e tecniche             ",0,0,4,1,5,2023
ABR,CH,M 69,Attività legali e contabilità                               ,0,0,0,0,0,2023
ABR,CH,M 70,Attività di direzione aziendale e di consulenza gestional...,0,0,0,0,0,2023
ABR,CH,M 71,Attività degli studi di architettura e d'ingegneria; coll...,0,0,0,1,1,2023
ABR,CH,M 72,Ricerca scientifica e sviluppo                              ,0,0,0,0,0,2023
ABR,CH,M 73,Pubblicità e ricerche di mercato                            ,0,0,1,0,1,2023
ABR,CH,M 74,"Altre attività professionali, scientifiche e tecniche       ",0,0,3,0,3,2023
ABR,CH,M 75,Servizi veterinari                                          ,0,0,0,0,0,2023
ABR,CH,N   ,"Noleggio, agenzie di viaggio, servizi di supporto alle im...",1,0,10,4,15,2023
ABR,CH,N 77,Attività di noleggio e leasing operativo                    ,0,0,3,0,3,2023
ABR,CH,N 78,"Attività di ricerca, selezione, fornitura di personale      ",0,0,0,0,0,2023
ABR,CH,N 79,"Attività dei servizi delle agenzie di viaggio, dei tour o...",0,0,0,1,1,2023
ABR,CH,N 80,Servizi di vigilanza e investigazione                       ,0,0,1,0,1,2023
ABR,CH,N 81,Attività di servizi per edifici e paesaggio                 ,0,0,1,2,3,2023
ABR,CH,N 82,Attività di supporto per le funzioni d'ufficio e altri se...,1,0,5,1,7,2023
ABR,CH,O   ,Amministrazione pubblica e difesa; assicurazione sociale ...,0,0,0,0,0,2023
ABR,CH,O 84,Amministrazione pubblica e difesa; assicurazione sociale ...,0,0,0,0,0,2023
ABR,CH,P   ,Istruzione                                                  ,0,0,1,0,1,2023
ABR,CH,P 85,Istruzione                                                  ,0,0,1,0,1,2023
ABR,CH,Q   ,Sanita' e assistenza sociale                                ,0,0,1,4,5,2023
ABR,CH,Q 86,Assistenza sanitaria                                        ,0,0,1,1,2,2023
ABR,CH,Q 87,Servizi di assistenza sociale residenziale                  ,0,0,0,0,0,2023
ABR,CH,Q 88,Assistenza sociale non residenziale                         ,0,0,0,3,3,2023
ABR,CH,R   ,"Attività artistiche, sportive, di intrattenimento e diver...",0,0,3,2,5,2023
ABR,CH,R 90,"Attività creative, artistiche e di intrattenimento          ",0,0,0,0,0,2023
ABR,CH,R 91,"Attività di biblioteche, archivi, musei ed altre attività...",0,0,0,1,1,2023
ABR,CH,R 92,"Attività riguardanti le lotterie, le scommesse, le case d...",0,0,1,0,1,2023
ABR,CH,R 93,"Attività sportive, di intrattenimento e di divertimento     ",0,0,2,1,3,2023
ABR,CH,S   ,Altre attività di servizi                                   ,0,0,3,2,5,2023
ABR,CH,S 94,Attività di organizzazioni associative                      ,0,0,0,1,1,2023
ABR,CH,S 95,Riparazione di computer e di beni per uso personale e per...,0,0,0,1,1,2023
ABR,CH,S 96,Altre attività di servizi per la persona                    ,0,0,3,0,3,2023
ABR,CH,T   ,Attività di famiglie e convivenze come datori di lavoro p...,0,0,0,0,0,2023
ABR,CH,T 97,Attività di famiglie e convivenze come datori di lavoro p...,0,0,0,0,0,2023
ABR,CH,T 98,Produzione di beni e servizi indifferenziati per uso prop...,0,0,0,0,0,2023
ABR,CH,U   ,Organizzazioni ed organismi extraterritoriali               ,0,0,0,0,0,2023
ABR,CH,U 99,Organizzazioni ed organismi extraterritoriali               ,0,0,0,0,0,2023
ABR,CH,XX  ,Imprese non classificate                                    ,5,0,24,5,34,2023
ABR,CH,TOT ,TOTALE                                                      ,40,0,421,25,486,2023
MOL,  ,A   ,"Agricoltura, silvicoltura pesca                             ",2,0,23,2,27,2023
MOL,  ,A 01,"Coltivazioni agricole e produzione di prodotti animali, c...",2,0,22,1,25,2023
MOL,  ,A 02,Silvicoltura ed utilizzo di aree forestali                  ,0,0,1,0,1,2023
MOL,  ,A 03,Pesca e acquacoltura                                        ,0,0,0,1,1,2023
MOL,  ,B   ,Estrazione di minerali da cave e miniere                    ,0,0,0,0,0,2023
MOL,  ,B 05,Estrazione di carbone (esclusa torba)                       ,0,0,0,0,0,2023
MOL,  ,B 06,Estraz.di petrolio greggio e di gas naturale                ,0,0,0,0,0,2023
MOL,  ,B 07,Estrazione di minerali metalliferi                          ,0,0,0,0,0,2023
MOL,  ,B 08,Altre attività di estrazione di minerali da cave e miniere  ,0,0,0,0,0,2023
MOL,  ,B 09,Attività dei servizi di supporto all'estrazione             ,0,0,0,0,0,2023
MOL,  ,C   ,Attività manifatturiere                                     ,36,0,19,2,57,2023
MOL,  ,C 10,Industrie alimentari                                        ,2,0,3,1,6,2023
MOL,  ,C 11,Industria delle bevande                                     ,0,0,0,0,0,2023
MOL,  ,C 12,Industria del tabacco                                       ,0,0,0,0,0,2023
MOL,  ,C 13,Industrie tessili                                           ,4,0,0,0,4,2023
MOL,  ,C 14,Confezione di articoli di abbigliamento; confezione di ar...,7,0,4,0,11,2023
MOL,  ,C 15,Fabbricazione di articoli in pelle e simili                 ,2,0,0,0,2,2023
MOL,  ,C 16,Industria del legno e dei prodotti in legno e sughero (es...,1,0,2,0,3,2023
MOL,  ,C 17,Fabbricazione di carta e di prodotti di carta               ,0,0,0,0,0,2023
MOL,  ,C 18,Stampa e riproduzione di supporti registrati                ,1,0,1,0,2,2023
MOL,  ,C 19,Fabbricazione di coke e prodotti derivanti dalla raffinaz...,0,0,0,0,0,2023
MOL,  ,C 20,Fabbricazione di prodotti chimici                           ,1,0,1,0,2,2023
MOL,  ,C 21,Fabbricazione di prodotti farmaceutici di base e di prepa...,0,0,0,0,0,2023
MOL,  ,C 22,Fabbricazione di articoli in gomma e materie plastiche      ,2,0,0,0,2,2023
MOL,  ,C 23,Fabbricazione di altri prodotti della lavorazione di miner..,4,0,1,0,5,2023
MOL,  ,C 24,Metallurgia                                                 ,0,0,0,0,0,2023
MOL,  ,C 25,Fabbricazione di prodotti in metallo (esclusi macchinari ...,9,0,5,0,14,2023
MOL,  ,C 26,Fabbricazione di computer e prodotti di elettronica e ott...,1,0,0,1,2,2023
MOL,  ,C 27,Fabbricazione di apparecchiature elettriche ed apparecchi...,0,0,0,0,0,2023
MOL,  ,C 28,Fabbricazione di macchinari ed apparecchiature nca          ,0,0,0,0,0,2023
MOL,  ,C 29,"Fabbricazione di autoveicoli, rimorchi e semirimorchi       ",0,0,0,0,0,2023
MOL,  ,C 30,Fabbricazione di altri mezzi di trasporto                   ,1,0,0,0,1,2023
MOL,  ,C 31,Fabbricazione di mobili                                     ,1,0,0,0,1,2023
MOL,  ,C 32,Altre industrie manifatturiere                              ,0,0,1,0,1,2023
MOL,  ,C 33,"Riparazione, manutenzione ed installazione di macchine ed...",0,0,1,0,1,2023
MOL,  ,D   ,"Fornitura di energia elettrica, gas, vapore e aria condiz...",1,0,0,0,1,2023
MOL,  ,D 35,"Fornitura di energia elettrica, gas, vapore e aria condiz...",1,0,0,0,1,2023
MOL,  ,E   ,"Fornitura di acqua; reti fognarie, attività di gestione d...",2,0,1,0,3,2023
MOL,  ,E 36,"Raccolta, trattamento e fornitura di acqua                  ",0,0,0,0,0,2023
MOL,  ,E 37,Gestione delle reti fognarie                                ,0,0,0,0,0,2023
MOL,  ,E 38,"Attività di raccolta, trattamento e smaltimento dei rifiu...",2,0,1,0,3,2023
MOL,  ,E 39,Attività di risanamento e altri servizi di gestione dei r...,0,0,0,0,0,2023
MOL,  ,F   ,Costruzioni                                                 ,43,5,50,5,103,2023
MOL,  ,F 41,Costruzione di edifici                                      ,30,3,15,5,53,2023
MOL,  ,F 42,Ingegneria civile                                           ,2,1,0,0,3,2023
MOL,  ,F 43,Lavori di costruzione specializzati                         ,11,1,35,0,47,2023
MOL,  ,G   ,Commercio all'ingrosso e al dettaglio; riparazione di aut...,65,4,46,3,118,2023
MOL,  ,G 45,Commercio all'ingrosso e al dettaglio e riparazione di au...,18,0,6,0,24,2023
MOL,  ,G 46,Commercio all'ingrosso (escluso quello di autoveicoli e d...,28,2,7,2,39,2023
MOL,  ,G 47,Commercio al dettaglio (escluso quello di autoveicoli e d...,19,2,33,1,55,2023
MOL,  ,H   ,Trasporto e magazzinaggio                                   ,12,1,14,0,27,2023
MOL,  ,H 49,Trasporto terrestre e mediante condotte                     ,11,1,13,0,25,2023
MOL,  ,H 50,Trasporto marittimo e per vie d'acqua                       ,0,0,0,0,0,2023
MOL,  ,H 51,Trasporto aereo                                             ,0,0,0,0,0,2023
MOL,  ,H 52,Magazzinaggio e attività di supporto ai trasporti           ,0,0,1,0,1,2023
MOL,  ,H 53,Servizi postali e attività di corriere                      ,1,0,0,0,1,2023
MOL,  ,I   ,Attività dei servizi alloggio e ristorazione                ,7,2,18,0,27,2023
MOL,  ,I 55,Alloggio                                                    ,0,0,1,0,1,2023
MOL,  ,I 56,Attività dei servizi di ristorazione                        ,7,2,17,0,26,2023
MOL,  ,J   ,Servizi di informazione e comunicazione                     ,7,1,1,0,9,2023
MOL,  ,J 58,Attività editoriali                                         ,2,0,0,0,2,2023
MOL,  ,J 59,"Attività di produzione cinematografica, di video e di pro...",0,0,0,0,0,2023
MOL,  ,J 60,Attività di programmazione e trasmissione                   ,1,0,0,0,1,2023
MOL,  ,J 61,Telecomunicazioni                                           ,0,0,0,0,0,2023
MOL,  ,J 62,"Produzione di software, consulenza informatica e attività...",1,0,0,0,1,2023
MOL,  ,J 63,Attività dei servizi d'informazione e altri servizi infor...,3,1,1,0,5,2023
MOL,  ,K   ,Attività finanziarie e assicurative                         ,3,0,0,0,3,2023
MOL,  ,K 64,Attività di servizi finanziari (escluse le assicurazioni ...,0,0,0,0,0,2023
MOL,  ,K 65,"Assicurazioni, riassicurazioni e fondi pensione (escluse ...",0,0,0,0,0,2023
MOL,  ,K 66,Attività ausiliarie dei servizi finanziari e delle attivi...,3,0,0,0,3,2023
MOL,  ,L   ,Attivita' immobiliari                                       ,4,0,1,0,5,2023
MOL,  ,L 68,Attivita' immobiliari                                       ,4,0,1,0,5,2023
MOL,  ,M   ,"Attività professionali, scientifiche e tecniche             ",17,0,2,2,21,2023
MOL,  ,M 69,Attività legali e contabilità                               ,1,0,0,1,2,2023
MOL,  ,M 70,Attività di direzione aziendale e di consulenza gestional...,8,0,0,1,9,2023
MOL,  ,M 71,Attività degli studi di architettura e d'ingegneria; coll...,0,0,0,0,0,2023
MOL,  ,M 72,Ricerca scientifica e sviluppo                              ,0,0,0,0,0,2023
MOL,  ,M 73,Pubblicità e ricerche di mercato                            ,6,0,0,0,6,2023
MOL,  ,M 74,"Altre attività professionali, scientifiche e tecniche       ",2,0,2,0,4,2023
MOL,  ,M 75,Servizi veterinari                                          ,0,0,0,0,0,2023
MOL,  ,N   ,"Noleggio, agenzie di viaggio, servizi di supporto alle im...",7,0,6,4,17,2023
MOL,  ,N 77,Attività di noleggio e leasing operativo                    ,1,0,0,0,1,2023
MOL,  ,N 78,"Attività di ricerca, selezione, fornitura di personale      ",0,0,0,0,0,2023
MOL,  ,N 79,"Attività dei servizi delle agenzie di viaggio, dei tour o...",0,0,1,0,1,2023
MOL,  ,N 80,Servizi di vigilanza e investigazione                       ,0,0,0,0,0,2023
MOL,  ,N 81,Attività di servizi per edifici e paesaggio                 ,3,0,2,3,8,2023
MOL,  ,N 82,Attività di supporto per le funzioni d'ufficio e altri se...,3,0,3,1,7,2023
MOL,  ,O   ,Amministrazione pubblica e difesa; assicurazione sociale ...,0,0,0,0,0,2023
MOL,  ,O 84,Amministrazione pubblica e difesa; assicurazione sociale ...,0,0,0,0,0,2023
MOL,  ,P   ,Istruzione                                                  ,0,0,1,2,3,2023
MOL,  ,P 85,Istruzione                                                  ,0,0,1,2,3,2023
MOL,  ,Q   ,Sanita' e assistenza sociale                                ,1,0,0,0,1,2023
MOL,  ,Q 86,Assistenza sanitaria                                        ,1,0,0,0,1,2023
MOL,  ,Q 87,Servizi di assistenza sociale residenziale                  ,0,0,0,0,0,2023
MOL,  ,Q 88,Assistenza sociale non residenziale                         ,0,0,0,0,0,2023
MOL,  ,R   ,"Attività artistiche, sportive, di intrattenimento e diver...",5,0,1,0,6,2023
MOL,  ,R 90,"Attività creative, artistiche e di intrattenimento          ",2,0,0,0,2,2023
MOL,  ,R 91,"Attività di biblioteche, archivi, musei ed altre attività...",0,0,0,0,0,2023
MOL,  ,R 92,"Attività riguardanti le lotterie, le scommesse, le case d...",0,0,0,0,0,2023
MOL,  ,R 93,"Attività sportive, di intrattenimento e di divertimento     ",3,0,1,0,4,2023
MOL,  ,S   ,Altre attività di servizi                                   ,1,0,12,0,13,2023
MOL,  ,S 94,Attività di organizzazioni associative                      ,0,0,0,0,0,2023
MOL,  ,S 95,Riparazione di computer e di beni per uso personale e per...,0,0,3,0,3,2023
MOL,  ,S 96,Altre attività di servizi per la persona                    ,1,0,9,0,10,2023
MOL,  ,T   ,Attività di famiglie e convivenze come datori di lavoro p...,0,0,0,0,0,2023
MOL,  ,T 97,Attività di famiglie e convivenze come datori di lavoro p...,0,0,0,0,0,2023
MOL,  ,T 98,Produzione di beni e servizi indifferenziati per uso prop...,0,0,0,0,0,2023
MOL,  ,U   ,Organizzazioni ed organismi extraterritoriali               ,0,0,0,0,0,2023
MOL,  ,U 99,Organizzazioni ed organismi extraterritoriali               ,0,0,0,0,0,2023
MOL,  ,XX  ,Imprese non classificate                                    ,106,2,28,12,148,2023
MOL,  ,TOT ,TOTALE                                                      ,319,15,223,32,589,2023
MOL,CB,A   ,"Agricoltura, silvicoltura pesca                             ",1,0,19,2,22,2023
MOL,CB,A 01,"Coltivazioni agricole e produzione di prodotti animali, c...",1,0,18,1,20,2023
MOL,CB,A 02,Silvicoltura ed utilizzo di aree forestali                  ,0,0,1,0,1,2023
MOL,CB,A 03,Pesca e acquacoltura                                        ,0,0,0,1,1,2023
MOL,CB,B   ,Estrazione di minerali da cave e miniere                    ,0,0,0,0,0,2023
MOL,CB,B 05,Estrazione di carbone (esclusa torba)                       ,0,0,0,0,0,2023
MOL,CB,B 06,Estraz.di petrolio greggio e di gas naturale                ,0,0,0,0,0,2023
MOL,CB,B 07,Estrazione di minerali metalliferi                          ,0,0,0,0,0,2023
MOL,CB,B 08,Altre attività di estrazione di minerali da cave e miniere  ,0,0,0,0,0,2023
MOL,CB,B 09,Attività dei servizi di supporto all'estrazione             ,0,0,0,0,0,2023
MOL,CB,C   ,Attività manifatturiere                                     ,24,0,18,2,44,2023
MOL,CB,C 10,Industrie alimentari                                        ,1,0,3,1,5,2023
MOL,CB,C 11,Industria delle bevande                                     ,0,0,0,0,0,2023
MOL,CB,C 12,Industria del tabacco                                       ,0,0,0,0,0,2023
MOL,CB,C 13,Industrie tessili                                           ,2,0,0,0,2,2023
MOL,CB,C 14,Confezione di articoli di abbigliamento; confezione di ar...,5,0,4,0,9,2023
MOL,CB,C 15,Fabbricazione di articoli in pelle e simili                 ,0,0,0,0,0,2023
MOL,CB,C 16,Industria del legno e dei prodotti in legno e sughero (es...,0,0,2,0,2,2023
MOL,CB,C 17,Fabbricazione di carta e di prodotti di carta               ,0,0,0,0,0,2023
MOL,CB,C 18,Stampa e riproduzione di supporti registrati                ,1,0,1,0,2,2023
MOL,CB,C 19,Fabbricazione di coke e prodotti derivanti dalla raffinaz...,0,0,0,0,0,2023
MOL,CB,C 20,Fabbricazione di prodotti chimici                           ,1,0,1,0,2,2023
MOL,CB,C 21,Fabbricazione di prodotti farmaceutici di base e di prepa...,0,0,0,0,0,2023
MOL,CB,C 22,Fabbricazione di articoli in gomma e materie plastiche      ,1,0,0,0,1,2023
MOL,CB,C 23,Fabbricazione di altri prodotti della lavorazione di miner..,3,0,1,0,4,2023
MOL,CB,C 24,Metallurgia                                                 ,0,0,0,0,0,2023
MOL,CB,C 25,Fabbricazione di prodotti in metallo (esclusi macchinari ...,7,0,4,0,11,2023
MOL,CB,C 26,Fabbricazione di computer e prodotti di elettronica e ott...,1,0,0,1,2,2023
MOL,CB,C 27,Fabbricazione di apparecchiature elettriche ed apparecchi...,0,0,0,0,0,2023
MOL,CB,C 28,Fabbricazione di macchinari ed apparecchiature nca          ,0,0,0,0,0,2023
MOL,CB,C 29,"Fabbricazione di autoveicoli, rimorchi e semirimorchi       ",0,0,0,0,0,2023
MOL,CB,C 30,Fabbricazione di altri mezzi di trasporto                   ,1,0,0,0,1,2023
MOL,CB,C 31,Fabbricazione di mobili                                     ,1,0,0,0,1,2023
MOL,CB,C 32,Altre industrie manifatturiere                              ,0,0,1,0,1,2023
MOL,CB,C 33,"Riparazione, manutenzione ed installazione di macchine ed...",0,0,1,0,1,2023
MOL,CB,D   ,"Fornitura di energia elettrica, gas, vapore e aria condiz...",0,0,0,0,0,2023
MOL,CB,D 35,"Fornitura di energia elettrica, gas, vapore e aria condiz...",0,0,0,0,0,2023
MOL,CB,E   ,"Fornitura di acqua; reti fognarie, attività di gestione d...",2,0,1,0,3,2023
MOL,CB,E 36,"Raccolta, trattamento e fornitura di acqua                  ",0,0,0,0,0,2023
MOL,CB,E 37,Gestione delle reti fognarie                                ,0,0,0,0,0,2023
MOL,CB,E 38,"Attività di raccolta, trattamento e smaltimento dei rifiu...",2,0,1,0,3,2023
MOL,CB,E 39,Attività di risanamento e altri servizi di gestione dei r...,0,0,0,0,0,2023
MOL,CB,F   ,Costruzioni                                                 ,29,5,41,4,79,2023
MOL,CB,F 41,Costruzione di edifici                                      ,20,3,12,4,39,2023
MOL,CB,F 42,Ingegneria civile                                           ,2,1,0,0,3,2023
MOL,CB,F 43,Lavori di costruzione specializzati                         ,7,1,29,0,37,2023
MOL,CB,G   ,Commercio all'ingrosso e al dettaglio; riparazione di aut...,51,2,36,2,91,2023
MOL,CB,G 45,Commercio all'ingrosso e al dettaglio e riparazione di au...,15,0,2,0,17,2023
MOL,CB,G 46,Commercio all'ingrosso (escluso quello di autoveicoli e d...,20,1,7,1,29,2023
MOL,CB,G 47,Commercio al dettaglio (escluso quello di autoveicoli e d...,16,1,27,1,45,2023
MOL,CB,H   ,Trasporto e magazzinaggio                                   ,6,1,11,0,18,2023
MOL,CB,H 49,Trasporto terrestre e mediante condotte                     ,6,1,10,0,17,2023
MOL,CB,H 50,Trasporto marittimo e per vie d'acqua                       ,0,0,0,0,0,2023
MOL,CB,H 51,Trasporto aereo                                             ,0,0,0,0,0,2023
MOL,CB,H 52,Magazzinaggio e attività di supporto ai trasporti           ,0,0,1,0,1,2023
MOL,CB,H 53,Servizi postali e attività di corriere                      ,0,0,0,0,0,2023
MOL,CB,I   ,Attività dei servizi alloggio e ristorazione                ,5,2,12,0,19,2023
MOL,CB,I 55,Alloggio                                                    ,0,0,0,0,0,2023
MOL,CB,I 56,Attività dei servizi di ristorazione                        ,5,2,12,0,19,2023
MOL,CB,J   ,Servizi di informazione e comunicazione                     ,6,1,1,0,8,2023
MOL,CB,J 58,Attività editoriali                                         ,2,0,0,0,2,2023
MOL,CB,J 59,"Attività di produzione cinematografica, di video e di pro...",0,0,0,0,0,2023
MOL,CB,J 60,Attività di programmazione e trasmissione                   ,1,0,0,0,1,2023
MOL,CB,J 61,Telecomunicazioni                                           ,0,0,0,0,0,2023
MOL,CB,J 62,"Produzione di software, consulenza informatica e attività...",1,0,0,0,1,2023
MOL,CB,J 63,Attività dei servizi d'informazione e altri servizi infor...,2,1,1,0,4,2023
MOL,CB,K   ,Attività finanziarie e assicurative                         ,3,0,0,0,3,2023
MOL,CB,K 64,Attività di servizi finanziari (escluse le assicurazioni ...,0,0,0,0,0,2023
MOL,CB,K 65,"Assicurazioni, riassicurazioni e fondi pensione (escluse ...",0,0,0,0,0,2023
MOL,CB,K 66,Attività ausiliarie dei servizi finanziari e delle attivi...,3,0,0,0,3,2023
MOL,CB,L   ,Attivita' immobiliari                                       ,3,0,1,0,4,2023
MOL,CB,L 68,Attivita' immobiliari                                       ,3,0,1,0,4,2023
MOL,CB,M   ,"Attività professionali, scientifiche e tecniche             ",11,0,2,2,15,2023
MOL,CB,M 69,Attività legali e contabilità                               ,0,0,0,1,1,2023
MOL,CB,M 70,Attività di direzione aziendale e di consulenza gestional...,5,0,0,1,6,2023
MOL,CB,M 71,Attività degli studi di architettura e d'ingegneria; coll...,0,0,0,0,0,2023
MOL,CB,M 72,Ricerca scientifica e sviluppo                              ,0,0,0,0,0,2023
MOL,CB,M 73,Pubblicità e ricerche di mercato                            ,5,0,0,0,5,2023
MOL,CB,M 74,"Altre attività professionali, scientifiche e tecniche       ",1,0,2,0,3,2023
MOL,CB,M 75,Servizi veterinari                                          ,0,0,0,0,0,2023
MOL,CB,N   ,"Noleggio, agenzie di viaggio, servizi di supporto alle im...",4,0,4,1,9,2023
MOL,CB,N 77,Attività di noleggio e leasing operativo                    ,0,0,0,0,0,2023
MOL,CB,N 78,"Attività di ricerca, selezione, fornitura di personale      ",0,0,0,0,0,2023
MOL,CB,N 79,"Attività dei servizi delle agenzie di viaggio, dei tour o...",0,0,1,0,1,2023
MOL,CB,N 80,Servizi di vigilanza e investigazione                       ,0,0,0,0,0,2023
MOL,CB,N 81,Attività di servizi per edifici e paesaggio                 ,1,0,1,1,3,2023
MOL,CB,N 82,Attività di supporto per le funzioni d'ufficio e altri se...,3,0,2,0,5,2023
MOL,CB,O   ,Amministrazione pubblica e difesa; assicurazione sociale ...,0,0,0,0,0,2023
MOL,CB,O 84,Amministrazione pubblica e difesa; assicurazione sociale ...,0,0,0,0,0,2023
MOL,CB,P   ,Istruzione                                                  ,0,0,1,2,3,2023
MOL,CB,P 85,Istruzione                                                  ,0,0,1,2,3,2023
MOL,CB,Q   ,Sanita' e assistenza sociale                                ,1,0,0,0,1,2023
MOL,CB,Q 86,Assistenza sanitaria                                        ,1,0,0,0,1,2023
MOL,CB,Q 87,Servizi di assistenza sociale residenziale                  ,0,0,0,0,0,2023
MOL,CB,Q 88,Assistenza sociale non residenziale                         ,0,0,0,0,0,2023
MOL,CB,R   ,"Attività artistiche, sportive, di intrattenimento e diver...",3,0,1,0,4,2023
MOL,CB,R 90,"Attività creative, artistiche e di intrattenimento          ",1,0,0,0,1,2023
MOL,CB,R 91,"Attività di biblioteche, archivi, musei ed altre attività...",0,0,0,0,0,2023
MOL,CB,R 92,"Attività riguardanti le lotterie, le scommesse, le case d...",0,0,0,0,0,2023
MOL,CB,R 93,"Attività sportive, di intrattenimento e di divertimento     ",2,0,1,0,3,2023
MOL,CB,S   ,Altre attività di servizi                                   ,1,0,8,0,9,2023
MOL,CB,S 94,Attività di organizzazioni associative                      ,0,0,0,0,0,2023
MOL,CB,S 95,Riparazione di computer e di beni per uso personale e per...,0,0,2,0,2,2023
MOL,CB,S 96,Altre attività di servizi per la persona                    ,1,0,6,0,7,2023
MOL,CB,T   ,Attività di famiglie e convivenze come datori di lavoro p...,0,0,0,0,0,2023
MOL,CB,T 97,Attività di famiglie e convivenze come datori di lavoro p...,0,0,0,0,0,2023
MOL,CB,T 98,Produzione di beni e servizi indifferenziati per uso prop...,0,0,0,0,0,2023
MOL,CB,U   ,Organizzazioni ed organismi extraterritoriali               ,0,0,0,0,0,2023
MOL,CB,U 99,Organizzazioni ed organismi extraterritoriali               ,0,0,0,0,0,2023
MOL,CB,XX  ,Imprese non classificate                                    ,72,1,18,7,98,2023
MOL,CB,TOT ,TOTALE                                                      ,222,12,174,22,430,2023
MOL,IS,A   ,"Agricoltura, silvicoltura pesca                             ",1,0,4,0,5,2023
MOL,IS,A 01,"Coltivazioni agricole e produzione di prodotti animali, c...",1,0,4,0,5,2023
MOL,IS,A 02,Silvicoltura ed utilizzo di aree forestali                  ,0,0,0,0,0,2023
MOL,IS,A 03,Pesca e acquacoltura                                        ,0,0,0,0,0,2023
MOL,IS,B   ,Estrazione di minerali da cave e miniere                    ,0,0,0,0,0,2023
MOL,IS,B 05,Estrazione di carbone (esclusa torba)                       ,0,0,0,0,0,2023
MOL,IS,B 06,Estraz.di petrolio greggio e di gas naturale                ,0,0,0,0,0,2023
MOL,IS,B 07,Estrazione di minerali metalliferi                          ,0,0,0,0,0,2023
MOL,IS,B 08,Altre attività di estrazione di minerali da cave e miniere  ,0,0,0,0,0,2023
MOL,IS,B 09,Attività dei servizi di supporto all'estrazione             ,0,0,0,0,0,2023
MOL,IS,C   ,Attività manifatturiere                                     ,12,0,1,0,13,2023
MOL,IS,C 10,Industrie alimentari                                        ,1,0,0,0,1,2023
MOL,IS,C 11,Industria delle bevande                                     ,0,0,0,0,0,2023
MOL,IS,C 12,Industria del tabacco                                       ,0,0,0,0,0,2023
MOL,IS,C 13,Industrie tessili                                           ,2,0,0,0,2,2023
MOL,IS,C 14,Confezione di articoli di abbigliamento; confezione di ar...,2,0,0,0,2,2023
MOL,IS,C 15,Fabbricazione di articoli in pelle e simili                 ,2,0,0,0,2,2023
MOL,IS,C 16,Industria del legno e dei prodotti in legno e sughero (es...,1,0,0,0,1,2023
MOL,IS,C 17,Fabbricazione di carta e di prodotti di carta               ,0,0,0,0,0,2023
MOL,IS,C 18,Stampa e riproduzione di supporti registrati                ,0,0,0,0,0,2023
MOL,IS,C 19,Fabbricazione di coke e prodotti derivanti dalla raffinaz...,0,0,0,0,0,2023
MOL,IS,C 20,Fabbricazione di prodotti chimici                           ,0,0,0,0,0,2023
MOL,IS,C 21,Fabbricazione di prodotti farmaceutici di base e di prepa...,0,0,0,0,0,2023
MOL,IS,C 22,Fabbricazione di articoli in gomma e materie plastiche      ,1,0,0,0,1,2023
MOL,IS,C 23,Fabbricazione di altri prodotti della lavorazione di miner..,1,0,0,0,1,2023
MOL,IS,C 24,Metallurgia                                                 ,0,0,0,0,0,2023
MOL,IS,C 25,Fabbricazione di prodotti in metallo (esclusi macchinari ...,2,0,1,0,3,2023
MOL,IS,C 26,Fabbricazione di computer e prodotti di elettronica e ott...,0,0,0,0,0,2023
MOL,IS,C 27,Fabbricazione di apparecchiature elettriche ed apparecchi...,0,0,0,0,0,2023
MOL,IS,C 28,Fabbricazione di macchinari ed apparecchiature nca          ,0,0,0,0,0,2023
MOL,IS,C 29,"Fabbricazione di autoveicoli, rimorchi e semirimorchi       ",0,0,0,0,0,2023
MOL,IS,C 30,Fabbricazione di altri mezzi di trasporto                   ,0,0,0,0,0,2023
MOL,IS,C 31,Fabbricazione di mobili                                     ,0,0,0,0,0,2023
MOL,IS,C 32,Altre industrie manifatturiere                              ,0,0,0,0,0,2023
MOL,IS,C 33,"Riparazione, manutenzione ed installazione di macchine ed...",0,0,0,0,0,2023
MOL,IS,D   ,"Fornitura di energia elettrica, gas, vapore e aria condiz...",1,0,0,0,1,2023
MOL,IS,D 35,"Fornitura di energia elettrica, gas, vapore e aria condiz...",1,0,0,0,1,2023
MOL,IS,E   ,"Fornitura di acqua; reti fognarie, attività di gestione d...",0,0,0,0,0,2023
MOL,IS,E 36,"Raccolta, trattamento e fornitura di acqua                  ",0,0,0,0,0,2023
MOL,IS,E 37,Gestione delle reti fognarie                                ,0,0,0,0,0,2023
MOL,IS,E 38,"Attività di raccolta, trattamento e smaltimento dei rifiu...",0,0,0,0,0,2023
MOL,IS,E 39,Attività di risanamento e altri servizi di gestione dei r...,0,0,0,0,0,2023
MOL,IS,F   ,Costruzioni                                                 ,14,0,9,1,24,2023
MOL,IS,F 41,Costruzione di edifici                                      ,10,0,3,1,14,2023
MOL,IS,F 42,Ingegneria civile                                           ,0,0,0,0,0,2023
MOL,IS,F 43,Lavori di costruzione specializzati                         ,4,0,6,0,10,2023
MOL,IS,G   ,Commercio all'ingrosso e al dettaglio; riparazione di aut...,14,2,10,1,27,2023
MOL,IS,G 45,Commercio all'ingrosso e al dettaglio e riparazione di au...,3,0,4,0,7,2023
MOL,IS,G 46,Commercio all'ingrosso (escluso quello di autoveicoli e d...,8,1,0,1,10,2023
MOL,IS,G 47,Commercio al dettaglio (escluso quello di autoveicoli e d...,3,1,6,0,10,2023
MOL,IS,H   ,Trasporto e magazzinaggio                                   ,6,0,3,0,9,2023
MOL,IS,H 49,Trasporto terrestre e mediante condotte                     ,5,0,3,0,8,2023
MOL,IS,H 50,Trasporto marittimo e per vie d'acqua                       ,0,0,0,0,0,2023
MOL,IS,H 51,Trasporto aereo                                             ,0,0,0,0,0,2023
MOL,IS,H 52,Magazzinaggio e attività di supporto ai trasporti           ,0,0,0,0,0,2023
MOL,IS,H 53,Servizi postali e attività di corriere                      ,1,0,0,0,1,2023
MOL,IS,I   ,Attività dei servizi alloggio e ristorazione                ,2,0,6,0,8,2023
MOL,IS,I 55,Alloggio                                                    ,0,0,1,0,1,2023
MOL,IS,I 56,Attività dei servizi di ristorazione                        ,2,0,5,0,7,2023
MOL,IS,J   ,Servizi di informazione e comunicazione                     ,1,0,0,0,1,2023
MOL,IS,J 58,Attività editoriali                                         ,0,0,0,0,0,2023
MOL,IS,J 59,"Attività di produzione cinematografica, di video e di pro...",0,0,0,0,0,2023
MOL,IS,J 60,Attività di programmazione e trasmissione                   ,0,0,0,0,0,2023
MOL,IS,J 61,Telecomunicazioni                                           ,0,0,0,0,0,2023
MOL,IS,J 62,"Produzione di software, consulenza informatica e attività...",0,0,0,0,0,2023
MOL,IS,J 63,Attività dei servizi d'informazione e altri servizi infor...,1,0,0,0,1,2023
MOL,IS,K   ,Attività finanziarie e assicurative                         ,0,0,0,0,0,2023
MOL,IS,K 64,Attività di servizi finanziari (escluse le assicurazioni ...,0,0,0,0,0,2023
MOL,IS,K 65,"Assicurazioni, riassicurazioni e fondi pensione (escluse ...",0,0,0,0,0,2023
MOL,IS,K 66,Attività ausiliarie dei servizi finanziari e delle attivi...,0,0,0,0,0,2023
MOL,IS,L   ,Attivita' immobiliari                                       ,1,0,0,0,1,2023
MOL,IS,L 68,Attivita' immobiliari                                       ,1,0,0,0,1,2023
MOL,IS,M   ,"Attività professionali, scientifiche e tecniche             ",6,0,0,0,6,2023
MOL,IS,M 69,Attività legali e contabilità                               ,1,0,0,0,1,2023
MOL,IS,M 70,Attività di direzione aziendale e di consulenza gestional...,3,0,0,0,3,2023
MOL,IS,M 71,Attività degli studi di architettura e d'ingegneria; coll...,0,0,0,0,0,2023
MOL,IS,M 72,Ricerca scientifica e sviluppo                              ,0,0,0,0,0,2023
MOL,IS,M 73,Pubblicità e ricerche di mercato                            ,1,0,0,0,1,2023
MOL,IS,M 74,"Altre attività professionali, scientifiche e tecniche       ",1,0,0,0,1,2023
MOL,IS,M 75,Servizi veterinari                                          ,0,0,0,0,0,2023
MOL,IS,N   ,"Noleggio, agenzie di viaggio, servizi di supporto alle im...",3,0,2,3,8,2023
MOL,IS,N 77,Attività di noleggio e leasing operativo                    ,1,0,0,0,1,2023
MOL,IS,N 78,"Attività di ricerca, selezione, fornitura di personale      ",0,0,0,0,0,2023
MOL,IS,N 79,"Attività dei servizi delle agenzie di viaggio, dei tour o...",0,0,0,0,0,2023
MOL,IS,N 80,Servizi di vigilanza e investigazione                       ,0,0,0,0,0,2023
MOL,IS,N 81,Attività di servizi per edifici e paesaggio                 ,2,0,1,2,5,2023
MOL,IS,N 82,Attività di supporto per le funzioni d'ufficio e altri se...,0,0,1,1,2,2023
MOL,IS,O   ,Amministrazione pubblica e difesa; assicurazione sociale ...,0,0,0,0,0,2023
MOL,IS,O 84,Amministrazione pubblica e difesa; assicurazione sociale ...,0,0,0,0,0,2023
MOL,IS,P   ,Istruzione                                                  ,0,0,0,0,0,2023
MOL,IS,P 85,Istruzione                                                  ,0,0,0,0,0,2023
MOL,IS,Q   ,Sanita' e assistenza sociale                                ,0,0,0,0,0,2023
MOL,IS,Q 86,Assistenza sanitaria                                        ,0,0,0,0,0,2023
MOL,IS,Q 87,Servizi di assistenza sociale residenziale                  ,0,0,0,0,0,2023
MOL,IS,Q 88,Assistenza sociale non residenziale                         ,0,0,0,0,0,2023
MOL,IS,R   ,"Attività artistiche, sportive, di intrattenimento e diver...",2,0,0,0,2,2023
MOL,IS,R 90,"Attività creative, artistiche e di intrattenimento          ",1,0,0,0,1,2023
MOL,IS,R 91,"Attività di biblioteche, archivi, musei ed altre attività...",0,0,0,0,0,2023
MOL,IS,R 92,"Attività riguardanti le lotterie, le scommesse, le case d...",0,0,0,0,0,2023
MOL,IS,R 93,"Attività sportive, di intrattenimento e di divertimento     ",1,0,0,0,1,2023
MOL,IS,S   ,Altre attività di servizi                                   ,0,0,4,0,4,2023
MOL,IS,S 94,Attività di organizzazioni associative                      ,0,0,0,0,0,2023
MOL,IS,S 95,Riparazione di computer e di beni per uso personale e per...,0,0,1,0,1,2023
MOL,IS,S 96,Altre attività di servizi per la persona                    ,0,0,3,0,3,2023
MOL,IS,T   ,Attività di famiglie e convivenze come datori di lavoro p...,0,0,0,0,0,2023
MOL,IS,T 97,Attività di famiglie e convivenze come datori di lavoro p...,0,0,0,0,0,2023
MOL,IS,T 98,Produzione di beni e servizi indifferenziati per uso prop...,0,0,0,0,0,2023
MOL,IS,U   ,Organizzazioni ed organismi extraterritoriali               ,0,0,0,0,0,2023
MOL,IS,U 99,Organizzazioni ed organismi extraterritoriali               ,0,0,0,0,0,2023
MOL,IS,XX  ,Imprese non classificate                                    ,34,1,10,5,50,2023
MOL,IS,TOT ,TOTALE                                                      ,97,3,49,10,159,2023
CAM,  ,A   ,"Agricoltura, silvicoltura pesca                             ",46,14,475,12,547,2023
CAM,  ,A 01,"Coltivazioni agricole e produzione di prodotti animali, c...",42,13,469,12,536,2023
CAM,  ,A 02,Silvicoltura ed utilizzo di aree forestali                  ,0,0,4,0,4,2023
CAM,  ,A 03,Pesca e acquacoltura                                        ,4,1,2,0,7,2023
CAM,  ,B   ,Estrazione di minerali da cave e miniere                    ,8,4,0,1,13,2023
CAM,  ,B 05,Estrazione di carbone (esclusa torba)                       ,0,1,0,0,1,2023
CAM,  ,B 06,Estraz.di petrolio greggio e di gas naturale                ,0,0,0,0,0,2023
CAM,  ,B 07,Estrazione di minerali metalliferi                          ,0,1,0,1,2,2023
CAM,  ,B 08,Altre attività di estrazione di minerali da cave e miniere  ,8,2,0,0,10,2023
CAM,  ,B 09,Attività dei servizi di supporto all'estrazione             ,0,0,0,0,0,2023
CAM,  ,C   ,Attività manifatturiere                                     ,1314,311,89,6,1720,2023
CAM,  ,C 10,Industrie alimentari                                        ,97,41,21,3,162,2023
CAM,  ,C 11,Industria delle bevande                                     ,8,1,0,0,9,2023
CAM,  ,C 12,Industria del tabacco                                       ,0,0,0,0,0,2023
CAM,  ,C 13,Industrie tessili                                           ,31,9,1,0,41,2023
CAM,  ,C 14,Confezione di articoli di abbigliamento; confezione di ar...,223,64,12,0,299,2023
CAM,  ,C 15,Fabbricazione di articoli in pelle e simili                 ,162,45,7,1,215,2023
CAM,  ,C 16,Industria del legno e dei prodotti in legno e sughero (es...,42,21,12,0,75,2023
CAM,  ,C 17,Fabbricazione di carta e di prodotti di carta               ,34,2,0,0,36,2023
CAM,  ,C 18,Stampa e riproduzione di supporti registrati                ,47,12,2,0,61,2023
CAM,  ,C 19,Fabbricazione di coke e prodotti derivanti dalla raffinaz...,7,1,0,0,8,2023
CAM,  ,C 20,Fabbricazione di prodotti chimici                           ,53,3,1,0,57,2023
CAM,  ,C 21,Fabbricazione di prodotti farmaceutici di base e di prepa...,7,0,0,0,7,2023
CAM,  ,C 22,Fabbricazione di articoli in gomma e materie plastiche      ,32,6,2,0,40,2023
CAM,  ,C 23,Fabbricazione di altri prodotti della lavorazione di miner..,63,16,7,1,87,2023
CAM,  ,C 24,Metallurgia                                                 ,24,1,1,1,27,2023
CAM,  ,C 25,Fabbricazione di prodotti in metallo (esclusi macchinari ...,202,38,9,0,249,2023
CAM,  ,C 26,Fabbricazione di computer e prodotti di elettronica e ott...,43,2,0,0,45,2023
CAM,  ,C 27,Fabbricazione di apparecchiature elettriche ed apparecchi...,58,8,1,0,67,2023
CAM,  ,C 28,Fabbricazione di macchinari ed apparecchiature nca          ,42,6,2,0,50,2023
CAM,  ,C 29,"Fabbricazione di autoveicoli, rimorchi e semirimorchi       ",6,1,1,0,8,2023
CAM,  ,C 30,Fabbricazione di altri mezzi di trasporto                   ,32,5,1,0,38,2023
CAM,  ,C 31,Fabbricazione di mobili                                     ,42,14,0,0,56,2023
CAM,  ,C 32,Altre industrie manifatturiere                              ,35,12,3,0,50,2023
CAM,  ,C 33,"Riparazione, manutenzione ed installazione di macchine ed...",24,3,6,0,33,2023
CAM,  ,D   ,"Fornitura di energia elettrica, gas, vapore e aria condiz...",5,1,0,0,6,2023
CAM,  ,D 35,"Fornitura di energia elettrica, gas, vapore e aria condiz...",5,1,0,0,6,2023
CAM,  ,E   ,"Fornitura di acqua; reti fognarie, attività di gestione d...",37,6,0,2,45,2023
CAM,  ,E 36,"Raccolta, trattamento e fornitura di acqua                  ",3,0,0,0,3,2023
CAM,  ,E 37,Gestione delle reti fognarie                                ,2,1,0,0,3,2023
CAM,  ,E 38,"Attività di raccolta, trattamento e smaltimento dei rifiu...",29,5,0,2,36,2023
CAM,  ,E 39,Attività di risanamento e altri servizi di gestione dei r...,3,0,0,0,3,2023
CAM,  ,F   ,Costruzioni                                                 ,1222,208,151,99,1680,2023
CAM,  ,F 41,Costruzione di edifici                                      ,975,136,86,89,1286,2023
CAM,  ,F 42,Ingegneria civile                                           ,18,2,2,1,23,2023
CAM,  ,F 43,Lavori di costruzione specializzati                         ,229,70,63,9,371,2023
CAM,  ,G   ,Commercio all'ingrosso e al dettaglio; riparazione di aut...,2316,1272,367,10,3965,2023
CAM,  ,G 45,Commercio all'ingrosso e al dettaglio e riparazione di au...,189,101,37,0,327,2023
CAM,  ,G 46,Commercio all'ingrosso (escluso quello di autoveicoli e d...,1437,516,65,5,2023,2023
CAM,  ,G 47,Commercio al dettaglio (escluso quello di autoveicoli e d...,690,655,265,5,1615,2023
CAM,  ,H   ,Trasporto e magazzinaggio                                   ,205,92,28,17,342,2023
CAM,  ,H 49,Trasporto terrestre e mediante condotte                     ,105,69,21,7,202,2023
CAM,  ,H 50,Trasporto marittimo e per vie d'acqua                       ,33,3,0,0,36,2023
CAM,  ,H 51,Trasporto aereo                                             ,3,0,0,0,3,2023
CAM,  ,H 52,Magazzinaggio e attività di supporto ai trasporti           ,59,19,7,9,94,2023
CAM,  ,H 53,Servizi postali e attività di corriere                      ,5,1,0,1,7,2023
CAM,  ,I   ,Attività dei servizi alloggio e ristorazione                ,209,395,69,0,673,2023
CAM,  ,I 55,Alloggio                                                    ,54,22,7,0,83,2023
CAM,  ,I 56,Attività dei servizi di ristorazione                        ,155,373,62,0,590,2023
CAM,  ,J   ,Servizi di informazione e comunicazione                     ,225,46,12,2,285,2023
CAM,  ,J 58,Attività editoriali                                         ,48,3,3,1,55,2023
CAM,  ,J 59,"Attività di produzione cinematografica, di video e di pro...",33,5,0,0,38,2023
CAM,  ,J 60,Attività di programmazione e trasmissione                   ,12,0,0,0,12,2023
CAM,  ,J 61,Telecomunicazioni                                           ,2,1,2,0,5,2023
CAM,  ,J 62,"Produzione di software, consulenza informatica e attività...",67,18,3,1,89,2023
CAM,  ,J 63,Attività dei servizi d'informazione e altri servizi infor...,63,19,4,0,86,2023
CAM,  ,K   ,Attività finanziarie e assicurative                         ,179,34,9,0,222,2023
CAM,  ,K 64,Attività di servizi finanziari (escluse le assicurazioni ...,127,9,0,0,136,2023
CAM,  ,K 65,"Assicurazioni, riassicurazioni e fondi pensione (escluse ...",7,2,0,0,9,2023
CAM,  ,K 66,Attività ausiliarie dei servizi finanziari e delle attivi...,45,23,9,0,77,2023
CAM,  ,L   ,Attivita' immobiliari                                       ,256,32,0,0,288,2023
CAM,  ,L 68,Attivita' immobiliari                                       ,256,32,0,0,288,2023
CAM,  ,M   ,"Attività professionali, scientifiche e tecniche             ",198,50,12,6,266,2023
CAM,  ,M 69,Attività legali e contabilità                               ,9,4,1,1,15,2023
CAM,  ,M 70,Attività di direzione aziendale e di consulenza gestional...,22,7,3,1,33,2023
CAM,  ,M 71,Attività degli studi di architettura e d'ingegneria; coll...,25,6,0,1,32,2023
CAM,  ,M 72,Ricerca scientifica e sviluppo                              ,10,2,0,0,12,2023
CAM,  ,M 73,Pubblicità e ricerche di mercato                            ,66,11,3,2,82,2023
CAM,  ,M 74,"Altre attività professionali, scientifiche e tecniche       ",66,19,5,1,91,2023
CAM,  ,M 75,Servizi veterinari                                          ,0,1,0,0,1,2023
CAM,  ,N   ,"Noleggio, agenzie di viaggio, servizi di supporto alle im...",172,87,16,12,287,2023
CAM,  ,N 77,Attività di noleggio e leasing operativo                    ,37,12,3,0,52,2023
CAM,  ,N 78,"Attività di ricerca, selezione, fornitura di personale      ",1,1,0,0,2,2023
CAM,  ,N 79,"Attività dei servizi delle agenzie di viaggio, dei tour o...",44,12,2,1,59,2023
CAM,  ,N 80,Servizi di vigilanza e investigazione                       ,2,1,0,1,4,2023
CAM,  ,N 81,Attività di servizi per edifici e paesaggio                 ,39,22,4,6,71,2023
CAM,  ,N 82,Attività di supporto per le funzioni d'ufficio e altri se...,49,39,7,4,99,2023
CAM,  ,O   ,Amministrazione pubblica e difesa; assicurazione sociale ...,1,0,0,0,1,2023
CAM,  ,O 84,Amministrazione pubblica e difesa; assicurazione sociale ...,1,0,0,0,1,2023
CAM,  ,P   ,Istruzione                                                  ,46,11,3,4,64,2023
CAM,  ,P 85,Istruzione                                                  ,46,11,3,4,64,2023
CAM,  ,Q   ,Sanita' e assistenza sociale                                ,61,25,0,17,103,2023
CAM,  ,Q 86,Assistenza sanitaria                                        ,57,25,0,1,83,2023
CAM,  ,Q 87,Servizi di assistenza sociale residenziale                  ,0,0,0,2,2,2023
CAM,  ,Q 88,Assistenza sociale non residenziale                         ,4,0,0,14,18,2023
CAM,  ,R   ,"Attività artistiche, sportive, di intrattenimento e diver...",87,32,5,3,127,2023
CAM,  ,R 90,"Attività creative, artistiche e di intrattenimento          ",24,6,2,1,33,2023
CAM,  ,R 91,"Attività di biblioteche, archivi, musei ed altre attività...",0,0,0,1,1,2023
CAM,  ,R 92,"Attività riguardanti le lotterie, le scommesse, le case d...",3,6,1,0,10,2023
CAM,  ,R 93,"Attività sportive, di intrattenimento e di divertimento     ",60,20,2,1,83,2023
CAM,  ,S   ,Altre attività di servizi                                   ,60,72,34,1,167,2023
CAM,  ,S 94,Attività di organizzazioni associative                      ,1,0,0,0,1,2023
CAM,  ,S 95,Riparazione di computer e di beni per uso personale e per...,14,13,10,0,37,2023
CAM,  ,S 96,Altre attività di servizi per la persona                    ,45,59,24,1,129,2023
CAM,  ,T   ,Attività di famiglie e convivenze come datori di lavoro p...,0,0,0,0,0,2023
CAM,  ,T 97,Attività di famiglie e convivenze come datori di lavoro p...,0,0,0,0,0,2023
CAM,  ,T 98,Produzione di beni e servizi indifferenziati per uso prop...,0,0,0,0,0,2023
CAM,  ,U   ,Organizzazioni ed organismi extraterritoriali               ,0,0,0,0,0,2023
CAM,  ,U 99,Organizzazioni ed organismi extraterritoriali               ,0,0,0,0,0,2023
CAM,  ,XX  ,Imprese non classificate                                    ,201,90,22,36,349,2023
CAM,  ,TOT ,TOTALE                                                      ,6848,2782,1292,228,11150,2023
CAM,CE,A   ,"Agricoltura, silvicoltura pesca                             ",0,0,25,7,32,2023
CAM,CE,A 01,"Coltivazioni agricole e produzione di prodotti animali, c...",0,0,23,7,30,2023
CAM,CE,A 02,Silvicoltura ed utilizzo di aree forestali                  ,0,0,2,0,2,2023
CAM,CE,A 03,Pesca e acquacoltura                                        ,0,0,0,0,0,2023
CAM,CE,B   ,Estrazione di minerali da cave e miniere                    ,0,0,0,0,0,2023
CAM,CE,B 05,Estrazione di carbone (esclusa torba)                       ,0,0,0,0,0,2023
CAM,CE,B 06,Estraz.di petrolio greggio e di gas naturale                ,0,0,0,0,0,2023
CAM,CE,B 07,Estrazione di minerali metalliferi                          ,0,0,0,0,0,2023
CAM,CE,B 08,Altre attività di estrazione di minerali da cave e miniere  ,0,0,0,0,0,2023
CAM,CE,B 09,Attività dei servizi di supporto all'estrazione             ,0,0,0,0,0,2023
CAM,CE,C   ,Attività manifatturiere                                     ,0,0,22,6,28,2023
CAM,CE,C 10,Industrie alimentari                                        ,0,0,3,3,6,2023
CAM,CE,C 11,Industria delle bevande                                     ,0,0,0,0,0,2023
CAM,CE,C 12,Industria del tabacco                                       ,0,0,0,0,0,2023
CAM,CE,C 13,Industrie tessili                                           ,0,0,0,0,0,2023
CAM,CE,C 14,Confezione di articoli di abbigliamento; confezione di ar...,0,0,5,0,5,2023
CAM,CE,C 15,Fabbricazione di articoli in pelle e simili                 ,0,0,3,1,4,2023
CAM,CE,C 16,Industria del legno e dei prodotti in legno e sughero (es...,0,0,1,0,1,2023
CAM,CE,C 17,Fabbricazione di carta e di prodotti di carta               ,0,0,0,0,0,2023
CAM,CE,C 18,Stampa e riproduzione di supporti registrati                ,0,0,2,0,2,2023
CAM,CE,C 19,Fabbricazione di coke e prodotti derivanti dalla raffinaz...,0,0,0,0,0,2023
CAM,CE,C 20,Fabbricazione di prodotti chimici                           ,0,0,0,0,0,2023
CAM,CE,C 21,Fabbricazione di prodotti farmaceutici di base e di prepa...,0,0,0,0,0,2023
CAM,CE,C 22,Fabbricazione di articoli in gomma e materie plastiche      ,0,0,0,0,0,2023
CAM,CE,C 23,Fabbricazione di altri prodotti della lavorazione di miner..,0,0,1,1,2,2023
CAM,CE,C 24,Metallurgia                                                 ,0,0,0,1,1,2023
CAM,CE,C 25,Fabbricazione di prodotti in metallo (esclusi macchinari ...,0,0,1,0,1,2023
CAM,CE,C 26,Fabbricazione di computer e prodotti di elettronica e ott...,0,0,0,0,0,2023
CAM,CE,C 27,Fabbricazione di apparecchiature elettriche ed apparecchi...,0,0,1,0,1,2023
CAM,CE,C 28,Fabbricazione di macchinari ed apparecchiature nca          ,0,0,0,0,0,2023
CAM,CE,C 29,"Fabbricazione di autoveicoli, rimorchi e semirimorchi       ",0,0,1,0,1,2023
CAM,CE,C 30,Fabbricazione di altri mezzi di trasporto                   ,0,0,0,0,0,2023
CAM,CE,C 31,Fabbricazione di mobili                                     ,0,0,0,0,0,2023
CAM,CE,C 32,Altre industrie manifatturiere                              ,0,0,1,0,1,2023
CAM,CE,C 33,"Riparazione, manutenzione ed installazione di macchine ed...",0,0,3,0,3,2023
CAM,CE,D   ,"Fornitura di energia elettrica, gas, vapore e aria condiz...",0,0,0,0,0,2023
CAM,CE,D 35,"Fornitura di energia elettrica, gas, vapore e aria condiz...",0,0,0,0,0,2023
CAM,CE,E   ,"Fornitura di acqua; reti fognarie, attività di gestione d...",0,0,0,0,0,2023
CAM,CE,E 36,"Raccolta, trattamento e fornitura di acqua                  ",0,0,0,0,0,2023
CAM,CE,E 37,Gestione delle reti fognarie                                ,0,0,0,0,0,2023
CAM,CE,E 38,"Attività di raccolta, trattamento e smaltimento dei rifiu...",0,0,0,0,0,2023
CAM,CE,E 39,Attività di risanamento e altri servizi di gestione dei r...,0,0,0,0,0,2023
CAM,CE,F   ,Costruzioni                                                 ,0,0,52,57,109,2023
CAM,CE,F 41,Costruzione di edifici                                      ,0,0,40,52,92,2023
CAM,CE,F 42,Ingegneria civile                                           ,0,0,0,0,0,2023
CAM,CE,F 43,Lavori di costruzione specializzati                         ,0,0,12,5,17,2023
CAM,CE,G   ,Commercio all'ingrosso e al dettaglio; riparazione di aut...,0,0,101,6,107,2023
CAM,CE,G 45,Commercio all'ingrosso e al dettaglio e riparazione di au...,0,0,9,0,9,2023
CAM,CE,G 46,Commercio all'ingrosso (escluso quello di autoveicoli e d...,0,0,8,4,12,2023
CAM,CE,G 47,Commercio al dettaglio (escluso quello di autoveicoli e d...,0,0,84,2,86,2023
CAM,CE,H   ,Trasporto e magazzinaggio                                   ,0,0,2,8,10,2023
CAM,CE,H 49,Trasporto terrestre e mediante condotte                     ,0,0,0,3,3,2023
CAM,CE,H 50,Trasporto marittimo e per vie d'acqua                       ,0,0,0,0,0,2023
CAM,CE,H 51,Trasporto aereo                                             ,0,0,0,0,0,2023
CAM,CE,H 52,Magazzinaggio e attività di supporto ai trasporti           ,0,0,2,4,6,2023
CAM,CE,H 53,Servizi postali e attività di corriere                      ,0,0,0,1,1,2023
CAM,CE,I   ,Attività dei servizi alloggio e ristorazione                ,0,0,15,0,15,2023
CAM,CE,I 55,Alloggio                                                    ,0,0,0,0,0,2023
CAM,CE,I 56,Attività dei servizi di ristorazione                        ,0,0,15,0,15,2023
CAM,CE,J   ,Servizi di informazione e comunicazione                     ,0,0,2,1,3,2023
CAM,CE,J 58,Attività editoriali                                         ,0,0,0,1,1,2023
CAM,CE,J 59,"Attività di produzione cinematografica, di video e di pro...",0,0,0,0,0,2023
CAM,CE,J 60,Attività di programmazione e trasmissione                   ,0,0,0,0,0,2023
CAM,CE,J 61,Telecomunicazioni                                           ,0,0,0,0,0,2023
CAM,CE,J 62,"Produzione di software, consulenza informatica e attività...",0,0,0,0,0,2023
CAM,CE,J 63,Attività dei servizi d'informazione e altri servizi infor...,0,0,2,0,2,2023
CAM,CE,K   ,Attività finanziarie e assicurative                         ,0,0,1,0,1,2023
CAM,CE,K 64,Attività di servizi finanziari (escluse le assicurazioni ...,0,0,0,0,0,2023
CAM,CE,K 65,"Assicurazioni, riassicurazioni e fondi pensione (escluse ...",0,0,0,0,0,2023
CAM,CE,K 66,Attività ausiliarie dei servizi finanziari e delle attivi...,0,0,1,0,1,2023
CAM,CE,L   ,Attivita' immobiliari                                       ,0,0,0,0,0,2023
CAM,CE,L 68,Attivita' immobiliari                                       ,0,0,0,0,0,2023
CAM,CE,M   ,"Attività professionali, scientifiche e tecniche             ",0,0,2,0,2,2023
CAM,CE,M 69,Attività legali e contabilità                               ,0,0,0,0,0,2023
CAM,CE,M 70,Attività di direzione aziendale e di consulenza gestional...,0,0,0,0,0,2023
CAM,CE,M 71,Attività degli studi di architettura e d'ingegneria; coll...,0,0,0,0,0,2023
CAM,CE,M 72,Ricerca scientifica e sviluppo                              ,0,0,0,0,0,2023
CAM,CE,M 73,Pubblicità e ricerche di mercato                            ,0,0,0,0,0,2023
CAM,CE,M 74,"Altre attività professionali, scientifiche e tecniche       ",0,0,2,0,2,2023
CAM,CE,M 75,Servizi veterinari                                          ,0,0,0,0,0,2023
CAM,CE,N   ,"Noleggio, agenzie di viaggio, servizi di supporto alle im...",0,0,4,4,8,2023
CAM,CE,N 77,Attività di noleggio e leasing operativo                    ,0,0,0,0,0,2023
CAM,CE,N 78,"Attività di ricerca, selezione, fornitura di personale      ",0,0,0,0,0,2023
CAM,CE,N 79,"Attività dei servizi delle agenzie di viaggio, dei tour o...",0,0,1,0,1,2023
CAM,CE,N 80,Servizi di vigilanza e investigazione                       ,0,0,0,1,1,2023
CAM,CE,N 81,Attività di servizi per edifici e paesaggio                 ,0,0,1,3,4,2023
CAM,CE,N 82,Attività di supporto per le funzioni d'ufficio e altri se...,0,0,2,0,2,2023
CAM,CE,O   ,Amministrazione pubblica e difesa; assicurazione sociale ...,0,0,0,0,0,2023
CAM,CE,O 84,Amministrazione pubblica e difesa; assicurazione sociale ...,0,0,0,0,0,2023
CAM,CE,P   ,Istruzione                                                  ,0,0,2,4,6,2023
CAM,CE,P 85,Istruzione                                                  ,0,0,2,4,6,2023
CAM,CE,Q   ,Sanita' e assistenza sociale                                ,0,0,0,6,6,2023
CAM,CE,Q 86,Assistenza sanitaria                                        ,0,0,0,0,0,2023
CAM,CE,Q 87,Servizi di assistenza sociale residenziale                  ,0,0,0,0,0,2023
CAM,CE,Q 88,Assistenza sociale non residenziale                         ,0,0,0,6,6,2023
CAM,CE,R   ,"Attività artistiche, sportive, di intrattenimento e diver...",0,0,1,0,1,2023
CAM,CE,R 90,"Attività creative, artistiche e di intrattenimento          ",0,0,0,0,0,2023
CAM,CE,R 91,"Attività di biblioteche, archivi, musei ed altre attività...",0,0,0,0,0,2023
CAM,CE,R 92,"Attività riguardanti le lotterie, le scommesse, le case d...",0,0,0,0,0,2023
CAM,CE,R 93,"Attività sportive, di intrattenimento e di divertimento     ",0,0,1,0,1,2023
CAM,CE,S   ,Altre attività di servizi                                   ,0,0,4,1,5,2023
CAM,CE,S 94,Attività di organizzazioni associative                      ,0,0,0,0,0,2023
CAM,CE,S 95,Riparazione di computer e di beni per uso personale e per...,0,0,3,0,3,2023
CAM,CE,S 96,Altre attività di servizi per la persona                    ,0,0,1,1,2,2023
CAM,CE,T   ,Attività di famiglie e convivenze come datori di lavoro p...,0,0,0,0,0,2023
CAM,CE,T 97,Attività di famiglie e convivenze come datori di lavoro p...,0,0,0,0,0,2023
CAM,CE,T 98,Produzione di beni e servizi indifferenziati per uso prop...,0,0,0,0,0,2023
CAM,CE,U   ,Organizzazioni ed organismi extraterritoriali               ,0,0,0,0,0,2023
CAM,CE,U 99,Organizzazioni ed organismi extraterritoriali               ,0,0,0,0,0,2023
CAM,CE,XX  ,Imprese non classificate                                    ,0,0,1,21,22,2023
CAM,CE,TOT ,TOTALE                                                      ,0,0,234,121,355,2023
CAM,BN,A   ,"Agricoltura, silvicoltura pesca                             ",0,0,0,0,0,2023
CAM,BN,A 01,"Coltivazioni agricole e produzione di prodotti animali, c...",0,0,0,0,0,2023
CAM,BN,A 02,Silvicoltura ed utilizzo di aree forestali                  ,0,0,0,0,0,2023
CAM,BN,A 03,Pesca e acquacoltura                                        ,0,0,0,0,0,2023
CAM,BN,B   ,Estrazione di minerali da cave e miniere                    ,0,0,0,0,0,2023
CAM,BN,B 05,Estrazione di carbone (esclusa torba)                       ,0,0,0,0,0,2023
CAM,BN,B 06,Estraz.di petrolio greggio e di gas naturale                ,0,0,0,0,0,2023
CAM,BN,B 07,Estrazione di minerali metalliferi                          ,0,0,0,0,0,2023
CAM,BN,B 08,Altre attività di estrazione di minerali da cave e miniere  ,0,0,0,0,0,2023
CAM,BN,B 09,Attività dei servizi di supporto all'estrazione             ,0,0,0,0,0,2023
CAM,BN,C   ,Attività manifatturiere                                     ,0,0,0,0,0,2023
CAM,BN,C 10,Industrie alimentari                                        ,0,0,0,0,0,2023
CAM,BN,C 11,Industria delle bevande                                     ,0,0,0,0,0,2023
CAM,BN,C 12,Industria del tabacco                                       ,0,0,0,0,0,2023
CAM,BN,C 13,Industrie tessili                                           ,0,0,0,0,0,2023
CAM,BN,C 14,Confezione di articoli di abbigliamento; confezione di ar...,0,0,0,0,0,2023
CAM,BN,C 15,Fabbricazione di articoli in pelle e simili                 ,0,0,0,0,0,2023
CAM,BN,C 16,Industria del legno e dei prodotti in legno e sughero (es...,0,0,0,0,0,2023
CAM,BN,C 17,Fabbricazione di carta e di prodotti di carta               ,0,0,0,0,0,2023
CAM,BN,C 18,Stampa e riproduzione di supporti registrati                ,0,0,0,0,0,2023
CAM,BN,C 19,Fabbricazione di coke e prodotti derivanti dalla raffinaz...,0,0,0,0,0,2023
CAM,BN,C 20,Fabbricazione di prodotti chimici                           ,0,0,0,0,0,2023
CAM,BN,C 21,Fabbricazione di prodotti farmaceutici di base e di prepa...,0,0,0,0,0,2023
CAM,BN,C 22,Fabbricazione di articoli in gomma e materie plastiche      ,0,0,0,0,0,2023
CAM,BN,C 23,Fabbricazione di altri prodotti della lavorazione di miner..,0,0,0,0,0,2023
CAM,BN,C 24,Metallurgia                                                 ,0,0,0,0,0,2023
CAM,BN,C 25,Fabbricazione di prodotti in metallo (esclusi macchinari ...,0,0,0,0,0,2023
CAM,BN,C 26,Fabbricazione di computer e prodotti di elettronica e ott...,0,0,0,0,0,2023
CAM,BN,C 27,Fabbricazione di apparecchiature elettriche ed apparecchi...,0,0,0,0,0,2023
CAM,BN,C 28,Fabbricazione di macchinari ed apparecchiature nca          ,0,0,0,0,0,2023
CAM,BN,C 29,"Fabbricazione di autoveicoli, rimorchi e semirimorchi       ",0,0,0,0,0,2023
CAM,BN,C 30,Fabbricazione di altri mezzi di trasporto                   ,0,0,0,0,0,2023
CAM,BN,C 31,Fabbricazione di mobili                                     ,0,0,0,0,0,2023
CAM,BN,C 32,Altre industrie manifatturiere                              ,0,0,0,0,0,2023
CAM,BN,C 33,"Riparazione, manutenzione ed installazione di macchine ed...",0,0,0,0,0,2023
CAM,BN,D   ,"Fornitura di energia elettrica, gas, vapore e aria condiz...",0,0,0,0,0,2023
CAM,BN,D 35,"Fornitura di energia elettrica, gas, vapore e aria condiz...",0,0,0,0,0,2023
CAM,BN,E   ,"Fornitura di acqua; reti fognarie, attività di gestione d...",0,0,0,0,0,2023
CAM,BN,E 36,"Raccolta, trattamento e fornitura di acqua                  ",0,0,0,0,0,2023
CAM,BN,E 37,Gestione delle reti fognarie                                ,0,0,0,0,0,2023
CAM,BN,E 38,"Attività di raccolta, trattamento e smaltimento dei rifiu...",0,0,0,0,0,2023
CAM,BN,E 39,Attività di risanamento e altri servizi di gestione dei r...,0,0,0,0,0,2023
CAM,BN,F   ,Costruzioni                                                 ,0,0,0,0,0,2023
CAM,BN,F 41,Costruzione di edifici                                      ,0,0,0,0,0,2023
CAM,BN,F 42,Ingegneria civile                                           ,0,0,0,0,0,2023
CAM,BN,F 43,Lavori di costruzione specializzati                         ,0,0,0,0,0,2023
CAM,BN,G   ,Commercio all'ingrosso e al dettaglio; riparazione di aut...,0,0,0,0,0,2023
CAM,BN,G 45,Commercio all'ingrosso e al dettaglio e riparazione di au...,0,0,0,0,0,2023
CAM,BN,G 46,Commercio all'ingrosso (escluso quello di autoveicoli e d...,0,0,0,0,0,2023
CAM,BN,G 47,Commercio al dettaglio (escluso quello di autoveicoli e d...,0,0,0,0,0,2023
CAM,BN,H   ,Trasporto e magazzinaggio                                   ,0,0,0,0,0,2023
CAM,BN,H 49,Trasporto terrestre e mediante condotte                     ,0,0,0,0,0,2023
CAM,BN,H 50,Trasporto marittimo e per vie d'acqua                       ,0,0,0,0,0,2023
CAM,BN,H 51,Trasporto aereo                                             ,0,0,0,0,0,2023
CAM,BN,H 52,Magazzinaggio e attività di supporto ai trasporti           ,0,0,0,0,0,2023
CAM,BN,H 53,Servizi postali e attività di corriere                      ,0,0,0,0,0,2023
CAM,BN,I   ,Attività dei servizi alloggio e ristorazione                ,0,0,0,0,0,2023
CAM,BN,I 55,Alloggio                                                    ,0,0,0,0,0,2023
CAM,BN,I 56,Attività dei servizi di ristorazione                        ,0,0,0,0,0,2023
CAM,BN,J   ,Servizi di informazione e comunicazione                     ,0,0,0,0,0,2023
CAM,BN,J 58,Attività editoriali                                         ,0,0,0,0,0,2023
CAM,BN,J 59,"Attività di produzione cinematografica, di video e di pro...",0,0,0,0,0,2023
CAM,BN,J 60,Attività di programmazione e trasmissione                   ,0,0,0,0,0,2023
CAM,BN,J 61,Telecomunicazioni                                           ,0,0,0,0,0,2023
CAM,BN,J 62,"Produzione di software, consulenza informatica e attività...",0,0,0,0,0,2023
CAM,BN,J 63,Attività dei servizi d'informazione e altri servizi infor...,0,0,0,0,0,2023
CAM,BN,K   ,Attività finanziarie e assicurative                         ,0,0,0,0,0,2023
CAM,BN,K 64,Attività di servizi finanziari (escluse le assicurazioni ...,0,0,0,0,0,2023
CAM,BN,K 65,"Assicurazioni, riassicurazioni e fondi pensione (escluse ...",0,0,0,0,0,2023
CAM,BN,K 66,Attività ausiliarie dei servizi finanziari e delle attivi...,0,0,0,0,0,2023
CAM,BN,L   ,Attivita' immobiliari                                       ,0,0,0,0,0,2023
CAM,BN,L 68,Attivita' immobiliari                                       ,0,0,0,0,0,2023
CAM,BN,M   ,"Attività professionali, scientifiche e tecniche             ",0,0,0,0,0,2023
CAM,BN,M 69,Attività legali e contabilità                               ,0,0,0,0,0,2023
CAM,BN,M 70,Attività di direzione aziendale e di consulenza gestional...,0,0,0,0,0,2023
CAM,BN,M 71,Attività degli studi di architettura e d'ingegneria; coll...,0,0,0,0,0,2023
CAM,BN,M 72,Ricerca scientifica e sviluppo                              ,0,0,0,0,0,2023
CAM,BN,M 73,Pubblicità e ricerche di mercato                            ,0,0,0,0,0,2023
CAM,BN,M 74,"Altre attività professionali, scientifiche e tecniche       ",0,0,0,0,0,2023
CAM,BN,M 75,Servizi veterinari                                          ,0,0,0,0,0,2023
CAM,BN,N   ,"Noleggio, agenzie di viaggio, servizi di supporto alle im...",0,0,0,0,0,2023
CAM,BN,N 77,Attività di noleggio e leasing operativo                    ,0,0,0,0,0,2023
CAM,BN,N 78,"Attività di ricerca, selezione, fornitura di personale      ",0,0,0,0,0,2023
CAM,BN,N 79,"Attività dei servizi delle agenzie di viaggio, dei tour o...",0,0,0,0,0,2023
CAM,BN,N 80,Servizi di vigilanza e investigazione                       ,0,0,0,0,0,2023
CAM,BN,N 81,Attività di servizi per edifici e paesaggio                 ,0,0,0,0,0,2023
CAM,BN,N 82,Attività di supporto per le funzioni d'ufficio e altri se...,0,0,0,0,0,2023
CAM,BN,O   ,Amministrazione pubblica e difesa; assicurazione sociale ...,0,0,0,0,0,2023
CAM,BN,O 84,Amministrazione pubblica e difesa; assicurazione sociale ...,0,0,0,0,0,2023
CAM,BN,P   ,Istruzione                                                  ,0,0,0,0,0,2023
CAM,BN,P 85,Istruzione                                                  ,0,0,0,0,0,2023
CAM,BN,Q   ,Sanita' e assistenza sociale                                ,0,0,0,0,0,2023
CAM,BN,Q 86,Assistenza sanitaria                                        ,0,0,0,0,0,2023
CAM,BN,Q 87,Servizi di assistenza sociale residenziale                  ,0,0,0,0,0,2023
CAM,BN,Q 88,Assistenza sociale non residenziale                         ,0,0,0,0,0,2023
CAM,BN,R   ,"Attività artistiche, sportive, di intrattenimento e diver...",0,0,0,0,0,2023
CAM,BN,R 90,"Attività creative, artistiche e di intrattenimento          ",0,0,0,0,0,2023
CAM,BN,R 91,"Attività di biblioteche, archivi, musei ed altre attività...",0,0,0,0,0,2023
CAM,BN,R 92,"Attività riguardanti le lotterie, le scommesse, le case d...",0,0,0,0,0,2023
CAM,BN,R 93,"Attività sportive, di intrattenimento e di divertimento     ",0,0,0,0,0,2023
CAM,BN,S   ,Altre attività di servizi                                   ,0,0,0,0,0,2023
CAM,BN,S 94,Attività di organizzazioni associative                      ,0,0,0,0,0,2023
CAM,BN,S 95,Riparazione di computer e di beni per uso personale e per...,0,0,0,0,0,2023
CAM,BN,S 96,Altre attività di servizi per la persona                    ,0,0,0,0,0,2023
CAM,BN,T   ,Attività di famiglie e convivenze come datori di lavoro p...,0,0,0,0,0,2023
CAM,BN,T 97,Attività di famiglie e convivenze come datori di lavoro p...,0,0,0,0,0,2023
CAM,BN,T 98,Produzione di beni e servizi indifferenziati per uso prop...,0,0,0,0,0,2023
CAM,BN,U   ,Organizzazioni ed organismi extraterritoriali               ,0,0,0,0,0,2023
CAM,BN,U 99,Organizzazioni ed organismi extraterritoriali               ,0,0,0,0,0,2023
CAM,BN,XX  ,Imprese non classificate                                    ,0,0,0,0,0,2023
CAM,BN,TOT ,TOTALE                                                      ,0,0,0,0,0,2023
CAM,NA,A   ,"Agricoltura, silvicoltura pesca                             ",46,12,6,0,64,2023
CAM,NA,A 01,"Coltivazioni agricole e produzione di prodotti animali, c...",42,11,5,0,58,2023
CAM,NA,A 02,Silvicoltura ed utilizzo di aree forestali                  ,0,0,0,0,0,2023
CAM,NA,A 03,Pesca e acquacoltura                                        ,4,1,1,0,6,2023
CAM,NA,B   ,Estrazione di minerali da cave e miniere                    ,8,4,0,1,13,2023
CAM,NA,B 05,Estrazione di carbone (esclusa torba)                       ,0,1,0,0,1,2023
CAM,NA,B 06,Estraz.di petrolio greggio e di gas naturale                ,0,0,0,0,0,2023
CAM,NA,B 07,Estrazione di minerali metalliferi                          ,0,1,0,1,2,2023
CAM,NA,B 08,Altre attività di estrazione di minerali da cave e miniere  ,8,2,0,0,10,2023
CAM,NA,B 09,Attività dei servizi di supporto all'estrazione             ,0,0,0,0,0,2023
CAM,NA,C   ,Attività manifatturiere                                     ,1312,303,18,0,1633,2023
CAM,NA,C 10,Industrie alimentari                                        ,97,41,3,0,141,2023
CAM,NA,C 11,Industria delle bevande                                     ,8,1,0,0,9,2023
CAM,NA,C 12,Industria del tabacco                                       ,0,0,0,0,0,2023
CAM,NA,C 13,Industrie tessili                                           ,31,9,0,0,40,2023
CAM,NA,C 14,Confezione di articoli di abbigliamento; confezione di ar...,223,64,6,0,293,2023
CAM,NA,C 15,Fabbricazione di articoli in pelle e simili                 ,162,45,1,0,208,2023
CAM,NA,C 16,Industria del legno e dei prodotti in legno e sughero (es...,42,18,0,0,60,2023
CAM,NA,C 17,Fabbricazione di carta e di prodotti di carta               ,34,2,0,0,36,2023
CAM,NA,C 18,Stampa e riproduzione di supporti registrati                ,47,10,0,0,57,2023
CAM,NA,C 19,Fabbricazione di coke e prodotti derivanti dalla raffinaz...,7,1,0,0,8,2023
CAM,NA,C 20,Fabbricazione di prodotti chimici                           ,53,3,0,0,56,2023
CAM,NA,C 21,Fabbricazione di prodotti farmaceutici di base e di prepa...,7,0,0,0,7,2023
CAM,NA,C 22,Fabbricazione di articoli in gomma e materie plastiche      ,32,6,1,0,39,2023
CAM,NA,C 23,Fabbricazione di altri prodotti della lavorazione di miner..,63,13,1,0,77,2023
CAM,NA,C 24,Metallurgia                                                 ,24,1,1,0,26,2023
CAM,NA,C 25,Fabbricazione di prodotti in metallo (esclusi macchinari ...,201,38,0,0,239,2023
CAM,NA,C 26,Fabbricazione di computer e prodotti di elettronica e ott...,43,2,0,0,45,2023
CAM,NA,C 27,Fabbricazione di apparecchiature elettriche ed apparecchi...,58,8,0,0,66,2023
CAM,NA,C 28,Fabbricazione di macchinari ed apparecchiature nca          ,42,6,0,0,48,2023
CAM,NA,C 29,"Fabbricazione di autoveicoli, rimorchi e semirimorchi       ",6,1,0,0,7,2023
CAM,NA,C 30,Fabbricazione di altri mezzi di trasporto                   ,31,5,1,0,37,2023
CAM,NA,C 31,Fabbricazione di mobili                                     ,42,14,0,0,56,2023
CAM,NA,C 32,Altre industrie manifatturiere                              ,35,12,1,0,48,2023
CAM,NA,C 33,"Riparazione, manutenzione ed installazione di macchine ed...",24,3,3,0,30,2023
CAM,NA,D   ,"Fornitura di energia elettrica, gas, vapore e aria condiz...",5,1,0,0,6,2023
CAM,NA,D 35,"Fornitura di energia elettrica, gas, vapore e aria condiz...",5,1,0,0,6,2023
CAM,NA,E   ,"Fornitura di acqua; reti fognarie, attività di gestione d...",36,6,0,2,44,2023
CAM,NA,E 36,"Raccolta, trattamento e fornitura di acqua                  ",3,0,0,0,3,2023
CAM,NA,E 37,Gestione delle reti fognarie                                ,2,1,0,0,3,2023
CAM,NA,E 38,"Attività di raccolta, trattamento e smaltimento dei rifiu...",28,5,0,2,35,2023
CAM,NA,E 39,Attività di risanamento e altri servizi di gestione dei r...,3,0,0,0,3,2023
CAM,NA,F   ,Costruzioni                                                 ,1216,204,49,28,1497,2023
CAM,NA,F 41,Costruzione di edifici                                      ,970,135,16,23,1144,2023
CAM,NA,F 42,Ingegneria civile                                           ,18,1,0,1,20,2023
CAM,NA,F 43,Lavori di costruzione specializzati                         ,228,68,33,4,333,2023
CAM,NA,G   ,Commercio all'ingrosso e al dettaglio; riparazione di aut...,2306,1249,141,2,3698,2023
CAM,NA,G 45,Commercio all'ingrosso e al dettaglio e riparazione di au...,186,99,18,0,303,2023
CAM,NA,G 46,Commercio all'ingrosso (escluso quello di autoveicoli e d...,1434,506,37,1,1978,2023
CAM,NA,G 47,Commercio al dettaglio (escluso quello di autoveicoli e d...,686,644,86,1,1417,2023
CAM,NA,H   ,Trasporto e magazzinaggio                                   ,204,91,4,7,306,2023
CAM,NA,H 49,Trasporto terrestre e mediante condotte                     ,105,68,1,3,177,2023
CAM,NA,H 50,Trasporto marittimo e per vie d'acqua                       ,33,3,0,0,36,2023
CAM,NA,H 51,Trasporto aereo                                             ,3,0,0,0,3,2023
CAM,NA,H 52,Magazzinaggio e attività di supporto ai trasporti           ,58,19,3,4,84,2023
CAM,NA,H 53,Servizi postali e attività di corriere                      ,5,1,0,0,6,2023
CAM,NA,I   ,Attività dei servizi alloggio e ristorazione                ,208,385,28,0,621,2023
CAM,NA,I 55,Alloggio                                                    ,54,21,0,0,75,2023
CAM,NA,I 56,Attività dei servizi di ristorazione                        ,154,364,28,0,546,2023
CAM,NA,J   ,Servizi di informazione e comunicazione                     ,224,45,7,1,277,2023
CAM,NA,J 58,Attività editoriali                                         ,48,3,1,0,52,2023
CAM,NA,J 59,"Attività di produzione cinematografica, di video e di pro...",33,5,0,0,38,2023
CAM,NA,J 60,Attività di programmazione e trasmissione                   ,12,0,0,0,12,2023
CAM,NA,J 61,Telecomunicazioni                                           ,2,1,2,0,5,2023
CAM,NA,J 62,"Produzione di software, consulenza informatica e attività...",66,17,3,1,87,2023
CAM,NA,J 63,Attività dei servizi d'informazione e altri servizi infor...,63,19,1,0,83,2023
CAM,NA,K   ,Attività finanziarie e assicurative                         ,179,33,7,0,219,2023
CAM,NA,K 64,Attività di servizi finanziari (escluse le assicurazioni ...,127,9,0,0,136,2023
CAM,NA,K 65,"Assicurazioni, riassicurazioni e fondi pensione (escluse ...",7,2,0,0,9,2023
CAM,NA,K 66,Attività ausiliarie dei servizi finanziari e delle attivi...,45,22,7,0,74,2023
CAM,NA,L   ,Attivita' immobiliari                                       ,254,32,0,0,286,2023
CAM,NA,L 68,Attivita' immobiliari                                       ,254,32,0,0,286,2023
CAM,NA,M   ,"Attività professionali, scientifiche e tecniche             ",195,49,8,5,257,2023
CAM,NA,M 69,Attività legali e contabilità                               ,9,4,1,1,15,2023
CAM,NA,M 70,Attività di direzione aziendale e di consulenza gestional...,21,7,3,1,32,2023
CAM,NA,M 71,Attività degli studi di architettura e d'ingegneria; coll...,25,5,0,0,30,2023
CAM,NA,M 72,Ricerca scientifica e sviluppo                              ,9,2,0,0,11,2023
CAM,NA,M 73,Pubblicità e ricerche di mercato                            ,65,11,3,2,81,2023
CAM,NA,M 74,"Altre attività professionali, scientifiche e tecniche       ",66,19,1,1,87,2023
CAM,NA,M 75,Servizi veterinari                                          ,0,1,0,0,1,2023
CAM,NA,N   ,"Noleggio, agenzie di viaggio, servizi di supporto alle im...",171,87,9,7,274,2023
CAM,NA,N 77,Attività di noleggio e leasing operativo                    ,37,12,2,0,51,2023
CAM,NA,N 78,"Attività di ricerca, selezione, fornitura di personale      ",1,1,0,0,2,2023
CAM,NA,N 79,"Attività dei servizi delle agenzie di viaggio, dei tour o...",44,12,0,1,57,2023
CAM,NA,N 80,Servizi di vigilanza e investigazione                       ,2,1,0,0,3,2023
CAM,NA,N 81,Attività di servizi per edifici e paesaggio                 ,39,22,2,2,65,2023
CAM,NA,N 82,Attività di supporto per le funzioni d'ufficio e altri se...,48,39,5,4,96,2023
CAM,NA,O   ,Amministrazione pubblica e difesa; assicurazione sociale ...,1,0,0,0,1,2023
CAM,NA,O 84,Amministrazione pubblica e difesa; assicurazione sociale ...,1,0,0,0,1,2023
CAM,NA,P   ,Istruzione                                                  ,46,11,0,0,57,2023
CAM,NA,P 85,Istruzione                                                  ,46,11,0,0,57,2023
CAM,NA,Q   ,Sanita' e assistenza sociale                                ,61,25,0,1,87,2023
CAM,NA,Q 86,Assistenza sanitaria                                        ,57,25,0,1,83,2023
CAM,NA,Q 87,Servizi di assistenza sociale residenziale                  ,0,0,0,0,0,2023
CAM,NA,Q 88,Assistenza sociale non residenziale                         ,4,0,0,0,4,2023
CAM,NA,R   ,"Attività artistiche, sportive, di intrattenimento e diver...",86,32,2,0,120,2023
CAM,NA,R 90,"Attività creative, artistiche e di intrattenimento          ",24,6,0,0,30,2023
CAM,NA,R 91,"Attività di biblioteche, archivi, musei ed altre attività...",0,0,0,0,0,2023
CAM,NA,R 92,"Attività riguardanti le lotterie, le scommesse, le case d...",2,6,1,0,9,2023
CAM,NA,R 93,"Attività sportive, di intrattenimento e di divertimento     ",60,20,1,0,81,2023
CAM,NA,S   ,Altre attività di servizi                                   ,58,69,24,0,151,2023
CAM,NA,S 94,Attività di organizzazioni associative                      ,1,0,0,0,1,2023
CAM,NA,S 95,Riparazione di computer e di beni per uso personale e per...,14,12,4,0,30,2023
CAM,NA,S 96,Altre attività di servizi per la persona                    ,43,57,20,0,120,2023
CAM,NA,T   ,Attività di famiglie e convivenze come datori di lavoro p...,0,0,0,0,0,2023
CAM,NA,T 97,Attività di famiglie e convivenze come datori di lavoro p...,0,0,0,0,0,2023
CAM,NA,T 98,Produzione di beni e servizi indifferenziati per uso prop...,0,0,0,0,0,2023
CAM,NA,U   ,Organizzazioni ed organismi extraterritoriali               ,0,0,0,0,0,2023
CAM,NA,U 99,Organizzazioni ed organismi extraterritoriali               ,0,0,0,0,0,2023
CAM,NA,XX  ,Imprese non classificate                                    ,199,89,14,8,310,2023
CAM,NA,TOT ,TOTALE                                                      ,6815,2727,317,62,9921,2023
CAM,AV,A   ,"Agricoltura, silvicoltura pesca                             ",0,0,0,0,0,2023
CAM,AV,A 01,"Coltivazioni agricole e produzione di prodotti animali, c...",0,0,0,0,0,2023
CAM,AV,A 02,Silvicoltura ed utilizzo di aree forestali                  ,0,0,0,0,0,2023
CAM,AV,A 03,Pesca e acquacoltura                                        ,0,0,0,0,0,2023
CAM,AV,B   ,Estrazione di minerali da cave e miniere                    ,0,0,0,0,0,2023
CAM,AV,B 05,Estrazione di carbone (esclusa torba)                       ,0,0,0,0,0,2023
CAM,AV,B 06,Estraz.di petrolio greggio e di gas naturale                ,0,0,0,0,0,2023
CAM,AV,B 07,Estrazione di minerali metalliferi                          ,0,0,0,0,0,2023
CAM,AV,B 08,Altre attività di estrazione di minerali da cave e miniere  ,0,0,0,0,0,2023
CAM,AV,B 09,Attività dei servizi di supporto all'estrazione             ,0,0,0,0,0,2023
CAM,AV,C   ,Attività manifatturiere                                     ,0,0,0,0,0,2023
CAM,AV,C 10,Industrie alimentari                                        ,0,0,0,0,0,2023
CAM,AV,C 11,Industria delle bevande                                     ,0,0,0,0,0,2023
CAM,AV,C 12,Industria del tabacco                                       ,0,0,0,0,0,2023
CAM,AV,C 13,Industrie tessili                                           ,0,0,0,0,0,2023
CAM,AV,C 14,Confezione di articoli di abbigliamento; confezione di ar...,0,0,0,0,0,2023
CAM,AV,C 15,Fabbricazione di articoli in pelle e simili                 ,0,0,0,0,0,2023
CAM,AV,C 16,Industria del legno e dei prodotti in legno e sughero (es...,0,0,0,0,0,2023
CAM,AV,C 17,Fabbricazione di carta e di prodotti di carta               ,0,0,0,0,0,2023
CAM,AV,C 18,Stampa e riproduzione di supporti registrati                ,0,0,0,0,0,2023
CAM,AV,C 19,Fabbricazione di coke e prodotti derivanti dalla raffinaz...,0,0,0,0,0,2023
CAM,AV,C 20,Fabbricazione di prodotti chimici                           ,0,0,0,0,0,2023
CAM,AV,C 21,Fabbricazione di prodotti farmaceutici di base e di prepa...,0,0,0,0,0,2023
CAM,AV,C 22,Fabbricazione di articoli in gomma e materie plastiche      ,0,0,0,0,0,2023
CAM,AV,C 23,Fabbricazione di altri prodotti della lavorazione di miner..,0,0,0,0,0,2023
CAM,AV,C 24,Metallurgia                                                 ,0,0,0,0,0,2023
CAM,AV,C 25,Fabbricazione di prodotti in metallo (esclusi macchinari ...,0,0,0,0,0,2023
CAM,AV,C 26,Fabbricazione di computer e prodotti di elettronica e ott...,0,0,0,0,0,2023
CAM,AV,C 27,Fabbricazione di apparecchiature elettriche ed apparecchi...,0,0,0,0,0,2023
CAM,AV,C 28,Fabbricazione di macchinari ed apparecchiature nca          ,0,0,0,0,0,2023
CAM,AV,C 29,"Fabbricazione di autoveicoli, rimorchi e semirimorchi       ",0,0,0,0,0,2023
CAM,AV,C 30,Fabbricazione di altri mezzi di trasporto                   ,0,0,0,0,0,2023
CAM,AV,C 31,Fabbricazione di mobili                                     ,0,0,0,0,0,2023
CAM,AV,C 32,Altre industrie manifatturiere                              ,0,0,0,0,0,2023
CAM,AV,C 33,"Riparazione, manutenzione ed installazione di macchine ed...",0,0,0,0,0,2023
CAM,AV,D   ,"Fornitura di energia elettrica, gas, vapore e aria condiz...",0,0,0,0,0,2023
CAM,AV,D 35,"Fornitura di energia elettrica, gas, vapore e aria condiz...",0,0,0,0,0,2023
CAM,AV,E   ,"Fornitura di acqua; reti fognarie, attività di gestione d...",0,0,0,0,0,2023
CAM,AV,E 36,"Raccolta, trattamento e fornitura di acqua                  ",0,0,0,0,0,2023
CAM,AV,E 37,Gestione delle reti fognarie                                ,0,0,0,0,0,2023
CAM,AV,E 38,"Attività di raccolta, trattamento e smaltimento dei rifiu...",0,0,0,0,0,2023
CAM,AV,E 39,Attività di risanamento e altri servizi di gestione dei r...,0,0,0,0,0,2023
CAM,AV,F   ,Costruzioni                                                 ,0,0,0,0,0,2023
CAM,AV,F 41,Costruzione di edifici                                      ,0,0,0,0,0,2023
CAM,AV,F 42,Ingegneria civile                                           ,0,0,0,0,0,2023
CAM,AV,F 43,Lavori di costruzione specializzati                         ,0,0,0,0,0,2023
CAM,AV,G   ,Commercio all'ingrosso e al dettaglio; riparazione di aut...,0,0,0,0,0,2023
CAM,AV,G 45,Commercio all'ingrosso e al dettaglio e riparazione di au...,0,0,0,0,0,2023
CAM,AV,G 46,Commercio all'ingrosso (escluso quello di autoveicoli e d...,0,0,0,0,0,2023
CAM,AV,G 47,Commercio al dettaglio (escluso quello di autoveicoli e d...,0,0,0,0,0,2023
CAM,AV,H   ,Trasporto e magazzinaggio                                   ,0,0,0,0,0,2023
CAM,AV,H 49,Trasporto terrestre e mediante condotte                     ,0,0,0,0,0,2023
CAM,AV,H 50,Trasporto marittimo e per vie d'acqua                       ,0,0,0,0,0,2023
CAM,AV,H 51,Trasporto aereo                                             ,0,0,0,0,0,2023
CAM,AV,H 52,Magazzinaggio e attività di supporto ai trasporti           ,0,0,0,0,0,2023
CAM,AV,H 53,Servizi postali e attività di corriere                      ,0,0,0,0,0,2023
CAM,AV,I   ,Attività dei servizi alloggio e ristorazione                ,0,0,0,0,0,2023
CAM,AV,I 55,Alloggio                                                    ,0,0,0,0,0,2023
CAM,AV,I 56,Attività dei servizi di ristorazione                        ,0,0,0,0,0,2023
CAM,AV,J   ,Servizi di informazione e comunicazione                     ,0,0,0,0,0,2023
CAM,AV,J 58,Attività editoriali                                         ,0,0,0,0,0,2023
CAM,AV,J 59,"Attività di produzione cinematografica, di video e di pro...",0,0,0,0,0,2023
CAM,AV,J 60,Attività di programmazione e trasmissione                   ,0,0,0,0,0,2023
CAM,AV,J 61,Telecomunicazioni                                           ,0,0,0,0,0,2023
CAM,AV,J 62,"Produzione di software, consulenza informatica e attività...",0,0,0,0,0,2023
CAM,AV,J 63,Attività dei servizi d'informazione e altri servizi infor...,0,0,0,0,0,2023
CAM,AV,K   ,Attività finanziarie e assicurative                         ,0,0,0,0,0,2023
CAM,AV,K 64,Attività di servizi finanziari (escluse le assicurazioni ...,0,0,0,0,0,2023
CAM,AV,K 65,"Assicurazioni, riassicurazioni e fondi pensione (escluse ...",0,0,0,0,0,2023
CAM,AV,K 66,Attività ausiliarie dei servizi finanziari e delle attivi...,0,0,0,0,0,2023
CAM,AV,L   ,Attivita' immobiliari                                       ,0,0,0,0,0,2023
CAM,AV,L 68,Attivita' immobiliari                                       ,0,0,0,0,0,2023
CAM,AV,M   ,"Attività professionali, scientifiche e tecniche             ",0,0,0,0,0,2023
CAM,AV,M 69,Attività legali e contabilità                               ,0,0,0,0,0,2023
CAM,AV,M 70,Attività di direzione aziendale e di consulenza gestional...,0,0,0,0,0,2023
CAM,AV,M 71,Attività degli studi di architettura e d'ingegneria; coll...,0,0,0,0,0,2023
CAM,AV,M 72,Ricerca scientifica e sviluppo                              ,0,0,0,0,0,2023
CAM,AV,M 73,Pubblicità e ricerche di mercato                            ,0,0,0,0,0,2023
CAM,AV,M 74,"Altre attività professionali, scientifiche e tecniche       ",0,0,0,0,0,2023
CAM,AV,M 75,Servizi veterinari                                          ,0,0,0,0,0,2023
CAM,AV,N   ,"Noleggio, agenzie di viaggio, servizi di supporto alle im...",0,0,0,0,0,2023
CAM,AV,N 77,Attività di noleggio e leasing operativo                    ,0,0,0,0,0,2023
CAM,AV,N 78,"Attività di ricerca, selezione, fornitura di personale      ",0,0,0,0,0,2023
CAM,AV,N 79,"Attività dei servizi delle agenzie di viaggio, dei tour o...",0,0,0,0,0,2023
CAM,AV,N 80,Servizi di vigilanza e investigazione                       ,0,0,0,0,0,2023
CAM,AV,N 81,Attività di servizi per edifici e paesaggio                 ,0,0,0,0,0,2023
CAM,AV,N 82,Attività di supporto per le funzioni d'ufficio e altri se...,0,0,0,0,0,2023
CAM,AV,O   ,Amministrazione pubblica e difesa; assicurazione sociale ...,0,0,0,0,0,2023
CAM,AV,O 84,Amministrazione pubblica e difesa; assicurazione sociale ...,0,0,0,0,0,2023
CAM,AV,P   ,Istruzione                                                  ,0,0,0,0,0,2023
CAM,AV,P 85,Istruzione                                                  ,0,0,0,0,0,2023
CAM,AV,Q   ,Sanita' e assistenza sociale                                ,0,0,0,1,1,2023
CAM,AV,Q 86,Assistenza sanitaria                                        ,0,0,0,0,0,2023
CAM,AV,Q 87,Servizi di assistenza sociale residenziale                  ,0,0,0,0,0,2023
CAM,AV,Q 88,Assistenza sociale non residenziale                         ,0,0,0,1,1,2023
CAM,AV,R   ,"Attività artistiche, sportive, di intrattenimento e diver...",0,0,0,0,0,2023
CAM,AV,R 90,"Attività creative, artistiche e di intrattenimento          ",0,0,0,0,0,2023
CAM,AV,R 91,"Attività di biblioteche, archivi, musei ed altre attività...",0,0,0,0,0,2023
CAM,AV,R 92,"Attività riguardanti le lotterie, le scommesse, le case d...",0,0,0,0,0,2023
CAM,AV,R 93,"Attività sportive, di intrattenimento e di divertimento     ",0,0,0,0,0,2023
CAM,AV,S   ,Altre attività di servizi                                   ,0,0,0,0,0,2023
CAM,AV,S 94,Attività di organizzazioni associative                      ,0,0,0,0,0,2023
CAM,AV,S 95,Riparazione di computer e di beni per uso personale e per...,0,0,0,0,0,2023
CAM,AV,S 96,Altre attività di servizi per la persona                    ,0,0,0,0,0,2023
CAM,AV,T   ,Attività di famiglie e convivenze come datori di lavoro p...,0,0,0,0,0,2023
CAM,AV,T 97,Attività di famiglie e convivenze come datori di lavoro p...,0,0,0,0,0,2023
CAM,AV,T 98,Produzione di beni e servizi indifferenziati per uso prop...,0,0,0,0,0,2023
CAM,AV,U   ,Organizzazioni ed organismi extraterritoriali               ,0,0,0,0,0,2023
CAM,AV,U 99,Organizzazioni ed organismi extraterritoriali               ,0,0,0,0,0,2023
CAM,AV,XX  ,Imprese non classificate                                    ,0,0,0,0,0,2023
CAM,AV,TOT ,TOTALE                                                      ,0,0,0,1,1,2023
CAM,SA,A   ,"Agricoltura, silvicoltura pesca                             ",0,2,444,5,451,2023
CAM,SA,A 01,"Coltivazioni agricole e produzione di prodotti animali, c...",0,2,441,5,448,2023
CAM,SA,A 02,Silvicoltura ed utilizzo di aree forestali                  ,0,0,2,0,2,2023
CAM,SA,A 03,Pesca e acquacoltura                                        ,0,0,1,0,1,2023
CAM,SA,B   ,Estrazione di minerali da cave e miniere                    ,0,0,0,0,0,2023
CAM,SA,B 05,Estrazione di carbone (esclusa torba)                       ,0,0,0,0,0,2023
CAM,SA,B 06,Estraz.di petrolio greggio e di gas naturale                ,0,0,0,0,0,2023
CAM,SA,B 07,Estrazione di minerali metalliferi                          ,0,0,0,0,0,2023
CAM,SA,B 08,Altre attività di estrazione di minerali da cave e miniere  ,0,0,0,0,0,2023
CAM,SA,B 09,Attività dei servizi di supporto all'estrazione             ,0,0,0,0,0,2023
CAM,SA,C   ,Attività manifatturiere                                     ,2,8,49,0,59,2023
CAM,SA,C 10,Industrie alimentari                                        ,0,0,15,0,15,2023
CAM,SA,C 11,Industria delle bevande                                     ,0,0,0,0,0,2023
CAM,SA,C 12,Industria del tabacco                                       ,0,0,0,0,0,2023
CAM,SA,C 13,Industrie tessili                                           ,0,0,1,0,1,2023
CAM,SA,C 14,Confezione di articoli di abbigliamento; confezione di ar...,0,0,1,0,1,2023
CAM,SA,C 15,Fabbricazione di articoli in pelle e simili                 ,0,0,3,0,3,2023
CAM,SA,C 16,Industria del legno e dei prodotti in legno e sughero (es...,0,3,11,0,14,2023
CAM,SA,C 17,Fabbricazione di carta e di prodotti di carta               ,0,0,0,0,0,2023
CAM,SA,C 18,Stampa e riproduzione di supporti registrati                ,0,2,0,0,2,2023
CAM,SA,C 19,Fabbricazione di coke e prodotti derivanti dalla raffinaz...,0,0,0,0,0,2023
CAM,SA,C 20,Fabbricazione di prodotti chimici                           ,0,0,1,0,1,2023
CAM,SA,C 21,Fabbricazione di prodotti farmaceutici di base e di prepa...,0,0,0,0,0,2023
CAM,SA,C 22,Fabbricazione di articoli in gomma e materie plastiche      ,0,0,1,0,1,2023
CAM,SA,C 23,Fabbricazione di altri prodotti della lavorazione di miner..,0,3,5,0,8,2023
CAM,SA,C 24,Metallurgia                                                 ,0,0,0,0,0,2023
CAM,SA,C 25,Fabbricazione di prodotti in metallo (esclusi macchinari ...,1,0,8,0,9,2023
CAM,SA,C 26,Fabbricazione di computer e prodotti di elettronica e ott...,0,0,0,0,0,2023
CAM,SA,C 27,Fabbricazione di apparecchiature elettriche ed apparecchi...,0,0,0,0,0,2023
CAM,SA,C 28,Fabbricazione di macchinari ed apparecchiature nca          ,0,0,2,0,2,2023
CAM,SA,C 29,"Fabbricazione di autoveicoli, rimorchi e semirimorchi       ",0,0,0,0,0,2023
CAM,SA,C 30,Fabbricazione di altri mezzi di trasporto                   ,1,0,0,0,1,2023
CAM,SA,C 31,Fabbricazione di mobili                                     ,0,0,0,0,0,2023
CAM,SA,C 32,Altre industrie manifatturiere                              ,0,0,1,0,1,2023
CAM,SA,C 33,"Riparazione, manutenzione ed installazione di macchine ed...",0,0,0,0,0,2023
CAM,SA,D   ,"Fornitura di energia elettrica, gas, vapore e aria condiz...",0,0,0,0,0,2023
CAM,SA,D 35,"Fornitura di energia elettrica, gas, vapore e aria condiz...",0,0,0,0,0,2023
CAM,SA,E   ,"Fornitura di acqua; reti fognarie, attività di gestione d...",1,0,0,0,1,2023
CAM,SA,E 36,"Raccolta, trattamento e fornitura di acqua                  ",0,0,0,0,0,2023
CAM,SA,E 37,Gestione delle reti fognarie                                ,0,0,0,0,0,2023
CAM,SA,E 38,"Attività di raccolta, trattamento e smaltimento dei rifiu...",1,0,0,0,1,2023
CAM,SA,E 39,Attività di risanamento e altri servizi di gestione dei r...,0,0,0,0,0,2023
CAM,SA,F   ,Costruzioni                                                 ,6,4,50,14,74,2023
CAM,SA,F 41,Costruzione di edifici                                      ,5,1,30,14,50,2023
CAM,SA,F 42,Ingegneria civile                                           ,0,1,2,0,3,2023
CAM,SA,F 43,Lavori di costruzione specializzati                         ,1,2,18,0,21,2023
CAM,SA,G   ,Commercio all'ingrosso e al dettaglio; riparazione di aut...,10,23,125,2,160,2023
CAM,SA,G 45,Commercio all'ingrosso e al dettaglio e riparazione di au...,3,2,10,0,15,2023
CAM,SA,G 46,Commercio all'ingrosso (escluso quello di autoveicoli e d...,3,10,20,0,33,2023
CAM,SA,G 47,Commercio al dettaglio (escluso quello di autoveicoli e d...,4,11,95,2,112,2023
CAM,SA,H   ,Trasporto e magazzinaggio                                   ,1,1,22,2,26,2023
CAM,SA,H 49,Trasporto terrestre e mediante condotte                     ,0,1,20,1,22,2023
CAM,SA,H 50,Trasporto marittimo e per vie d'acqua                       ,0,0,0,0,0,2023
CAM,SA,H 51,Trasporto aereo                                             ,0,0,0,0,0,2023
CAM,SA,H 52,Magazzinaggio e attività di supporto ai trasporti           ,1,0,2,1,4,2023
CAM,SA,H 53,Servizi postali e attività di corriere                      ,0,0,0,0,0,2023
CAM,SA,I   ,Attività dei servizi alloggio e ristorazione                ,1,10,26,0,37,2023
CAM,SA,I 55,Alloggio                                                    ,0,1,7,0,8,2023
CAM,SA,I 56,Attività dei servizi di ristorazione                        ,1,9,19,0,29,2023
CAM,SA,J   ,Servizi di informazione e comunicazione                     ,1,1,3,0,5,2023
CAM,SA,J 58,Attività editoriali                                         ,0,0,2,0,2,2023
CAM,SA,J 59,"Attività di produzione cinematografica, di video e di pro...",0,0,0,0,0,2023
CAM,SA,J 60,Attività di programmazione e trasmissione                   ,0,0,0,0,0,2023
CAM,SA,J 61,Telecomunicazioni                                           ,0,0,0,0,0,2023
CAM,SA,J 62,"Produzione di software, consulenza informatica e attività...",1,1,0,0,2,2023
CAM,SA,J 63,Attività dei servizi d'informazione e altri servizi infor...,0,0,1,0,1,2023
CAM,SA,K   ,Attività finanziarie e assicurative                         ,0,1,1,0,2,2023
CAM,SA,K 64,Attività di servizi finanziari (escluse le assicurazioni ...,0,0,0,0,0,2023
CAM,SA,K 65,"Assicurazioni, riassicurazioni e fondi pensione (escluse ...",0,0,0,0,0,2023
CAM,SA,K 66,Attività ausiliarie dei servizi finanziari e delle attivi...,0,1,1,0,2,2023
CAM,SA,L   ,Attivita' immobiliari                                       ,2,0,0,0,2,2023
CAM,SA,L 68,Attivita' immobiliari                                       ,2,0,0,0,2,2023
CAM,SA,M   ,"Attività professionali, scientifiche e tecniche             ",3,1,2,1,7,2023
CAM,SA,M 69,Attività legali e contabilità                               ,0,0,0,0,0,2023
CAM,SA,M 70,Attività di direzione aziendale e di consulenza gestional...,1,0,0,0,1,2023
CAM,SA,M 71,Attività degli studi di architettura e d'ingegneria; coll...,0,1,0,1,2,2023
CAM,SA,M 72,Ricerca scientifica e sviluppo                              ,1,0,0,0,1,2023
CAM,SA,M 73,Pubblicità e ricerche di mercato                            ,1,0,0,0,1,2023
CAM,SA,M 74,"Altre attività professionali, scientifiche e tecniche       ",0,0,2,0,2,2023
CAM,SA,M 75,Servizi veterinari                                          ,0,0,0,0,0,2023
CAM,SA,N   ,"Noleggio, agenzie di viaggio, servizi di supporto alle im...",1,0,3,1,5,2023
CAM,SA,N 77,Attività di noleggio e leasing operativo                    ,0,0,1,0,1,2023
CAM,SA,N 78,"Attività di ricerca, selezione, fornitura di personale      ",0,0,0,0,0,2023
CAM,SA,N 79,"Attività dei servizi delle agenzie di viaggio, dei tour o...",0,0,1,0,1,2023
CAM,SA,N 80,Servizi di vigilanza e investigazione                       ,0,0,0,0,0,2023
CAM,SA,N 81,Attività di servizi per edifici e paesaggio                 ,0,0,1,1,2,2023
CAM,SA,N 82,Attività di supporto per le funzioni d'ufficio e altri se...,1,0,0,0,1,2023
CAM,SA,O   ,Amministrazione pubblica e difesa; assicurazione sociale ...,0,0,0,0,0,2023
CAM,SA,O 84,Amministrazione pubblica e difesa; assicurazione sociale ...,0,0,0,0,0,2023
CAM,SA,P   ,Istruzione                                                  ,0,0,1,0,1,2023
CAM,SA,P 85,Istruzione                                                  ,0,0,1,0,1,2023
CAM,SA,Q   ,Sanita' e assistenza sociale                                ,0,0,0,9,9,2023
CAM,SA,Q 86,Assistenza sanitaria                                        ,0,0,0,0,0,2023
CAM,SA,Q 87,Servizi di assistenza sociale residenziale                  ,0,0,0,2,2,2023
CAM,SA,Q 88,Assistenza sociale non residenziale                         ,0,0,0,7,7,2023
CAM,SA,R   ,"Attività artistiche, sportive, di intrattenimento e diver...",1,0,2,3,6,2023
CAM,SA,R 90,"Attività creative, artistiche e di intrattenimento          ",0,0,2,1,3,2023
CAM,SA,R 91,"Attività di biblioteche, archivi, musei ed altre attività...",0,0,0,1,1,2023
CAM,SA,R 92,"Attività riguardanti le lotterie, le scommesse, le case d...",1,0,0,0,1,2023
CAM,SA,R 93,"Attività sportive, di intrattenimento e di divertimento     ",0,0,0,1,1,2023
CAM,SA,S   ,Altre attività di servizi                                   ,2,3,6,0,11,2023
CAM,SA,S 94,Attività di organizzazioni associative                      ,0,0,0,0,0,2023
CAM,SA,S 95,Riparazione di computer e di beni per uso personale e per...,0,1,3,0,4,2023
CAM,SA,S 96,Altre attività di servizi per la persona                    ,2,2,3,0,7,2023
CAM,SA,T   ,Attività di famiglie e convivenze come datori di lavoro p...,0,0,0,0,0,2023
CAM,SA,T 97,Attività di famiglie e convivenze come datori di lavoro p...,0,0,0,0,0,2023
CAM,SA,T 98,Produzione di beni e servizi indifferenziati per uso prop...,0,0,0,0,0,2023
CAM,SA,U   ,Organizzazioni ed organismi extraterritoriali               ,0,0,0,0,0,2023
CAM,SA,U 99,Organizzazioni ed organismi extraterritoriali               ,0,0,0,0,0,2023
CAM,SA,XX  ,Imprese non classificate                                    ,2,1,7,7,17,2023
CAM,SA,TOT ,TOTALE                                                      ,33,55,741,44,873,2023
PUG,  ,A   ,"Agricoltura, silvicoltura pesca                             ",39,36,1507,38,1620,2023
PUG,  ,A 01,"Coltivazioni agricole e produzione di prodotti animali, c...",37,34,1503,36,1610,2023
PUG,  ,A 02,Silvicoltura ed utilizzo di aree forestali                  ,0,0,1,0,1,2023
PUG,  ,A 03,Pesca e acquacoltura                                        ,2,2,3,2,9,2023
PUG,  ,B   ,Estrazione di minerali da cave e miniere                    ,5,4,6,2,17,2023
PUG,  ,B 05,Estrazione di carbone (esclusa torba)                       ,0,0,0,0,0,2023
PUG,  ,B 06,Estraz.di petrolio greggio e di gas naturale                ,0,0,0,0,0,2023
PUG,  ,B 07,Estrazione di minerali metalliferi                          ,0,0,0,0,0,2023
PUG,  ,B 08,Altre attività di estrazione di minerali da cave e miniere  ,5,4,6,2,17,2023
PUG,  ,B 09,Attività dei servizi di supporto all'estrazione             ,0,0,0,0,0,2023
PUG,  ,C   ,Attività manifatturiere                                     ,489,130,81,27,727,2023
PUG,  ,C 10,Industrie alimentari                                        ,38,30,20,10,98,2023
PUG,  ,C 11,Industria delle bevande                                     ,3,1,3,1,8,2023
PUG,  ,C 12,Industria del tabacco                                       ,1,0,0,0,1,2023
PUG,  ,C 13,Industrie tessili                                           ,20,5,1,1,27,2023
PUG,  ,C 14,Confezione di articoli di abbigliamento; confezione di ar...,103,25,18,2,148,2023
PUG,  ,C 15,Fabbricazione di articoli in pelle e simili                 ,24,6,3,0,33,2023
PUG,  ,C 16,Industria del legno e dei prodotti in legno e sughero (es...,16,5,3,1,25,2023
PUG,  ,C 17,Fabbricazione di carta e di prodotti di carta               ,6,2,1,0,9,2023
PUG,  ,C 18,Stampa e riproduzione di supporti registrati                ,13,6,2,1,22,2023
PUG,  ,C 19,Fabbricazione di coke e prodotti derivanti dalla raffinaz...,0,0,0,0,0,2023
PUG,  ,C 20,Fabbricazione di prodotti chimici                           ,5,1,0,0,6,2023
PUG,  ,C 21,Fabbricazione di prodotti farmaceutici di base e di prepa...,0,0,0,0,0,2023
PUG,  ,C 22,Fabbricazione di articoli in gomma e materie plastiche      ,10,3,0,0,13,2023
PUG,  ,C 23,Fabbricazione di altri prodotti della lavorazione di miner..,21,9,3,0,33,2023
PUG,  ,C 24,Metallurgia                                                 ,1,0,0,0,1,2023
PUG,  ,C 25,Fabbricazione di prodotti in metallo (esclusi macchinari ...,44,13,12,3,72,2023
PUG,  ,C 26,Fabbricazione di computer e prodotti di elettronica e ott...,17,1,0,1,19,2023
PUG,  ,C 27,Fabbricazione di apparecchiature elettriche ed apparecchi...,17,4,1,1,23,2023
PUG,  ,C 28,Fabbricazione di macchinari ed apparecchiature nca          ,32,2,1,4,39,2023
PUG,  ,C 29,"Fabbricazione di autoveicoli, rimorchi e semirimorchi       ",2,0,1,0,3,2023
PUG,  ,C 30,Fabbricazione di altri mezzi di trasporto                   ,4,4,0,0,8,2023
PUG,  ,C 31,Fabbricazione di mobili                                     ,88,8,6,0,102,2023
PUG,  ,C 32,Altre industrie manifatturiere                              ,9,2,2,0,13,2023
PUG,  ,C 33,"Riparazione, manutenzione ed installazione di macchine ed...",15,3,4,2,24,2023
PUG,  ,D   ,"Fornitura di energia elettrica, gas, vapore e aria condiz...",4,0,0,0,4,2023
PUG,  ,D 35,"Fornitura di energia elettrica, gas, vapore e aria condiz...",4,0,0,0,4,2023
PUG,  ,E   ,"Fornitura di acqua; reti fognarie, attività di gestione d...",6,1,1,2,10,2023
PUG,  ,E 36,"Raccolta, trattamento e fornitura di acqua                  ",0,0,0,1,1,2023
PUG,  ,E 37,Gestione delle reti fognarie                                ,0,1,1,1,3,2023
PUG,  ,E 38,"Attività di raccolta, trattamento e smaltimento dei rifiu...",5,0,0,0,5,2023
PUG,  ,E 39,Attività di risanamento e altri servizi di gestione dei r...,1,0,0,0,1,2023
PUG,  ,F   ,Costruzioni                                                 ,524,123,119,115,881,2023
PUG,  ,F 41,Costruzione di edifici                                      ,362,56,52,77,547,2023
PUG,  ,F 42,Ingegneria civile                                           ,11,2,3,7,23,2023
PUG,  ,F 43,Lavori di costruzione specializzati                         ,151,65,64,31,311,2023
PUG,  ,G   ,Commercio all'ingrosso e al dettaglio; riparazione di aut...,928,314,676,38,1956,2023
PUG,  ,G 45,Commercio all'ingrosso e al dettaglio e riparazione di au...,83,28,38,3,152,2023
PUG,  ,G 46,Commercio all'ingrosso (escluso quello di autoveicoli e d...,399,114,174,17,704,2023
PUG,  ,G 47,Commercio al dettaglio (escluso quello di autoveicoli e d...,446,172,464,18,1100,2023
PUG,  ,H   ,Trasporto e magazzinaggio                                   ,87,31,27,44,189,2023
PUG,  ,H 49,Trasporto terrestre e mediante condotte                     ,56,25,22,28,131,2023
PUG,  ,H 50,Trasporto marittimo e per vie d'acqua                       ,1,0,0,0,1,2023
PUG,  ,H 51,Trasporto aereo                                             ,0,0,0,0,0,2023
PUG,  ,H 52,Magazzinaggio e attività di supporto ai trasporti           ,20,6,3,16,45,2023
PUG,  ,H 53,Servizi postali e attività di corriere                      ,10,0,2,0,12,2023
PUG,  ,I   ,Attività dei servizi alloggio e ristorazione                ,206,199,100,9,514,2023
PUG,  ,I 55,Alloggio                                                    ,14,7,4,2,27,2023
PUG,  ,I 56,Attività dei servizi di ristorazione                        ,192,192,96,7,487,2023
PUG,  ,J   ,Servizi di informazione e comunicazione                     ,104,24,16,5,149,2023
PUG,  ,J 58,Attività editoriali                                         ,11,3,1,0,15,2023
PUG,  ,J 59,"Attività di produzione cinematografica, di video e di pro...",8,3,4,1,16,2023
PUG,  ,J 60,Attività di programmazione e trasmissione                   ,3,3,1,1,8,2023
PUG,  ,J 61,Telecomunicazioni                                           ,6,5,2,0,13,2023
PUG,  ,J 62,"Produzione di software, consulenza informatica e attività...",36,3,1,0,40,2023
PUG,  ,J 63,Attività dei servizi d'informazione e altri servizi infor...,40,7,7,3,57,2023
PUG,  ,K   ,Attività finanziarie e assicurative                         ,27,13,13,0,53,2023
PUG,  ,K 64,Attività di servizi finanziari (escluse le assicurazioni ...,11,1,0,0,12,2023
PUG,  ,K 65,"Assicurazioni, riassicurazioni e fondi pensione (escluse ...",0,0,0,0,0,2023
PUG,  ,K 66,Attività ausiliarie dei servizi finanziari e delle attivi...,16,12,13,0,41,2023
PUG,  ,L   ,Attivita' immobiliari                                       ,74,20,13,1,108,2023
PUG,  ,L 68,Attivita' immobiliari                                       ,74,20,13,1,108,2023
PUG,  ,M   ,"Attività professionali, scientifiche e tecniche             ",145,20,19,18,202,2023
PUG,  ,M 69,Attività legali e contabilità                               ,7,0,0,1,8,2023
PUG,  ,M 70,Attività di direzione aziendale e di consulenza gestional...,34,7,5,8,54,2023
PUG,  ,M 71,Attività degli studi di architettura e d'ingegneria; coll...,21,0,2,2,25,2023
PUG,  ,M 72,Ricerca scientifica e sviluppo                              ,2,0,0,1,3,2023
PUG,  ,M 73,Pubblicità e ricerche di mercato                            ,52,8,9,3,72,2023
PUG,  ,M 74,"Altre attività professionali, scientifiche e tecniche       ",29,5,3,3,40,2023
PUG,  ,M 75,Servizi veterinari                                          ,0,0,0,0,0,2023
PUG,  ,N   ,"Noleggio, agenzie di viaggio, servizi di supporto alle im...",83,29,31,32,175,2023
PUG,  ,N 77,Attività di noleggio e leasing operativo                    ,14,1,5,0,20,2023
PUG,  ,N 78,"Attività di ricerca, selezione, fornitura di personale      ",3,0,0,0,3,2023
PUG,  ,N 79,"Attività dei servizi delle agenzie di viaggio, dei tour o...",14,11,2,2,29,2023
PUG,  ,N 80,Servizi di vigilanza e investigazione                       ,3,1,0,1,5,2023
PUG,  ,N 81,Attività di servizi per edifici e paesaggio                 ,15,6,8,25,54,2023
PUG,  ,N 82,Attività di supporto per le funzioni d'ufficio e altri se...,34,10,16,4,64,2023
PUG,  ,O   ,Amministrazione pubblica e difesa; assicurazione sociale ...,0,0,0,1,1,2023
PUG,  ,O 84,Amministrazione pubblica e difesa; assicurazione sociale ...,0,0,0,1,1,2023
PUG,  ,P   ,Istruzione                                                  ,15,10,2,12,39,2023
PUG,  ,P 85,Istruzione                                                  ,15,10,2,12,39,2023
PUG,  ,Q   ,Sanita' e assistenza sociale                                ,16,8,1,26,51,2023
PUG,  ,Q 86,Assistenza sanitaria                                        ,12,6,1,5,24,2023
PUG,  ,Q 87,Servizi di assistenza sociale residenziale                  ,1,0,0,5,6,2023
PUG,  ,Q 88,Assistenza sociale non residenziale                         ,3,2,0,16,21,2023
PUG,  ,R   ,"Attività artistiche, sportive, di intrattenimento e diver...",42,20,14,6,82,2023
PUG,  ,R 90,"Attività creative, artistiche e di intrattenimento          ",7,2,2,1,12,2023
PUG,  ,R 91,"Attività di biblioteche, archivi, musei ed altre attività...",0,1,1,1,3,2023
PUG,  ,R 92,"Attività riguardanti le lotterie, le scommesse, le case d...",6,6,2,0,14,2023
PUG,  ,R 93,"Attività sportive, di intrattenimento e di divertimento     ",29,11,9,4,53,2023
PUG,  ,S   ,Altre attività di servizi                                   ,31,28,18,8,85,2023
PUG,  ,S 94,Attività di organizzazioni associative                      ,1,0,0,0,1,2023
PUG,  ,S 95,Riparazione di computer e di beni per uso personale e per...,13,3,4,0,20,2023
PUG,  ,S 96,Altre attività di servizi per la persona                    ,17,25,14,8,64,2023
PUG,  ,T   ,Attività di famiglie e convivenze come datori di lavoro p...,0,0,0,0,0,2023
PUG,  ,T 97,Attività di famiglie e convivenze come datori di lavoro p...,0,0,0,0,0,2023
PUG,  ,T 98,Produzione di beni e servizi indifferenziati per uso prop...,0,0,0,0,0,2023
PUG,  ,U   ,Organizzazioni ed organismi extraterritoriali               ,0,0,0,0,0,2023
PUG,  ,U 99,Organizzazioni ed organismi extraterritoriali               ,0,0,0,0,0,2023
PUG,  ,XX  ,Imprese non classificate                                    ,854,213,435,75,1577,2023
PUG,  ,TOT ,TOTALE                                                      ,3679,1223,3079,459,8440,2023
PUG,FG,A   ,"Agricoltura, silvicoltura pesca                             ",6,4,42,18,70,2023
PUG,FG,A 01,"Coltivazioni agricole e produzione di prodotti animali, c...",6,4,42,16,68,2023
PUG,FG,A 02,Silvicoltura ed utilizzo di aree forestali                  ,0,0,0,0,0,2023
PUG,FG,A 03,Pesca e acquacoltura                                        ,0,0,0,2,2,2023
PUG,FG,B   ,Estrazione di minerali da cave e miniere                    ,0,3,1,0,4,2023
PUG,FG,B 05,Estrazione di carbone (esclusa torba)                       ,0,0,0,0,0,2023
PUG,FG,B 06,Estraz.di petrolio greggio e di gas naturale                ,0,0,0,0,0,2023
PUG,FG,B 07,Estrazione di minerali metalliferi                          ,0,0,0,0,0,2023
PUG,FG,B 08,Altre attività di estrazione di minerali da cave e miniere  ,0,3,1,0,4,2023
PUG,FG,B 09,Attività dei servizi di supporto all'estrazione             ,0,0,0,0,0,2023
PUG,FG,C   ,Attività manifatturiere                                     ,13,28,10,9,60,2023
PUG,FG,C 10,Industrie alimentari                                        ,4,4,2,4,14,2023
PUG,FG,C 11,Industria delle bevande                                     ,2,0,1,1,4,2023
PUG,FG,C 12,Industria del tabacco                                       ,0,0,0,0,0,2023
PUG,FG,C 13,Industrie tessili                                           ,0,0,0,0,0,2023
PUG,FG,C 14,Confezione di articoli di abbigliamento; confezione di ar...,0,5,1,0,6,2023
PUG,FG,C 15,Fabbricazione di articoli in pelle e simili                 ,1,3,0,0,4,2023
PUG,FG,C 16,Industria del legno e dei prodotti in legno e sughero (es...,0,0,1,0,1,2023
PUG,FG,C 17,Fabbricazione di carta e di prodotti di carta               ,0,1,0,0,1,2023
PUG,FG,C 18,Stampa e riproduzione di supporti registrati                ,0,1,0,0,1,2023
PUG,FG,C 19,Fabbricazione di coke e prodotti derivanti dalla raffinaz...,0,0,0,0,0,2023
PUG,FG,C 20,Fabbricazione di prodotti chimici                           ,0,1,0,0,1,2023
PUG,FG,C 21,Fabbricazione di prodotti farmaceutici di base e di prepa...,0,0,0,0,0,2023
PUG,FG,C 22,Fabbricazione di articoli in gomma e materie plastiche      ,1,0,0,0,1,2023
PUG,FG,C 23,Fabbricazione di altri prodotti della lavorazione di miner..,3,3,1,0,7,2023
PUG,FG,C 24,Metallurgia                                                 ,0,0,0,0,0,2023
PUG,FG,C 25,Fabbricazione di prodotti in metallo (esclusi macchinari ...,0,4,1,1,6,2023
PUG,FG,C 26,Fabbricazione di computer e prodotti di elettronica e ott...,0,1,0,1,2,2023
PUG,FG,C 27,Fabbricazione di apparecchiature elettriche ed apparecchi...,0,1,0,0,1,2023
PUG,FG,C 28,Fabbricazione di macchinari ed apparecchiature nca          ,1,0,0,1,2,2023
PUG,FG,C 29,"Fabbricazione di autoveicoli, rimorchi e semirimorchi       ",0,0,0,0,0,2023
PUG,FG,C 30,Fabbricazione di altri mezzi di trasporto                   ,0,2,0,0,2,2023
PUG,FG,C 31,Fabbricazione di mobili                                     ,1,2,2,0,5,2023
PUG,FG,C 32,Altre industrie manifatturiere                              ,0,0,0,0,0,2023
PUG,FG,C 33,"Riparazione, manutenzione ed installazione di macchine ed...",0,0,1,1,2,2023
PUG,FG,D   ,"Fornitura di energia elettrica, gas, vapore e aria condiz...",0,0,0,0,0,2023
PUG,FG,D 35,"Fornitura di energia elettrica, gas, vapore e aria condiz...",0,0,0,0,0,2023
PUG,FG,E   ,"Fornitura di acqua; reti fognarie, attività di gestione d...",1,0,0,1,2,2023
PUG,FG,E 36,"Raccolta, trattamento e fornitura di acqua                  ",0,0,0,0,0,2023
PUG,FG,E 37,Gestione delle reti fognarie                                ,0,0,0,1,1,2023
PUG,FG,E 38,"Attività di raccolta, trattamento e smaltimento dei rifiu...",1,0,0,0,1,2023
PUG,FG,E 39,Attività di risanamento e altri servizi di gestione dei r...,0,0,0,0,0,2023
PUG,FG,F   ,Costruzioni                                                 ,23,34,20,11,88,2023
PUG,FG,F 41,Costruzione di edifici                                      ,19,25,12,9,65,2023
PUG,FG,F 42,Ingegneria civile                                           ,0,1,1,0,2,2023
PUG,FG,F 43,Lavori di costruzione specializzati                         ,4,8,7,2,21,2023
PUG,FG,G   ,Commercio all'ingrosso e al dettaglio; riparazione di aut...,62,103,105,3,273,2023
PUG,FG,G 45,Commercio all'ingrosso e al dettaglio e riparazione di au...,6,12,5,0,23,2023
PUG,FG,G 46,Commercio all'ingrosso (escluso quello di autoveicoli e d...,25,35,23,1,84,2023
PUG,FG,G 47,Commercio al dettaglio (escluso quello di autoveicoli e d...,31,56,77,2,166,2023
PUG,FG,H   ,Trasporto e magazzinaggio                                   ,4,3,5,21,33,2023
PUG,FG,H 49,Trasporto terrestre e mediante condotte                     ,3,3,5,17,28,2023
PUG,FG,H 50,Trasporto marittimo e per vie d'acqua                       ,1,0,0,0,1,2023
PUG,FG,H 51,Trasporto aereo                                             ,0,0,0,0,0,2023
PUG,FG,H 52,Magazzinaggio e attività di supporto ai trasporti           ,0,0,0,4,4,2023
PUG,FG,H 53,Servizi postali e attività di corriere                      ,0,0,0,0,0,2023
PUG,FG,I   ,Attività dei servizi alloggio e ristorazione                ,6,19,15,1,41,2023
PUG,FG,I 55,Alloggio                                                    ,1,3,2,1,7,2023
PUG,FG,I 56,Attività dei servizi di ristorazione                        ,5,16,13,0,34,2023
PUG,FG,J   ,Servizi di informazione e comunicazione                     ,5,3,2,0,10,2023
PUG,FG,J 58,Attività editoriali                                         ,0,1,0,0,1,2023
PUG,FG,J 59,"Attività di produzione cinematografica, di video e di pro...",0,0,1,0,1,2023
PUG,FG,J 60,Attività di programmazione e trasmissione                   ,0,0,0,0,0,2023
PUG,FG,J 61,Telecomunicazioni                                           ,0,0,0,0,0,2023
PUG,FG,J 62,"Produzione di software, consulenza informatica e attività...",0,0,0,0,0,2023
PUG,FG,J 63,Attività dei servizi d'informazione e altri servizi infor...,5,2,1,0,8,2023
PUG,FG,K   ,Attività finanziarie e assicurative                         ,1,0,1,0,2,2023
PUG,FG,K 64,Attività di servizi finanziari (escluse le assicurazioni ...,1,0,0,0,1,2023
PUG,FG,K 65,"Assicurazioni, riassicurazioni e fondi pensione (escluse ...",0,0,0,0,0,2023
PUG,FG,K 66,Attività ausiliarie dei servizi finanziari e delle attivi...,0,0,1,0,1,2023
PUG,FG,L   ,Attivita' immobiliari                                       ,0,3,0,0,3,2023
PUG,FG,L 68,Attivita' immobiliari                                       ,0,3,0,0,3,2023
PUG,FG,M   ,"Attività professionali, scientifiche e tecniche             ",0,2,0,0,2,2023
PUG,FG,M 69,Attività legali e contabilità                               ,0,0,0,0,0,2023
PUG,FG,M 70,Attività di direzione aziendale e di consulenza gestional...,0,0,0,0,0,2023
PUG,FG,M 71,Attività degli studi di architettura e d'ingegneria; coll...,0,0,0,0,0,2023
PUG,FG,M 72,Ricerca scientifica e sviluppo                              ,0,0,0,0,0,2023
PUG,FG,M 73,Pubblicità e ricerche di mercato                            ,0,2,0,0,2,2023
PUG,FG,M 74,"Altre attività professionali, scientifiche e tecniche       ",0,0,0,0,0,2023
PUG,FG,M 75,Servizi veterinari                                          ,0,0,0,0,0,2023
PUG,FG,N   ,"Noleggio, agenzie di viaggio, servizi di supporto alle im...",3,2,2,3,10,2023
PUG,FG,N 77,Attività di noleggio e leasing operativo                    ,0,1,0,0,1,2023
PUG,FG,N 78,"Attività di ricerca, selezione, fornitura di personale      ",0,0,0,0,0,2023
PUG,FG,N 79,"Attività dei servizi delle agenzie di viaggio, dei tour o...",0,0,0,0,0,2023
PUG,FG,N 80,Servizi di vigilanza e investigazione                       ,1,1,0,0,2,2023
PUG,FG,N 81,Attività di servizi per edifici e paesaggio                 ,1,0,1,3,5,2023
PUG,FG,N 82,Attività di supporto per le funzioni d'ufficio e altri se...,1,0,1,0,2,2023
PUG,FG,O   ,Amministrazione pubblica e difesa; assicurazione sociale ...,0,0,0,0,0,2023
PUG,FG,O 84,Amministrazione pubblica e difesa; assicurazione sociale ...,0,0,0,0,0,2023
PUG,FG,P   ,Istruzione                                                  ,0,1,0,0,1,2023
PUG,FG,P 85,Istruzione                                                  ,0,1,0,0,1,2023
PUG,FG,Q   ,Sanita' e assistenza sociale                                ,0,2,0,4,6,2023
PUG,FG,Q 86,Assistenza sanitaria                                        ,0,2,0,2,4,2023
PUG,FG,Q 87,Servizi di assistenza sociale residenziale                  ,0,0,0,1,1,2023
PUG,FG,Q 88,Assistenza sociale non residenziale                         ,0,0,0,1,1,2023
PUG,FG,R   ,"Attività artistiche, sportive, di intrattenimento e diver...",0,4,0,0,4,2023
PUG,FG,R 90,"Attività creative, artistiche e di intrattenimento          ",0,0,0,0,0,2023
PUG,FG,R 91,"Attività di biblioteche, archivi, musei ed altre attività...",0,1,0,0,1,2023
PUG,FG,R 92,"Attività riguardanti le lotterie, le scommesse, le case d...",0,0,0,0,0,2023
PUG,FG,R 93,"Attività sportive, di intrattenimento e di divertimento     ",0,3,0,0,3,2023
PUG,FG,S   ,Altre attività di servizi                                   ,0,2,2,1,5,2023
PUG,FG,S 94,Attività di organizzazioni associative                      ,0,0,0,0,0,2023
PUG,FG,S 95,Riparazione di computer e di beni per uso personale e per...,0,2,1,0,3,2023
PUG,FG,S 96,Altre attività di servizi per la persona                    ,0,0,1,1,2,2023
PUG,FG,T   ,Attività di famiglie e convivenze come datori di lavoro p...,0,0,0,0,0,2023
PUG,FG,T 97,Attività di famiglie e convivenze come datori di lavoro p...,0,0,0,0,0,2023
PUG,FG,T 98,Produzione di beni e servizi indifferenziati per uso prop...,0,0,0,0,0,2023
PUG,FG,U   ,Organizzazioni ed organismi extraterritoriali               ,0,0,0,0,0,2023
PUG,FG,U 99,Organizzazioni ed organismi extraterritoriali               ,0,0,0,0,0,2023
PUG,FG,XX  ,Imprese non classificate                                    ,48,20,4,16,88,2023
PUG,FG,TOT ,TOTALE                                                      ,172,233,209,88,702,2023
PUG,BA,A   ,"Agricoltura, silvicoltura pesca                             ",30,32,449,8,519,2023
PUG,BA,A 01,"Coltivazioni agricole e produzione di prodotti animali, c...",28,30,448,8,514,2023
PUG,BA,A 02,Silvicoltura ed utilizzo di aree forestali                  ,0,0,0,0,0,2023
PUG,BA,A 03,Pesca e acquacoltura                                        ,2,2,1,0,5,2023
PUG,BA,B   ,Estrazione di minerali da cave e miniere                    ,5,1,4,1,11,2023
PUG,BA,B 05,Estrazione di carbone (esclusa torba)                       ,0,0,0,0,0,2023
PUG,BA,B 06,Estraz.di petrolio greggio e di gas naturale                ,0,0,0,0,0,2023
PUG,BA,B 07,Estrazione di minerali metalliferi                          ,0,0,0,0,0,2023
PUG,BA,B 08,Altre attività di estrazione di minerali da cave e miniere  ,5,1,4,1,11,2023
PUG,BA,B 09,Attività dei servizi di supporto all'estrazione             ,0,0,0,0,0,2023
PUG,BA,C   ,Attività manifatturiere                                     ,441,88,50,12,591,2023
PUG,BA,C 10,Industrie alimentari                                        ,31,20,12,5,68,2023
PUG,BA,C 11,Industria delle bevande                                     ,1,0,1,0,2,2023
PUG,BA,C 12,Industria del tabacco                                       ,0,0,0,0,0,2023
PUG,BA,C 13,Industrie tessili                                           ,19,4,1,0,24,2023
PUG,BA,C 14,Confezione di articoli di abbigliamento; confezione di ar...,95,18,14,1,128,2023
PUG,BA,C 15,Fabbricazione di articoli in pelle e simili                 ,21,3,3,0,27,2023
PUG,BA,C 16,Industria del legno e dei prodotti in legno e sughero (es...,15,4,2,1,22,2023
PUG,BA,C 17,Fabbricazione di carta e di prodotti di carta               ,6,1,0,0,7,2023
PUG,BA,C 18,Stampa e riproduzione di supporti registrati                ,11,4,2,0,17,2023
PUG,BA,C 19,Fabbricazione di coke e prodotti derivanti dalla raffinaz...,0,0,0,0,0,2023
PUG,BA,C 20,Fabbricazione di prodotti chimici                           ,4,0,0,0,4,2023
PUG,BA,C 21,Fabbricazione di prodotti farmaceutici di base e di prepa...,0,0,0,0,0,2023
PUG,BA,C 22,Fabbricazione di articoli in gomma e materie plastiche      ,8,3,0,0,11,2023
PUG,BA,C 23,Fabbricazione di altri prodotti della lavorazione di miner..,17,5,1,0,23,2023
PUG,BA,C 24,Metallurgia                                                 ,1,0,0,0,1,2023
PUG,BA,C 25,Fabbricazione di prodotti in metallo (esclusi macchinari ...,40,9,6,2,57,2023
PUG,BA,C 26,Fabbricazione di computer e prodotti di elettronica e ott...,17,0,0,0,17,2023
PUG,BA,C 27,Fabbricazione di apparecchiature elettriche ed apparecchi...,16,2,0,1,19,2023
PUG,BA,C 28,Fabbricazione di macchinari ed apparecchiature nca          ,29,2,1,2,34,2023
PUG,BA,C 29,"Fabbricazione di autoveicoli, rimorchi e semirimorchi       ",2,0,0,0,2,2023
PUG,BA,C 30,Fabbricazione di altri mezzi di trasporto                   ,3,2,0,0,5,2023
PUG,BA,C 31,Fabbricazione di mobili                                     ,82,6,4,0,92,2023
PUG,BA,C 32,Altre industrie manifatturiere                              ,8,2,2,0,12,2023
PUG,BA,C 33,"Riparazione, manutenzione ed installazione di macchine ed...",15,3,1,0,19,2023
PUG,BA,D   ,"Fornitura di energia elettrica, gas, vapore e aria condiz...",3,0,0,0,3,2023
PUG,BA,D 35,"Fornitura di energia elettrica, gas, vapore e aria condiz...",3,0,0,0,3,2023
PUG,BA,E   ,"Fornitura di acqua; reti fognarie, attività di gestione d...",5,1,1,1,8,2023
PUG,BA,E 36,"Raccolta, trattamento e fornitura di acqua                  ",0,0,0,1,1,2023
PUG,BA,E 37,Gestione delle reti fognarie                                ,0,1,1,0,2,2023
PUG,BA,E 38,"Attività di raccolta, trattamento e smaltimento dei rifiu...",4,0,0,0,4,2023
PUG,BA,E 39,Attività di risanamento e altri servizi di gestione dei r...,1,0,0,0,1,2023
PUG,BA,F   ,Costruzioni                                                 ,455,77,73,55,660,2023
PUG,BA,F 41,Costruzione di edifici                                      ,317,25,22,46,410,2023
PUG,BA,F 42,Ingegneria civile                                           ,10,1,1,5,17,2023
PUG,BA,F 43,Lavori di costruzione specializzati                         ,128,51,50,4,233,2023
PUG,BA,G   ,Commercio all'ingrosso e al dettaglio; riparazione di aut...,788,182,411,23,1404,2023
PUG,BA,G 45,Commercio all'ingrosso e al dettaglio e riparazione di au...,66,13,22,2,103,2023
PUG,BA,G 46,Commercio all'ingrosso (escluso quello di autoveicoli e d...,351,69,122,11,553,2023
PUG,BA,G 47,Commercio al dettaglio (escluso quello di autoveicoli e d...,371,100,267,10,748,2023
PUG,BA,H   ,Trasporto e magazzinaggio                                   ,74,28,11,18,131,2023
PUG,BA,H 49,Trasporto terrestre e mediante condotte                     ,48,22,6,10,86,2023
PUG,BA,H 50,Trasporto marittimo e per vie d'acqua                       ,0,0,0,0,0,2023
PUG,BA,H 51,Trasporto aereo                                             ,0,0,0,0,0,2023
PUG,BA,H 52,Magazzinaggio e attività di supporto ai trasporti           ,18,6,3,8,35,2023
PUG,BA,H 53,Servizi postali e attività di corriere                      ,8,0,2,0,10,2023
PUG,BA,I   ,Attività dei servizi alloggio e ristorazione                ,172,163,64,1,400,2023
PUG,BA,I 55,Alloggio                                                    ,9,4,0,0,13,2023
PUG,BA,I 56,Attività dei servizi di ristorazione                        ,163,159,64,1,387,2023
PUG,BA,J   ,Servizi di informazione e comunicazione                     ,94,17,8,3,122,2023
PUG,BA,J 58,Attività editoriali                                         ,10,2,0,0,12,2023
PUG,BA,J 59,"Attività di produzione cinematografica, di video e di pro...",8,3,1,0,12,2023
PUG,BA,J 60,Attività di programmazione e trasmissione                   ,3,2,0,0,5,2023
PUG,BA,J 61,Telecomunicazioni                                           ,6,5,2,0,13,2023
PUG,BA,J 62,"Produzione di software, consulenza informatica e attività...",34,2,0,0,36,2023
PUG,BA,J 63,Attività dei servizi d'informazione e altri servizi infor...,33,3,5,3,44,2023
PUG,BA,K   ,Attività finanziarie e assicurative                         ,26,10,11,0,47,2023
PUG,BA,K 64,Attività di servizi finanziari (escluse le assicurazioni ...,10,1,0,0,11,2023
PUG,BA,K 65,"Assicurazioni, riassicurazioni e fondi pensione (escluse ...",0,0,0,0,0,2023
PUG,BA,K 66,Attività ausiliarie dei servizi finanziari e delle attivi...,16,9,11,0,36,2023
PUG,BA,L   ,Attivita' immobiliari                                       ,72,16,9,0,97,2023
PUG,BA,L 68,Attivita' immobiliari                                       ,72,16,9,0,97,2023
PUG,BA,M   ,"Attività professionali, scientifiche e tecniche             ",139,16,19,13,187,2023
PUG,BA,M 69,Attività legali e contabilità                               ,6,0,0,1,7,2023
PUG,BA,M 70,Attività di direzione aziendale e di consulenza gestional...,32,6,5,7,50,2023
PUG,BA,M 71,Attività degli studi di architettura e d'ingegneria; coll...,19,0,2,2,23,2023
PUG,BA,M 72,Ricerca scientifica e sviluppo                              ,1,0,0,1,2,2023
PUG,BA,M 73,Pubblicità e ricerche di mercato                            ,52,6,9,1,68,2023
PUG,BA,M 74,"Altre attività professionali, scientifiche e tecniche       ",29,4,3,1,37,2023
PUG,BA,M 75,Servizi veterinari                                          ,0,0,0,0,0,2023
PUG,BA,N   ,"Noleggio, agenzie di viaggio, servizi di supporto alle im...",78,23,25,16,142,2023
PUG,BA,N 77,Attività di noleggio e leasing operativo                    ,14,0,5,0,19,2023
PUG,BA,N 78,"Attività di ricerca, selezione, fornitura di personale      ",3,0,0,0,3,2023
PUG,BA,N 79,"Attività dei servizi delle agenzie di viaggio, dei tour o...",13,11,2,2,28,2023
PUG,BA,N 80,Servizi di vigilanza e investigazione                       ,2,0,0,0,2,2023
PUG,BA,N 81,Attività di servizi per edifici e paesaggio                 ,14,5,5,11,35,2023
PUG,BA,N 82,Attività di supporto per le funzioni d'ufficio e altri se...,32,7,13,3,55,2023
PUG,BA,O   ,Amministrazione pubblica e difesa; assicurazione sociale ...,0,0,0,1,1,2023
PUG,BA,O 84,Amministrazione pubblica e difesa; assicurazione sociale ...,0,0,0,1,1,2023
PUG,BA,P   ,Istruzione                                                  ,14,8,0,6,28,2023
PUG,BA,P 85,Istruzione                                                  ,14,8,0,6,28,2023
PUG,BA,Q   ,Sanita' e assistenza sociale                                ,15,6,1,15,37,2023
PUG,BA,Q 86,Assistenza sanitaria                                        ,11,4,1,3,19,2023
PUG,BA,Q 87,Servizi di assistenza sociale residenziale                  ,1,0,0,3,4,2023
PUG,BA,Q 88,Assistenza sociale non residenziale                         ,3,2,0,9,14,2023
PUG,BA,R   ,"Attività artistiche, sportive, di intrattenimento e diver...",41,13,14,5,73,2023
PUG,BA,R 90,"Attività creative, artistiche e di intrattenimento          ",6,1,2,1,10,2023
PUG,BA,R 91,"Attività di biblioteche, archivi, musei ed altre attività...",0,0,1,1,2,2023
PUG,BA,R 92,"Attività riguardanti le lotterie, le scommesse, le case d...",6,5,2,0,13,2023
PUG,BA,R 93,"Attività sportive, di intrattenimento e di divertimento     ",29,7,9,3,48,2023
PUG,BA,S   ,Altre attività di servizi                                   ,27,25,14,6,72,2023
PUG,BA,S 94,Attività di organizzazioni associative                      ,1,0,0,0,1,2023
PUG,BA,S 95,Riparazione di computer e di beni per uso personale e per...,13,0,3,0,16,2023
PUG,BA,S 96,Altre attività di servizi per la persona                    ,13,25,11,6,55,2023
PUG,BA,T   ,Attività di famiglie e convivenze come datori di lavoro p...,0,0,0,0,0,2023
PUG,BA,T 97,Attività di famiglie e convivenze come datori di lavoro p...,0,0,0,0,0,2023
PUG,BA,T 98,Produzione di beni e servizi indifferenziati per uso prop...,0,0,0,0,0,2023
PUG,BA,U   ,Organizzazioni ed organismi extraterritoriali               ,0,0,0,0,0,2023
PUG,BA,U 99,Organizzazioni ed organismi extraterritoriali               ,0,0,0,0,0,2023
PUG,BA,XX  ,Imprese non classificate                                    ,743,170,428,38,1379,2023
PUG,BA,TOT ,TOTALE                                                      ,3222,876,1592,222,5912,2023
PUG,TA,A   ,"Agricoltura, silvicoltura pesca                             ",0,0,376,4,380,2023
PUG,TA,A 01,"Coltivazioni agricole e produzione di prodotti animali, c...",0,0,375,4,379,2023
PUG,TA,A 02,Silvicoltura ed utilizzo di aree forestali                  ,0,0,0,0,0,2023
PUG,TA,A 03,Pesca e acquacoltura                                        ,0,0,1,0,1,2023
PUG,TA,B   ,Estrazione di minerali da cave e miniere                    ,0,0,1,0,1,2023
PUG,TA,B 05,Estrazione di carbone (esclusa torba)                       ,0,0,0,0,0,2023
PUG,TA,B 06,Estraz.di petrolio greggio e di gas naturale                ,0,0,0,0,0,2023
PUG,TA,B 07,Estrazione di minerali metalliferi                          ,0,0,0,0,0,2023
PUG,TA,B 08,Altre attività di estrazione di minerali da cave e miniere  ,0,0,1,0,1,2023
PUG,TA,B 09,Attività dei servizi di supporto all'estrazione             ,0,0,0,0,0,2023
PUG,TA,C   ,Attività manifatturiere                                     ,1,2,2,1,6,2023
PUG,TA,C 10,Industrie alimentari                                        ,0,0,0,0,0,2023
PUG,TA,C 11,Industria delle bevande                                     ,0,1,0,0,1,2023
PUG,TA,C 12,Industria del tabacco                                       ,0,0,0,0,0,2023
PUG,TA,C 13,Industrie tessili                                           ,0,0,0,0,0,2023
PUG,TA,C 14,Confezione di articoli di abbigliamento; confezione di ar...,0,1,0,0,1,2023
PUG,TA,C 15,Fabbricazione di articoli in pelle e simili                 ,0,0,0,0,0,2023
PUG,TA,C 16,Industria del legno e dei prodotti in legno e sughero (es...,0,0,0,0,0,2023
PUG,TA,C 17,Fabbricazione di carta e di prodotti di carta               ,0,0,0,0,0,2023
PUG,TA,C 18,Stampa e riproduzione di supporti registrati                ,0,0,0,1,1,2023
PUG,TA,C 19,Fabbricazione di coke e prodotti derivanti dalla raffinaz...,0,0,0,0,0,2023
PUG,TA,C 20,Fabbricazione di prodotti chimici                           ,0,0,0,0,0,2023
PUG,TA,C 21,Fabbricazione di prodotti farmaceutici di base e di prepa...,0,0,0,0,0,2023
PUG,TA,C 22,Fabbricazione di articoli in gomma e materie plastiche      ,0,0,0,0,0,2023
PUG,TA,C 23,Fabbricazione di altri prodotti della lavorazione di miner..,0,0,0,0,0,2023
PUG,TA,C 24,Metallurgia                                                 ,0,0,0,0,0,2023
PUG,TA,C 25,Fabbricazione di prodotti in metallo (esclusi macchinari ...,0,0,2,0,2,2023
PUG,TA,C 26,Fabbricazione di computer e prodotti di elettronica e ott...,0,0,0,0,0,2023
PUG,TA,C 27,Fabbricazione di apparecchiature elettriche ed apparecchi...,0,0,0,0,0,2023
PUG,TA,C 28,Fabbricazione di macchinari ed apparecchiature nca          ,1,0,0,0,1,2023
PUG,TA,C 29,"Fabbricazione di autoveicoli, rimorchi e semirimorchi       ",0,0,0,0,0,2023
PUG,TA,C 30,Fabbricazione di altri mezzi di trasporto                   ,0,0,0,0,0,2023
PUG,TA,C 31,Fabbricazione di mobili                                     ,0,0,0,0,0,2023
PUG,TA,C 32,Altre industrie manifatturiere                              ,0,0,0,0,0,2023
PUG,TA,C 33,"Riparazione, manutenzione ed installazione di macchine ed...",0,0,0,0,0,2023
PUG,TA,D   ,"Fornitura di energia elettrica, gas, vapore e aria condiz...",0,0,0,0,0,2023
PUG,TA,D 35,"Fornitura di energia elettrica, gas, vapore e aria condiz...",0,0,0,0,0,2023
PUG,TA,E   ,"Fornitura di acqua; reti fognarie, attività di gestione d...",0,0,0,0,0,2023
PUG,TA,E 36,"Raccolta, trattamento e fornitura di acqua                  ",0,0,0,0,0,2023
PUG,TA,E 37,Gestione delle reti fognarie                                ,0,0,0,0,0,2023
PUG,TA,E 38,"Attività di raccolta, trattamento e smaltimento dei rifiu...",0,0,0,0,0,2023
PUG,TA,E 39,Attività di risanamento e altri servizi di gestione dei r...,0,0,0,0,0,2023
PUG,TA,F   ,Costruzioni                                                 ,1,1,7,13,22,2023
PUG,TA,F 41,Costruzione di edifici                                      ,1,0,6,7,14,2023
PUG,TA,F 42,Ingegneria civile                                           ,0,0,0,0,0,2023
PUG,TA,F 43,Lavori di costruzione specializzati                         ,0,1,1,6,8,2023
PUG,TA,G   ,Commercio all'ingrosso e al dettaglio; riparazione di aut...,0,4,79,5,88,2023
PUG,TA,G 45,Commercio all'ingrosso e al dettaglio e riparazione di au...,0,1,5,0,6,2023
PUG,TA,G 46,Commercio all'ingrosso (escluso quello di autoveicoli e d...,0,0,16,1,17,2023
PUG,TA,G 47,Commercio al dettaglio (escluso quello di autoveicoli e d...,0,3,58,4,65,2023
PUG,TA,H   ,Trasporto e magazzinaggio                                   ,0,0,5,3,8,2023
PUG,TA,H 49,Trasporto terrestre e mediante condotte                     ,0,0,5,1,6,2023
PUG,TA,H 50,Trasporto marittimo e per vie d'acqua                       ,0,0,0,0,0,2023
PUG,TA,H 51,Trasporto aereo                                             ,0,0,0,0,0,2023
PUG,TA,H 52,Magazzinaggio e attività di supporto ai trasporti           ,0,0,0,2,2,2023
PUG,TA,H 53,Servizi postali e attività di corriere                      ,0,0,0,0,0,2023
PUG,TA,I   ,Attività dei servizi alloggio e ristorazione                ,0,3,11,3,17,2023
PUG,TA,I 55,Alloggio                                                    ,0,0,0,1,1,2023
PUG,TA,I 56,Attività dei servizi di ristorazione                        ,0,3,11,2,16,2023
PUG,TA,J   ,Servizi di informazione e comunicazione                     ,0,2,3,1,6,2023
PUG,TA,J 58,Attività editoriali                                         ,0,0,1,0,1,2023
PUG,TA,J 59,"Attività di produzione cinematografica, di video e di pro...",0,0,1,0,1,2023
PUG,TA,J 60,Attività di programmazione e trasmissione                   ,0,1,0,1,2,2023
PUG,TA,J 61,Telecomunicazioni                                           ,0,0,0,0,0,2023
PUG,TA,J 62,"Produzione di software, consulenza informatica e attività...",0,1,1,0,2,2023
PUG,TA,J 63,Attività dei servizi d'informazione e altri servizi infor...,0,0,0,0,0,2023
PUG,TA,K   ,Attività finanziarie e assicurative                         ,0,0,1,0,1,2023
PUG,TA,K 64,Attività di servizi finanziari (escluse le assicurazioni ...,0,0,0,0,0,2023
PUG,TA,K 65,"Assicurazioni, riassicurazioni e fondi pensione (escluse ...",0,0,0,0,0,2023
PUG,TA,K 66,Attività ausiliarie dei servizi finanziari e delle attivi...,0,0,1,0,1,2023
PUG,TA,L   ,Attivita' immobiliari                                       ,0,0,2,0,2,2023
PUG,TA,L 68,Attivita' immobiliari                                       ,0,0,2,0,2,2023
PUG,TA,M   ,"Attività professionali, scientifiche e tecniche             ",0,1,0,2,3,2023
PUG,TA,M 69,Attività legali e contabilità                               ,0,0,0,0,0,2023
PUG,TA,M 70,Attività di direzione aziendale e di consulenza gestional...,0,1,0,0,1,2023
PUG,TA,M 71,Attività degli studi di architettura e d'ingegneria; coll...,0,0,0,0,0,2023
PUG,TA,M 72,Ricerca scientifica e sviluppo                              ,0,0,0,0,0,2023
PUG,TA,M 73,Pubblicità e ricerche di mercato                            ,0,0,0,1,1,2023
PUG,TA,M 74,"Altre attività professionali, scientifiche e tecniche       ",0,0,0,1,1,2023
PUG,TA,M 75,Servizi veterinari                                          ,0,0,0,0,0,2023
PUG,TA,N   ,"Noleggio, agenzie di viaggio, servizi di supporto alle im...",0,1,1,7,9,2023
PUG,TA,N 77,Attività di noleggio e leasing operativo                    ,0,0,0,0,0,2023
PUG,TA,N 78,"Attività di ricerca, selezione, fornitura di personale      ",0,0,0,0,0,2023
PUG,TA,N 79,"Attività dei servizi delle agenzie di viaggio, dei tour o...",0,0,0,0,0,2023
PUG,TA,N 80,Servizi di vigilanza e investigazione                       ,0,0,0,1,1,2023
PUG,TA,N 81,Attività di servizi per edifici e paesaggio                 ,0,0,0,6,6,2023
PUG,TA,N 82,Attività di supporto per le funzioni d'ufficio e altri se...,0,1,1,0,2,2023
PUG,TA,O   ,Amministrazione pubblica e difesa; assicurazione sociale ...,0,0,0,0,0,2023
PUG,TA,O 84,Amministrazione pubblica e difesa; assicurazione sociale ...,0,0,0,0,0,2023
PUG,TA,P   ,Istruzione                                                  ,0,0,0,0,0,2023
PUG,TA,P 85,Istruzione                                                  ,0,0,0,0,0,2023
PUG,TA,Q   ,Sanita' e assistenza sociale                                ,0,0,0,5,5,2023
PUG,TA,Q 86,Assistenza sanitaria                                        ,0,0,0,0,0,2023
PUG,TA,Q 87,Servizi di assistenza sociale residenziale                  ,0,0,0,1,1,2023
PUG,TA,Q 88,Assistenza sociale non residenziale                         ,0,0,0,4,4,2023
PUG,TA,R   ,"Attività artistiche, sportive, di intrattenimento e diver...",0,0,0,0,0,2023
PUG,TA,R 90,"Attività creative, artistiche e di intrattenimento          ",0,0,0,0,0,2023
PUG,TA,R 91,"Attività di biblioteche, archivi, musei ed altre attività...",0,0,0,0,0,2023
PUG,TA,R 92,"Attività riguardanti le lotterie, le scommesse, le case d...",0,0,0,0,0,2023
PUG,TA,R 93,"Attività sportive, di intrattenimento e di divertimento     ",0,0,0,0,0,2023
PUG,TA,S   ,Altre attività di servizi                                   ,0,0,1,1,2,2023
PUG,TA,S 94,Attività di organizzazioni associative                      ,0,0,0,0,0,2023
PUG,TA,S 95,Riparazione di computer e di beni per uso personale e per...,0,0,0,0,0,2023
PUG,TA,S 96,Altre attività di servizi per la persona                    ,0,0,1,1,2,2023
PUG,TA,T   ,Attività di famiglie e convivenze come datori di lavoro p...,0,0,0,0,0,2023
PUG,TA,T 97,Attività di famiglie e convivenze come datori di lavoro p...,0,0,0,0,0,2023
PUG,TA,T 98,Produzione di beni e servizi indifferenziati per uso prop...,0,0,0,0,0,2023
PUG,TA,U   ,Organizzazioni ed organismi extraterritoriali               ,0,0,0,0,0,2023
PUG,TA,U 99,Organizzazioni ed organismi extraterritoriali               ,0,0,0,0,0,2023
PUG,TA,XX  ,Imprese non classificate                                    ,0,8,1,7,16,2023
PUG,TA,TOT ,TOTALE                                                      ,2,22,490,52,566,2023
PUG,BR,A   ,"Agricoltura, silvicoltura pesca                             ",1,0,348,3,352,2023
PUG,BR,A 01,"Coltivazioni agricole e produzione di prodotti animali, c...",1,0,347,3,351,2023
PUG,BR,A 02,Silvicoltura ed utilizzo di aree forestali                  ,0,0,1,0,1,2023
PUG,BR,A 03,Pesca e acquacoltura                                        ,0,0,0,0,0,2023
PUG,BR,B   ,Estrazione di minerali da cave e miniere                    ,0,0,0,0,0,2023
PUG,BR,B 05,Estrazione di carbone (esclusa torba)                       ,0,0,0,0,0,2023
PUG,BR,B 06,Estraz.di petrolio greggio e di gas naturale                ,0,0,0,0,0,2023
PUG,BR,B 07,Estrazione di minerali metalliferi                          ,0,0,0,0,0,2023
PUG,BR,B 08,Altre attività di estrazione di minerali da cave e miniere  ,0,0,0,0,0,2023
PUG,BR,B 09,Attività dei servizi di supporto all'estrazione             ,0,0,0,0,0,2023
PUG,BR,C   ,Attività manifatturiere                                     ,6,1,13,0,20,2023
PUG,BR,C 10,Industrie alimentari                                        ,1,1,5,0,7,2023
PUG,BR,C 11,Industria delle bevande                                     ,0,0,0,0,0,2023
PUG,BR,C 12,Industria del tabacco                                       ,0,0,0,0,0,2023
PUG,BR,C 13,Industrie tessili                                           ,0,0,0,0,0,2023
PUG,BR,C 14,Confezione di articoli di abbigliamento; confezione di ar...,0,0,2,0,2,2023
PUG,BR,C 15,Fabbricazione di articoli in pelle e simili                 ,0,0,0,0,0,2023
PUG,BR,C 16,Industria del legno e dei prodotti in legno e sughero (es...,1,0,0,0,1,2023
PUG,BR,C 17,Fabbricazione di carta e di prodotti di carta               ,0,0,0,0,0,2023
PUG,BR,C 18,Stampa e riproduzione di supporti registrati                ,1,0,0,0,1,2023
PUG,BR,C 19,Fabbricazione di coke e prodotti derivanti dalla raffinaz...,0,0,0,0,0,2023
PUG,BR,C 20,Fabbricazione di prodotti chimici                           ,0,0,0,0,0,2023
PUG,BR,C 21,Fabbricazione di prodotti farmaceutici di base e di prepa...,0,0,0,0,0,2023
PUG,BR,C 22,Fabbricazione di articoli in gomma e materie plastiche      ,0,0,0,0,0,2023
PUG,BR,C 23,Fabbricazione di altri prodotti della lavorazione di miner..,0,0,1,0,1,2023
PUG,BR,C 24,Metallurgia                                                 ,0,0,0,0,0,2023
PUG,BR,C 25,Fabbricazione di prodotti in metallo (esclusi macchinari ...,1,0,3,0,4,2023
PUG,BR,C 26,Fabbricazione di computer e prodotti di elettronica e ott...,0,0,0,0,0,2023
PUG,BR,C 27,Fabbricazione di apparecchiature elettriche ed apparecchi...,1,0,1,0,2,2023
PUG,BR,C 28,Fabbricazione di macchinari ed apparecchiature nca          ,0,0,0,0,0,2023
PUG,BR,C 29,"Fabbricazione di autoveicoli, rimorchi e semirimorchi       ",0,0,0,0,0,2023
PUG,BR,C 30,Fabbricazione di altri mezzi di trasporto                   ,0,0,0,0,0,2023
PUG,BR,C 31,Fabbricazione di mobili                                     ,1,0,0,0,1,2023
PUG,BR,C 32,Altre industrie manifatturiere                              ,0,0,0,0,0,2023
PUG,BR,C 33,"Riparazione, manutenzione ed installazione di macchine ed...",0,0,1,0,1,2023
PUG,BR,D   ,"Fornitura di energia elettrica, gas, vapore e aria condiz...",0,0,0,0,0,2023
PUG,BR,D 35,"Fornitura di energia elettrica, gas, vapore e aria condiz...",0,0,0,0,0,2023
PUG,BR,E   ,"Fornitura di acqua; reti fognarie, attività di gestione d...",0,0,0,0,0,2023
PUG,BR,E 36,"Raccolta, trattamento e fornitura di acqua                  ",0,0,0,0,0,2023
PUG,BR,E 37,Gestione delle reti fognarie                                ,0,0,0,0,0,2023
PUG,BR,E 38,"Attività di raccolta, trattamento e smaltimento dei rifiu...",0,0,0,0,0,2023
PUG,BR,E 39,Attività di risanamento e altri servizi di gestione dei r...,0,0,0,0,0,2023
PUG,BR,F   ,Costruzioni                                                 ,10,1,14,1,26,2023
PUG,BR,F 41,Costruzione di edifici                                      ,5,1,8,1,15,2023
PUG,BR,F 42,Ingegneria civile                                           ,0,0,1,0,1,2023
PUG,BR,F 43,Lavori di costruzione specializzati                         ,5,0,5,0,10,2023
PUG,BR,G   ,Commercio all'ingrosso e al dettaglio; riparazione di aut...,19,2,52,2,75,2023
PUG,BR,G 45,Commercio all'ingrosso e al dettaglio e riparazione di au...,4,0,4,0,8,2023
PUG,BR,G 46,Commercio all'ingrosso (escluso quello di autoveicoli e d...,4,0,8,2,14,2023
PUG,BR,G 47,Commercio al dettaglio (escluso quello di autoveicoli e d...,11,2,40,0,53,2023
PUG,BR,H   ,Trasporto e magazzinaggio                                   ,2,0,3,0,5,2023
PUG,BR,H 49,Trasporto terrestre e mediante condotte                     ,1,0,3,0,4,2023
PUG,BR,H 50,Trasporto marittimo e per vie d'acqua                       ,0,0,0,0,0,2023
PUG,BR,H 51,Trasporto aereo                                             ,0,0,0,0,0,2023
PUG,BR,H 52,Magazzinaggio e attività di supporto ai trasporti           ,1,0,0,0,1,2023
PUG,BR,H 53,Servizi postali e attività di corriere                      ,0,0,0,0,0,2023
PUG,BR,I   ,Attività dei servizi alloggio e ristorazione                ,6,7,8,0,21,2023
PUG,BR,I 55,Alloggio                                                    ,0,0,0,0,0,2023
PUG,BR,I 56,Attività dei servizi di ristorazione                        ,6,7,8,0,21,2023
PUG,BR,J   ,Servizi di informazione e comunicazione                     ,2,0,1,1,4,2023
PUG,BR,J 58,Attività editoriali                                         ,1,0,0,0,1,2023
PUG,BR,J 59,"Attività di produzione cinematografica, di video e di pro...",0,0,0,1,1,2023
PUG,BR,J 60,Attività di programmazione e trasmissione                   ,0,0,1,0,1,2023
PUG,BR,J 61,Telecomunicazioni                                           ,0,0,0,0,0,2023
PUG,BR,J 62,"Produzione di software, consulenza informatica e attività...",0,0,0,0,0,2023
PUG,BR,J 63,Attività dei servizi d'informazione e altri servizi infor...,1,0,0,0,1,2023
PUG,BR,K   ,Attività finanziarie e assicurative                         ,0,0,0,0,0,2023
PUG,BR,K 64,Attività di servizi finanziari (escluse le assicurazioni ...,0,0,0,0,0,2023
PUG,BR,K 65,"Assicurazioni, riassicurazioni e fondi pensione (escluse ...",0,0,0,0,0,2023
PUG,BR,K 66,Attività ausiliarie dei servizi finanziari e delle attivi...,0,0,0,0,0,2023
PUG,BR,L   ,Attivita' immobiliari                                       ,0,0,2,0,2,2023
PUG,BR,L 68,Attivita' immobiliari                                       ,0,0,2,0,2,2023
PUG,BR,M   ,"Attività professionali, scientifiche e tecniche             ",1,1,0,1,3,2023
PUG,BR,M 69,Attività legali e contabilità                               ,0,0,0,0,0,2023
PUG,BR,M 70,Attività di direzione aziendale e di consulenza gestional...,0,0,0,1,1,2023
PUG,BR,M 71,Attività degli studi di architettura e d'ingegneria; coll...,1,0,0,0,1,2023
PUG,BR,M 72,Ricerca scientifica e sviluppo                              ,0,0,0,0,0,2023
PUG,BR,M 73,Pubblicità e ricerche di mercato                            ,0,0,0,0,0,2023
PUG,BR,M 74,"Altre attività professionali, scientifiche e tecniche       ",0,1,0,0,1,2023
PUG,BR,M 75,Servizi veterinari                                          ,0,0,0,0,0,2023
PUG,BR,N   ,"Noleggio, agenzie di viaggio, servizi di supporto alle im...",1,1,1,2,5,2023
PUG,BR,N 77,Attività di noleggio e leasing operativo                    ,0,0,0,0,0,2023
PUG,BR,N 78,"Attività di ricerca, selezione, fornitura di personale      ",0,0,0,0,0,2023
PUG,BR,N 79,"Attività dei servizi delle agenzie di viaggio, dei tour o...",0,0,0,0,0,2023
PUG,BR,N 80,Servizi di vigilanza e investigazione                       ,0,0,0,0,0,2023
PUG,BR,N 81,Attività di servizi per edifici e paesaggio                 ,0,0,1,2,3,2023
PUG,BR,N 82,Attività di supporto per le funzioni d'ufficio e altri se...,1,1,0,0,2,2023
PUG,BR,O   ,Amministrazione pubblica e difesa; assicurazione sociale ...,0,0,0,0,0,2023
PUG,BR,O 84,Amministrazione pubblica e difesa; assicurazione sociale ...,0,0,0,0,0,2023
PUG,BR,P   ,Istruzione                                                  ,0,1,1,1,3,2023
PUG,BR,P 85,Istruzione                                                  ,0,1,1,1,3,2023
PUG,BR,Q   ,Sanita' e assistenza sociale                                ,0,0,0,0,0,2023
PUG,BR,Q 86,Assistenza sanitaria                                        ,0,0,0,0,0,2023
PUG,BR,Q 87,Servizi di assistenza sociale residenziale                  ,0,0,0,0,0,2023
PUG,BR,Q 88,Assistenza sociale non residenziale                         ,0,0,0,0,0,2023
PUG,BR,R   ,"Attività artistiche, sportive, di intrattenimento e diver...",0,3,0,0,3,2023
PUG,BR,R 90,"Attività creative, artistiche e di intrattenimento          ",0,1,0,0,1,2023
PUG,BR,R 91,"Attività di biblioteche, archivi, musei ed altre attività...",0,0,0,0,0,2023
PUG,BR,R 92,"Attività riguardanti le lotterie, le scommesse, le case d...",0,1,0,0,1,2023
PUG,BR,R 93,"Attività sportive, di intrattenimento e di divertimento     ",0,1,0,0,1,2023
PUG,BR,S   ,Altre attività di servizi                                   ,1,0,0,0,1,2023
PUG,BR,S 94,Attività di organizzazioni associative                      ,0,0,0,0,0,2023
PUG,BR,S 95,Riparazione di computer e di beni per uso personale e per...,0,0,0,0,0,2023
PUG,BR,S 96,Altre attività di servizi per la persona                    ,1,0,0,0,1,2023
PUG,BR,T   ,Attività di famiglie e convivenze come datori di lavoro p...,0,0,0,0,0,2023
PUG,BR,T 97,Attività di famiglie e convivenze come datori di lavoro p...,0,0,0,0,0,2023
PUG,BR,T 98,Produzione di beni e servizi indifferenziati per uso prop...,0,0,0,0,0,2023
PUG,BR,U   ,Organizzazioni ed organismi extraterritoriali               ,0,0,0,0,0,2023
PUG,BR,U 99,Organizzazioni ed organismi extraterritoriali               ,0,0,0,0,0,2023
PUG,BR,XX  ,Imprese non classificate                                    ,21,6,0,1,28,2023
PUG,BR,TOT ,TOTALE                                                      ,70,23,443,12,548,2023
PUG,LE,A   ,"Agricoltura, silvicoltura pesca                             ",2,0,292,5,299,2023
PUG,LE,A 01,"Coltivazioni agricole e produzione di prodotti animali, c...",2,0,291,5,298,2023
PUG,LE,A 02,Silvicoltura ed utilizzo di aree forestali                  ,0,0,0,0,0,2023
PUG,LE,A 03,Pesca e acquacoltura                                        ,0,0,1,0,1,2023
PUG,LE,B   ,Estrazione di minerali da cave e miniere                    ,0,0,0,1,1,2023
PUG,LE,B 05,Estrazione di carbone (esclusa torba)                       ,0,0,0,0,0,2023
PUG,LE,B 06,Estraz.di petrolio greggio e di gas naturale                ,0,0,0,0,0,2023
PUG,LE,B 07,Estrazione di minerali metalliferi                          ,0,0,0,0,0,2023
PUG,LE,B 08,Altre attività di estrazione di minerali da cave e miniere  ,0,0,0,1,1,2023
PUG,LE,B 09,Attività dei servizi di supporto all'estrazione             ,0,0,0,0,0,2023
PUG,LE,C   ,Attività manifatturiere                                     ,28,11,6,5,50,2023
PUG,LE,C 10,Industrie alimentari                                        ,2,5,1,1,9,2023
PUG,LE,C 11,Industria delle bevande                                     ,0,0,1,0,1,2023
PUG,LE,C 12,Industria del tabacco                                       ,1,0,0,0,1,2023
PUG,LE,C 13,Industrie tessili                                           ,1,1,0,1,3,2023
PUG,LE,C 14,Confezione di articoli di abbigliamento; confezione di ar...,8,1,1,1,11,2023
PUG,LE,C 15,Fabbricazione di articoli in pelle e simili                 ,2,0,0,0,2,2023
PUG,LE,C 16,Industria del legno e dei prodotti in legno e sughero (es...,0,1,0,0,1,2023
PUG,LE,C 17,Fabbricazione di carta e di prodotti di carta               ,0,0,1,0,1,2023
PUG,LE,C 18,Stampa e riproduzione di supporti registrati                ,1,1,0,0,2,2023
PUG,LE,C 19,Fabbricazione di coke e prodotti derivanti dalla raffinaz...,0,0,0,0,0,2023
PUG,LE,C 20,Fabbricazione di prodotti chimici                           ,1,0,0,0,1,2023
PUG,LE,C 21,Fabbricazione di prodotti farmaceutici di base e di prepa...,0,0,0,0,0,2023
PUG,LE,C 22,Fabbricazione di articoli in gomma e materie plastiche      ,1,0,0,0,1,2023
PUG,LE,C 23,Fabbricazione di altri prodotti della lavorazione di miner..,1,1,0,0,2,2023
PUG,LE,C 24,Metallurgia                                                 ,0,0,0,0,0,2023
PUG,LE,C 25,Fabbricazione di prodotti in metallo (esclusi macchinari ...,3,0,0,0,3,2023
PUG,LE,C 26,Fabbricazione di computer e prodotti di elettronica e ott...,0,0,0,0,0,2023
PUG,LE,C 27,Fabbricazione di apparecchiature elettriche ed apparecchi...,0,1,0,0,1,2023
PUG,LE,C 28,Fabbricazione di macchinari ed apparecchiature nca          ,1,0,0,1,2,2023
PUG,LE,C 29,"Fabbricazione di autoveicoli, rimorchi e semirimorchi       ",0,0,1,0,1,2023
PUG,LE,C 30,Fabbricazione di altri mezzi di trasporto                   ,1,0,0,0,1,2023
PUG,LE,C 31,Fabbricazione di mobili                                     ,4,0,0,0,4,2023
PUG,LE,C 32,Altre industrie manifatturiere                              ,1,0,0,0,1,2023
PUG,LE,C 33,"Riparazione, manutenzione ed installazione di macchine ed...",0,0,1,1,2,2023
PUG,LE,D   ,"Fornitura di energia elettrica, gas, vapore e aria condiz...",1,0,0,0,1,2023
PUG,LE,D 35,"Fornitura di energia elettrica, gas, vapore e aria condiz...",1,0,0,0,1,2023
PUG,LE,E   ,"Fornitura di acqua; reti fognarie, attività di gestione d...",0,0,0,0,0,2023
PUG,LE,E 36,"Raccolta, trattamento e fornitura di acqua                  ",0,0,0,0,0,2023
PUG,LE,E 37,Gestione delle reti fognarie                                ,0,0,0,0,0,2023
PUG,LE,E 38,"Attività di raccolta, trattamento e smaltimento dei rifiu...",0,0,0,0,0,2023
PUG,LE,E 39,Attività di risanamento e altri servizi di gestione dei r...,0,0,0,0,0,2023
PUG,LE,F   ,Costruzioni                                                 ,35,10,5,35,85,2023
PUG,LE,F 41,Costruzione di edifici                                      ,20,5,4,14,43,2023
PUG,LE,F 42,Ingegneria civile                                           ,1,0,0,2,3,2023
PUG,LE,F 43,Lavori di costruzione specializzati                         ,14,5,1,19,39,2023
PUG,LE,G   ,Commercio all'ingrosso e al dettaglio; riparazione di aut...,59,23,29,5,116,2023
PUG,LE,G 45,Commercio all'ingrosso e al dettaglio e riparazione di au...,7,2,2,1,12,2023
PUG,LE,G 46,Commercio all'ingrosso (escluso quello di autoveicoli e d...,19,10,5,2,36,2023
PUG,LE,G 47,Commercio al dettaglio (escluso quello di autoveicoli e d...,33,11,22,2,68,2023
PUG,LE,H   ,Trasporto e magazzinaggio                                   ,7,0,3,2,12,2023
PUG,LE,H 49,Trasporto terrestre e mediante condotte                     ,4,0,3,0,7,2023
PUG,LE,H 50,Trasporto marittimo e per vie d'acqua                       ,0,0,0,0,0,2023
PUG,LE,H 51,Trasporto aereo                                             ,0,0,0,0,0,2023
PUG,LE,H 52,Magazzinaggio e attività di supporto ai trasporti           ,1,0,0,2,3,2023
PUG,LE,H 53,Servizi postali e attività di corriere                      ,2,0,0,0,2,2023
PUG,LE,I   ,Attività dei servizi alloggio e ristorazione                ,22,7,2,4,35,2023
PUG,LE,I 55,Alloggio                                                    ,4,0,2,0,6,2023
PUG,LE,I 56,Attività dei servizi di ristorazione                        ,18,7,0,4,29,2023
PUG,LE,J   ,Servizi di informazione e comunicazione                     ,3,2,2,0,7,2023
PUG,LE,J 58,Attività editoriali                                         ,0,0,0,0,0,2023
PUG,LE,J 59,"Attività di produzione cinematografica, di video e di pro...",0,0,1,0,1,2023
PUG,LE,J 60,Attività di programmazione e trasmissione                   ,0,0,0,0,0,2023
PUG,LE,J 61,Telecomunicazioni                                           ,0,0,0,0,0,2023
PUG,LE,J 62,"Produzione di software, consulenza informatica e attività...",2,0,0,0,2,2023
PUG,LE,J 63,Attività dei servizi d'informazione e altri servizi infor...,1,2,1,0,4,2023
PUG,LE,K   ,Attività finanziarie e assicurative                         ,0,3,0,0,3,2023
PUG,LE,K 64,Attività di servizi finanziari (escluse le assicurazioni ...,0,0,0,0,0,2023
PUG,LE,K 65,"Assicurazioni, riassicurazioni e fondi pensione (escluse ...",0,0,0,0,0,2023
PUG,LE,K 66,Attività ausiliarie dei servizi finanziari e delle attivi...,0,3,0,0,3,2023
PUG,LE,L   ,Attivita' immobiliari                                       ,2,1,0,1,4,2023
PUG,LE,L 68,Attivita' immobiliari                                       ,2,1,0,1,4,2023
PUG,LE,M   ,"Attività professionali, scientifiche e tecniche             ",5,0,0,2,7,2023
PUG,LE,M 69,Attività legali e contabilità                               ,1,0,0,0,1,2023
PUG,LE,M 70,Attività di direzione aziendale e di consulenza gestional...,2,0,0,0,2,2023
PUG,LE,M 71,Attività degli studi di architettura e d'ingegneria; coll...,1,0,0,0,1,2023
PUG,LE,M 72,Ricerca scientifica e sviluppo                              ,1,0,0,0,1,2023
PUG,LE,M 73,Pubblicità e ricerche di mercato                            ,0,0,0,1,1,2023
PUG,LE,M 74,"Altre attività professionali, scientifiche e tecniche       ",0,0,0,1,1,2023
PUG,LE,M 75,Servizi veterinari                                          ,0,0,0,0,0,2023
PUG,LE,N   ,"Noleggio, agenzie di viaggio, servizi di supporto alle im...",1,2,2,4,9,2023
PUG,LE,N 77,Attività di noleggio e leasing operativo                    ,0,0,0,0,0,2023
PUG,LE,N 78,"Attività di ricerca, selezione, fornitura di personale      ",0,0,0,0,0,2023
PUG,LE,N 79,"Attività dei servizi delle agenzie di viaggio, dei tour o...",1,0,0,0,1,2023
PUG,LE,N 80,Servizi di vigilanza e investigazione                       ,0,0,0,0,0,2023
PUG,LE,N 81,Attività di servizi per edifici e paesaggio                 ,0,1,1,3,5,2023
PUG,LE,N 82,Attività di supporto per le funzioni d'ufficio e altri se...,0,1,1,1,3,2023
PUG,LE,O   ,Amministrazione pubblica e difesa; assicurazione sociale ...,0,0,0,0,0,2023
PUG,LE,O 84,Amministrazione pubblica e difesa; assicurazione sociale ...,0,0,0,0,0,2023
PUG,LE,P   ,Istruzione                                                  ,1,0,1,5,7,2023
PUG,LE,P 85,Istruzione                                                  ,1,0,1,5,7,2023
PUG,LE,Q   ,Sanita' e assistenza sociale                                ,1,0,0,2,3,2023
PUG,LE,Q 86,Assistenza sanitaria                                        ,1,0,0,0,1,2023
PUG,LE,Q 87,Servizi di assistenza sociale residenziale                  ,0,0,0,0,0,2023
PUG,LE,Q 88,Assistenza sociale non residenziale                         ,0,0,0,2,2,2023
PUG,LE,R   ,"Attività artistiche, sportive, di intrattenimento e diver...",1,0,0,1,2,2023
PUG,LE,R 90,"Attività creative, artistiche e di intrattenimento          ",1,0,0,0,1,2023
PUG,LE,R 91,"Attività di biblioteche, archivi, musei ed altre attività...",0,0,0,0,0,2023
PUG,LE,R 92,"Attività riguardanti le lotterie, le scommesse, le case d...",0,0,0,0,0,2023
PUG,LE,R 93,"Attività sportive, di intrattenimento e di divertimento     ",0,0,0,1,1,2023
PUG,LE,S   ,Altre attività di servizi                                   ,3,1,1,0,5,2023
PUG,LE,S 94,Attività di organizzazioni associative                      ,0,0,0,0,0,2023
PUG,LE,S 95,Riparazione di computer e di beni per uso personale e per...,0,1,0,0,1,2023
PUG,LE,S 96,Altre attività di servizi per la persona                    ,3,0,1,0,4,2023
PUG,LE,T   ,Attività di famiglie e convivenze come datori di lavoro p...,0,0,0,0,0,2023
PUG,LE,T 97,Attività di famiglie e convivenze come datori di lavoro p...,0,0,0,0,0,2023
PUG,LE,T 98,Produzione di beni e servizi indifferenziati per uso prop...,0,0,0,0,0,2023
PUG,LE,U   ,Organizzazioni ed organismi extraterritoriali               ,0,0,0,0,0,2023
PUG,LE,U 99,Organizzazioni ed organismi extraterritoriali               ,0,0,0,0,0,2023
PUG,LE,XX  ,Imprese non classificate                                    ,42,9,2,13,66,2023
PUG,LE,TOT ,TOTALE                                                      ,213,69,345,85,712,2023
BAS,  ,A   ,"Agricoltura, silvicoltura pesca                             ",12,6,330,3,351,2023
BAS,  ,A 01,"Coltivazioni agricole e produzione di prodotti animali, c...",11,6,327,3,347,2023
BAS,  ,A 02,Silvicoltura ed utilizzo di aree forestali                  ,0,0,3,0,3,2023
BAS,  ,A 03,Pesca e acquacoltura                                        ,1,0,0,0,1,2023
BAS,  ,B   ,Estrazione di minerali da cave e miniere                    ,1,1,0,0,2,2023
BAS,  ,B 05,Estrazione di carbone (esclusa torba)                       ,0,0,0,0,0,2023
BAS,  ,B 06,Estraz.di petrolio greggio e di gas naturale                ,0,0,0,0,0,2023
BAS,  ,B 07,Estrazione di minerali metalliferi                          ,0,0,0,0,0,2023
BAS,  ,B 08,Altre attività di estrazione di minerali da cave e miniere  ,1,1,0,0,2,2023
BAS,  ,B 09,Attività dei servizi di supporto all'estrazione             ,0,0,0,0,0,2023
BAS,  ,C   ,Attività manifatturiere                                     ,66,24,60,3,153,2023
BAS,  ,C 10,Industrie alimentari                                        ,13,11,10,0,34,2023
BAS,  ,C 11,Industria delle bevande                                     ,1,0,0,0,1,2023
BAS,  ,C 12,Industria del tabacco                                       ,0,0,0,0,0,2023
BAS,  ,C 13,Industrie tessili                                           ,1,0,3,0,4,2023
BAS,  ,C 14,Confezione di articoli di abbigliamento; confezione di ar...,5,0,8,2,15,2023
BAS,  ,C 15,Fabbricazione di articoli in pelle e simili                 ,3,0,0,0,3,2023
BAS,  ,C 16,Industria del legno e dei prodotti in legno e sughero (es...,2,0,11,1,14,2023
BAS,  ,C 17,Fabbricazione di carta e di prodotti di carta               ,2,0,0,0,2,2023
BAS,  ,C 18,Stampa e riproduzione di supporti registrati                ,0,2,1,0,3,2023
BAS,  ,C 19,Fabbricazione di coke e prodotti derivanti dalla raffinaz...,0,1,0,0,1,2023
BAS,  ,C 20,Fabbricazione di prodotti chimici                           ,4,1,0,0,5,2023
BAS,  ,C 21,Fabbricazione di prodotti farmaceutici di base e di prepa...,0,0,0,0,0,2023
BAS,  ,C 22,Fabbricazione di articoli in gomma e materie plastiche      ,3,0,0,0,3,2023
BAS,  ,C 23,Fabbricazione di altri prodotti della lavorazione di miner..,11,1,2,0,14,2023
BAS,  ,C 24,Metallurgia                                                 ,1,0,0,0,1,2023
BAS,  ,C 25,Fabbricazione di prodotti in metallo (esclusi macchinari ...,5,7,11,0,23,2023
BAS,  ,C 26,Fabbricazione di computer e prodotti di elettronica e ott...,1,0,1,0,2,2023
BAS,  ,C 27,Fabbricazione di apparecchiature elettriche ed apparecchi...,0,0,0,0,0,2023
BAS,  ,C 28,Fabbricazione di macchinari ed apparecchiature nca          ,8,1,0,0,9,2023
BAS,  ,C 29,"Fabbricazione di autoveicoli, rimorchi e semirimorchi       ",1,0,0,0,1,2023
BAS,  ,C 30,Fabbricazione di altri mezzi di trasporto                   ,0,0,0,0,0,2023
BAS,  ,C 31,Fabbricazione di mobili                                     ,5,0,4,0,9,2023
BAS,  ,C 32,Altre industrie manifatturiere                              ,0,0,7,0,7,2023
BAS,  ,C 33,"Riparazione, manutenzione ed installazione di macchine ed...",0,0,2,0,2,2023
BAS,  ,D   ,"Fornitura di energia elettrica, gas, vapore e aria condiz...",0,0,0,0,0,2023
BAS,  ,D 35,"Fornitura di energia elettrica, gas, vapore e aria condiz...",0,0,0,0,0,2023
BAS,  ,E   ,"Fornitura di acqua; reti fognarie, attività di gestione d...",2,0,2,0,4,2023
BAS,  ,E 36,"Raccolta, trattamento e fornitura di acqua                  ",0,0,0,0,0,2023
BAS,  ,E 37,Gestione delle reti fognarie                                ,0,0,0,0,0,2023
BAS,  ,E 38,"Attività di raccolta, trattamento e smaltimento dei rifiu...",2,0,1,0,3,2023
BAS,  ,E 39,Attività di risanamento e altri servizi di gestione dei r...,0,0,1,0,1,2023
BAS,  ,F   ,Costruzioni                                                 ,46,24,126,5,201,2023
BAS,  ,F 41,Costruzione di edifici                                      ,35,13,60,5,113,2023
BAS,  ,F 42,Ingegneria civile                                           ,0,1,4,0,5,2023
BAS,  ,F 43,Lavori di costruzione specializzati                         ,11,10,62,0,83,2023
BAS,  ,G   ,Commercio all'ingrosso e al dettaglio; riparazione di aut...,65,30,280,5,380,2023
BAS,  ,G 45,Commercio all'ingrosso e al dettaglio e riparazione di au...,7,4,38,0,49,2023
BAS,  ,G 46,Commercio all'ingrosso (escluso quello di autoveicoli e d...,31,9,44,3,87,2023
BAS,  ,G 47,Commercio al dettaglio (escluso quello di autoveicoli e d...,27,17,198,2,244,2023
BAS,  ,H   ,Trasporto e magazzinaggio                                   ,10,5,26,1,42,2023
BAS,  ,H 49,Trasporto terrestre e mediante condotte                     ,5,5,26,1,37,2023
BAS,  ,H 50,Trasporto marittimo e per vie d'acqua                       ,2,0,0,0,2,2023
BAS,  ,H 51,Trasporto aereo                                             ,0,0,0,0,0,2023
BAS,  ,H 52,Magazzinaggio e attività di supporto ai trasporti           ,2,0,0,0,2,2023
BAS,  ,H 53,Servizi postali e attività di corriere                      ,1,0,0,0,1,2023
BAS,  ,I   ,Attività dei servizi alloggio e ristorazione                ,14,29,41,1,85,2023
BAS,  ,I 55,Alloggio                                                    ,4,0,1,0,5,2023
BAS,  ,I 56,Attività dei servizi di ristorazione                        ,10,29,40,1,80,2023
BAS,  ,J   ,Servizi di informazione e comunicazione                     ,9,2,5,3,19,2023
BAS,  ,J 58,Attività editoriali                                         ,0,0,1,2,3,2023
BAS,  ,J 59,"Attività di produzione cinematografica, di video e di pro...",0,1,1,0,2,2023
BAS,  ,J 60,Attività di programmazione e trasmissione                   ,1,0,1,0,2,2023
BAS,  ,J 61,Telecomunicazioni                                           ,1,0,1,0,2,2023
BAS,  ,J 62,"Produzione di software, consulenza informatica e attività...",4,1,0,0,5,2023
BAS,  ,J 63,Attività dei servizi d'informazione e altri servizi infor...,3,0,1,1,5,2023
BAS,  ,K   ,Attività finanziarie e assicurative                         ,2,1,4,0,7,2023
BAS,  ,K 64,Attività di servizi finanziari (escluse le assicurazioni ...,0,0,0,0,0,2023
BAS,  ,K 65,"Assicurazioni, riassicurazioni e fondi pensione (escluse ...",0,0,0,0,0,2023
BAS,  ,K 66,Attività ausiliarie dei servizi finanziari e delle attivi...,2,1,4,0,7,2023
BAS,  ,L   ,Attivita' immobiliari                                       ,6,0,0,0,6,2023
BAS,  ,L 68,Attivita' immobiliari                                       ,6,0,0,0,6,2023
BAS,  ,M   ,"Attività professionali, scientifiche e tecniche             ",13,0,9,1,23,2023
BAS,  ,M 69,Attività legali e contabilità                               ,0,0,0,0,0,2023
BAS,  ,M 70,Attività di direzione aziendale e di consulenza gestional...,2,0,0,0,2,2023
BAS,  ,M 71,Attività degli studi di architettura e d'ingegneria; coll...,6,0,0,0,6,2023
BAS,  ,M 72,Ricerca scientifica e sviluppo                              ,1,0,0,1,2,2023
BAS,  ,M 73,Pubblicità e ricerche di mercato                            ,0,0,2,0,2,2023
BAS,  ,M 74,"Altre attività professionali, scientifiche e tecniche       ",4,0,7,0,11,2023
BAS,  ,M 75,Servizi veterinari                                          ,0,0,0,0,0,2023
BAS,  ,N   ,"Noleggio, agenzie di viaggio, servizi di supporto alle im...",7,6,15,7,35,2023
BAS,  ,N 77,Attività di noleggio e leasing operativo                    ,1,0,2,0,3,2023
BAS,  ,N 78,"Attività di ricerca, selezione, fornitura di personale      ",0,0,0,0,0,2023
BAS,  ,N 79,"Attività dei servizi delle agenzie di viaggio, dei tour o...",1,0,2,0,3,2023
BAS,  ,N 80,Servizi di vigilanza e investigazione                       ,1,0,0,1,2,2023
BAS,  ,N 81,Attività di servizi per edifici e paesaggio                 ,1,6,10,6,23,2023
BAS,  ,N 82,Attività di supporto per le funzioni d'ufficio e altri se...,3,0,1,0,4,2023
BAS,  ,O   ,Amministrazione pubblica e difesa; assicurazione sociale ...,0,0,0,0,0,2023
BAS,  ,O 84,Amministrazione pubblica e difesa; assicurazione sociale ...,0,0,0,0,0,2023
BAS,  ,P   ,Istruzione                                                  ,2,0,1,1,4,2023
BAS,  ,P 85,Istruzione                                                  ,2,0,1,1,4,2023
BAS,  ,Q   ,Sanita' e assistenza sociale                                ,1,2,2,4,9,2023
BAS,  ,Q 86,Assistenza sanitaria                                        ,1,2,1,1,5,2023
BAS,  ,Q 87,Servizi di assistenza sociale residenziale                  ,0,0,0,0,0,2023
BAS,  ,Q 88,Assistenza sociale non residenziale                         ,0,0,1,3,4,2023
BAS,  ,R   ,"Attività artistiche, sportive, di intrattenimento e diver...",8,5,3,1,17,2023
BAS,  ,R 90,"Attività creative, artistiche e di intrattenimento          ",2,1,0,0,3,2023
BAS,  ,R 91,"Attività di biblioteche, archivi, musei ed altre attività...",0,0,0,1,1,2023
BAS,  ,R 92,"Attività riguardanti le lotterie, le scommesse, le case d...",2,0,0,0,2,2023
BAS,  ,R 93,"Attività sportive, di intrattenimento e di divertimento     ",4,4,3,0,11,2023
BAS,  ,S   ,Altre attività di servizi                                   ,2,4,26,2,34,2023
BAS,  ,S 94,Attività di organizzazioni associative                      ,0,0,0,0,0,2023
BAS,  ,S 95,Riparazione di computer e di beni per uso personale e per...,0,1,8,0,9,2023
BAS,  ,S 96,Altre attività di servizi per la persona                    ,2,3,18,2,25,2023
BAS,  ,T   ,Attività di famiglie e convivenze come datori di lavoro p...,0,0,0,0,0,2023
BAS,  ,T 97,Attività di famiglie e convivenze come datori di lavoro p...,0,0,0,0,0,2023
BAS,  ,T 98,Produzione di beni e servizi indifferenziati per uso prop...,0,0,0,0,0,2023
BAS,  ,U   ,Organizzazioni ed organismi extraterritoriali               ,0,0,0,0,0,2023
BAS,  ,U 99,Organizzazioni ed organismi extraterritoriali               ,0,0,0,0,0,2023
BAS,  ,XX  ,Imprese non classificate                                    ,51,26,19,5,101,2023
BAS,  ,TOT ,TOTALE                                                      ,317,165,949,42,1473,2023
BAS,PZ,A   ,"Agricoltura, silvicoltura pesca                             ",4,5,219,3,231,2023
BAS,PZ,A 01,"Coltivazioni agricole e produzione di prodotti animali, c...",3,5,216,3,227,2023
BAS,PZ,A 02,Silvicoltura ed utilizzo di aree forestali                  ,0,0,3,0,3,2023
BAS,PZ,A 03,Pesca e acquacoltura                                        ,1,0,0,0,1,2023
BAS,PZ,B   ,Estrazione di minerali da cave e miniere                    ,1,1,0,0,2,2023
BAS,PZ,B 05,Estrazione di carbone (esclusa torba)                       ,0,0,0,0,0,2023
BAS,PZ,B 06,Estraz.di petrolio greggio e di gas naturale                ,0,0,0,0,0,2023
BAS,PZ,B 07,Estrazione di minerali metalliferi                          ,0,0,0,0,0,2023
BAS,PZ,B 08,Altre attività di estrazione di minerali da cave e miniere  ,1,1,0,0,2,2023
BAS,PZ,B 09,Attività dei servizi di supporto all'estrazione             ,0,0,0,0,0,2023
BAS,PZ,C   ,Attività manifatturiere                                     ,44,13,33,2,92,2023
BAS,PZ,C 10,Industrie alimentari                                        ,8,3,6,0,17,2023
BAS,PZ,C 11,Industria delle bevande                                     ,0,0,0,0,0,2023
BAS,PZ,C 12,Industria del tabacco                                       ,0,0,0,0,0,2023
BAS,PZ,C 13,Industrie tessili                                           ,1,0,2,0,3,2023
BAS,PZ,C 14,Confezione di articoli di abbigliamento; confezione di ar...,2,0,3,2,7,2023
BAS,PZ,C 15,Fabbricazione di articoli in pelle e simili                 ,3,0,0,0,3,2023
BAS,PZ,C 16,Industria del legno e dei prodotti in legno e sughero (es...,1,0,6,0,7,2023
BAS,PZ,C 17,Fabbricazione di carta e di prodotti di carta               ,2,0,0,0,2,2023
BAS,PZ,C 18,Stampa e riproduzione di supporti registrati                ,0,1,0,0,1,2023
BAS,PZ,C 19,Fabbricazione di coke e prodotti derivanti dalla raffinaz...,0,1,0,0,1,2023
BAS,PZ,C 20,Fabbricazione di prodotti chimici                           ,3,1,0,0,4,2023
BAS,PZ,C 21,Fabbricazione di prodotti farmaceutici di base e di prepa...,0,0,0,0,0,2023
BAS,PZ,C 22,Fabbricazione di articoli in gomma e materie plastiche      ,2,0,0,0,2,2023
BAS,PZ,C 23,Fabbricazione di altri prodotti della lavorazione di miner..,8,0,2,0,10,2023
BAS,PZ,C 24,Metallurgia                                                 ,1,0,0,0,1,2023
BAS,PZ,C 25,Fabbricazione di prodotti in metallo (esclusi macchinari ...,2,6,8,0,16,2023
BAS,PZ,C 26,Fabbricazione di computer e prodotti di elettronica e ott...,1,0,0,0,1,2023
BAS,PZ,C 27,Fabbricazione di apparecchiature elettriche ed apparecchi...,0,0,0,0,0,2023
BAS,PZ,C 28,Fabbricazione di macchinari ed apparecchiature nca          ,6,1,0,0,7,2023
BAS,PZ,C 29,"Fabbricazione di autoveicoli, rimorchi e semirimorchi       ",0,0,0,0,0,2023
BAS,PZ,C 30,Fabbricazione di altri mezzi di trasporto                   ,0,0,0,0,0,2023
BAS,PZ,C 31,Fabbricazione di mobili                                     ,4,0,1,0,5,2023
BAS,PZ,C 32,Altre industrie manifatturiere                              ,0,0,4,0,4,2023
BAS,PZ,C 33,"Riparazione, manutenzione ed installazione di macchine ed...",0,0,1,0,1,2023
BAS,PZ,D   ,"Fornitura di energia elettrica, gas, vapore e aria condiz...",0,0,0,0,0,2023
BAS,PZ,D 35,"Fornitura di energia elettrica, gas, vapore e aria condiz...",0,0,0,0,0,2023
BAS,PZ,E   ,"Fornitura di acqua; reti fognarie, attività di gestione d...",2,0,2,0,4,2023
BAS,PZ,E 36,"Raccolta, trattamento e fornitura di acqua                  ",0,0,0,0,0,2023
BAS,PZ,E 37,Gestione delle reti fognarie                                ,0,0,0,0,0,2023
BAS,PZ,E 38,"Attività di raccolta, trattamento e smaltimento dei rifiu...",2,0,1,0,3,2023
BAS,PZ,E 39,Attività di risanamento e altri servizi di gestione dei r...,0,0,1,0,1,2023
BAS,PZ,F   ,Costruzioni                                                 ,35,17,64,2,118,2023
BAS,PZ,F 41,Costruzione di edifici                                      ,28,8,26,2,64,2023
BAS,PZ,F 42,Ingegneria civile                                           ,0,1,3,0,4,2023
BAS,PZ,F 43,Lavori di costruzione specializzati                         ,7,8,35,0,50,2023
BAS,PZ,G   ,Commercio all'ingrosso e al dettaglio; riparazione di aut...,45,19,164,4,232,2023
BAS,PZ,G 45,Commercio all'ingrosso e al dettaglio e riparazione di au...,4,3,25,0,32,2023
BAS,PZ,G 46,Commercio all'ingrosso (escluso quello di autoveicoli e d...,20,7,29,3,59,2023
BAS,PZ,G 47,Commercio al dettaglio (escluso quello di autoveicoli e d...,21,9,110,1,141,2023
BAS,PZ,H   ,Trasporto e magazzinaggio                                   ,9,3,13,1,26,2023
BAS,PZ,H 49,Trasporto terrestre e mediante condotte                     ,4,3,13,1,21,2023
BAS,PZ,H 50,Trasporto marittimo e per vie d'acqua                       ,2,0,0,0,2,2023
BAS,PZ,H 51,Trasporto aereo                                             ,0,0,0,0,0,2023
BAS,PZ,H 52,Magazzinaggio e attività di supporto ai trasporti           ,2,0,0,0,2,2023
BAS,PZ,H 53,Servizi postali e attività di corriere                      ,1,0,0,0,1,2023
BAS,PZ,I   ,Attività dei servizi alloggio e ristorazione                ,9,15,18,1,43,2023
BAS,PZ,I 55,Alloggio                                                    ,3,0,1,0,4,2023
BAS,PZ,I 56,Attività dei servizi di ristorazione                        ,6,15,17,1,39,2023
BAS,PZ,J   ,Servizi di informazione e comunicazione                     ,6,0,2,2,10,2023
BAS,PZ,J 58,Attività editoriali                                         ,0,0,0,2,2,2023
BAS,PZ,J 59,"Attività di produzione cinematografica, di video e di pro...",0,0,1,0,1,2023
BAS,PZ,J 60,Attività di programmazione e trasmissione                   ,1,0,0,0,1,2023
BAS,PZ,J 61,Telecomunicazioni                                           ,0,0,0,0,0,2023
BAS,PZ,J 62,"Produzione di software, consulenza informatica e attività...",3,0,0,0,3,2023
BAS,PZ,J 63,Attività dei servizi d'informazione e altri servizi infor...,2,0,1,0,3,2023
BAS,PZ,K   ,Attività finanziarie e assicurative                         ,2,1,2,0,5,2023
BAS,PZ,K 64,Attività di servizi finanziari (escluse le assicurazioni ...,0,0,0,0,0,2023
BAS,PZ,K 65,"Assicurazioni, riassicurazioni e fondi pensione (escluse ...",0,0,0,0,0,2023
BAS,PZ,K 66,Attività ausiliarie dei servizi finanziari e delle attivi...,2,1,2,0,5,2023
BAS,PZ,L   ,Attivita' immobiliari                                       ,6,0,0,0,6,2023
BAS,PZ,L 68,Attivita' immobiliari                                       ,6,0,0,0,6,2023
BAS,PZ,M   ,"Attività professionali, scientifiche e tecniche             ",9,0,5,0,14,2023
BAS,PZ,M 69,Attività legali e contabilità                               ,0,0,0,0,0,2023
BAS,PZ,M 70,Attività di direzione aziendale e di consulenza gestional...,1,0,0,0,1,2023
BAS,PZ,M 71,Attività degli studi di architettura e d'ingegneria; coll...,5,0,0,0,5,2023
BAS,PZ,M 72,Ricerca scientifica e sviluppo                              ,0,0,0,0,0,2023
BAS,PZ,M 73,Pubblicità e ricerche di mercato                            ,0,0,2,0,2,2023
BAS,PZ,M 74,"Altre attività professionali, scientifiche e tecniche       ",3,0,3,0,6,2023
BAS,PZ,M 75,Servizi veterinari                                          ,0,0,0,0,0,2023
BAS,PZ,N   ,"Noleggio, agenzie di viaggio, servizi di supporto alle im...",6,2,6,3,17,2023
BAS,PZ,N 77,Attività di noleggio e leasing operativo                    ,1,0,1,0,2,2023
BAS,PZ,N 78,"Attività di ricerca, selezione, fornitura di personale      ",0,0,0,0,0,2023
BAS,PZ,N 79,"Attività dei servizi delle agenzie di viaggio, dei tour o...",0,0,2,0,2,2023
BAS,PZ,N 80,Servizi di vigilanza e investigazione                       ,1,0,0,0,1,2023
BAS,PZ,N 81,Attività di servizi per edifici e paesaggio                 ,1,2,3,3,9,2023
BAS,PZ,N 82,Attività di supporto per le funzioni d'ufficio e altri se...,3,0,0,0,3,2023
BAS,PZ,O   ,Amministrazione pubblica e difesa; assicurazione sociale ...,0,0,0,0,0,2023
BAS,PZ,O 84,Amministrazione pubblica e difesa; assicurazione sociale ...,0,0,0,0,0,2023
BAS,PZ,P   ,Istruzione                                                  ,2,0,0,1,3,2023
BAS,PZ,P 85,Istruzione                                                  ,2,0,0,1,3,2023
BAS,PZ,Q   ,Sanita' e assistenza sociale                                ,1,1,2,4,8,2023
BAS,PZ,Q 86,Assistenza sanitaria                                        ,1,1,1,1,4,2023
BAS,PZ,Q 87,Servizi di assistenza sociale residenziale                  ,0,0,0,0,0,2023
BAS,PZ,Q 88,Assistenza sociale non residenziale                         ,0,0,1,3,4,2023
BAS,PZ,R   ,"Attività artistiche, sportive, di intrattenimento e diver...",7,2,2,0,11,2023
BAS,PZ,R 90,"Attività creative, artistiche e di intrattenimento          ",2,0,0,0,2,2023
BAS,PZ,R 91,"Attività di biblioteche, archivi, musei ed altre attività...",0,0,0,0,0,2023
BAS,PZ,R 92,"Attività riguardanti le lotterie, le scommesse, le case d...",2,0,0,0,2,2023
BAS,PZ,R 93,"Attività sportive, di intrattenimento e di divertimento     ",3,2,2,0,7,2023
BAS,PZ,S   ,Altre attività di servizi                                   ,0,2,14,1,17,2023
BAS,PZ,S 94,Attività di organizzazioni associative                      ,0,0,0,0,0,2023
BAS,PZ,S 95,Riparazione di computer e di beni per uso personale e per...,0,1,4,0,5,2023
BAS,PZ,S 96,Altre attività di servizi per la persona                    ,0,1,10,1,12,2023
BAS,PZ,T   ,Attività di famiglie e convivenze come datori di lavoro p...,0,0,0,0,0,2023
BAS,PZ,T 97,Attività di famiglie e convivenze come datori di lavoro p...,0,0,0,0,0,2023
BAS,PZ,T 98,Produzione di beni e servizi indifferenziati per uso prop...,0,0,0,0,0,2023
BAS,PZ,U   ,Organizzazioni ed organismi extraterritoriali               ,0,0,0,0,0,2023
BAS,PZ,U 99,Organizzazioni ed organismi extraterritoriali               ,0,0,0,0,0,2023
BAS,PZ,XX  ,Imprese non classificate                                    ,22,11,13,2,48,2023
BAS,PZ,TOT ,TOTALE                                                      ,210,92,559,26,887,2023
BAS,MT,A   ,"Agricoltura, silvicoltura pesca                             ",8,1,111,0,120,2023
BAS,MT,A 01,"Coltivazioni agricole e produzione di prodotti animali, c...",8,1,111,0,120,2023
BAS,MT,A 02,Silvicoltura ed utilizzo di aree forestali                  ,0,0,0,0,0,2023
BAS,MT,A 03,Pesca e acquacoltura                                        ,0,0,0,0,0,2023
BAS,MT,B   ,Estrazione di minerali da cave e miniere                    ,0,0,0,0,0,2023
BAS,MT,B 05,Estrazione di carbone (esclusa torba)                       ,0,0,0,0,0,2023
BAS,MT,B 06,Estraz.di petrolio greggio e di gas naturale                ,0,0,0,0,0,2023
BAS,MT,B 07,Estrazione di minerali metalliferi                          ,0,0,0,0,0,2023
BAS,MT,B 08,Altre attività di estrazione di minerali da cave e miniere  ,0,0,0,0,0,2023
BAS,MT,B 09,Attività dei servizi di supporto all'estrazione             ,0,0,0,0,0,2023
BAS,MT,C   ,Attività manifatturiere                                     ,22,11,27,1,61,2023
BAS,MT,C 10,Industrie alimentari                                        ,5,8,4,0,17,2023
BAS,MT,C 11,Industria delle bevande                                     ,1,0,0,0,1,2023
BAS,MT,C 12,Industria del tabacco                                       ,0,0,0,0,0,2023
BAS,MT,C 13,Industrie tessili                                           ,0,0,1,0,1,2023
BAS,MT,C 14,Confezione di articoli di abbigliamento; confezione di ar...,3,0,5,0,8,2023
BAS,MT,C 15,Fabbricazione di articoli in pelle e simili                 ,0,0,0,0,0,2023
BAS,MT,C 16,Industria del legno e dei prodotti in legno e sughero (es...,1,0,5,1,7,2023
BAS,MT,C 17,Fabbricazione di carta e di prodotti di carta               ,0,0,0,0,0,2023
BAS,MT,C 18,Stampa e riproduzione di supporti registrati                ,0,1,1,0,2,2023
BAS,MT,C 19,Fabbricazione di coke e prodotti derivanti dalla raffinaz...,0,0,0,0,0,2023
BAS,MT,C 20,Fabbricazione di prodotti chimici                           ,1,0,0,0,1,2023
BAS,MT,C 21,Fabbricazione di prodotti farmaceutici di base e di prepa...,0,0,0,0,0,2023
BAS,MT,C 22,Fabbricazione di articoli in gomma e materie plastiche      ,1,0,0,0,1,2023
BAS,MT,C 23,Fabbricazione di altri prodotti della lavorazione di miner..,3,1,0,0,4,2023
BAS,MT,C 24,Metallurgia                                                 ,0,0,0,0,0,2023
BAS,MT,C 25,Fabbricazione di prodotti in metallo (esclusi macchinari ...,3,1,3,0,7,2023
BAS,MT,C 26,Fabbricazione di computer e prodotti di elettronica e ott...,0,0,1,0,1,2023
BAS,MT,C 27,Fabbricazione di apparecchiature elettriche ed apparecchi...,0,0,0,0,0,2023
BAS,MT,C 28,Fabbricazione di macchinari ed apparecchiature nca          ,2,0,0,0,2,2023
BAS,MT,C 29,"Fabbricazione di autoveicoli, rimorchi e semirimorchi       ",1,0,0,0,1,2023
BAS,MT,C 30,Fabbricazione di altri mezzi di trasporto                   ,0,0,0,0,0,2023
BAS,MT,C 31,Fabbricazione di mobili                                     ,1,0,3,0,4,2023
BAS,MT,C 32,Altre industrie manifatturiere                              ,0,0,3,0,3,2023
BAS,MT,C 33,"Riparazione, manutenzione ed installazione di macchine ed...",0,0,1,0,1,2023
BAS,MT,D   ,"Fornitura di energia elettrica, gas, vapore e aria condiz...",0,0,0,0,0,2023
BAS,MT,D 35,"Fornitura di energia elettrica, gas, vapore e aria condiz...",0,0,0,0,0,2023
BAS,MT,E   ,"Fornitura di acqua; reti fognarie, attività di gestione d...",0,0,0,0,0,2023
BAS,MT,E 36,"Raccolta, trattamento e fornitura di acqua                  ",0,0,0,0,0,2023
BAS,MT,E 37,Gestione delle reti fognarie                                ,0,0,0,0,0,2023
BAS,MT,E 38,"Attività di raccolta, trattamento e smaltimento dei rifiu...",0,0,0,0,0,2023
BAS,MT,E 39,Attività di risanamento e altri servizi di gestione dei r...,0,0,0,0,0,2023
BAS,MT,F   ,Costruzioni                                                 ,11,7,62,3,83,2023
BAS,MT,F 41,Costruzione di edifici                                      ,7,5,34,3,49,2023
BAS,MT,F 42,Ingegneria civile                                           ,0,0,1,0,1,2023
BAS,MT,F 43,Lavori di costruzione specializzati                         ,4,2,27,0,33,2023
BAS,MT,G   ,Commercio all'ingrosso e al dettaglio; riparazione di aut...,20,11,116,1,148,2023
BAS,MT,G 45,Commercio all'ingrosso e al dettaglio e riparazione di au...,3,1,13,0,17,2023
BAS,MT,G 46,Commercio all'ingrosso (escluso quello di autoveicoli e d...,11,2,15,0,28,2023
BAS,MT,G 47,Commercio al dettaglio (escluso quello di autoveicoli e d...,6,8,88,1,103,2023
BAS,MT,H   ,Trasporto e magazzinaggio                                   ,1,2,13,0,16,2023
BAS,MT,H 49,Trasporto terrestre e mediante condotte                     ,1,2,13,0,16,2023
BAS,MT,H 50,Trasporto marittimo e per vie d'acqua                       ,0,0,0,0,0,2023
BAS,MT,H 51,Trasporto aereo                                             ,0,0,0,0,0,2023
BAS,MT,H 52,Magazzinaggio e attività di supporto ai trasporti           ,0,0,0,0,0,2023
BAS,MT,H 53,Servizi postali e attività di corriere                      ,0,0,0,0,0,2023
BAS,MT,I   ,Attività dei servizi alloggio e ristorazione                ,5,14,23,0,42,2023
BAS,MT,I 55,Alloggio                                                    ,1,0,0,0,1,2023
BAS,MT,I 56,Attività dei servizi di ristorazione                        ,4,14,23,0,41,2023
BAS,MT,J   ,Servizi di informazione e comunicazione                     ,3,2,3,1,9,2023
BAS,MT,J 58,Attività editoriali                                         ,0,0,1,0,1,2023
BAS,MT,J 59,"Attività di produzione cinematografica, di video e di pro...",0,1,0,0,1,2023
BAS,MT,J 60,Attività di programmazione e trasmissione                   ,0,0,1,0,1,2023
BAS,MT,J 61,Telecomunicazioni                                           ,1,0,1,0,2,2023
BAS,MT,J 62,"Produzione di software, consulenza informatica e attività...",1,1,0,0,2,2023
BAS,MT,J 63,Attività dei servizi d'informazione e altri servizi infor...,1,0,0,1,2,2023
BAS,MT,K   ,Attività finanziarie e assicurative                         ,0,0,2,0,2,2023
BAS,MT,K 64,Attività di servizi finanziari (escluse le assicurazioni ...,0,0,0,0,0,2023
BAS,MT,K 65,"Assicurazioni, riassicurazioni e fondi pensione (escluse ...",0,0,0,0,0,2023
BAS,MT,K 66,Attività ausiliarie dei servizi finanziari e delle attivi...,0,0,2,0,2,2023
BAS,MT,L   ,Attivita' immobiliari                                       ,0,0,0,0,0,2023
BAS,MT,L 68,Attivita' immobiliari                                       ,0,0,0,0,0,2023
BAS,MT,M   ,"Attività professionali, scientifiche e tecniche             ",4,0,4,1,9,2023
BAS,MT,M 69,Attività legali e contabilità                               ,0,0,0,0,0,2023
BAS,MT,M 70,Attività di direzione aziendale e di consulenza gestional...,1,0,0,0,1,2023
BAS,MT,M 71,Attività degli studi di architettura e d'ingegneria; coll...,1,0,0,0,1,2023
BAS,MT,M 72,Ricerca scientifica e sviluppo                              ,1,0,0,1,2,2023
BAS,MT,M 73,Pubblicità e ricerche di mercato                            ,0,0,0,0,0,2023
BAS,MT,M 74,"Altre attività professionali, scientifiche e tecniche       ",1,0,4,0,5,2023
BAS,MT,M 75,Servizi veterinari                                          ,0,0,0,0,0,2023
BAS,MT,N   ,"Noleggio, agenzie di viaggio, servizi di supporto alle im...",1,4,9,4,18,2023
BAS,MT,N 77,Attività di noleggio e leasing operativo                    ,0,0,1,0,1,2023
BAS,MT,N 78,"Attività di ricerca, selezione, fornitura di personale      ",0,0,0,0,0,2023
BAS,MT,N 79,"Attività dei servizi delle agenzie di viaggio, dei tour o...",1,0,0,0,1,2023
BAS,MT,N 80,Servizi di vigilanza e investigazione                       ,0,0,0,1,1,2023
BAS,MT,N 81,Attività di servizi per edifici e paesaggio                 ,0,4,7,3,14,2023
BAS,MT,N 82,Attività di supporto per le funzioni d'ufficio e altri se...,0,0,1,0,1,2023
BAS,MT,O   ,Amministrazione pubblica e difesa; assicurazione sociale ...,0,0,0,0,0,2023
BAS,MT,O 84,Amministrazione pubblica e difesa; assicurazione sociale ...,0,0,0,0,0,2023
BAS,MT,P   ,Istruzione                                                  ,0,0,1,0,1,2023
BAS,MT,P 85,Istruzione                                                  ,0,0,1,0,1,2023
BAS,MT,Q   ,Sanita' e assistenza sociale                                ,0,1,0,0,1,2023
BAS,MT,Q 86,Assistenza sanitaria                                        ,0,1,0,0,1,2023
BAS,MT,Q 87,Servizi di assistenza sociale residenziale                  ,0,0,0,0,0,2023
BAS,MT,Q 88,Assistenza sociale non residenziale                         ,0,0,0,0,0,2023
BAS,MT,R   ,"Attività artistiche, sportive, di intrattenimento e diver...",1,3,1,1,6,2023
BAS,MT,R 90,"Attività creative, artistiche e di intrattenimento          ",0,1,0,0,1,2023
BAS,MT,R 91,"Attività di biblioteche, archivi, musei ed altre attività...",0,0,0,1,1,2023
BAS,MT,R 92,"Attività riguardanti le lotterie, le scommesse, le case d...",0,0,0,0,0,2023
BAS,MT,R 93,"Attività sportive, di intrattenimento e di divertimento     ",1,2,1,0,4,2023
BAS,MT,S   ,Altre attività di servizi                                   ,2,2,12,1,17,2023
BAS,MT,S 94,Attività di organizzazioni associative                      ,0,0,0,0,0,2023
BAS,MT,S 95,Riparazione di computer e di beni per uso personale e per...,0,0,4,0,4,2023
BAS,MT,S 96,Altre attività di servizi per la persona                    ,2,2,8,1,13,2023
BAS,MT,T   ,Attività di famiglie e convivenze come datori di lavoro p...,0,0,0,0,0,2023
BAS,MT,T 97,Attività di famiglie e convivenze come datori di lavoro p...,0,0,0,0,0,2023
BAS,MT,T 98,Produzione di beni e servizi indifferenziati per uso prop...,0,0,0,0,0,2023
BAS,MT,U   ,Organizzazioni ed organismi extraterritoriali               ,0,0,0,0,0,2023
BAS,MT,U 99,Organizzazioni ed organismi extraterritoriali               ,0,0,0,0,0,2023
BAS,MT,XX  ,Imprese non classificate                                    ,29,15,6,3,53,2023
BAS,MT,TOT ,TOTALE                                                      ,107,73,390,16,586,2023
CAL,  ,A   ,"Agricoltura, silvicoltura pesca                             ",8,7,495,21,531,2023
CAL,  ,A 01,"Coltivazioni agricole e produzione di prodotti animali, c...",8,5,484,20,517,2023
CAL,  ,A 02,Silvicoltura ed utilizzo di aree forestali                  ,0,2,10,0,12,2023
CAL,  ,A 03,Pesca e acquacoltura                                        ,0,0,1,1,2,2023
CAL,  ,B   ,Estrazione di minerali da cave e miniere                    ,1,1,9,0,11,2023
CAL,  ,B 05,Estrazione di carbone (esclusa torba)                       ,0,0,0,0,0,2023
CAL,  ,B 06,Estraz.di petrolio greggio e di gas naturale                ,0,0,0,0,0,2023
CAL,  ,B 07,Estrazione di minerali metalliferi                          ,0,0,0,0,0,2023
CAL,  ,B 08,Altre attività di estrazione di minerali da cave e miniere  ,1,1,9,0,11,2023
CAL,  ,B 09,Attività dei servizi di supporto all'estrazione             ,0,0,0,0,0,2023
CAL,  ,C   ,Attività manifatturiere                                     ,34,42,53,7,136,2023
CAL,  ,C 10,Industrie alimentari                                        ,12,12,41,2,67,2023
CAL,  ,C 11,Industria delle bevande                                     ,0,0,0,0,0,2023
CAL,  ,C 12,Industria del tabacco                                       ,0,0,0,0,0,2023
CAL,  ,C 13,Industrie tessili                                           ,0,0,0,0,0,2023
CAL,  ,C 14,Confezione di articoli di abbigliamento; confezione di ar...,2,4,1,0,7,2023
CAL,  ,C 15,Fabbricazione di articoli in pelle e simili                 ,0,1,0,0,1,2023
CAL,  ,C 16,Industria del legno e dei prodotti in legno e sughero (es...,0,1,3,0,4,2023
CAL,  ,C 17,Fabbricazione di carta e di prodotti di carta               ,0,0,0,0,0,2023
CAL,  ,C 18,Stampa e riproduzione di supporti registrati                ,0,1,0,2,3,2023
CAL,  ,C 19,Fabbricazione di coke e prodotti derivanti dalla raffinaz...,0,0,0,0,0,2023
CAL,  ,C 20,Fabbricazione di prodotti chimici                           ,2,1,0,0,3,2023
CAL,  ,C 21,Fabbricazione di prodotti farmaceutici di base e di prepa...,0,0,0,0,0,2023
CAL,  ,C 22,Fabbricazione di articoli in gomma e materie plastiche      ,2,2,0,0,4,2023
CAL,  ,C 23,Fabbricazione di altri prodotti della lavorazione di miner..,5,3,1,0,9,2023
CAL,  ,C 24,Metallurgia                                                 ,1,0,1,1,3,2023
CAL,  ,C 25,Fabbricazione di prodotti in metallo (esclusi macchinari ...,6,8,2,1,17,2023
CAL,  ,C 26,Fabbricazione di computer e prodotti di elettronica e ott...,0,1,0,0,1,2023
CAL,  ,C 27,Fabbricazione di apparecchiature elettriche ed apparecchi...,2,2,1,0,5,2023
CAL,  ,C 28,Fabbricazione di macchinari ed apparecchiature nca          ,0,2,1,0,3,2023
CAL,  ,C 29,"Fabbricazione di autoveicoli, rimorchi e semirimorchi       ",0,1,0,0,1,2023
CAL,  ,C 30,Fabbricazione di altri mezzi di trasporto                   ,1,0,0,0,1,2023
CAL,  ,C 31,Fabbricazione di mobili                                     ,1,1,1,0,3,2023
CAL,  ,C 32,Altre industrie manifatturiere                              ,0,1,1,0,2,2023
CAL,  ,C 33,"Riparazione, manutenzione ed installazione di macchine ed...",0,1,0,1,2,2023
CAL,  ,D   ,"Fornitura di energia elettrica, gas, vapore e aria condiz...",1,0,0,0,1,2023
CAL,  ,D 35,"Fornitura di energia elettrica, gas, vapore e aria condiz...",1,0,0,0,1,2023
CAL,  ,E   ,"Fornitura di acqua; reti fognarie, attività di gestione d...",1,0,0,5,6,2023
CAL,  ,E 36,"Raccolta, trattamento e fornitura di acqua                  ",0,0,0,0,0,2023
CAL,  ,E 37,Gestione delle reti fognarie                                ,0,0,0,0,0,2023
CAL,  ,E 38,"Attività di raccolta, trattamento e smaltimento dei rifiu...",1,0,0,0,1,2023
CAL,  ,E 39,Attività di risanamento e altri servizi di gestione dei r...,0,0,0,5,5,2023
CAL,  ,F   ,Costruzioni                                                 ,19,36,57,27,139,2023
CAL,  ,F 41,Costruzione di edifici                                      ,15,24,48,17,104,2023
CAL,  ,F 42,Ingegneria civile                                           ,2,2,1,0,5,2023
CAL,  ,F 43,Lavori di costruzione specializzati                         ,2,10,8,10,30,2023
CAL,  ,G   ,Commercio all'ingrosso e al dettaglio; riparazione di aut...,49,154,228,17,448,2023
CAL,  ,G 45,Commercio all'ingrosso e al dettaglio e riparazione di au...,9,9,12,0,30,2023
CAL,  ,G 46,Commercio all'ingrosso (escluso quello di autoveicoli e d...,31,54,51,12,148,2023
CAL,  ,G 47,Commercio al dettaglio (escluso quello di autoveicoli e d...,9,91,165,5,270,2023
CAL,  ,H   ,Trasporto e magazzinaggio                                   ,4,14,38,21,77,2023
CAL,  ,H 49,Trasporto terrestre e mediante condotte                     ,2,14,36,15,67,2023
CAL,  ,H 50,Trasporto marittimo e per vie d'acqua                       ,0,0,0,0,0,2023
CAL,  ,H 51,Trasporto aereo                                             ,0,0,0,0,0,2023
CAL,  ,H 52,Magazzinaggio e attività di supporto ai trasporti           ,2,0,2,6,10,2023
CAL,  ,H 53,Servizi postali e attività di corriere                      ,0,0,0,0,0,2023
CAL,  ,I   ,Attività dei servizi alloggio e ristorazione                ,2,35,30,2,69,2023
CAL,  ,I 55,Alloggio                                                    ,1,2,9,0,12,2023
CAL,  ,I 56,Attività dei servizi di ristorazione                        ,1,33,21,2,57,2023
CAL,  ,J   ,Servizi di informazione e comunicazione                     ,7,3,7,5,22,2023
CAL,  ,J 58,Attività editoriali                                         ,2,2,3,2,9,2023
CAL,  ,J 59,"Attività di produzione cinematografica, di video e di pro...",0,0,2,0,2,2023
CAL,  ,J 60,Attività di programmazione e trasmissione                   ,3,0,1,0,4,2023
CAL,  ,J 61,Telecomunicazioni                                           ,0,0,0,1,1,2023
CAL,  ,J 62,"Produzione di software, consulenza informatica e attività...",0,1,1,0,2,2023
CAL,  ,J 63,Attività dei servizi d'informazione e altri servizi infor...,2,0,0,2,4,2023
CAL,  ,K   ,Attività finanziarie e assicurative                         ,2,2,3,0,7,2023
CAL,  ,K 64,Attività di servizi finanziari (escluse le assicurazioni ...,1,0,0,0,1,2023
CAL,  ,K 65,"Assicurazioni, riassicurazioni e fondi pensione (escluse ...",0,0,0,0,0,2023
CAL,  ,K 66,Attività ausiliarie dei servizi finanziari e delle attivi...,1,2,3,0,6,2023
CAL,  ,L   ,Attivita' immobiliari                                       ,9,2,1,1,13,2023
CAL,  ,L 68,Attivita' immobiliari                                       ,9,2,1,1,13,2023
CAL,  ,M   ,"Attività professionali, scientifiche e tecniche             ",9,12,4,8,33,2023
CAL,  ,M 69,Attività legali e contabilità                               ,0,4,0,0,4,2023
CAL,  ,M 70,Attività di direzione aziendale e di consulenza gestional...,3,4,0,3,10,2023
CAL,  ,M 71,Attività degli studi di architettura e d'ingegneria; coll...,3,1,1,1,6,2023
CAL,  ,M 72,Ricerca scientifica e sviluppo                              ,0,0,0,0,0,2023
CAL,  ,M 73,Pubblicità e ricerche di mercato                            ,2,0,1,2,5,2023
CAL,  ,M 74,"Altre attività professionali, scientifiche e tecniche       ",1,3,2,2,8,2023
CAL,  ,M 75,Servizi veterinari                                          ,0,0,0,0,0,2023
CAL,  ,N   ,"Noleggio, agenzie di viaggio, servizi di supporto alle im...",1,10,8,25,44,2023
CAL,  ,N 77,Attività di noleggio e leasing operativo                    ,0,1,1,2,4,2023
CAL,  ,N 78,"Attività di ricerca, selezione, fornitura di personale      ",0,0,0,0,0,2023
CAL,  ,N 79,"Attività dei servizi delle agenzie di viaggio, dei tour o...",0,1,0,1,2,2023
CAL,  ,N 80,Servizi di vigilanza e investigazione                       ,0,1,1,1,3,2023
CAL,  ,N 81,Attività di servizi per edifici e paesaggio                 ,0,4,4,17,25,2023
CAL,  ,N 82,Attività di supporto per le funzioni d'ufficio e altri se...,1,3,2,4,10,2023
CAL,  ,O   ,Amministrazione pubblica e difesa; assicurazione sociale ...,0,0,0,0,0,2023
CAL,  ,O 84,Amministrazione pubblica e difesa; assicurazione sociale ...,0,0,0,0,0,2023
CAL,  ,P   ,Istruzione                                                  ,1,0,3,9,13,2023
CAL,  ,P 85,Istruzione                                                  ,1,0,3,9,13,2023
CAL,  ,Q   ,Sanita' e assistenza sociale                                ,3,2,0,19,24,2023
CAL,  ,Q 86,Assistenza sanitaria                                        ,2,2,0,3,7,2023
CAL,  ,Q 87,Servizi di assistenza sociale residenziale                  ,0,0,0,2,2,2023
CAL,  ,Q 88,Assistenza sociale non residenziale                         ,1,0,0,14,15,2023
CAL,  ,R   ,"Attività artistiche, sportive, di intrattenimento e diver...",3,5,3,4,15,2023
CAL,  ,R 90,"Attività creative, artistiche e di intrattenimento          ",2,0,1,0,3,2023
CAL,  ,R 91,"Attività di biblioteche, archivi, musei ed altre attività...",0,0,0,2,2,2023
CAL,  ,R 92,"Attività riguardanti le lotterie, le scommesse, le case d...",0,0,0,0,0,2023
CAL,  ,R 93,"Attività sportive, di intrattenimento e di divertimento     ",1,5,2,2,10,2023
CAL,  ,S   ,Altre attività di servizi                                   ,1,6,8,2,17,2023
CAL,  ,S 94,Attività di organizzazioni associative                      ,0,0,0,0,0,2023
CAL,  ,S 95,Riparazione di computer e di beni per uso personale e per...,1,1,2,1,5,2023
CAL,  ,S 96,Altre attività di servizi per la persona                    ,0,5,6,1,12,2023
CAL,  ,T   ,Attività di famiglie e convivenze come datori di lavoro p...,0,0,0,0,0,2023
CAL,  ,T 97,Attività di famiglie e convivenze come datori di lavoro p...,0,0,0,0,0,2023
CAL,  ,T 98,Produzione di beni e servizi indifferenziati per uso prop...,0,0,0,0,0,2023
CAL,  ,U   ,Organizzazioni ed organismi extraterritoriali               ,0,0,0,0,0,2023
CAL,  ,U 99,Organizzazioni ed organismi extraterritoriali               ,0,0,0,0,0,2023
CAL,  ,XX  ,Imprese non classificate                                    ,14,109,1,99,223,2023
CAL,  ,TOT ,TOTALE                                                      ,169,440,948,272,1829,2023
CAL,CS,A   ,"Agricoltura, silvicoltura pesca                             ",1,0,0,0,1,2023
CAL,CS,A 01,"Coltivazioni agricole e produzione di prodotti animali, c...",1,0,0,0,1,2023
CAL,CS,A 02,Silvicoltura ed utilizzo di aree forestali                  ,0,0,0,0,0,2023
CAL,CS,A 03,Pesca e acquacoltura                                        ,0,0,0,0,0,2023
CAL,CS,B   ,Estrazione di minerali da cave e miniere                    ,0,0,0,0,0,2023
CAL,CS,B 05,Estrazione di carbone (esclusa torba)                       ,0,0,0,0,0,2023
CAL,CS,B 06,Estraz.di petrolio greggio e di gas naturale                ,0,0,0,0,0,2023
CAL,CS,B 07,Estrazione di minerali metalliferi                          ,0,0,0,0,0,2023
CAL,CS,B 08,Altre attività di estrazione di minerali da cave e miniere  ,0,0,0,0,0,2023
CAL,CS,B 09,Attività dei servizi di supporto all'estrazione             ,0,0,0,0,0,2023
CAL,CS,C   ,Attività manifatturiere                                     ,6,0,0,0,6,2023
CAL,CS,C 10,Industrie alimentari                                        ,2,0,0,0,2,2023
CAL,CS,C 11,Industria delle bevande                                     ,0,0,0,0,0,2023
CAL,CS,C 12,Industria del tabacco                                       ,0,0,0,0,0,2023
CAL,CS,C 13,Industrie tessili                                           ,0,0,0,0,0,2023
CAL,CS,C 14,Confezione di articoli di abbigliamento; confezione di ar...,0,0,0,0,0,2023
CAL,CS,C 15,Fabbricazione di articoli in pelle e simili                 ,0,0,0,0,0,2023
CAL,CS,C 16,Industria del legno e dei prodotti in legno e sughero (es...,0,0,0,0,0,2023
CAL,CS,C 17,Fabbricazione di carta e di prodotti di carta               ,0,0,0,0,0,2023
CAL,CS,C 18,Stampa e riproduzione di supporti registrati                ,0,0,0,0,0,2023
CAL,CS,C 19,Fabbricazione di coke e prodotti derivanti dalla raffinaz...,0,0,0,0,0,2023
CAL,CS,C 20,Fabbricazione di prodotti chimici                           ,0,0,0,0,0,2023
CAL,CS,C 21,Fabbricazione di prodotti farmaceutici di base e di prepa...,0,0,0,0,0,2023
CAL,CS,C 22,Fabbricazione di articoli in gomma e materie plastiche      ,1,0,0,0,1,2023
CAL,CS,C 23,Fabbricazione di altri prodotti della lavorazione di miner..,3,0,0,0,3,2023
CAL,CS,C 24,Metallurgia                                                 ,0,0,0,0,0,2023
CAL,CS,C 25,Fabbricazione di prodotti in metallo (esclusi macchinari ...,0,0,0,0,0,2023
CAL,CS,C 26,Fabbricazione di computer e prodotti di elettronica e ott...,0,0,0,0,0,2023
CAL,CS,C 27,Fabbricazione di apparecchiature elettriche ed apparecchi...,0,0,0,0,0,2023
CAL,CS,C 28,Fabbricazione di macchinari ed apparecchiature nca          ,0,0,0,0,0,2023
CAL,CS,C 29,"Fabbricazione di autoveicoli, rimorchi e semirimorchi       ",0,0,0,0,0,2023
CAL,CS,C 30,Fabbricazione di altri mezzi di trasporto                   ,0,0,0,0,0,2023
CAL,CS,C 31,Fabbricazione di mobili                                     ,0,0,0,0,0,2023
CAL,CS,C 32,Altre industrie manifatturiere                              ,0,0,0,0,0,2023
CAL,CS,C 33,"Riparazione, manutenzione ed installazione di macchine ed...",0,0,0,0,0,2023
CAL,CS,D   ,"Fornitura di energia elettrica, gas, vapore e aria condiz...",0,0,0,0,0,2023
CAL,CS,D 35,"Fornitura di energia elettrica, gas, vapore e aria condiz...",0,0,0,0,0,2023
CAL,CS,E   ,"Fornitura di acqua; reti fognarie, attività di gestione d...",0,0,0,0,0,2023
CAL,CS,E 36,"Raccolta, trattamento e fornitura di acqua                  ",0,0,0,0,0,2023
CAL,CS,E 37,Gestione delle reti fognarie                                ,0,0,0,0,0,2023
CAL,CS,E 38,"Attività di raccolta, trattamento e smaltimento dei rifiu...",0,0,0,0,0,2023
CAL,CS,E 39,Attività di risanamento e altri servizi di gestione dei r...,0,0,0,0,0,2023
CAL,CS,F   ,Costruzioni                                                 ,6,0,0,0,6,2023
CAL,CS,F 41,Costruzione di edifici                                      ,3,0,0,0,3,2023
CAL,CS,F 42,Ingegneria civile                                           ,2,0,0,0,2,2023
CAL,CS,F 43,Lavori di costruzione specializzati                         ,1,0,0,0,1,2023
CAL,CS,G   ,Commercio all'ingrosso e al dettaglio; riparazione di aut...,11,1,0,0,12,2023
CAL,CS,G 45,Commercio all'ingrosso e al dettaglio e riparazione di au...,3,0,0,0,3,2023
CAL,CS,G 46,Commercio all'ingrosso (escluso quello di autoveicoli e d...,5,0,0,0,5,2023
CAL,CS,G 47,Commercio al dettaglio (escluso quello di autoveicoli e d...,3,1,0,0,4,2023
CAL,CS,H   ,Trasporto e magazzinaggio                                   ,0,0,0,0,0,2023
CAL,CS,H 49,Trasporto terrestre e mediante condotte                     ,0,0,0,0,0,2023
CAL,CS,H 50,Trasporto marittimo e per vie d'acqua                       ,0,0,0,0,0,2023
CAL,CS,H 51,Trasporto aereo                                             ,0,0,0,0,0,2023
CAL,CS,H 52,Magazzinaggio e attività di supporto ai trasporti           ,0,0,0,0,0,2023
CAL,CS,H 53,Servizi postali e attività di corriere                      ,0,0,0,0,0,2023
CAL,CS,I   ,Attività dei servizi alloggio e ristorazione                ,0,0,0,0,0,2023
CAL,CS,I 55,Alloggio                                                    ,0,0,0,0,0,2023
CAL,CS,I 56,Attività dei servizi di ristorazione                        ,0,0,0,0,0,2023
CAL,CS,J   ,Servizi di informazione e comunicazione                     ,3,0,0,0,3,2023
CAL,CS,J 58,Attività editoriali                                         ,1,0,0,0,1,2023
CAL,CS,J 59,"Attività di produzione cinematografica, di video e di pro...",0,0,0,0,0,2023
CAL,CS,J 60,Attività di programmazione e trasmissione                   ,1,0,0,0,1,2023
CAL,CS,J 61,Telecomunicazioni                                           ,0,0,0,0,0,2023
CAL,CS,J 62,"Produzione di software, consulenza informatica e attività...",0,0,0,0,0,2023
CAL,CS,J 63,Attività dei servizi d'informazione e altri servizi infor...,1,0,0,0,1,2023
CAL,CS,K   ,Attività finanziarie e assicurative                         ,0,0,0,0,0,2023
CAL,CS,K 64,Attività di servizi finanziari (escluse le assicurazioni ...,0,0,0,0,0,2023
CAL,CS,K 65,"Assicurazioni, riassicurazioni e fondi pensione (escluse ...",0,0,0,0,0,2023
CAL,CS,K 66,Attività ausiliarie dei servizi finanziari e delle attivi...,0,0,0,0,0,2023
CAL,CS,L   ,Attivita' immobiliari                                       ,3,0,0,0,3,2023
CAL,CS,L 68,Attivita' immobiliari                                       ,3,0,0,0,3,2023
CAL,CS,M   ,"Attività professionali, scientifiche e tecniche             ",0,0,0,0,0,2023
CAL,CS,M 69,Attività legali e contabilità                               ,0,0,0,0,0,2023
CAL,CS,M 70,Attività di direzione aziendale e di consulenza gestional...,0,0,0,0,0,2023
CAL,CS,M 71,Attività degli studi di architettura e d'ingegneria; coll...,0,0,0,0,0,2023
CAL,CS,M 72,Ricerca scientifica e sviluppo                              ,0,0,0,0,0,2023
CAL,CS,M 73,Pubblicità e ricerche di mercato                            ,0,0,0,0,0,2023
CAL,CS,M 74,"Altre attività professionali, scientifiche e tecniche       ",0,0,0,0,0,2023
CAL,CS,M 75,Servizi veterinari                                          ,0,0,0,0,0,2023
CAL,CS,N   ,"Noleggio, agenzie di viaggio, servizi di supporto alle im...",0,0,0,0,0,2023
CAL,CS,N 77,Attività di noleggio e leasing operativo                    ,0,0,0,0,0,2023
CAL,CS,N 78,"Attività di ricerca, selezione, fornitura di personale      ",0,0,0,0,0,2023
CAL,CS,N 79,"Attività dei servizi delle agenzie di viaggio, dei tour o...",0,0,0,0,0,2023
CAL,CS,N 80,Servizi di vigilanza e investigazione                       ,0,0,0,0,0,2023
CAL,CS,N 81,Attività di servizi per edifici e paesaggio                 ,0,0,0,0,0,2023
CAL,CS,N 82,Attività di supporto per le funzioni d'ufficio e altri se...,0,0,0,0,0,2023
CAL,CS,O   ,Amministrazione pubblica e difesa; assicurazione sociale ...,0,0,0,0,0,2023
CAL,CS,O 84,Amministrazione pubblica e difesa; assicurazione sociale ...,0,0,0,0,0,2023
CAL,CS,P   ,Istruzione                                                  ,1,0,0,0,1,2023
CAL,CS,P 85,Istruzione                                                  ,1,0,0,0,1,2023
CAL,CS,Q   ,Sanita' e assistenza sociale                                ,0,0,0,1,1,2023
CAL,CS,Q 86,Assistenza sanitaria                                        ,0,0,0,1,1,2023
CAL,CS,Q 87,Servizi di assistenza sociale residenziale                  ,0,0,0,0,0,2023
CAL,CS,Q 88,Assistenza sociale non residenziale                         ,0,0,0,0,0,2023
CAL,CS,R   ,"Attività artistiche, sportive, di intrattenimento e diver...",1,0,0,0,1,2023
CAL,CS,R 90,"Attività creative, artistiche e di intrattenimento          ",1,0,0,0,1,2023
CAL,CS,R 91,"Attività di biblioteche, archivi, musei ed altre attività...",0,0,0,0,0,2023
CAL,CS,R 92,"Attività riguardanti le lotterie, le scommesse, le case d...",0,0,0,0,0,2023
CAL,CS,R 93,"Attività sportive, di intrattenimento e di divertimento     ",0,0,0,0,0,2023
CAL,CS,S   ,Altre attività di servizi                                   ,0,0,0,0,0,2023
CAL,CS,S 94,Attività di organizzazioni associative                      ,0,0,0,0,0,2023
CAL,CS,S 95,Riparazione di computer e di beni per uso personale e per...,0,0,0,0,0,2023
CAL,CS,S 96,Altre attività di servizi per la persona                    ,0,0,0,0,0,2023
CAL,CS,T   ,Attività di famiglie e convivenze come datori di lavoro p...,0,0,0,0,0,2023
CAL,CS,T 97,Attività di famiglie e convivenze come datori di lavoro p...,0,0,0,0,0,2023
CAL,CS,T 98,Produzione di beni e servizi indifferenziati per uso prop...,0,0,0,0,0,2023
CAL,CS,U   ,Organizzazioni ed organismi extraterritoriali               ,0,0,0,0,0,2023
CAL,CS,U 99,Organizzazioni ed organismi extraterritoriali               ,0,0,0,0,0,2023
CAL,CS,XX  ,Imprese non classificate                                    ,3,0,0,0,3,2023
CAL,CS,TOT ,TOTALE                                                      ,35,1,0,1,37,2023
CAL,CZ,A   ,"Agricoltura, silvicoltura pesca                             ",0,0,0,2,2,2023
CAL,CZ,A 01,"Coltivazioni agricole e produzione di prodotti animali, c...",0,0,0,2,2,2023
CAL,CZ,A 02,Silvicoltura ed utilizzo di aree forestali                  ,0,0,0,0,0,2023
CAL,CZ,A 03,Pesca e acquacoltura                                        ,0,0,0,0,0,2023
CAL,CZ,B   ,Estrazione di minerali da cave e miniere                    ,0,0,0,0,0,2023
CAL,CZ,B 05,Estrazione di carbone (esclusa torba)                       ,0,0,0,0,0,2023
CAL,CZ,B 06,Estraz.di petrolio greggio e di gas naturale                ,0,0,0,0,0,2023
CAL,CZ,B 07,Estrazione di minerali metalliferi                          ,0,0,0,0,0,2023
CAL,CZ,B 08,Altre attività di estrazione di minerali da cave e miniere  ,0,0,0,0,0,2023
CAL,CZ,B 09,Attività dei servizi di supporto all'estrazione             ,0,0,0,0,0,2023
CAL,CZ,C   ,Attività manifatturiere                                     ,0,8,0,1,9,2023
CAL,CZ,C 10,Industrie alimentari                                        ,0,2,0,1,3,2023
CAL,CZ,C 11,Industria delle bevande                                     ,0,0,0,0,0,2023
CAL,CZ,C 12,Industria del tabacco                                       ,0,0,0,0,0,2023
CAL,CZ,C 13,Industrie tessili                                           ,0,0,0,0,0,2023
CAL,CZ,C 14,Confezione di articoli di abbigliamento; confezione di ar...,0,0,0,0,0,2023
CAL,CZ,C 15,Fabbricazione di articoli in pelle e simili                 ,0,0,0,0,0,2023
CAL,CZ,C 16,Industria del legno e dei prodotti in legno e sughero (es...,0,0,0,0,0,2023
CAL,CZ,C 17,Fabbricazione di carta e di prodotti di carta               ,0,0,0,0,0,2023
CAL,CZ,C 18,Stampa e riproduzione di supporti registrati                ,0,1,0,0,1,2023
CAL,CZ,C 19,Fabbricazione di coke e prodotti derivanti dalla raffinaz...,0,0,0,0,0,2023
CAL,CZ,C 20,Fabbricazione di prodotti chimici                           ,0,0,0,0,0,2023
CAL,CZ,C 21,Fabbricazione di prodotti farmaceutici di base e di prepa...,0,0,0,0,0,2023
CAL,CZ,C 22,Fabbricazione di articoli in gomma e materie plastiche      ,0,0,0,0,0,2023
CAL,CZ,C 23,Fabbricazione di altri prodotti della lavorazione di miner..,0,1,0,0,1,2023
CAL,CZ,C 24,Metallurgia                                                 ,0,0,0,0,0,2023
CAL,CZ,C 25,Fabbricazione di prodotti in metallo (esclusi macchinari ...,0,3,0,0,3,2023
CAL,CZ,C 26,Fabbricazione di computer e prodotti di elettronica e ott...,0,0,0,0,0,2023
CAL,CZ,C 27,Fabbricazione di apparecchiature elettriche ed apparecchi...,0,0,0,0,0,2023
CAL,CZ,C 28,Fabbricazione di macchinari ed apparecchiature nca          ,0,0,0,0,0,2023
CAL,CZ,C 29,"Fabbricazione di autoveicoli, rimorchi e semirimorchi       ",0,0,0,0,0,2023
CAL,CZ,C 30,Fabbricazione di altri mezzi di trasporto                   ,0,0,0,0,0,2023
CAL,CZ,C 31,Fabbricazione di mobili                                     ,0,0,0,0,0,2023
CAL,CZ,C 32,Altre industrie manifatturiere                              ,0,1,0,0,1,2023
CAL,CZ,C 33,"Riparazione, manutenzione ed installazione di macchine ed...",0,0,0,0,0,2023
CAL,CZ,D   ,"Fornitura di energia elettrica, gas, vapore e aria condiz...",0,0,0,0,0,2023
CAL,CZ,D 35,"Fornitura di energia elettrica, gas, vapore e aria condiz...",0,0,0,0,0,2023
CAL,CZ,E   ,"Fornitura di acqua; reti fognarie, attività di gestione d...",0,0,0,0,0,2023
CAL,CZ,E 36,"Raccolta, trattamento e fornitura di acqua                  ",0,0,0,0,0,2023
CAL,CZ,E 37,Gestione delle reti fognarie                                ,0,0,0,0,0,2023
CAL,CZ,E 38,"Attività di raccolta, trattamento e smaltimento dei rifiu...",0,0,0,0,0,2023
CAL,CZ,E 39,Attività di risanamento e altri servizi di gestione dei r...,0,0,0,0,0,2023
CAL,CZ,F   ,Costruzioni                                                 ,0,9,0,1,10,2023
CAL,CZ,F 41,Costruzione di edifici                                      ,0,5,0,1,6,2023
CAL,CZ,F 42,Ingegneria civile                                           ,0,1,0,0,1,2023
CAL,CZ,F 43,Lavori di costruzione specializzati                         ,0,3,0,0,3,2023
CAL,CZ,G   ,Commercio all'ingrosso e al dettaglio; riparazione di aut...,0,20,0,1,21,2023
CAL,CZ,G 45,Commercio all'ingrosso e al dettaglio e riparazione di au...,0,2,0,0,2,2023
CAL,CZ,G 46,Commercio all'ingrosso (escluso quello di autoveicoli e d...,0,6,0,0,6,2023
CAL,CZ,G 47,Commercio al dettaglio (escluso quello di autoveicoli e d...,0,12,0,1,13,2023
CAL,CZ,H   ,Trasporto e magazzinaggio                                   ,0,3,0,3,6,2023
CAL,CZ,H 49,Trasporto terrestre e mediante condotte                     ,0,3,0,3,6,2023
CAL,CZ,H 50,Trasporto marittimo e per vie d'acqua                       ,0,0,0,0,0,2023
CAL,CZ,H 51,Trasporto aereo                                             ,0,0,0,0,0,2023
CAL,CZ,H 52,Magazzinaggio e attività di supporto ai trasporti           ,0,0,0,0,0,2023
CAL,CZ,H 53,Servizi postali e attività di corriere                      ,0,0,0,0,0,2023
CAL,CZ,I   ,Attività dei servizi alloggio e ristorazione                ,0,6,0,0,6,2023
CAL,CZ,I 55,Alloggio                                                    ,0,1,0,0,1,2023
CAL,CZ,I 56,Attività dei servizi di ristorazione                        ,0,5,0,0,5,2023
CAL,CZ,J   ,Servizi di informazione e comunicazione                     ,0,0,0,0,0,2023
CAL,CZ,J 58,Attività editoriali                                         ,0,0,0,0,0,2023
CAL,CZ,J 59,"Attività di produzione cinematografica, di video e di pro...",0,0,0,0,0,2023
CAL,CZ,J 60,Attività di programmazione e trasmissione                   ,0,0,0,0,0,2023
CAL,CZ,J 61,Telecomunicazioni                                           ,0,0,0,0,0,2023
CAL,CZ,J 62,"Produzione di software, consulenza informatica e attività...",0,0,0,0,0,2023
CAL,CZ,J 63,Attività dei servizi d'informazione e altri servizi infor...,0,0,0,0,0,2023
CAL,CZ,K   ,Attività finanziarie e assicurative                         ,0,2,0,0,2,2023
CAL,CZ,K 64,Attività di servizi finanziari (escluse le assicurazioni ...,0,0,0,0,0,2023
CAL,CZ,K 65,"Assicurazioni, riassicurazioni e fondi pensione (escluse ...",0,0,0,0,0,2023
CAL,CZ,K 66,Attività ausiliarie dei servizi finanziari e delle attivi...,0,2,0,0,2,2023
CAL,CZ,L   ,Attivita' immobiliari                                       ,0,2,0,0,2,2023
CAL,CZ,L 68,Attivita' immobiliari                                       ,0,2,0,0,2,2023
CAL,CZ,M   ,"Attività professionali, scientifiche e tecniche             ",0,3,0,3,6,2023
CAL,CZ,M 69,Attività legali e contabilità                               ,0,1,0,0,1,2023
CAL,CZ,M 70,Attività di direzione aziendale e di consulenza gestional...,0,2,0,1,3,2023
CAL,CZ,M 71,Attività degli studi di architettura e d'ingegneria; coll...,0,0,0,1,1,2023
CAL,CZ,M 72,Ricerca scientifica e sviluppo                              ,0,0,0,0,0,2023
CAL,CZ,M 73,Pubblicità e ricerche di mercato                            ,0,0,0,1,1,2023
CAL,CZ,M 74,"Altre attività professionali, scientifiche e tecniche       ",0,0,0,0,0,2023
CAL,CZ,M 75,Servizi veterinari                                          ,0,0,0,0,0,2023
CAL,CZ,N   ,"Noleggio, agenzie di viaggio, servizi di supporto alle im...",0,2,0,2,4,2023
CAL,CZ,N 77,Attività di noleggio e leasing operativo                    ,0,1,0,0,1,2023
CAL,CZ,N 78,"Attività di ricerca, selezione, fornitura di personale      ",0,0,0,0,0,2023
CAL,CZ,N 79,"Attività dei servizi delle agenzie di viaggio, dei tour o...",0,0,0,0,0,2023
CAL,CZ,N 80,Servizi di vigilanza e investigazione                       ,0,0,0,0,0,2023
CAL,CZ,N 81,Attività di servizi per edifici e paesaggio                 ,0,1,0,1,2,2023
CAL,CZ,N 82,Attività di supporto per le funzioni d'ufficio e altri se...,0,0,0,1,1,2023
CAL,CZ,O   ,Amministrazione pubblica e difesa; assicurazione sociale ...,0,0,0,0,0,2023
CAL,CZ,O 84,Amministrazione pubblica e difesa; assicurazione sociale ...,0,0,0,0,0,2023
CAL,CZ,P   ,Istruzione                                                  ,0,0,0,0,0,2023
CAL,CZ,P 85,Istruzione                                                  ,0,0,0,0,0,2023
CAL,CZ,Q   ,Sanita' e assistenza sociale                                ,0,0,0,3,3,2023
CAL,CZ,Q 86,Assistenza sanitaria                                        ,0,0,0,0,0,2023
CAL,CZ,Q 87,Servizi di assistenza sociale residenziale                  ,0,0,0,1,1,2023
CAL,CZ,Q 88,Assistenza sociale non residenziale                         ,0,0,0,2,2,2023
CAL,CZ,R   ,"Attività artistiche, sportive, di intrattenimento e diver...",0,3,0,1,4,2023
CAL,CZ,R 90,"Attività creative, artistiche e di intrattenimento          ",0,0,0,0,0,2023
CAL,CZ,R 91,"Attività di biblioteche, archivi, musei ed altre attività...",0,0,0,1,1,2023
CAL,CZ,R 92,"Attività riguardanti le lotterie, le scommesse, le case d...",0,0,0,0,0,2023
CAL,CZ,R 93,"Attività sportive, di intrattenimento e di divertimento     ",0,3,0,0,3,2023
CAL,CZ,S   ,Altre attività di servizi                                   ,0,2,0,1,3,2023
CAL,CZ,S 94,Attività di organizzazioni associative                      ,0,0,0,0,0,2023
CAL,CZ,S 95,Riparazione di computer e di beni per uso personale e per...,0,1,0,1,2,2023
CAL,CZ,S 96,Altre attività di servizi per la persona                    ,0,1,0,0,1,2023
CAL,CZ,T   ,Attività di famiglie e convivenze come datori di lavoro p...,0,0,0,0,0,2023
CAL,CZ,T 97,Attività di famiglie e convivenze come datori di lavoro p...,0,0,0,0,0,2023
CAL,CZ,T 98,Produzione di beni e servizi indifferenziati per uso prop...,0,0,0,0,0,2023
CAL,CZ,U   ,Organizzazioni ed organismi extraterritoriali               ,0,0,0,0,0,2023
CAL,CZ,U 99,Organizzazioni ed organismi extraterritoriali               ,0,0,0,0,0,2023
CAL,CZ,XX  ,Imprese non classificate                                    ,0,7,0,8,15,2023
CAL,CZ,TOT ,TOTALE                                                      ,0,67,0,26,93,2023
CAL,RC,A   ,"Agricoltura, silvicoltura pesca                             ",7,7,495,17,526,2023
CAL,RC,A 01,"Coltivazioni agricole e produzione di prodotti animali, c...",7,5,484,17,513,2023
CAL,RC,A 02,Silvicoltura ed utilizzo di aree forestali                  ,0,2,10,0,12,2023
CAL,RC,A 03,Pesca e acquacoltura                                        ,0,0,1,0,1,2023
CAL,RC,B   ,Estrazione di minerali da cave e miniere                    ,1,1,9,0,11,2023
CAL,RC,B 05,Estrazione di carbone (esclusa torba)                       ,0,0,0,0,0,2023
CAL,RC,B 06,Estraz.di petrolio greggio e di gas naturale                ,0,0,0,0,0,2023
CAL,RC,B 07,Estrazione di minerali metalliferi                          ,0,0,0,0,0,2023
CAL,RC,B 08,Altre attività di estrazione di minerali da cave e miniere  ,1,1,9,0,11,2023
CAL,RC,B 09,Attività dei servizi di supporto all'estrazione             ,0,0,0,0,0,2023
CAL,RC,C   ,Attività manifatturiere                                     ,28,34,53,5,120,2023
CAL,RC,C 10,Industrie alimentari                                        ,10,10,41,1,62,2023
CAL,RC,C 11,Industria delle bevande                                     ,0,0,0,0,0,2023
CAL,RC,C 12,Industria del tabacco                                       ,0,0,0,0,0,2023
CAL,RC,C 13,Industrie tessili                                           ,0,0,0,0,0,2023
CAL,RC,C 14,Confezione di articoli di abbigliamento; confezione di ar...,2,4,1,0,7,2023
CAL,RC,C 15,Fabbricazione di articoli in pelle e simili                 ,0,1,0,0,1,2023
CAL,RC,C 16,Industria del legno e dei prodotti in legno e sughero (es...,0,1,3,0,4,2023
CAL,RC,C 17,Fabbricazione di carta e di prodotti di carta               ,0,0,0,0,0,2023
CAL,RC,C 18,Stampa e riproduzione di supporti registrati                ,0,0,0,2,2,2023
CAL,RC,C 19,Fabbricazione di coke e prodotti derivanti dalla raffinaz...,0,0,0,0,0,2023
CAL,RC,C 20,Fabbricazione di prodotti chimici                           ,2,1,0,0,3,2023
CAL,RC,C 21,Fabbricazione di prodotti farmaceutici di base e di prepa...,0,0,0,0,0,2023
CAL,RC,C 22,Fabbricazione di articoli in gomma e materie plastiche      ,1,2,0,0,3,2023
CAL,RC,C 23,Fabbricazione di altri prodotti della lavorazione di miner..,2,2,1,0,5,2023
CAL,RC,C 24,Metallurgia                                                 ,1,0,1,1,3,2023
CAL,RC,C 25,Fabbricazione di prodotti in metallo (esclusi macchinari ...,6,5,2,1,14,2023
CAL,RC,C 26,Fabbricazione di computer e prodotti di elettronica e ott...,0,1,0,0,1,2023
CAL,RC,C 27,Fabbricazione di apparecchiature elettriche ed apparecchi...,2,2,1,0,5,2023
CAL,RC,C 28,Fabbricazione di macchinari ed apparecchiature nca          ,0,2,1,0,3,2023
CAL,RC,C 29,"Fabbricazione di autoveicoli, rimorchi e semirimorchi       ",0,1,0,0,1,2023
CAL,RC,C 30,Fabbricazione di altri mezzi di trasporto                   ,1,0,0,0,1,2023
CAL,RC,C 31,Fabbricazione di mobili                                     ,1,1,1,0,3,2023
CAL,RC,C 32,Altre industrie manifatturiere                              ,0,0,1,0,1,2023
CAL,RC,C 33,"Riparazione, manutenzione ed installazione di macchine ed...",0,1,0,0,1,2023
CAL,RC,D   ,"Fornitura di energia elettrica, gas, vapore e aria condiz...",1,0,0,0,1,2023
CAL,RC,D 35,"Fornitura di energia elettrica, gas, vapore e aria condiz...",1,0,0,0,1,2023
CAL,RC,E   ,"Fornitura di acqua; reti fognarie, attività di gestione d...",1,0,0,5,6,2023
CAL,RC,E 36,"Raccolta, trattamento e fornitura di acqua                  ",0,0,0,0,0,2023
CAL,RC,E 37,Gestione delle reti fognarie                                ,0,0,0,0,0,2023
CAL,RC,E 38,"Attività di raccolta, trattamento e smaltimento dei rifiu...",1,0,0,0,1,2023
CAL,RC,E 39,Attività di risanamento e altri servizi di gestione dei r...,0,0,0,5,5,2023
CAL,RC,F   ,Costruzioni                                                 ,13,27,57,16,113,2023
CAL,RC,F 41,Costruzione di edifici                                      ,12,19,48,10,89,2023
CAL,RC,F 42,Ingegneria civile                                           ,0,1,1,0,2,2023
CAL,RC,F 43,Lavori di costruzione specializzati                         ,1,7,8,6,22,2023
CAL,RC,G   ,Commercio all'ingrosso e al dettaglio; riparazione di aut...,37,133,228,11,409,2023
CAL,RC,G 45,Commercio all'ingrosso e al dettaglio e riparazione di au...,6,7,12,0,25,2023
CAL,RC,G 46,Commercio all'ingrosso (escluso quello di autoveicoli e d...,25,48,51,9,133,2023
CAL,RC,G 47,Commercio al dettaglio (escluso quello di autoveicoli e d...,6,78,165,2,251,2023
CAL,RC,H   ,Trasporto e magazzinaggio                                   ,4,11,38,16,69,2023
CAL,RC,H 49,Trasporto terrestre e mediante condotte                     ,2,11,36,10,59,2023
CAL,RC,H 50,Trasporto marittimo e per vie d'acqua                       ,0,0,0,0,0,2023
CAL,RC,H 51,Trasporto aereo                                             ,0,0,0,0,0,2023
CAL,RC,H 52,Magazzinaggio e attività di supporto ai trasporti           ,2,0,2,6,10,2023
CAL,RC,H 53,Servizi postali e attività di corriere                      ,0,0,0,0,0,2023
CAL,RC,I   ,Attività dei servizi alloggio e ristorazione                ,2,29,30,2,63,2023
CAL,RC,I 55,Alloggio                                                    ,1,1,9,0,11,2023
CAL,RC,I 56,Attività dei servizi di ristorazione                        ,1,28,21,2,52,2023
CAL,RC,J   ,Servizi di informazione e comunicazione                     ,4,3,7,4,18,2023
CAL,RC,J 58,Attività editoriali                                         ,1,2,3,2,8,2023
CAL,RC,J 59,"Attività di produzione cinematografica, di video e di pro...",0,0,2,0,2,2023
CAL,RC,J 60,Attività di programmazione e trasmissione                   ,2,0,1,0,3,2023
CAL,RC,J 61,Telecomunicazioni                                           ,0,0,0,1,1,2023
CAL,RC,J 62,"Produzione di software, consulenza informatica e attività...",0,1,1,0,2,2023
CAL,RC,J 63,Attività dei servizi d'informazione e altri servizi infor...,1,0,0,1,2,2023
CAL,RC,K   ,Attività finanziarie e assicurative                         ,2,0,3,0,5,2023
CAL,RC,K 64,Attività di servizi finanziari (escluse le assicurazioni ...,1,0,0,0,1,2023
CAL,RC,K 65,"Assicurazioni, riassicurazioni e fondi pensione (escluse ...",0,0,0,0,0,2023
CAL,RC,K 66,Attività ausiliarie dei servizi finanziari e delle attivi...,1,0,3,0,4,2023
CAL,RC,L   ,Attivita' immobiliari                                       ,6,0,1,0,7,2023
CAL,RC,L 68,Attivita' immobiliari                                       ,6,0,1,0,7,2023
CAL,RC,M   ,"Attività professionali, scientifiche e tecniche             ",9,9,4,4,26,2023
CAL,RC,M 69,Attività legali e contabilità                               ,0,3,0,0,3,2023
CAL,RC,M 70,Attività di direzione aziendale e di consulenza gestional...,3,2,0,1,6,2023
CAL,RC,M 71,Attività degli studi di architettura e d'ingegneria; coll...,3,1,1,0,5,2023
CAL,RC,M 72,Ricerca scientifica e sviluppo                              ,0,0,0,0,0,2023
CAL,RC,M 73,Pubblicità e ricerche di mercato                            ,2,0,1,1,4,2023
CAL,RC,M 74,"Altre attività professionali, scientifiche e tecniche       ",1,3,2,2,8,2023
CAL,RC,M 75,Servizi veterinari                                          ,0,0,0,0,0,2023
CAL,RC,N   ,"Noleggio, agenzie di viaggio, servizi di supporto alle im...",1,8,8,19,36,2023
CAL,RC,N 77,Attività di noleggio e leasing operativo                    ,0,0,1,2,3,2023
CAL,RC,N 78,"Attività di ricerca, selezione, fornitura di personale      ",0,0,0,0,0,2023
CAL,RC,N 79,"Attività dei servizi delle agenzie di viaggio, dei tour o...",0,1,0,1,2,2023
CAL,RC,N 80,Servizi di vigilanza e investigazione                       ,0,1,1,1,3,2023
CAL,RC,N 81,Attività di servizi per edifici e paesaggio                 ,0,3,4,13,20,2023
CAL,RC,N 82,Attività di supporto per le funzioni d'ufficio e altri se...,1,3,2,2,8,2023
CAL,RC,O   ,Amministrazione pubblica e difesa; assicurazione sociale ...,0,0,0,0,0,2023
CAL,RC,O 84,Amministrazione pubblica e difesa; assicurazione sociale ...,0,0,0,0,0,2023
CAL,RC,P   ,Istruzione                                                  ,0,0,3,8,11,2023
CAL,RC,P 85,Istruzione                                                  ,0,0,3,8,11,2023
CAL,RC,Q   ,Sanita' e assistenza sociale                                ,3,2,0,13,18,2023
CAL,RC,Q 86,Assistenza sanitaria                                        ,2,2,0,1,5,2023
CAL,RC,Q 87,Servizi di assistenza sociale residenziale                  ,0,0,0,0,0,2023
CAL,RC,Q 88,Assistenza sociale non residenziale                         ,1,0,0,12,13,2023
CAL,RC,R   ,"Attività artistiche, sportive, di intrattenimento e diver...",2,2,3,2,9,2023
CAL,RC,R 90,"Attività creative, artistiche e di intrattenimento          ",1,0,1,0,2,2023
CAL,RC,R 91,"Attività di biblioteche, archivi, musei ed altre attività...",0,0,0,1,1,2023
CAL,RC,R 92,"Attività riguardanti le lotterie, le scommesse, le case d...",0,0,0,0,0,2023
CAL,RC,R 93,"Attività sportive, di intrattenimento e di divertimento     ",1,2,2,1,6,2023
CAL,RC,S   ,Altre attività di servizi                                   ,1,4,8,1,14,2023
CAL,RC,S 94,Attività di organizzazioni associative                      ,0,0,0,0,0,2023
CAL,RC,S 95,Riparazione di computer e di beni per uso personale e per...,1,0,2,0,3,2023
CAL,RC,S 96,Altre attività di servizi per la persona                    ,0,4,6,1,11,2023
CAL,RC,T   ,Attività di famiglie e convivenze come datori di lavoro p...,0,0,0,0,0,2023
CAL,RC,T 97,Attività di famiglie e convivenze come datori di lavoro p...,0,0,0,0,0,2023
CAL,RC,T 98,Produzione di beni e servizi indifferenziati per uso prop...,0,0,0,0,0,2023
CAL,RC,U   ,Organizzazioni ed organismi extraterritoriali               ,0,0,0,0,0,2023
CAL,RC,U 99,Organizzazioni ed organismi extraterritoriali               ,0,0,0,0,0,2023
CAL,RC,XX  ,Imprese non classificate                                    ,10,102,1,80,193,2023
CAL,RC,TOT ,TOTALE                                                      ,132,372,948,203,1655,2023
CAL,KR,A   ,"Agricoltura, silvicoltura pesca                             ",0,0,0,1,1,2023
CAL,KR,A 01,"Coltivazioni agricole e produzione di prodotti animali, c...",0,0,0,1,1,2023
CAL,KR,A 02,Silvicoltura ed utilizzo di aree forestali                  ,0,0,0,0,0,2023
CAL,KR,A 03,Pesca e acquacoltura                                        ,0,0,0,0,0,2023
CAL,KR,B   ,Estrazione di minerali da cave e miniere                    ,0,0,0,0,0,2023
CAL,KR,B 05,Estrazione di carbone (esclusa torba)                       ,0,0,0,0,0,2023
CAL,KR,B 06,Estraz.di petrolio greggio e di gas naturale                ,0,0,0,0,0,2023
CAL,KR,B 07,Estrazione di minerali metalliferi                          ,0,0,0,0,0,2023
CAL,KR,B 08,Altre attività di estrazione di minerali da cave e miniere  ,0,0,0,0,0,2023
CAL,KR,B 09,Attività dei servizi di supporto all'estrazione             ,0,0,0,0,0,2023
CAL,KR,C   ,Attività manifatturiere                                     ,0,0,0,1,1,2023
CAL,KR,C 10,Industrie alimentari                                        ,0,0,0,0,0,2023
CAL,KR,C 11,Industria delle bevande                                     ,0,0,0,0,0,2023
CAL,KR,C 12,Industria del tabacco                                       ,0,0,0,0,0,2023
CAL,KR,C 13,Industrie tessili                                           ,0,0,0,0,0,2023
CAL,KR,C 14,Confezione di articoli di abbigliamento; confezione di ar...,0,0,0,0,0,2023
CAL,KR,C 15,Fabbricazione di articoli in pelle e simili                 ,0,0,0,0,0,2023
CAL,KR,C 16,Industria del legno e dei prodotti in legno e sughero (es...,0,0,0,0,0,2023
CAL,KR,C 17,Fabbricazione di carta e di prodotti di carta               ,0,0,0,0,0,2023
CAL,KR,C 18,Stampa e riproduzione di supporti registrati                ,0,0,0,0,0,2023
CAL,KR,C 19,Fabbricazione di coke e prodotti derivanti dalla raffinaz...,0,0,0,0,0,2023
CAL,KR,C 20,Fabbricazione di prodotti chimici                           ,0,0,0,0,0,2023
CAL,KR,C 21,Fabbricazione di prodotti farmaceutici di base e di prepa...,0,0,0,0,0,2023
CAL,KR,C 22,Fabbricazione di articoli in gomma e materie plastiche      ,0,0,0,0,0,2023
CAL,KR,C 23,Fabbricazione di altri prodotti della lavorazione di miner..,0,0,0,0,0,2023
CAL,KR,C 24,Metallurgia                                                 ,0,0,0,0,0,2023
CAL,KR,C 25,Fabbricazione di prodotti in metallo (esclusi macchinari ...,0,0,0,0,0,2023
CAL,KR,C 26,Fabbricazione di computer e prodotti di elettronica e ott...,0,0,0,0,0,2023
CAL,KR,C 27,Fabbricazione di apparecchiature elettriche ed apparecchi...,0,0,0,0,0,2023
CAL,KR,C 28,Fabbricazione di macchinari ed apparecchiature nca          ,0,0,0,0,0,2023
CAL,KR,C 29,"Fabbricazione di autoveicoli, rimorchi e semirimorchi       ",0,0,0,0,0,2023
CAL,KR,C 30,Fabbricazione di altri mezzi di trasporto                   ,0,0,0,0,0,2023
CAL,KR,C 31,Fabbricazione di mobili                                     ,0,0,0,0,0,2023
CAL,KR,C 32,Altre industrie manifatturiere                              ,0,0,0,0,0,2023
CAL,KR,C 33,"Riparazione, manutenzione ed installazione di macchine ed...",0,0,0,1,1,2023
CAL,KR,D   ,"Fornitura di energia elettrica, gas, vapore e aria condiz...",0,0,0,0,0,2023
CAL,KR,D 35,"Fornitura di energia elettrica, gas, vapore e aria condiz...",0,0,0,0,0,2023
CAL,KR,E   ,"Fornitura di acqua; reti fognarie, attività di gestione d...",0,0,0,0,0,2023
CAL,KR,E 36,"Raccolta, trattamento e fornitura di acqua                  ",0,0,0,0,0,2023
CAL,KR,E 37,Gestione delle reti fognarie                                ,0,0,0,0,0,2023
CAL,KR,E 38,"Attività di raccolta, trattamento e smaltimento dei rifiu...",0,0,0,0,0,2023
CAL,KR,E 39,Attività di risanamento e altri servizi di gestione dei r...,0,0,0,0,0,2023
CAL,KR,F   ,Costruzioni                                                 ,0,0,0,3,3,2023
CAL,KR,F 41,Costruzione di edifici                                      ,0,0,0,2,2,2023
CAL,KR,F 42,Ingegneria civile                                           ,0,0,0,0,0,2023
CAL,KR,F 43,Lavori di costruzione specializzati                         ,0,0,0,1,1,2023
CAL,KR,G   ,Commercio all'ingrosso e al dettaglio; riparazione di aut...,0,0,0,2,2,2023
CAL,KR,G 45,Commercio all'ingrosso e al dettaglio e riparazione di au...,0,0,0,0,0,2023
CAL,KR,G 46,Commercio all'ingrosso (escluso quello di autoveicoli e d...,0,0,0,2,2,2023
CAL,KR,G 47,Commercio al dettaglio (escluso quello di autoveicoli e d...,0,0,0,0,0,2023
CAL,KR,H   ,Trasporto e magazzinaggio                                   ,0,0,0,2,2,2023
CAL,KR,H 49,Trasporto terrestre e mediante condotte                     ,0,0,0,2,2,2023
CAL,KR,H 50,Trasporto marittimo e per vie d'acqua                       ,0,0,0,0,0,2023
CAL,KR,H 51,Trasporto aereo                                             ,0,0,0,0,0,2023
CAL,KR,H 52,Magazzinaggio e attività di supporto ai trasporti           ,0,0,0,0,0,2023
CAL,KR,H 53,Servizi postali e attività di corriere                      ,0,0,0,0,0,2023
CAL,KR,I   ,Attività dei servizi alloggio e ristorazione                ,0,0,0,0,0,2023
CAL,KR,I 55,Alloggio                                                    ,0,0,0,0,0,2023
CAL,KR,I 56,Attività dei servizi di ristorazione                        ,0,0,0,0,0,2023
CAL,KR,J   ,Servizi di informazione e comunicazione                     ,0,0,0,1,1,2023
CAL,KR,J 58,Attività editoriali                                         ,0,0,0,0,0,2023
CAL,KR,J 59,"Attività di produzione cinematografica, di video e di pro...",0,0,0,0,0,2023
CAL,KR,J 60,Attività di programmazione e trasmissione                   ,0,0,0,0,0,2023
CAL,KR,J 61,Telecomunicazioni                                           ,0,0,0,0,0,2023
CAL,KR,J 62,"Produzione di software, consulenza informatica e attività...",0,0,0,0,0,2023
CAL,KR,J 63,Attività dei servizi d'informazione e altri servizi infor...,0,0,0,1,1,2023
CAL,KR,K   ,Attività finanziarie e assicurative                         ,0,0,0,0,0,2023
CAL,KR,K 64,Attività di servizi finanziari (escluse le assicurazioni ...,0,0,0,0,0,2023
CAL,KR,K 65,"Assicurazioni, riassicurazioni e fondi pensione (escluse ...",0,0,0,0,0,2023
CAL,KR,K 66,Attività ausiliarie dei servizi finanziari e delle attivi...,0,0,0,0,0,2023
CAL,KR,L   ,Attivita' immobiliari                                       ,0,0,0,0,0,2023
CAL,KR,L 68,Attivita' immobiliari                                       ,0,0,0,0,0,2023
CAL,KR,M   ,"Attività professionali, scientifiche e tecniche             ",0,0,0,1,1,2023
CAL,KR,M 69,Attività legali e contabilità                               ,0,0,0,0,0,2023
CAL,KR,M 70,Attività di direzione aziendale e di consulenza gestional...,0,0,0,1,1,2023
CAL,KR,M 71,Attività degli studi di architettura e d'ingegneria; coll...,0,0,0,0,0,2023
CAL,KR,M 72,Ricerca scientifica e sviluppo                              ,0,0,0,0,0,2023
CAL,KR,M 73,Pubblicità e ricerche di mercato                            ,0,0,0,0,0,2023
CAL,KR,M 74,"Altre attività professionali, scientifiche e tecniche       ",0,0,0,0,0,2023
CAL,KR,M 75,Servizi veterinari                                          ,0,0,0,0,0,2023
CAL,KR,N   ,"Noleggio, agenzie di viaggio, servizi di supporto alle im...",0,0,0,1,1,2023
CAL,KR,N 77,Attività di noleggio e leasing operativo                    ,0,0,0,0,0,2023
CAL,KR,N 78,"Attività di ricerca, selezione, fornitura di personale      ",0,0,0,0,0,2023
CAL,KR,N 79,"Attività dei servizi delle agenzie di viaggio, dei tour o...",0,0,0,0,0,2023
CAL,KR,N 80,Servizi di vigilanza e investigazione                       ,0,0,0,0,0,2023
CAL,KR,N 81,Attività di servizi per edifici e paesaggio                 ,0,0,0,1,1,2023
CAL,KR,N 82,Attività di supporto per le funzioni d'ufficio e altri se...,0,0,0,0,0,2023
CAL,KR,O   ,Amministrazione pubblica e difesa; assicurazione sociale ...,0,0,0,0,0,2023
CAL,KR,O 84,Amministrazione pubblica e difesa; assicurazione sociale ...,0,0,0,0,0,2023
CAL,KR,P   ,Istruzione                                                  ,0,0,0,1,1,2023
CAL,KR,P 85,Istruzione                                                  ,0,0,0,1,1,2023
CAL,KR,Q   ,Sanita' e assistenza sociale                                ,0,0,0,2,2,2023
CAL,KR,Q 86,Assistenza sanitaria                                        ,0,0,0,1,1,2023
CAL,KR,Q 87,Servizi di assistenza sociale residenziale                  ,0,0,0,1,1,2023
CAL,KR,Q 88,Assistenza sociale non residenziale                         ,0,0,0,0,0,2023
CAL,KR,R   ,"Attività artistiche, sportive, di intrattenimento e diver...",0,0,0,0,0,2023
CAL,KR,R 90,"Attività creative, artistiche e di intrattenimento          ",0,0,0,0,0,2023
CAL,KR,R 91,"Attività di biblioteche, archivi, musei ed altre attività...",0,0,0,0,0,2023
CAL,KR,R 92,"Attività riguardanti le lotterie, le scommesse, le case d...",0,0,0,0,0,2023
CAL,KR,R 93,"Attività sportive, di intrattenimento e di divertimento     ",0,0,0,0,0,2023
CAL,KR,S   ,Altre attività di servizi                                   ,0,0,0,0,0,2023
CAL,KR,S 94,Attività di organizzazioni associative                      ,0,0,0,0,0,2023
CAL,KR,S 95,Riparazione di computer e di beni per uso personale e per...,0,0,0,0,0,2023
CAL,KR,S 96,Altre attività di servizi per la persona                    ,0,0,0,0,0,2023
CAL,KR,T   ,Attività di famiglie e convivenze come datori di lavoro p...,0,0,0,0,0,2023
CAL,KR,T 97,Attività di famiglie e convivenze come datori di lavoro p...,0,0,0,0,0,2023
CAL,KR,T 98,Produzione di beni e servizi indifferenziati per uso prop...,0,0,0,0,0,2023
CAL,KR,U   ,Organizzazioni ed organismi extraterritoriali               ,0,0,0,0,0,2023
CAL,KR,U 99,Organizzazioni ed organismi extraterritoriali               ,0,0,0,0,0,2023
CAL,KR,XX  ,Imprese non classificate                                    ,0,0,0,7,7,2023
CAL,KR,TOT ,TOTALE                                                      ,0,0,0,22,22,2023
CAL,VV,A   ,"Agricoltura, silvicoltura pesca                             ",0,0,0,1,1,2023
CAL,VV,A 01,"Coltivazioni agricole e produzione di prodotti animali, c...",0,0,0,0,0,2023
CAL,VV,A 02,Silvicoltura ed utilizzo di aree forestali                  ,0,0,0,0,0,2023
CAL,VV,A 03,Pesca e acquacoltura                                        ,0,0,0,1,1,2023
CAL,VV,B   ,Estrazione di minerali da cave e miniere                    ,0,0,0,0,0,2023
CAL,VV,B 05,Estrazione di carbone (esclusa torba)                       ,0,0,0,0,0,2023
CAL,VV,B 06,Estraz.di petrolio greggio e di gas naturale                ,0,0,0,0,0,2023
CAL,VV,B 07,Estrazione di minerali metalliferi                          ,0,0,0,0,0,2023
CAL,VV,B 08,Altre attività di estrazione di minerali da cave e miniere  ,0,0,0,0,0,2023
CAL,VV,B 09,Attività dei servizi di supporto all'estrazione             ,0,0,0,0,0,2023
CAL,VV,C   ,Attività manifatturiere                                     ,0,0,0,0,0,2023
CAL,VV,C 10,Industrie alimentari                                        ,0,0,0,0,0,2023
CAL,VV,C 11,Industria delle bevande                                     ,0,0,0,0,0,2023
CAL,VV,C 12,Industria del tabacco                                       ,0,0,0,0,0,2023
CAL,VV,C 13,Industrie tessili                                           ,0,0,0,0,0,2023
CAL,VV,C 14,Confezione di articoli di abbigliamento; confezione di ar...,0,0,0,0,0,2023
CAL,VV,C 15,Fabbricazione di articoli in pelle e simili                 ,0,0,0,0,0,2023
CAL,VV,C 16,Industria del legno e dei prodotti in legno e sughero (es...,0,0,0,0,0,2023
CAL,VV,C 17,Fabbricazione di carta e di prodotti di carta               ,0,0,0,0,0,2023
CAL,VV,C 18,Stampa e riproduzione di supporti registrati                ,0,0,0,0,0,2023
CAL,VV,C 19,Fabbricazione di coke e prodotti derivanti dalla raffinaz...,0,0,0,0,0,2023
CAL,VV,C 20,Fabbricazione di prodotti chimici                           ,0,0,0,0,0,2023
CAL,VV,C 21,Fabbricazione di prodotti farmaceutici di base e di prepa...,0,0,0,0,0,2023
CAL,VV,C 22,Fabbricazione di articoli in gomma e materie plastiche      ,0,0,0,0,0,2023
CAL,VV,C 23,Fabbricazione di altri prodotti della lavorazione di miner..,0,0,0,0,0,2023
CAL,VV,C 24,Metallurgia                                                 ,0,0,0,0,0,2023
CAL,VV,C 25,Fabbricazione di prodotti in metallo (esclusi macchinari ...,0,0,0,0,0,2023
CAL,VV,C 26,Fabbricazione di computer e prodotti di elettronica e ott...,0,0,0,0,0,2023
CAL,VV,C 27,Fabbricazione di apparecchiature elettriche ed apparecchi...,0,0,0,0,0,2023
CAL,VV,C 28,Fabbricazione di macchinari ed apparecchiature nca          ,0,0,0,0,0,2023
CAL,VV,C 29,"Fabbricazione di autoveicoli, rimorchi e semirimorchi       ",0,0,0,0,0,2023
CAL,VV,C 30,Fabbricazione di altri mezzi di trasporto                   ,0,0,0,0,0,2023
CAL,VV,C 31,Fabbricazione di mobili                                     ,0,0,0,0,0,2023
CAL,VV,C 32,Altre industrie manifatturiere                              ,0,0,0,0,0,2023
CAL,VV,C 33,"Riparazione, manutenzione ed installazione di macchine ed...",0,0,0,0,0,2023
CAL,VV,D   ,"Fornitura di energia elettrica, gas, vapore e aria condiz...",0,0,0,0,0,2023
CAL,VV,D 35,"Fornitura di energia elettrica, gas, vapore e aria condiz...",0,0,0,0,0,2023
CAL,VV,E   ,"Fornitura di acqua; reti fognarie, attività di gestione d...",0,0,0,0,0,2023
CAL,VV,E 36,"Raccolta, trattamento e fornitura di acqua                  ",0,0,0,0,0,2023
CAL,VV,E 37,Gestione delle reti fognarie                                ,0,0,0,0,0,2023
CAL,VV,E 38,"Attività di raccolta, trattamento e smaltimento dei rifiu...",0,0,0,0,0,2023
CAL,VV,E 39,Attività di risanamento e altri servizi di gestione dei r...,0,0,0,0,0,2023
CAL,VV,F   ,Costruzioni                                                 ,0,0,0,7,7,2023
CAL,VV,F 41,Costruzione di edifici                                      ,0,0,0,4,4,2023
CAL,VV,F 42,Ingegneria civile                                           ,0,0,0,0,0,2023
CAL,VV,F 43,Lavori di costruzione specializzati                         ,0,0,0,3,3,2023
CAL,VV,G   ,Commercio all'ingrosso e al dettaglio; riparazione di aut...,1,0,0,3,4,2023
CAL,VV,G 45,Commercio all'ingrosso e al dettaglio e riparazione di au...,0,0,0,0,0,2023
CAL,VV,G 46,Commercio all'ingrosso (escluso quello di autoveicoli e d...,1,0,0,1,2,2023
CAL,VV,G 47,Commercio al dettaglio (escluso quello di autoveicoli e d...,0,0,0,2,2,2023
CAL,VV,H   ,Trasporto e magazzinaggio                                   ,0,0,0,0,0,2023
CAL,VV,H 49,Trasporto terrestre e mediante condotte                     ,0,0,0,0,0,2023
CAL,VV,H 50,Trasporto marittimo e per vie d'acqua                       ,0,0,0,0,0,2023
CAL,VV,H 51,Trasporto aereo                                             ,0,0,0,0,0,2023
CAL,VV,H 52,Magazzinaggio e attività di supporto ai trasporti           ,0,0,0,0,0,2023
CAL,VV,H 53,Servizi postali e attività di corriere                      ,0,0,0,0,0,2023
CAL,VV,I   ,Attività dei servizi alloggio e ristorazione                ,0,0,0,0,0,2023
CAL,VV,I 55,Alloggio                                                    ,0,0,0,0,0,2023
CAL,VV,I 56,Attività dei servizi di ristorazione                        ,0,0,0,0,0,2023
CAL,VV,J   ,Servizi di informazione e comunicazione                     ,0,0,0,0,0,2023
CAL,VV,J 58,Attività editoriali                                         ,0,0,0,0,0,2023
CAL,VV,J 59,"Attività di produzione cinematografica, di video e di pro...",0,0,0,0,0,2023
CAL,VV,J 60,Attività di programmazione e trasmissione                   ,0,0,0,0,0,2023
CAL,VV,J 61,Telecomunicazioni                                           ,0,0,0,0,0,2023
CAL,VV,J 62,"Produzione di software, consulenza informatica e attività...",0,0,0,0,0,2023
CAL,VV,J 63,Attività dei servizi d'informazione e altri servizi infor...,0,0,0,0,0,2023
CAL,VV,K   ,Attività finanziarie e assicurative                         ,0,0,0,0,0,2023
CAL,VV,K 64,Attività di servizi finanziari (escluse le assicurazioni ...,0,0,0,0,0,2023
CAL,VV,K 65,"Assicurazioni, riassicurazioni e fondi pensione (escluse ...",0,0,0,0,0,2023
CAL,VV,K 66,Attività ausiliarie dei servizi finanziari e delle attivi...,0,0,0,0,0,2023
CAL,VV,L   ,Attivita' immobiliari                                       ,0,0,0,1,1,2023
CAL,VV,L 68,Attivita' immobiliari                                       ,0,0,0,1,1,2023
CAL,VV,M   ,"Attività professionali, scientifiche e tecniche             ",0,0,0,0,0,2023
CAL,VV,M 69,Attività legali e contabilità                               ,0,0,0,0,0,2023
CAL,VV,M 70,Attività di direzione aziendale e di consulenza gestional...,0,0,0,0,0,2023
CAL,VV,M 71,Attività degli studi di architettura e d'ingegneria; coll...,0,0,0,0,0,2023
CAL,VV,M 72,Ricerca scientifica e sviluppo                              ,0,0,0,0,0,2023
CAL,VV,M 73,Pubblicità e ricerche di mercato                            ,0,0,0,0,0,2023
CAL,VV,M 74,"Altre attività professionali, scientifiche e tecniche       ",0,0,0,0,0,2023
CAL,VV,M 75,Servizi veterinari                                          ,0,0,0,0,0,2023
CAL,VV,N   ,"Noleggio, agenzie di viaggio, servizi di supporto alle im...",0,0,0,3,3,2023
CAL,VV,N 77,Attività di noleggio e leasing operativo                    ,0,0,0,0,0,2023
CAL,VV,N 78,"Attività di ricerca, selezione, fornitura di personale      ",0,0,0,0,0,2023
CAL,VV,N 79,"Attività dei servizi delle agenzie di viaggio, dei tour o...",0,0,0,0,0,2023
CAL,VV,N 80,Servizi di vigilanza e investigazione                       ,0,0,0,0,0,2023
CAL,VV,N 81,Attività di servizi per edifici e paesaggio                 ,0,0,0,2,2,2023
CAL,VV,N 82,Attività di supporto per le funzioni d'ufficio e altri se...,0,0,0,1,1,2023
CAL,VV,O   ,Amministrazione pubblica e difesa; assicurazione sociale ...,0,0,0,0,0,2023
CAL,VV,O 84,Amministrazione pubblica e difesa; assicurazione sociale ...,0,0,0,0,0,2023
CAL,VV,P   ,Istruzione                                                  ,0,0,0,0,0,2023
CAL,VV,P 85,Istruzione                                                  ,0,0,0,0,0,2023
CAL,VV,Q   ,Sanita' e assistenza sociale                                ,0,0,0,0,0,2023
CAL,VV,Q 86,Assistenza sanitaria                                        ,0,0,0,0,0,2023
CAL,VV,Q 87,Servizi di assistenza sociale residenziale                  ,0,0,0,0,0,2023
CAL,VV,Q 88,Assistenza sociale non residenziale                         ,0,0,0,0,0,2023
CAL,VV,R   ,"Attività artistiche, sportive, di intrattenimento e diver...",0,0,0,1,1,2023
CAL,VV,R 90,"Attività creative, artistiche e di intrattenimento          ",0,0,0,0,0,2023
CAL,VV,R 91,"Attività di biblioteche, archivi, musei ed altre attività...",0,0,0,0,0,2023
CAL,VV,R 92,"Attività riguardanti le lotterie, le scommesse, le case d...",0,0,0,0,0,2023
CAL,VV,R 93,"Attività sportive, di intrattenimento e di divertimento     ",0,0,0,1,1,2023
CAL,VV,S   ,Altre attività di servizi                                   ,0,0,0,0,0,2023
CAL,VV,S 94,Attività di organizzazioni associative                      ,0,0,0,0,0,2023
CAL,VV,S 95,Riparazione di computer e di beni per uso personale e per...,0,0,0,0,0,2023
CAL,VV,S 96,Altre attività di servizi per la persona                    ,0,0,0,0,0,2023
CAL,VV,T   ,Attività di famiglie e convivenze come datori di lavoro p...,0,0,0,0,0,2023
CAL,VV,T 97,Attività di famiglie e convivenze come datori di lavoro p...,0,0,0,0,0,2023
CAL,VV,T 98,Produzione di beni e servizi indifferenziati per uso prop...,0,0,0,0,0,2023
CAL,VV,U   ,Organizzazioni ed organismi extraterritoriali               ,0,0,0,0,0,2023
CAL,VV,U 99,Organizzazioni ed organismi extraterritoriali               ,0,0,0,0,0,2023
CAL,VV,XX  ,Imprese non classificate                                    ,1,0,0,4,5,2023
CAL,VV,TOT ,TOTALE                                                      ,2,0,0,20,22,2023
SIC,  ,A   ,"Agricoltura, silvicoltura pesca                             ",61,0,1497,12,1570,2023
SIC,  ,A 01,"Coltivazioni agricole e produzione di prodotti animali, c...",58,0,1478,8,1544,2023
SIC,  ,A 02,Silvicoltura ed utilizzo di aree forestali                  ,2,0,2,1,5,2023
SIC,  ,A 03,Pesca e acquacoltura                                        ,1,0,17,3,21,2023
SIC,  ,B   ,Estrazione di minerali da cave e miniere                    ,8,0,6,0,14,2023
SIC,  ,B 05,Estrazione di carbone (esclusa torba)                       ,0,0,0,0,0,2023
SIC,  ,B 06,Estraz.di petrolio greggio e di gas naturale                ,0,0,0,0,0,2023
SIC,  ,B 07,Estrazione di minerali metalliferi                          ,1,0,0,0,1,2023
SIC,  ,B 08,Altre attività di estrazione di minerali da cave e miniere  ,7,0,6,0,13,2023
SIC,  ,B 09,Attività dei servizi di supporto all'estrazione             ,0,0,0,0,0,2023
SIC,  ,C   ,Attività manifatturiere                                     ,423,0,51,1,475,2023
SIC,  ,C 10,Industrie alimentari                                        ,60,0,12,0,72,2023
SIC,  ,C 11,Industria delle bevande                                     ,5,0,1,0,6,2023
SIC,  ,C 12,Industria del tabacco                                       ,0,0,0,0,0,2023
SIC,  ,C 13,Industrie tessili                                           ,5,0,1,0,6,2023
SIC,  ,C 14,Confezione di articoli di abbigliamento; confezione di ar...,11,0,4,0,15,2023
SIC,  ,C 15,Fabbricazione di articoli in pelle e simili                 ,3,0,0,0,3,2023
SIC,  ,C 16,Industria del legno e dei prodotti in legno e sughero (es...,30,0,6,0,36,2023
SIC,  ,C 17,Fabbricazione di carta e di prodotti di carta               ,10,0,0,0,10,2023
SIC,  ,C 18,Stampa e riproduzione di supporti registrati                ,10,0,2,0,12,2023
SIC,  ,C 19,Fabbricazione di coke e prodotti derivanti dalla raffinaz...,1,0,0,0,1,2023
SIC,  ,C 20,Fabbricazione di prodotti chimici                           ,12,0,1,0,13,2023
SIC,  ,C 21,Fabbricazione di prodotti farmaceutici di base e di prepa...,1,0,0,0,1,2023
SIC,  ,C 22,Fabbricazione di articoli in gomma e materie plastiche      ,9,0,0,0,9,2023
SIC,  ,C 23,Fabbricazione di altri prodotti della lavorazione di miner..,62,0,9,1,72,2023
SIC,  ,C 24,Metallurgia                                                 ,6,0,0,0,6,2023
SIC,  ,C 25,Fabbricazione di prodotti in metallo (esclusi macchinari ...,85,0,7,0,92,2023
SIC,  ,C 26,Fabbricazione di computer e prodotti di elettronica e ott...,11,0,0,0,11,2023
SIC,  ,C 27,Fabbricazione di apparecchiature elettriche ed apparecchi...,13,0,1,0,14,2023
SIC,  ,C 28,Fabbricazione di macchinari ed apparecchiature nca          ,21,0,1,0,22,2023
SIC,  ,C 29,"Fabbricazione di autoveicoli, rimorchi e semirimorchi       ",4,0,0,0,4,2023
SIC,  ,C 30,Fabbricazione di altri mezzi di trasporto                   ,18,0,2,0,20,2023
SIC,  ,C 31,Fabbricazione di mobili                                     ,15,0,1,0,16,2023
SIC,  ,C 32,Altre industrie manifatturiere                              ,11,0,2,0,13,2023
SIC,  ,C 33,"Riparazione, manutenzione ed installazione di macchine ed...",20,0,1,0,21,2023
SIC,  ,D   ,"Fornitura di energia elettrica, gas, vapore e aria condiz...",5,0,0,0,5,2023
SIC,  ,D 35,"Fornitura di energia elettrica, gas, vapore e aria condiz...",5,0,0,0,5,2023
SIC,  ,E   ,"Fornitura di acqua; reti fognarie, attività di gestione d...",17,0,4,1,22,2023
SIC,  ,E 36,"Raccolta, trattamento e fornitura di acqua                  ",2,0,3,0,5,2023
SIC,  ,E 37,Gestione delle reti fognarie                                ,2,0,0,0,2,2023
SIC,  ,E 38,"Attività di raccolta, trattamento e smaltimento dei rifiu...",9,0,1,1,11,2023
SIC,  ,E 39,Attività di risanamento e altri servizi di gestione dei r...,4,0,0,0,4,2023
SIC,  ,F   ,Costruzioni                                                 ,800,1,72,83,956,2023
SIC,  ,F 41,Costruzione di edifici                                      ,582,1,61,51,695,2023
SIC,  ,F 42,Ingegneria civile                                           ,32,0,2,18,52,2023
SIC,  ,F 43,Lavori di costruzione specializzati                         ,186,0,9,14,209,2023
SIC,  ,G   ,Commercio all'ingrosso e al dettaglio; riparazione di aut...,1258,0,373,6,1637,2023
SIC,  ,G 45,Commercio all'ingrosso e al dettaglio e riparazione di au...,117,0,23,1,141,2023
SIC,  ,G 46,Commercio all'ingrosso (escluso quello di autoveicoli e d...,539,0,70,2,611,2023
SIC,  ,G 47,Commercio al dettaglio (escluso quello di autoveicoli e d...,602,0,280,3,885,2023
SIC,  ,H   ,Trasporto e magazzinaggio                                   ,123,0,50,1,174,2023
SIC,  ,H 49,Trasporto terrestre e mediante condotte                     ,78,0,47,0,125,2023
SIC,  ,H 50,Trasporto marittimo e per vie d'acqua                       ,4,0,0,0,4,2023
SIC,  ,H 51,Trasporto aereo                                             ,1,0,0,0,1,2023
SIC,  ,H 52,Magazzinaggio e attività di supporto ai trasporti           ,33,0,2,1,36,2023
SIC,  ,H 53,Servizi postali e attività di corriere                      ,7,0,1,0,8,2023
SIC,  ,I   ,Attività dei servizi alloggio e ristorazione                ,257,0,49,3,309,2023
SIC,  ,I 55,Alloggio                                                    ,20,0,9,0,29,2023
SIC,  ,I 56,Attività dei servizi di ristorazione                        ,237,0,40,3,280,2023
SIC,  ,J   ,Servizi di informazione e comunicazione                     ,124,0,11,4,139,2023
SIC,  ,J 58,Attività editoriali                                         ,13,0,5,0,18,2023
SIC,  ,J 59,"Attività di produzione cinematografica, di video e di pro...",4,0,2,1,7,2023
SIC,  ,J 60,Attività di programmazione e trasmissione                   ,2,0,2,0,4,2023
SIC,  ,J 61,Telecomunicazioni                                           ,10,0,0,0,10,2023
SIC,  ,J 62,"Produzione di software, consulenza informatica e attività...",44,0,0,2,46,2023
SIC,  ,J 63,Attività dei servizi d'informazione e altri servizi infor...,51,0,2,1,54,2023
SIC,  ,K   ,Attività finanziarie e assicurative                         ,57,0,3,0,60,2023
SIC,  ,K 64,Attività di servizi finanziari (escluse le assicurazioni ...,7,0,0,0,7,2023
SIC,  ,K 65,"Assicurazioni, riassicurazioni e fondi pensione (escluse ...",1,0,0,0,1,2023
SIC,  ,K 66,Attività ausiliarie dei servizi finanziari e delle attivi...,49,0,3,0,52,2023
SIC,  ,L   ,Attivita' immobiliari                                       ,91,0,0,0,91,2023
SIC,  ,L 68,Attivita' immobiliari                                       ,91,0,0,0,91,2023
SIC,  ,M   ,"Attività professionali, scientifiche e tecniche             ",145,0,4,10,159,2023
SIC,  ,M 69,Attività legali e contabilità                               ,11,0,0,1,12,2023
SIC,  ,M 70,Attività di direzione aziendale e di consulenza gestional...,31,0,0,5,36,2023
SIC,  ,M 71,Attività degli studi di architettura e d'ingegneria; coll...,44,0,1,1,46,2023
SIC,  ,M 72,Ricerca scientifica e sviluppo                              ,5,0,0,0,5,2023
SIC,  ,M 73,Pubblicità e ricerche di mercato                            ,22,0,1,2,25,2023
SIC,  ,M 74,"Altre attività professionali, scientifiche e tecniche       ",32,0,2,1,35,2023
SIC,  ,M 75,Servizi veterinari                                          ,0,0,0,0,0,2023
SIC,  ,N   ,"Noleggio, agenzie di viaggio, servizi di supporto alle im...",142,0,11,8,161,2023
SIC,  ,N 77,Attività di noleggio e leasing operativo                    ,36,0,0,1,37,2023
SIC,  ,N 78,"Attività di ricerca, selezione, fornitura di personale      ",0,0,0,0,0,2023
SIC,  ,N 79,"Attività dei servizi delle agenzie di viaggio, dei tour o...",32,0,3,2,37,2023
SIC,  ,N 80,Servizi di vigilanza e investigazione                       ,2,0,0,0,2,2023
SIC,  ,N 81,Attività di servizi per edifici e paesaggio                 ,22,0,8,3,33,2023
SIC,  ,N 82,Attività di supporto per le funzioni d'ufficio e altri se...,50,0,0,2,52,2023
SIC,  ,O   ,Amministrazione pubblica e difesa; assicurazione sociale ...,0,0,0,0,0,2023
SIC,  ,O 84,Amministrazione pubblica e difesa; assicurazione sociale ...,0,0,0,0,0,2023
SIC,  ,P   ,Istruzione                                                  ,28,0,3,8,39,2023
SIC,  ,P 85,Istruzione                                                  ,28,0,3,8,39,2023
SIC,  ,Q   ,Sanita' e assistenza sociale                                ,48,0,1,6,55,2023
SIC,  ,Q 86,Assistenza sanitaria                                        ,35,0,0,1,36,2023
SIC,  ,Q 87,Servizi di assistenza sociale residenziale                  ,9,0,1,1,11,2023
SIC,  ,Q 88,Assistenza sociale non residenziale                         ,4,0,0,4,8,2023
SIC,  ,R   ,"Attività artistiche, sportive, di intrattenimento e diver...",62,0,11,5,78,2023
SIC,  ,R 90,"Attività creative, artistiche e di intrattenimento          ",13,0,2,4,19,2023
SIC,  ,R 91,"Attività di biblioteche, archivi, musei ed altre attività...",2,0,0,0,2,2023
SIC,  ,R 92,"Attività riguardanti le lotterie, le scommesse, le case d...",11,0,2,0,13,2023
SIC,  ,R 93,"Attività sportive, di intrattenimento e di divertimento     ",36,0,7,1,44,2023
SIC,  ,S   ,Altre attività di servizi                                   ,44,0,13,2,59,2023
SIC,  ,S 94,Attività di organizzazioni associative                      ,0,0,0,0,0,2023
SIC,  ,S 95,Riparazione di computer e di beni per uso personale e per...,10,0,8,0,18,2023
SIC,  ,S 96,Altre attività di servizi per la persona                    ,34,0,5,2,41,2023
SIC,  ,T   ,Attività di famiglie e convivenze come datori di lavoro p...,0,0,0,0,0,2023
SIC,  ,T 97,Attività di famiglie e convivenze come datori di lavoro p...,0,0,0,0,0,2023
SIC,  ,T 98,Produzione di beni e servizi indifferenziati per uso prop...,0,0,0,0,0,2023
SIC,  ,U   ,Organizzazioni ed organismi extraterritoriali               ,0,0,0,0,0,2023
SIC,  ,U 99,Organizzazioni ed organismi extraterritoriali               ,0,0,0,0,0,2023
SIC,  ,XX  ,Imprese non classificate                                    ,1548,0,32,138,1718,2023
SIC,  ,TOT ,TOTALE                                                      ,5241,1,2191,288,7721,2023
SIC,TP,A   ,"Agricoltura, silvicoltura pesca                             ",0,0,19,3,22,2023
SIC,TP,A 01,"Coltivazioni agricole e produzione di prodotti animali, c...",0,0,17,1,18,2023
SIC,TP,A 02,Silvicoltura ed utilizzo di aree forestali                  ,0,0,0,0,0,2023
SIC,TP,A 03,Pesca e acquacoltura                                        ,0,0,2,2,4,2023
SIC,TP,B   ,Estrazione di minerali da cave e miniere                    ,0,0,0,0,0,2023
SIC,TP,B 05,Estrazione di carbone (esclusa torba)                       ,0,0,0,0,0,2023
SIC,TP,B 06,Estraz.di petrolio greggio e di gas naturale                ,0,0,0,0,0,2023
SIC,TP,B 07,Estrazione di minerali metalliferi                          ,0,0,0,0,0,2023
SIC,TP,B 08,Altre attività di estrazione di minerali da cave e miniere  ,0,0,0,0,0,2023
SIC,TP,B 09,Attività dei servizi di supporto all'estrazione             ,0,0,0,0,0,2023
SIC,TP,C   ,Attività manifatturiere                                     ,0,0,0,1,1,2023
SIC,TP,C 10,Industrie alimentari                                        ,0,0,0,0,0,2023
SIC,TP,C 11,Industria delle bevande                                     ,0,0,0,0,0,2023
SIC,TP,C 12,Industria del tabacco                                       ,0,0,0,0,0,2023
SIC,TP,C 13,Industrie tessili                                           ,0,0,0,0,0,2023
SIC,TP,C 14,Confezione di articoli di abbigliamento; confezione di ar...,0,0,0,0,0,2023
SIC,TP,C 15,Fabbricazione di articoli in pelle e simili                 ,0,0,0,0,0,2023
SIC,TP,C 16,Industria del legno e dei prodotti in legno e sughero (es...,0,0,0,0,0,2023
SIC,TP,C 17,Fabbricazione di carta e di prodotti di carta               ,0,0,0,0,0,2023
SIC,TP,C 18,Stampa e riproduzione di supporti registrati                ,0,0,0,0,0,2023
SIC,TP,C 19,Fabbricazione di coke e prodotti derivanti dalla raffinaz...,0,0,0,0,0,2023
SIC,TP,C 20,Fabbricazione di prodotti chimici                           ,0,0,0,0,0,2023
SIC,TP,C 21,Fabbricazione di prodotti farmaceutici di base e di prepa...,0,0,0,0,0,2023
SIC,TP,C 22,Fabbricazione di articoli in gomma e materie plastiche      ,0,0,0,0,0,2023
SIC,TP,C 23,Fabbricazione di altri prodotti della lavorazione di miner..,0,0,0,1,1,2023
SIC,TP,C 24,Metallurgia                                                 ,0,0,0,0,0,2023
SIC,TP,C 25,Fabbricazione di prodotti in metallo (esclusi macchinari ...,0,0,0,0,0,2023
SIC,TP,C 26,Fabbricazione di computer e prodotti di elettronica e ott...,0,0,0,0,0,2023
SIC,TP,C 27,Fabbricazione di apparecchiature elettriche ed apparecchi...,0,0,0,0,0,2023
SIC,TP,C 28,Fabbricazione di macchinari ed apparecchiature nca          ,0,0,0,0,0,2023
SIC,TP,C 29,"Fabbricazione di autoveicoli, rimorchi e semirimorchi       ",0,0,0,0,0,2023
SIC,TP,C 30,Fabbricazione di altri mezzi di trasporto                   ,0,0,0,0,0,2023
SIC,TP,C 31,Fabbricazione di mobili                                     ,0,0,0,0,0,2023
SIC,TP,C 32,Altre industrie manifatturiere                              ,0,0,0,0,0,2023
SIC,TP,C 33,"Riparazione, manutenzione ed installazione di macchine ed...",0,0,0,0,0,2023
SIC,TP,D   ,"Fornitura di energia elettrica, gas, vapore e aria condiz...",0,0,0,0,0,2023
SIC,TP,D 35,"Fornitura di energia elettrica, gas, vapore e aria condiz...",0,0,0,0,0,2023
SIC,TP,E   ,"Fornitura di acqua; reti fognarie, attività di gestione d...",0,0,0,0,0,2023
SIC,TP,E 36,"Raccolta, trattamento e fornitura di acqua                  ",0,0,0,0,0,2023
SIC,TP,E 37,Gestione delle reti fognarie                                ,0,0,0,0,0,2023
SIC,TP,E 38,"Attività di raccolta, trattamento e smaltimento dei rifiu...",0,0,0,0,0,2023
SIC,TP,E 39,Attività di risanamento e altri servizi di gestione dei r...,0,0,0,0,0,2023
SIC,TP,F   ,Costruzioni                                                 ,0,0,5,0,5,2023
SIC,TP,F 41,Costruzione di edifici                                      ,0,0,4,0,4,2023
SIC,TP,F 42,Ingegneria civile                                           ,0,0,1,0,1,2023
SIC,TP,F 43,Lavori di costruzione specializzati                         ,0,0,0,0,0,2023
SIC,TP,G   ,Commercio all'ingrosso e al dettaglio; riparazione di aut...,0,0,12,0,12,2023
SIC,TP,G 45,Commercio all'ingrosso e al dettaglio e riparazione di au...,0,0,1,0,1,2023
SIC,TP,G 46,Commercio all'ingrosso (escluso quello di autoveicoli e d...,0,0,2,0,2,2023
SIC,TP,G 47,Commercio al dettaglio (escluso quello di autoveicoli e d...,0,0,9,0,9,2023
SIC,TP,H   ,Trasporto e magazzinaggio                                   ,0,0,2,0,2,2023
SIC,TP,H 49,Trasporto terrestre e mediante condotte                     ,0,0,2,0,2,2023
SIC,TP,H 50,Trasporto marittimo e per vie d'acqua                       ,0,0,0,0,0,2023
SIC,TP,H 51,Trasporto aereo                                             ,0,0,0,0,0,2023
SIC,TP,H 52,Magazzinaggio e attività di supporto ai trasporti           ,0,0,0,0,0,2023
SIC,TP,H 53,Servizi postali e attività di corriere                      ,0,0,0,0,0,2023
SIC,TP,I   ,Attività dei servizi alloggio e ristorazione                ,0,0,2,0,2,2023
SIC,TP,I 55,Alloggio                                                    ,0,0,0,0,0,2023
SIC,TP,I 56,Attività dei servizi di ristorazione                        ,0,0,2,0,2,2023
SIC,TP,J   ,Servizi di informazione e comunicazione                     ,0,0,1,1,2,2023
SIC,TP,J 58,Attività editoriali                                         ,0,0,0,0,0,2023
SIC,TP,J 59,"Attività di produzione cinematografica, di video e di pro...",0,0,0,0,0,2023
SIC,TP,J 60,Attività di programmazione e trasmissione                   ,0,0,0,0,0,2023
SIC,TP,J 61,Telecomunicazioni                                           ,0,0,0,0,0,2023
SIC,TP,J 62,"Produzione di software, consulenza informatica e attività...",0,0,0,1,1,2023
SIC,TP,J 63,Attività dei servizi d'informazione e altri servizi infor...,0,0,1,0,1,2023
SIC,TP,K   ,Attività finanziarie e assicurative                         ,0,0,0,0,0,2023
SIC,TP,K 64,Attività di servizi finanziari (escluse le assicurazioni ...,0,0,0,0,0,2023
SIC,TP,K 65,"Assicurazioni, riassicurazioni e fondi pensione (escluse ...",0,0,0,0,0,2023
SIC,TP,K 66,Attività ausiliarie dei servizi finanziari e delle attivi...,0,0,0,0,0,2023
SIC,TP,L   ,Attivita' immobiliari                                       ,0,0,0,0,0,2023
SIC,TP,L 68,Attivita' immobiliari                                       ,0,0,0,0,0,2023
SIC,TP,M   ,"Attività professionali, scientifiche e tecniche             ",0,0,0,1,1,2023
SIC,TP,M 69,Attività legali e contabilità                               ,0,0,0,0,0,2023
SIC,TP,M 70,Attività di direzione aziendale e di consulenza gestional...,0,0,0,0,0,2023
SIC,TP,M 71,Attività degli studi di architettura e d'ingegneria; coll...,0,0,0,0,0,2023
SIC,TP,M 72,Ricerca scientifica e sviluppo                              ,0,0,0,0,0,2023
SIC,TP,M 73,Pubblicità e ricerche di mercato                            ,0,0,0,0,0,2023
SIC,TP,M 74,"Altre attività professionali, scientifiche e tecniche       ",0,0,0,1,1,2023
SIC,TP,M 75,Servizi veterinari                                          ,0,0,0,0,0,2023
SIC,TP,N   ,"Noleggio, agenzie di viaggio, servizi di supporto alle im...",0,0,0,0,0,2023
SIC,TP,N 77,Attività di noleggio e leasing operativo                    ,0,0,0,0,0,2023
SIC,TP,N 78,"Attività di ricerca, selezione, fornitura di personale      ",0,0,0,0,0,2023
SIC,TP,N 79,"Attività dei servizi delle agenzie di viaggio, dei tour o...",0,0,0,0,0,2023
SIC,TP,N 80,Servizi di vigilanza e investigazione                       ,0,0,0,0,0,2023
SIC,TP,N 81,Attività di servizi per edifici e paesaggio                 ,0,0,0,0,0,2023
SIC,TP,N 82,Attività di supporto per le funzioni d'ufficio e altri se...,0,0,0,0,0,2023
SIC,TP,O   ,Amministrazione pubblica e difesa; assicurazione sociale ...,0,0,0,0,0,2023
SIC,TP,O 84,Amministrazione pubblica e difesa; assicurazione sociale ...,0,0,0,0,0,2023
SIC,TP,P   ,Istruzione                                                  ,0,0,0,0,0,2023
SIC,TP,P 85,Istruzione                                                  ,0,0,0,0,0,2023
SIC,TP,Q   ,Sanita' e assistenza sociale                                ,0,0,0,1,1,2023
SIC,TP,Q 86,Assistenza sanitaria                                        ,0,0,0,0,0,2023
SIC,TP,Q 87,Servizi di assistenza sociale residenziale                  ,0,0,0,1,1,2023
SIC,TP,Q 88,Assistenza sociale non residenziale                         ,0,0,0,0,0,2023
SIC,TP,R   ,"Attività artistiche, sportive, di intrattenimento e diver...",0,0,0,0,0,2023
SIC,TP,R 90,"Attività creative, artistiche e di intrattenimento          ",0,0,0,0,0,2023
SIC,TP,R 91,"Attività di biblioteche, archivi, musei ed altre attività...",0,0,0,0,0,2023
SIC,TP,R 92,"Attività riguardanti le lotterie, le scommesse, le case d...",0,0,0,0,0,2023
SIC,TP,R 93,"Attività sportive, di intrattenimento e di divertimento     ",0,0,0,0,0,2023
SIC,TP,S   ,Altre attività di servizi                                   ,0,0,0,0,0,2023
SIC,TP,S 94,Attività di organizzazioni associative                      ,0,0,0,0,0,2023
SIC,TP,S 95,Riparazione di computer e di beni per uso personale e per...,0,0,0,0,0,2023
SIC,TP,S 96,Altre attività di servizi per la persona                    ,0,0,0,0,0,2023
SIC,TP,T   ,Attività di famiglie e convivenze come datori di lavoro p...,0,0,0,0,0,2023
SIC,TP,T 97,Attività di famiglie e convivenze come datori di lavoro p...,0,0,0,0,0,2023
SIC,TP,T 98,Produzione di beni e servizi indifferenziati per uso prop...,0,0,0,0,0,2023
SIC,TP,U   ,Organizzazioni ed organismi extraterritoriali               ,0,0,0,0,0,2023
SIC,TP,U 99,Organizzazioni ed organismi extraterritoriali               ,0,0,0,0,0,2023
SIC,TP,XX  ,Imprese non classificate                                    ,0,0,1,4,5,2023
SIC,TP,TOT ,TOTALE                                                      ,0,0,42,11,53,2023
SIC,PA,A   ,"Agricoltura, silvicoltura pesca                             ",0,0,0,0,0,2023
SIC,PA,A 01,"Coltivazioni agricole e produzione di prodotti animali, c...",0,0,0,0,0,2023
SIC,PA,A 02,Silvicoltura ed utilizzo di aree forestali                  ,0,0,0,0,0,2023
SIC,PA,A 03,Pesca e acquacoltura                                        ,0,0,0,0,0,2023
SIC,PA,B   ,Estrazione di minerali da cave e miniere                    ,0,0,0,0,0,2023
SIC,PA,B 05,Estrazione di carbone (esclusa torba)                       ,0,0,0,0,0,2023
SIC,PA,B 06,Estraz.di petrolio greggio e di gas naturale                ,0,0,0,0,0,2023
SIC,PA,B 07,Estrazione di minerali metalliferi                          ,0,0,0,0,0,2023
SIC,PA,B 08,Altre attività di estrazione di minerali da cave e miniere  ,0,0,0,0,0,2023
SIC,PA,B 09,Attività dei servizi di supporto all'estrazione             ,0,0,0,0,0,2023
SIC,PA,C   ,Attività manifatturiere                                     ,0,0,0,0,0,2023
SIC,PA,C 10,Industrie alimentari                                        ,0,0,0,0,0,2023
SIC,PA,C 11,Industria delle bevande                                     ,0,0,0,0,0,2023
SIC,PA,C 12,Industria del tabacco                                       ,0,0,0,0,0,2023
SIC,PA,C 13,Industrie tessili                                           ,0,0,0,0,0,2023
SIC,PA,C 14,Confezione di articoli di abbigliamento; confezione di ar...,0,0,0,0,0,2023
SIC,PA,C 15,Fabbricazione di articoli in pelle e simili                 ,0,0,0,0,0,2023
SIC,PA,C 16,Industria del legno e dei prodotti in legno e sughero (es...,0,0,0,0,0,2023
SIC,PA,C 17,Fabbricazione di carta e di prodotti di carta               ,0,0,0,0,0,2023
SIC,PA,C 18,Stampa e riproduzione di supporti registrati                ,0,0,0,0,0,2023
SIC,PA,C 19,Fabbricazione di coke e prodotti derivanti dalla raffinaz...,0,0,0,0,0,2023
SIC,PA,C 20,Fabbricazione di prodotti chimici                           ,0,0,0,0,0,2023
SIC,PA,C 21,Fabbricazione di prodotti farmaceutici di base e di prepa...,0,0,0,0,0,2023
SIC,PA,C 22,Fabbricazione di articoli in gomma e materie plastiche      ,0,0,0,0,0,2023
SIC,PA,C 23,Fabbricazione di altri prodotti della lavorazione di miner..,0,0,0,0,0,2023
SIC,PA,C 24,Metallurgia                                                 ,0,0,0,0,0,2023
SIC,PA,C 25,Fabbricazione di prodotti in metallo (esclusi macchinari ...,0,0,0,0,0,2023
SIC,PA,C 26,Fabbricazione di computer e prodotti di elettronica e ott...,0,0,0,0,0,2023
SIC,PA,C 27,Fabbricazione di apparecchiature elettriche ed apparecchi...,0,0,0,0,0,2023
SIC,PA,C 28,Fabbricazione di macchinari ed apparecchiature nca          ,0,0,0,0,0,2023
SIC,PA,C 29,"Fabbricazione di autoveicoli, rimorchi e semirimorchi       ",0,0,0,0,0,2023
SIC,PA,C 30,Fabbricazione di altri mezzi di trasporto                   ,0,0,0,0,0,2023
SIC,PA,C 31,Fabbricazione di mobili                                     ,0,0,0,0,0,2023
SIC,PA,C 32,Altre industrie manifatturiere                              ,0,0,0,0,0,2023
SIC,PA,C 33,"Riparazione, manutenzione ed installazione di macchine ed...",0,0,0,0,0,2023
SIC,PA,D   ,"Fornitura di energia elettrica, gas, vapore e aria condiz...",0,0,0,0,0,2023
SIC,PA,D 35,"Fornitura di energia elettrica, gas, vapore e aria condiz...",0,0,0,0,0,2023
SIC,PA,E   ,"Fornitura di acqua; reti fognarie, attività di gestione d...",0,0,0,0,0,2023
SIC,PA,E 36,"Raccolta, trattamento e fornitura di acqua                  ",0,0,0,0,0,2023
SIC,PA,E 37,Gestione delle reti fognarie                                ,0,0,0,0,0,2023
SIC,PA,E 38,"Attività di raccolta, trattamento e smaltimento dei rifiu...",0,0,0,0,0,2023
SIC,PA,E 39,Attività di risanamento e altri servizi di gestione dei r...,0,0,0,0,0,2023
SIC,PA,F   ,Costruzioni                                                 ,0,1,0,1,2,2023
SIC,PA,F 41,Costruzione di edifici                                      ,0,1,0,1,2,2023
SIC,PA,F 42,Ingegneria civile                                           ,0,0,0,0,0,2023
SIC,PA,F 43,Lavori di costruzione specializzati                         ,0,0,0,0,0,2023
SIC,PA,G   ,Commercio all'ingrosso e al dettaglio; riparazione di aut...,1,0,0,0,1,2023
SIC,PA,G 45,Commercio all'ingrosso e al dettaglio e riparazione di au...,0,0,0,0,0,2023
SIC,PA,G 46,Commercio all'ingrosso (escluso quello di autoveicoli e d...,0,0,0,0,0,2023
SIC,PA,G 47,Commercio al dettaglio (escluso quello di autoveicoli e d...,1,0,0,0,1,2023
SIC,PA,H   ,Trasporto e magazzinaggio                                   ,0,0,0,0,0,2023
SIC,PA,H 49,Trasporto terrestre e mediante condotte                     ,0,0,0,0,0,2023
SIC,PA,H 50,Trasporto marittimo e per vie d'acqua                       ,0,0,0,0,0,2023
SIC,PA,H 51,Trasporto aereo                                             ,0,0,0,0,0,2023
SIC,PA,H 52,Magazzinaggio e attività di supporto ai trasporti           ,0,0,0,0,0,2023
SIC,PA,H 53,Servizi postali e attività di corriere                      ,0,0,0,0,0,2023
SIC,PA,I   ,Attività dei servizi alloggio e ristorazione                ,0,0,0,0,0,2023
SIC,PA,I 55,Alloggio                                                    ,0,0,0,0,0,2023
SIC,PA,I 56,Attività dei servizi di ristorazione                        ,0,0,0,0,0,2023
SIC,PA,J   ,Servizi di informazione e comunicazione                     ,0,0,0,0,0,2023
SIC,PA,J 58,Attività editoriali                                         ,0,0,0,0,0,2023
SIC,PA,J 59,"Attività di produzione cinematografica, di video e di pro...",0,0,0,0,0,2023
SIC,PA,J 60,Attività di programmazione e trasmissione                   ,0,0,0,0,0,2023
SIC,PA,J 61,Telecomunicazioni                                           ,0,0,0,0,0,2023
SIC,PA,J 62,"Produzione di software, consulenza informatica e attività...",0,0,0,0,0,2023
SIC,PA,J 63,Attività dei servizi d'informazione e altri servizi infor...,0,0,0,0,0,2023
SIC,PA,K   ,Attività finanziarie e assicurative                         ,0,0,0,0,0,2023
SIC,PA,K 64,Attività di servizi finanziari (escluse le assicurazioni ...,0,0,0,0,0,2023
SIC,PA,K 65,"Assicurazioni, riassicurazioni e fondi pensione (escluse ...",0,0,0,0,0,2023
SIC,PA,K 66,Attività ausiliarie dei servizi finanziari e delle attivi...,0,0,0,0,0,2023
SIC,PA,L   ,Attivita' immobiliari                                       ,0,0,0,0,0,2023
SIC,PA,L 68,Attivita' immobiliari                                       ,0,0,0,0,0,2023
SIC,PA,M   ,"Attività professionali, scientifiche e tecniche             ",0,0,0,0,0,2023
SIC,PA,M 69,Attività legali e contabilità                               ,0,0,0,0,0,2023
SIC,PA,M 70,Attività di direzione aziendale e di consulenza gestional...,0,0,0,0,0,2023
SIC,PA,M 71,Attività degli studi di architettura e d'ingegneria; coll...,0,0,0,0,0,2023
SIC,PA,M 72,Ricerca scientifica e sviluppo                              ,0,0,0,0,0,2023
SIC,PA,M 73,Pubblicità e ricerche di mercato                            ,0,0,0,0,0,2023
SIC,PA,M 74,"Altre attività professionali, scientifiche e tecniche       ",0,0,0,0,0,2023
SIC,PA,M 75,Servizi veterinari                                          ,0,0,0,0,0,2023
SIC,PA,N   ,"Noleggio, agenzie di viaggio, servizi di supporto alle im...",0,0,0,2,2,2023
SIC,PA,N 77,Attività di noleggio e leasing operativo                    ,0,0,0,0,0,2023
SIC,PA,N 78,"Attività di ricerca, selezione, fornitura di personale      ",0,0,0,0,0,2023
SIC,PA,N 79,"Attività dei servizi delle agenzie di viaggio, dei tour o...",0,0,0,2,2,2023
SIC,PA,N 80,Servizi di vigilanza e investigazione                       ,0,0,0,0,0,2023
SIC,PA,N 81,Attività di servizi per edifici e paesaggio                 ,0,0,0,0,0,2023
SIC,PA,N 82,Attività di supporto per le funzioni d'ufficio e altri se...,0,0,0,0,0,2023
SIC,PA,O   ,Amministrazione pubblica e difesa; assicurazione sociale ...,0,0,0,0,0,2023
SIC,PA,O 84,Amministrazione pubblica e difesa; assicurazione sociale ...,0,0,0,0,0,2023
SIC,PA,P   ,Istruzione                                                  ,0,0,0,3,3,2023
SIC,PA,P 85,Istruzione                                                  ,0,0,0,3,3,2023
SIC,PA,Q   ,Sanita' e assistenza sociale                                ,0,0,0,0,0,2023
SIC,PA,Q 86,Assistenza sanitaria                                        ,0,0,0,0,0,2023
SIC,PA,Q 87,Servizi di assistenza sociale residenziale                  ,0,0,0,0,0,2023
SIC,PA,Q 88,Assistenza sociale non residenziale                         ,0,0,0,0,0,2023
SIC,PA,R   ,"Attività artistiche, sportive, di intrattenimento e diver...",0,0,0,1,1,2023
SIC,PA,R 90,"Attività creative, artistiche e di intrattenimento          ",0,0,0,1,1,2023
SIC,PA,R 91,"Attività di biblioteche, archivi, musei ed altre attività...",0,0,0,0,0,2023
SIC,PA,R 92,"Attività riguardanti le lotterie, le scommesse, le case d...",0,0,0,0,0,2023
SIC,PA,R 93,"Attività sportive, di intrattenimento e di divertimento     ",0,0,0,0,0,2023
SIC,PA,S   ,Altre attività di servizi                                   ,0,0,0,0,0,2023
SIC,PA,S 94,Attività di organizzazioni associative                      ,0,0,0,0,0,2023
SIC,PA,S 95,Riparazione di computer e di beni per uso personale e per...,0,0,0,0,0,2023
SIC,PA,S 96,Altre attività di servizi per la persona                    ,0,0,0,0,0,2023
SIC,PA,T   ,Attività di famiglie e convivenze come datori di lavoro p...,0,0,0,0,0,2023
SIC,PA,T 97,Attività di famiglie e convivenze come datori di lavoro p...,0,0,0,0,0,2023
SIC,PA,T 98,Produzione di beni e servizi indifferenziati per uso prop...,0,0,0,0,0,2023
SIC,PA,U   ,Organizzazioni ed organismi extraterritoriali               ,0,0,0,0,0,2023
SIC,PA,U 99,Organizzazioni ed organismi extraterritoriali               ,0,0,0,0,0,2023
SIC,PA,XX  ,Imprese non classificate                                    ,0,0,1,11,12,2023
SIC,PA,TOT ,TOTALE                                                      ,1,1,1,18,21,2023
SIC,ME,A   ,"Agricoltura, silvicoltura pesca                             ",9,0,2,2,13,2023
SIC,ME,A 01,"Coltivazioni agricole e produzione di prodotti animali, c...",8,0,1,1,10,2023
SIC,ME,A 02,Silvicoltura ed utilizzo di aree forestali                  ,1,0,1,0,2,2023
SIC,ME,A 03,Pesca e acquacoltura                                        ,0,0,0,1,1,2023
SIC,ME,B   ,Estrazione di minerali da cave e miniere                    ,3,0,0,0,3,2023
SIC,ME,B 05,Estrazione di carbone (esclusa torba)                       ,0,0,0,0,0,2023
SIC,ME,B 06,Estraz.di petrolio greggio e di gas naturale                ,0,0,0,0,0,2023
SIC,ME,B 07,Estrazione di minerali metalliferi                          ,1,0,0,0,1,2023
SIC,ME,B 08,Altre attività di estrazione di minerali da cave e miniere  ,2,0,0,0,2,2023
SIC,ME,B 09,Attività dei servizi di supporto all'estrazione             ,0,0,0,0,0,2023
SIC,ME,C   ,Attività manifatturiere                                     ,109,0,0,0,109,2023
SIC,ME,C 10,Industrie alimentari                                        ,15,0,0,0,15,2023
SIC,ME,C 11,Industria delle bevande                                     ,2,0,0,0,2,2023
SIC,ME,C 12,Industria del tabacco                                       ,0,0,0,0,0,2023
SIC,ME,C 13,Industrie tessili                                           ,1,0,0,0,1,2023
SIC,ME,C 14,Confezione di articoli di abbigliamento; confezione di ar...,5,0,0,0,5,2023
SIC,ME,C 15,Fabbricazione di articoli in pelle e simili                 ,0,0,0,0,0,2023
SIC,ME,C 16,Industria del legno e dei prodotti in legno e sughero (es...,4,0,0,0,4,2023
SIC,ME,C 17,Fabbricazione di carta e di prodotti di carta               ,1,0,0,0,1,2023
SIC,ME,C 18,Stampa e riproduzione di supporti registrati                ,2,0,0,0,2,2023
SIC,ME,C 19,Fabbricazione di coke e prodotti derivanti dalla raffinaz...,1,0,0,0,1,2023
SIC,ME,C 20,Fabbricazione di prodotti chimici                           ,1,0,0,0,1,2023
SIC,ME,C 21,Fabbricazione di prodotti farmaceutici di base e di prepa...,0,0,0,0,0,2023
SIC,ME,C 22,Fabbricazione di articoli in gomma e materie plastiche      ,2,0,0,0,2,2023
SIC,ME,C 23,Fabbricazione di altri prodotti della lavorazione di miner..,23,0,0,0,23,2023
SIC,ME,C 24,Metallurgia                                                 ,1,0,0,0,1,2023
SIC,ME,C 25,Fabbricazione di prodotti in metallo (esclusi macchinari ...,19,0,0,0,19,2023
SIC,ME,C 26,Fabbricazione di computer e prodotti di elettronica e ott...,3,0,0,0,3,2023
SIC,ME,C 27,Fabbricazione di apparecchiature elettriche ed apparecchi...,5,0,0,0,5,2023
SIC,ME,C 28,Fabbricazione di macchinari ed apparecchiature nca          ,4,0,0,0,4,2023
SIC,ME,C 29,"Fabbricazione di autoveicoli, rimorchi e semirimorchi       ",0,0,0,0,0,2023
SIC,ME,C 30,Fabbricazione di altri mezzi di trasporto                   ,7,0,0,0,7,2023
SIC,ME,C 31,Fabbricazione di mobili                                     ,5,0,0,0,5,2023
SIC,ME,C 32,Altre industrie manifatturiere                              ,1,0,0,0,1,2023
SIC,ME,C 33,"Riparazione, manutenzione ed installazione di macchine ed...",7,0,0,0,7,2023
SIC,ME,D   ,"Fornitura di energia elettrica, gas, vapore e aria condiz...",0,0,0,0,0,2023
SIC,ME,D 35,"Fornitura di energia elettrica, gas, vapore e aria condiz...",0,0,0,0,0,2023
SIC,ME,E   ,"Fornitura di acqua; reti fognarie, attività di gestione d...",5,0,0,0,5,2023
SIC,ME,E 36,"Raccolta, trattamento e fornitura di acqua                  ",0,0,0,0,0,2023
SIC,ME,E 37,Gestione delle reti fognarie                                ,1,0,0,0,1,2023
SIC,ME,E 38,"Attività di raccolta, trattamento e smaltimento dei rifiu...",3,0,0,0,3,2023
SIC,ME,E 39,Attività di risanamento e altri servizi di gestione dei r...,1,0,0,0,1,2023
SIC,ME,F   ,Costruzioni                                                 ,196,0,0,23,219,2023
SIC,ME,F 41,Costruzione di edifici                                      ,155,0,0,14,169,2023
SIC,ME,F 42,Ingegneria civile                                           ,3,0,0,4,7,2023
SIC,ME,F 43,Lavori di costruzione specializzati                         ,38,0,0,5,43,2023
SIC,ME,G   ,Commercio all'ingrosso e al dettaglio; riparazione di aut...,261,0,1,1,263,2023
SIC,ME,G 45,Commercio all'ingrosso e al dettaglio e riparazione di au...,25,0,0,0,25,2023
SIC,ME,G 46,Commercio all'ingrosso (escluso quello di autoveicoli e d...,105,0,1,0,106,2023
SIC,ME,G 47,Commercio al dettaglio (escluso quello di autoveicoli e d...,131,0,0,1,132,2023
SIC,ME,H   ,Trasporto e magazzinaggio                                   ,19,0,0,1,20,2023
SIC,ME,H 49,Trasporto terrestre e mediante condotte                     ,8,0,0,0,8,2023
SIC,ME,H 50,Trasporto marittimo e per vie d'acqua                       ,3,0,0,0,3,2023
SIC,ME,H 51,Trasporto aereo                                             ,0,0,0,0,0,2023
SIC,ME,H 52,Magazzinaggio e attività di supporto ai trasporti           ,7,0,0,1,8,2023
SIC,ME,H 53,Servizi postali e attività di corriere                      ,1,0,0,0,1,2023
SIC,ME,I   ,Attività dei servizi alloggio e ristorazione                ,60,0,0,2,62,2023
SIC,ME,I 55,Alloggio                                                    ,5,0,0,0,5,2023
SIC,ME,I 56,Attività dei servizi di ristorazione                        ,55,0,0,2,57,2023
SIC,ME,J   ,Servizi di informazione e comunicazione                     ,37,0,0,1,38,2023
SIC,ME,J 58,Attività editoriali                                         ,4,0,0,0,4,2023
SIC,ME,J 59,"Attività di produzione cinematografica, di video e di pro...",3,0,0,0,3,2023
SIC,ME,J 60,Attività di programmazione e trasmissione                   ,0,0,0,0,0,2023
SIC,ME,J 61,Telecomunicazioni                                           ,0,0,0,0,0,2023
SIC,ME,J 62,"Produzione di software, consulenza informatica e attività...",15,0,0,0,15,2023
SIC,ME,J 63,Attività dei servizi d'informazione e altri servizi infor...,15,0,0,1,16,2023
SIC,ME,K   ,Attività finanziarie e assicurative                         ,16,0,0,0,16,2023
SIC,ME,K 64,Attività di servizi finanziari (escluse le assicurazioni ...,2,0,0,0,2,2023
SIC,ME,K 65,"Assicurazioni, riassicurazioni e fondi pensione (escluse ...",1,0,0,0,1,2023
SIC,ME,K 66,Attività ausiliarie dei servizi finanziari e delle attivi...,13,0,0,0,13,2023
SIC,ME,L   ,Attivita' immobiliari                                       ,35,0,0,0,35,2023
SIC,ME,L 68,Attivita' immobiliari                                       ,35,0,0,0,35,2023
SIC,ME,M   ,"Attività professionali, scientifiche e tecniche             ",24,0,0,1,25,2023
SIC,ME,M 69,Attività legali e contabilità                               ,3,0,0,0,3,2023
SIC,ME,M 70,Attività di direzione aziendale e di consulenza gestional...,4,0,0,1,5,2023
SIC,ME,M 71,Attività degli studi di architettura e d'ingegneria; coll...,6,0,0,0,6,2023
SIC,ME,M 72,Ricerca scientifica e sviluppo                              ,1,0,0,0,1,2023
SIC,ME,M 73,Pubblicità e ricerche di mercato                            ,4,0,0,0,4,2023
SIC,ME,M 74,"Altre attività professionali, scientifiche e tecniche       ",6,0,0,0,6,2023
SIC,ME,M 75,Servizi veterinari                                          ,0,0,0,0,0,2023
SIC,ME,N   ,"Noleggio, agenzie di viaggio, servizi di supporto alle im...",23,0,0,1,24,2023
SIC,ME,N 77,Attività di noleggio e leasing operativo                    ,7,0,0,1,8,2023
SIC,ME,N 78,"Attività di ricerca, selezione, fornitura di personale      ",0,0,0,0,0,2023
SIC,ME,N 79,"Attività dei servizi delle agenzie di viaggio, dei tour o...",5,0,0,0,5,2023
SIC,ME,N 80,Servizi di vigilanza e investigazione                       ,0,0,0,0,0,2023
SIC,ME,N 81,Attività di servizi per edifici e paesaggio                 ,5,0,0,0,5,2023
SIC,ME,N 82,Attività di supporto per le funzioni d'ufficio e altri se...,6,0,0,0,6,2023
SIC,ME,O   ,Amministrazione pubblica e difesa; assicurazione sociale ...,0,0,0,0,0,2023
SIC,ME,O 84,Amministrazione pubblica e difesa; assicurazione sociale ...,0,0,0,0,0,2023
SIC,ME,P   ,Istruzione                                                  ,2,0,0,0,2,2023
SIC,ME,P 85,Istruzione                                                  ,2,0,0,0,2,2023
SIC,ME,Q   ,Sanita' e assistenza sociale                                ,16,0,0,1,17,2023
SIC,ME,Q 86,Assistenza sanitaria                                        ,12,0,0,0,12,2023
SIC,ME,Q 87,Servizi di assistenza sociale residenziale                  ,1,0,0,0,1,2023
SIC,ME,Q 88,Assistenza sociale non residenziale                         ,3,0,0,1,4,2023
SIC,ME,R   ,"Attività artistiche, sportive, di intrattenimento e diver...",17,0,0,3,20,2023
SIC,ME,R 90,"Attività creative, artistiche e di intrattenimento          ",5,0,0,3,8,2023
SIC,ME,R 91,"Attività di biblioteche, archivi, musei ed altre attività...",1,0,0,0,1,2023
SIC,ME,R 92,"Attività riguardanti le lotterie, le scommesse, le case d...",2,0,0,0,2,2023
SIC,ME,R 93,"Attività sportive, di intrattenimento e di divertimento     ",9,0,0,0,9,2023
SIC,ME,S   ,Altre attività di servizi                                   ,9,0,0,0,9,2023
SIC,ME,S 94,Attività di organizzazioni associative                      ,0,0,0,0,0,2023
SIC,ME,S 95,Riparazione di computer e di beni per uso personale e per...,2,0,0,0,2,2023
SIC,ME,S 96,Altre attività di servizi per la persona                    ,7,0,0,0,7,2023
SIC,ME,T   ,Attività di famiglie e convivenze come datori di lavoro p...,0,0,0,0,0,2023
SIC,ME,T 97,Attività di famiglie e convivenze come datori di lavoro p...,0,0,0,0,0,2023
SIC,ME,T 98,Produzione di beni e servizi indifferenziati per uso prop...,0,0,0,0,0,2023
SIC,ME,U   ,Organizzazioni ed organismi extraterritoriali               ,0,0,0,0,0,2023
SIC,ME,U 99,Organizzazioni ed organismi extraterritoriali               ,0,0,0,0,0,2023
SIC,ME,XX  ,Imprese non classificate                                    ,378,0,0,33,411,2023
SIC,ME,TOT ,TOTALE                                                      ,1219,0,3,69,1291,2023
SIC,AG,A   ,"Agricoltura, silvicoltura pesca                             ",4,0,0,1,5,2023
SIC,AG,A 01,"Coltivazioni agricole e produzione di prodotti animali, c...",4,0,0,0,4,2023
SIC,AG,A 02,Silvicoltura ed utilizzo di aree forestali                  ,0,0,0,1,1,2023
SIC,AG,A 03,Pesca e acquacoltura                                        ,0,0,0,0,0,2023
SIC,AG,B   ,Estrazione di minerali da cave e miniere                    ,0,0,0,0,0,2023
SIC,AG,B 05,Estrazione di carbone (esclusa torba)                       ,0,0,0,0,0,2023
SIC,AG,B 06,Estraz.di petrolio greggio e di gas naturale                ,0,0,0,0,0,2023
SIC,AG,B 07,Estrazione di minerali metalliferi                          ,0,0,0,0,0,2023
SIC,AG,B 08,Altre attività di estrazione di minerali da cave e miniere  ,0,0,0,0,0,2023
SIC,AG,B 09,Attività dei servizi di supporto all'estrazione             ,0,0,0,0,0,2023
SIC,AG,C   ,Attività manifatturiere                                     ,34,0,0,0,34,2023
SIC,AG,C 10,Industrie alimentari                                        ,6,0,0,0,6,2023
SIC,AG,C 11,Industria delle bevande                                     ,0,0,0,0,0,2023
SIC,AG,C 12,Industria del tabacco                                       ,0,0,0,0,0,2023
SIC,AG,C 13,Industrie tessili                                           ,0,0,0,0,0,2023
SIC,AG,C 14,Confezione di articoli di abbigliamento; confezione di ar...,1,0,0,0,1,2023
SIC,AG,C 15,Fabbricazione di articoli in pelle e simili                 ,0,0,0,0,0,2023
SIC,AG,C 16,Industria del legno e dei prodotti in legno e sughero (es...,3,0,0,0,3,2023
SIC,AG,C 17,Fabbricazione di carta e di prodotti di carta               ,2,0,0,0,2,2023
SIC,AG,C 18,Stampa e riproduzione di supporti registrati                ,0,0,0,0,0,2023
SIC,AG,C 19,Fabbricazione di coke e prodotti derivanti dalla raffinaz...,0,0,0,0,0,2023
SIC,AG,C 20,Fabbricazione di prodotti chimici                           ,1,0,0,0,1,2023
SIC,AG,C 21,Fabbricazione di prodotti farmaceutici di base e di prepa...,0,0,0,0,0,2023
SIC,AG,C 22,Fabbricazione di articoli in gomma e materie plastiche      ,0,0,0,0,0,2023
SIC,AG,C 23,Fabbricazione di altri prodotti della lavorazione di miner..,8,0,0,0,8,2023
SIC,AG,C 24,Metallurgia                                                 ,0,0,0,0,0,2023
SIC,AG,C 25,Fabbricazione di prodotti in metallo (esclusi macchinari ...,5,0,0,0,5,2023
SIC,AG,C 26,Fabbricazione di computer e prodotti di elettronica e ott...,0,0,0,0,0,2023
SIC,AG,C 27,Fabbricazione di apparecchiature elettriche ed apparecchi...,2,0,0,0,2,2023
SIC,AG,C 28,Fabbricazione di macchinari ed apparecchiature nca          ,1,0,0,0,1,2023
SIC,AG,C 29,"Fabbricazione di autoveicoli, rimorchi e semirimorchi       ",0,0,0,0,0,2023
SIC,AG,C 30,Fabbricazione di altri mezzi di trasporto                   ,0,0,0,0,0,2023
SIC,AG,C 31,Fabbricazione di mobili                                     ,1,0,0,0,1,2023
SIC,AG,C 32,Altre industrie manifatturiere                              ,3,0,0,0,3,2023
SIC,AG,C 33,"Riparazione, manutenzione ed installazione di macchine ed...",1,0,0,0,1,2023
SIC,AG,D   ,"Fornitura di energia elettrica, gas, vapore e aria condiz...",2,0,0,0,2,2023
SIC,AG,D 35,"Fornitura di energia elettrica, gas, vapore e aria condiz...",2,0,0,0,2,2023
SIC,AG,E   ,"Fornitura di acqua; reti fognarie, attività di gestione d...",0,0,0,0,0,2023
SIC,AG,E 36,"Raccolta, trattamento e fornitura di acqua                  ",0,0,0,0,0,2023
SIC,AG,E 37,Gestione delle reti fognarie                                ,0,0,0,0,0,2023
SIC,AG,E 38,"Attività di raccolta, trattamento e smaltimento dei rifiu...",0,0,0,0,0,2023
SIC,AG,E 39,Attività di risanamento e altri servizi di gestione dei r...,0,0,0,0,0,2023
SIC,AG,F   ,Costruzioni                                                 ,111,0,1,14,126,2023
SIC,AG,F 41,Costruzione di edifici                                      ,77,0,1,6,84,2023
SIC,AG,F 42,Ingegneria civile                                           ,17,0,0,6,23,2023
SIC,AG,F 43,Lavori di costruzione specializzati                         ,17,0,0,2,19,2023
SIC,AG,G   ,Commercio all'ingrosso e al dettaglio; riparazione di aut...,106,0,0,1,107,2023
SIC,AG,G 45,Commercio all'ingrosso e al dettaglio e riparazione di au...,7,0,0,0,7,2023
SIC,AG,G 46,Commercio all'ingrosso (escluso quello di autoveicoli e d...,44,0,0,1,45,2023
SIC,AG,G 47,Commercio al dettaglio (escluso quello di autoveicoli e d...,55,0,0,0,55,2023
SIC,AG,H   ,Trasporto e magazzinaggio                                   ,9,0,0,0,9,2023
SIC,AG,H 49,Trasporto terrestre e mediante condotte                     ,7,0,0,0,7,2023
SIC,AG,H 50,Trasporto marittimo e per vie d'acqua                       ,0,0,0,0,0,2023
SIC,AG,H 51,Trasporto aereo                                             ,0,0,0,0,0,2023
SIC,AG,H 52,Magazzinaggio e attività di supporto ai trasporti           ,2,0,0,0,2,2023
SIC,AG,H 53,Servizi postali e attività di corriere                      ,0,0,0,0,0,2023
SIC,AG,I   ,Attività dei servizi alloggio e ristorazione                ,22,0,0,0,22,2023
SIC,AG,I 55,Alloggio                                                    ,3,0,0,0,3,2023
SIC,AG,I 56,Attività dei servizi di ristorazione                        ,19,0,0,0,19,2023
SIC,AG,J   ,Servizi di informazione e comunicazione                     ,6,0,0,0,6,2023
SIC,AG,J 58,Attività editoriali                                         ,1,0,0,0,1,2023
SIC,AG,J 59,"Attività di produzione cinematografica, di video e di pro...",0,0,0,0,0,2023
SIC,AG,J 60,Attività di programmazione e trasmissione                   ,0,0,0,0,0,2023
SIC,AG,J 61,Telecomunicazioni                                           ,1,0,0,0,1,2023
SIC,AG,J 62,"Produzione di software, consulenza informatica e attività...",1,0,0,0,1,2023
SIC,AG,J 63,Attività dei servizi d'informazione e altri servizi infor...,3,0,0,0,3,2023
SIC,AG,K   ,Attività finanziarie e assicurative                         ,4,0,0,0,4,2023
SIC,AG,K 64,Attività di servizi finanziari (escluse le assicurazioni ...,0,0,0,0,0,2023
SIC,AG,K 65,"Assicurazioni, riassicurazioni e fondi pensione (escluse ...",0,0,0,0,0,2023
SIC,AG,K 66,Attività ausiliarie dei servizi finanziari e delle attivi...,4,0,0,0,4,2023
SIC,AG,L   ,Attivita' immobiliari                                       ,4,0,0,0,4,2023
SIC,AG,L 68,Attivita' immobiliari                                       ,4,0,0,0,4,2023
SIC,AG,M   ,"Attività professionali, scientifiche e tecniche             ",12,0,0,1,13,2023
SIC,AG,M 69,Attività legali e contabilità                               ,1,0,0,0,1,2023
SIC,AG,M 70,Attività di direzione aziendale e di consulenza gestional...,3,0,0,1,4,2023
SIC,AG,M 71,Attività degli studi di architettura e d'ingegneria; coll...,3,0,0,0,3,2023
SIC,AG,M 72,Ricerca scientifica e sviluppo                              ,0,0,0,0,0,2023
SIC,AG,M 73,Pubblicità e ricerche di mercato                            ,1,0,0,0,1,2023
SIC,AG,M 74,"Altre attività professionali, scientifiche e tecniche       ",4,0,0,0,4,2023
SIC,AG,M 75,Servizi veterinari                                          ,0,0,0,0,0,2023
SIC,AG,N   ,"Noleggio, agenzie di viaggio, servizi di supporto alle im...",11,0,0,1,12,2023
SIC,AG,N 77,Attività di noleggio e leasing operativo                    ,4,0,0,0,4,2023
SIC,AG,N 78,"Attività di ricerca, selezione, fornitura di personale      ",0,0,0,0,0,2023
SIC,AG,N 79,"Attività dei servizi delle agenzie di viaggio, dei tour o...",3,0,0,0,3,2023
SIC,AG,N 80,Servizi di vigilanza e investigazione                       ,0,0,0,0,0,2023
SIC,AG,N 81,Attività di servizi per edifici e paesaggio                 ,1,0,0,0,1,2023
SIC,AG,N 82,Attività di supporto per le funzioni d'ufficio e altri se...,3,0,0,1,4,2023
SIC,AG,O   ,Amministrazione pubblica e difesa; assicurazione sociale ...,0,0,0,0,0,2023
SIC,AG,O 84,Amministrazione pubblica e difesa; assicurazione sociale ...,0,0,0,0,0,2023
SIC,AG,P   ,Istruzione                                                  ,4,0,0,0,4,2023
SIC,AG,P 85,Istruzione                                                  ,4,0,0,0,4,2023
SIC,AG,Q   ,Sanita' e assistenza sociale                                ,4,0,0,0,4,2023
SIC,AG,Q 86,Assistenza sanitaria                                        ,3,0,0,0,3,2023
SIC,AG,Q 87,Servizi di assistenza sociale residenziale                  ,0,0,0,0,0,2023
SIC,AG,Q 88,Assistenza sociale non residenziale                         ,1,0,0,0,1,2023
SIC,AG,R   ,"Attività artistiche, sportive, di intrattenimento e diver...",4,0,0,0,4,2023
SIC,AG,R 90,"Attività creative, artistiche e di intrattenimento          ",1,0,0,0,1,2023
SIC,AG,R 91,"Attività di biblioteche, archivi, musei ed altre attività...",0,0,0,0,0,2023
SIC,AG,R 92,"Attività riguardanti le lotterie, le scommesse, le case d...",1,0,0,0,1,2023
SIC,AG,R 93,"Attività sportive, di intrattenimento e di divertimento     ",2,0,0,0,2,2023
SIC,AG,S   ,Altre attività di servizi                                   ,2,0,0,0,2,2023
SIC,AG,S 94,Attività di organizzazioni associative                      ,0,0,0,0,0,2023
SIC,AG,S 95,Riparazione di computer e di beni per uso personale e per...,1,0,0,0,1,2023
SIC,AG,S 96,Altre attività di servizi per la persona                    ,1,0,0,0,1,2023
SIC,AG,T   ,Attività di famiglie e convivenze come datori di lavoro p...,0,0,0,0,0,2023
SIC,AG,T 97,Attività di famiglie e convivenze come datori di lavoro p...,0,0,0,0,0,2023
SIC,AG,T 98,Produzione di beni e servizi indifferenziati per uso prop...,0,0,0,0,0,2023
SIC,AG,U   ,Organizzazioni ed organismi extraterritoriali               ,0,0,0,0,0,2023
SIC,AG,U 99,Organizzazioni ed organismi extraterritoriali               ,0,0,0,0,0,2023
SIC,AG,XX  ,Imprese non classificate                                    ,105,0,0,14,119,2023
SIC,AG,TOT ,TOTALE                                                      ,444,0,1,32,477,2023
SIC,CL,A   ,"Agricoltura, silvicoltura pesca                             ",0,0,43,0,43,2023
SIC,CL,A 01,"Coltivazioni agricole e produzione di prodotti animali, c...",0,0,42,0,42,2023
SIC,CL,A 02,Silvicoltura ed utilizzo di aree forestali                  ,0,0,1,0,1,2023
SIC,CL,A 03,Pesca e acquacoltura                                        ,0,0,0,0,0,2023
SIC,CL,B   ,Estrazione di minerali da cave e miniere                    ,0,0,5,0,5,2023
SIC,CL,B 05,Estrazione di carbone (esclusa torba)                       ,0,0,0,0,0,2023
SIC,CL,B 06,Estraz.di petrolio greggio e di gas naturale                ,0,0,0,0,0,2023
SIC,CL,B 07,Estrazione di minerali metalliferi                          ,0,0,0,0,0,2023
SIC,CL,B 08,Altre attività di estrazione di minerali da cave e miniere  ,0,0,5,0,5,2023
SIC,CL,B 09,Attività dei servizi di supporto all'estrazione             ,0,0,0,0,0,2023
SIC,CL,C   ,Attività manifatturiere                                     ,0,0,22,0,22,2023
SIC,CL,C 10,Industrie alimentari                                        ,0,0,2,0,2,2023
SIC,CL,C 11,Industria delle bevande                                     ,0,0,0,0,0,2023
SIC,CL,C 12,Industria del tabacco                                       ,0,0,0,0,0,2023
SIC,CL,C 13,Industrie tessili                                           ,0,0,1,0,1,2023
SIC,CL,C 14,Confezione di articoli di abbigliamento; confezione di ar...,0,0,3,0,3,2023
SIC,CL,C 15,Fabbricazione di articoli in pelle e simili                 ,0,0,0,0,0,2023
SIC,CL,C 16,Industria del legno e dei prodotti in legno e sughero (es...,0,0,4,0,4,2023
SIC,CL,C 17,Fabbricazione di carta e di prodotti di carta               ,0,0,0,0,0,2023
SIC,CL,C 18,Stampa e riproduzione di supporti registrati                ,0,0,0,0,0,2023
SIC,CL,C 19,Fabbricazione di coke e prodotti derivanti dalla raffinaz...,0,0,0,0,0,2023
SIC,CL,C 20,Fabbricazione di prodotti chimici                           ,0,0,1,0,1,2023
SIC,CL,C 21,Fabbricazione di prodotti farmaceutici di base e di prepa...,0,0,0,0,0,2023
SIC,CL,C 22,Fabbricazione di articoli in gomma e materie plastiche      ,0,0,0,0,0,2023
SIC,CL,C 23,Fabbricazione di altri prodotti della lavorazione di miner..,0,0,6,0,6,2023
SIC,CL,C 24,Metallurgia                                                 ,0,0,0,0,0,2023
SIC,CL,C 25,Fabbricazione di prodotti in metallo (esclusi macchinari ...,0,0,2,0,2,2023
SIC,CL,C 26,Fabbricazione di computer e prodotti di elettronica e ott...,0,0,0,0,0,2023
SIC,CL,C 27,Fabbricazione di apparecchiature elettriche ed apparecchi...,0,0,0,0,0,2023
SIC,CL,C 28,Fabbricazione di macchinari ed apparecchiature nca          ,0,0,0,0,0,2023
SIC,CL,C 29,"Fabbricazione di autoveicoli, rimorchi e semirimorchi       ",0,0,0,0,0,2023
SIC,CL,C 30,Fabbricazione di altri mezzi di trasporto                   ,0,0,1,0,1,2023
SIC,CL,C 31,Fabbricazione di mobili                                     ,0,0,0,0,0,2023
SIC,CL,C 32,Altre industrie manifatturiere                              ,0,0,2,0,2,2023
SIC,CL,C 33,"Riparazione, manutenzione ed installazione di macchine ed...",0,0,0,0,0,2023
SIC,CL,D   ,"Fornitura di energia elettrica, gas, vapore e aria condiz...",0,0,0,0,0,2023
SIC,CL,D 35,"Fornitura di energia elettrica, gas, vapore e aria condiz...",0,0,0,0,0,2023
SIC,CL,E   ,"Fornitura di acqua; reti fognarie, attività di gestione d...",0,0,0,0,0,2023
SIC,CL,E 36,"Raccolta, trattamento e fornitura di acqua                  ",0,0,0,0,0,2023
SIC,CL,E 37,Gestione delle reti fognarie                                ,0,0,0,0,0,2023
SIC,CL,E 38,"Attività di raccolta, trattamento e smaltimento dei rifiu...",0,0,0,0,0,2023
SIC,CL,E 39,Attività di risanamento e altri servizi di gestione dei r...,0,0,0,0,0,2023
SIC,CL,F   ,Costruzioni                                                 ,0,0,17,0,17,2023
SIC,CL,F 41,Costruzione di edifici                                      ,0,0,13,0,13,2023
SIC,CL,F 42,Ingegneria civile                                           ,0,0,0,0,0,2023
SIC,CL,F 43,Lavori di costruzione specializzati                         ,0,0,4,0,4,2023
SIC,CL,G   ,Commercio all'ingrosso e al dettaglio; riparazione di aut...,0,0,70,0,70,2023
SIC,CL,G 45,Commercio all'ingrosso e al dettaglio e riparazione di au...,0,0,3,0,3,2023
SIC,CL,G 46,Commercio all'ingrosso (escluso quello di autoveicoli e d...,0,0,8,0,8,2023
SIC,CL,G 47,Commercio al dettaglio (escluso quello di autoveicoli e d...,0,0,59,0,59,2023
SIC,CL,H   ,Trasporto e magazzinaggio                                   ,0,0,10,0,10,2023
SIC,CL,H 49,Trasporto terrestre e mediante condotte                     ,0,0,9,0,9,2023
SIC,CL,H 50,Trasporto marittimo e per vie d'acqua                       ,0,0,0,0,0,2023
SIC,CL,H 51,Trasporto aereo                                             ,0,0,0,0,0,2023
SIC,CL,H 52,Magazzinaggio e attività di supporto ai trasporti           ,0,0,1,0,1,2023
SIC,CL,H 53,Servizi postali e attività di corriere                      ,0,0,0,0,0,2023
SIC,CL,I   ,Attività dei servizi alloggio e ristorazione                ,0,0,3,0,3,2023
SIC,CL,I 55,Alloggio                                                    ,0,0,0,0,0,2023
SIC,CL,I 56,Attività dei servizi di ristorazione                        ,0,0,3,0,3,2023
SIC,CL,J   ,Servizi di informazione e comunicazione                     ,0,0,1,0,1,2023
SIC,CL,J 58,Attività editoriali                                         ,0,0,0,0,0,2023
SIC,CL,J 59,"Attività di produzione cinematografica, di video e di pro...",0,0,0,0,0,2023
SIC,CL,J 60,Attività di programmazione e trasmissione                   ,0,0,1,0,1,2023
SIC,CL,J 61,Telecomunicazioni                                           ,0,0,0,0,0,2023
SIC,CL,J 62,"Produzione di software, consulenza informatica e attività...",0,0,0,0,0,2023
SIC,CL,J 63,Attività dei servizi d'informazione e altri servizi infor...,0,0,0,0,0,2023
SIC,CL,K   ,Attività finanziarie e assicurative                         ,0,0,0,0,0,2023
SIC,CL,K 64,Attività di servizi finanziari (escluse le assicurazioni ...,0,0,0,0,0,2023
SIC,CL,K 65,"Assicurazioni, riassicurazioni e fondi pensione (escluse ...",0,0,0,0,0,2023
SIC,CL,K 66,Attività ausiliarie dei servizi finanziari e delle attivi...,0,0,0,0,0,2023
SIC,CL,L   ,Attivita' immobiliari                                       ,0,0,0,0,0,2023
SIC,CL,L 68,Attivita' immobiliari                                       ,0,0,0,0,0,2023
SIC,CL,M   ,"Attività professionali, scientifiche e tecniche             ",0,0,1,0,1,2023
SIC,CL,M 69,Attività legali e contabilità                               ,0,0,0,0,0,2023
SIC,CL,M 70,Attività di direzione aziendale e di consulenza gestional...,0,0,0,0,0,2023
SIC,CL,M 71,Attività degli studi di architettura e d'ingegneria; coll...,0,0,0,0,0,2023
SIC,CL,M 72,Ricerca scientifica e sviluppo                              ,0,0,0,0,0,2023
SIC,CL,M 73,Pubblicità e ricerche di mercato                            ,0,0,0,0,0,2023
SIC,CL,M 74,"Altre attività professionali, scientifiche e tecniche       ",0,0,1,0,1,2023
SIC,CL,M 75,Servizi veterinari                                          ,0,0,0,0,0,2023
SIC,CL,N   ,"Noleggio, agenzie di viaggio, servizi di supporto alle im...",0,0,1,0,1,2023
SIC,CL,N 77,Attività di noleggio e leasing operativo                    ,0,0,0,0,0,2023
SIC,CL,N 78,"Attività di ricerca, selezione, fornitura di personale      ",0,0,0,0,0,2023
SIC,CL,N 79,"Attività dei servizi delle agenzie di viaggio, dei tour o...",0,0,0,0,0,2023
SIC,CL,N 80,Servizi di vigilanza e investigazione                       ,0,0,0,0,0,2023
SIC,CL,N 81,Attività di servizi per edifici e paesaggio                 ,0,0,1,0,1,2023
SIC,CL,N 82,Attività di supporto per le funzioni d'ufficio e altri se...,0,0,0,0,0,2023
SIC,CL,O   ,Amministrazione pubblica e difesa; assicurazione sociale ...,0,0,0,0,0,2023
SIC,CL,O 84,Amministrazione pubblica e difesa; assicurazione sociale ...,0,0,0,0,0,2023
SIC,CL,P   ,Istruzione                                                  ,0,0,0,0,0,2023
SIC,CL,P 85,Istruzione                                                  ,0,0,0,0,0,2023
SIC,CL,Q   ,Sanita' e assistenza sociale                                ,0,0,0,0,0,2023
SIC,CL,Q 86,Assistenza sanitaria                                        ,0,0,0,0,0,2023
SIC,CL,Q 87,Servizi di assistenza sociale residenziale                  ,0,0,0,0,0,2023
SIC,CL,Q 88,Assistenza sociale non residenziale                         ,0,0,0,0,0,2023
SIC,CL,R   ,"Attività artistiche, sportive, di intrattenimento e diver...",0,0,0,0,0,2023
SIC,CL,R 90,"Attività creative, artistiche e di intrattenimento          ",0,0,0,0,0,2023
SIC,CL,R 91,"Attività di biblioteche, archivi, musei ed altre attività...",0,0,0,0,0,2023
SIC,CL,R 92,"Attività riguardanti le lotterie, le scommesse, le case d...",0,0,0,0,0,2023
SIC,CL,R 93,"Attività sportive, di intrattenimento e di divertimento     ",0,0,0,0,0,2023
SIC,CL,S   ,Altre attività di servizi                                   ,0,0,10,0,10,2023
SIC,CL,S 94,Attività di organizzazioni associative                      ,0,0,0,0,0,2023
SIC,CL,S 95,Riparazione di computer e di beni per uso personale e per...,0,0,6,0,6,2023
SIC,CL,S 96,Altre attività di servizi per la persona                    ,0,0,4,0,4,2023
SIC,CL,T   ,Attività di famiglie e convivenze come datori di lavoro p...,0,0,0,0,0,2023
SIC,CL,T 97,Attività di famiglie e convivenze come datori di lavoro p...,0,0,0,0,0,2023
SIC,CL,T 98,Produzione di beni e servizi indifferenziati per uso prop...,0,0,0,0,0,2023
SIC,CL,U   ,Organizzazioni ed organismi extraterritoriali               ,0,0,0,0,0,2023
SIC,CL,U 99,Organizzazioni ed organismi extraterritoriali               ,0,0,0,0,0,2023
SIC,CL,XX  ,Imprese non classificate                                    ,0,0,0,0,0,2023
SIC,CL,TOT ,TOTALE                                                      ,0,0,183,0,183,2023
SIC,EN,A   ,"Agricoltura, silvicoltura pesca                             ",0,0,0,0,0,2023
SIC,EN,A 01,"Coltivazioni agricole e produzione di prodotti animali, c...",0,0,0,0,0,2023
SIC,EN,A 02,Silvicoltura ed utilizzo di aree forestali                  ,0,0,0,0,0,2023
SIC,EN,A 03,Pesca e acquacoltura                                        ,0,0,0,0,0,2023
SIC,EN,B   ,Estrazione di minerali da cave e miniere                    ,0,0,0,0,0,2023
SIC,EN,B 05,Estrazione di carbone (esclusa torba)                       ,0,0,0,0,0,2023
SIC,EN,B 06,Estraz.di petrolio greggio e di gas naturale                ,0,0,0,0,0,2023
SIC,EN,B 07,Estrazione di minerali metalliferi                          ,0,0,0,0,0,2023
SIC,EN,B 08,Altre attività di estrazione di minerali da cave e miniere  ,0,0,0,0,0,2023
SIC,EN,B 09,Attività dei servizi di supporto all'estrazione             ,0,0,0,0,0,2023
SIC,EN,C   ,Attività manifatturiere                                     ,0,0,0,0,0,2023
SIC,EN,C 10,Industrie alimentari                                        ,0,0,0,0,0,2023
SIC,EN,C 11,Industria delle bevande                                     ,0,0,0,0,0,2023
SIC,EN,C 12,Industria del tabacco                                       ,0,0,0,0,0,2023
SIC,EN,C 13,Industrie tessili                                           ,0,0,0,0,0,2023
SIC,EN,C 14,Confezione di articoli di abbigliamento; confezione di ar...,0,0,0,0,0,2023
SIC,EN,C 15,Fabbricazione di articoli in pelle e simili                 ,0,0,0,0,0,2023
SIC,EN,C 16,Industria del legno e dei prodotti in legno e sughero (es...,0,0,0,0,0,2023
SIC,EN,C 17,Fabbricazione di carta e di prodotti di carta               ,0,0,0,0,0,2023
SIC,EN,C 18,Stampa e riproduzione di supporti registrati                ,0,0,0,0,0,2023
SIC,EN,C 19,Fabbricazione di coke e prodotti derivanti dalla raffinaz...,0,0,0,0,0,2023
SIC,EN,C 20,Fabbricazione di prodotti chimici                           ,0,0,0,0,0,2023
SIC,EN,C 21,Fabbricazione di prodotti farmaceutici di base e di prepa...,0,0,0,0,0,2023
SIC,EN,C 22,Fabbricazione di articoli in gomma e materie plastiche      ,0,0,0,0,0,2023
SIC,EN,C 23,Fabbricazione di altri prodotti della lavorazione di miner..,0,0,0,0,0,2023
SIC,EN,C 24,Metallurgia                                                 ,0,0,0,0,0,2023
SIC,EN,C 25,Fabbricazione di prodotti in metallo (esclusi macchinari ...,0,0,0,0,0,2023
SIC,EN,C 26,Fabbricazione di computer e prodotti di elettronica e ott...,0,0,0,0,0,2023
SIC,EN,C 27,Fabbricazione di apparecchiature elettriche ed apparecchi...,0,0,0,0,0,2023
SIC,EN,C 28,Fabbricazione di macchinari ed apparecchiature nca          ,0,0,0,0,0,2023
SIC,EN,C 29,"Fabbricazione di autoveicoli, rimorchi e semirimorchi       ",0,0,0,0,0,2023
SIC,EN,C 30,Fabbricazione di altri mezzi di trasporto                   ,0,0,0,0,0,2023
SIC,EN,C 31,Fabbricazione di mobili                                     ,0,0,0,0,0,2023
SIC,EN,C 32,Altre industrie manifatturiere                              ,0,0,0,0,0,2023
SIC,EN,C 33,"Riparazione, manutenzione ed installazione di macchine ed...",0,0,0,0,0,2023
SIC,EN,D   ,"Fornitura di energia elettrica, gas, vapore e aria condiz...",0,0,0,0,0,2023
SIC,EN,D 35,"Fornitura di energia elettrica, gas, vapore e aria condiz...",0,0,0,0,0,2023
SIC,EN,E   ,"Fornitura di acqua; reti fognarie, attività di gestione d...",0,0,0,0,0,2023
SIC,EN,E 36,"Raccolta, trattamento e fornitura di acqua                  ",0,0,0,0,0,2023
SIC,EN,E 37,Gestione delle reti fognarie                                ,0,0,0,0,0,2023
SIC,EN,E 38,"Attività di raccolta, trattamento e smaltimento dei rifiu...",0,0,0,0,0,2023
SIC,EN,E 39,Attività di risanamento e altri servizi di gestione dei r...,0,0,0,0,0,2023
SIC,EN,F   ,Costruzioni                                                 ,0,0,0,0,0,2023
SIC,EN,F 41,Costruzione di edifici                                      ,0,0,0,0,0,2023
SIC,EN,F 42,Ingegneria civile                                           ,0,0,0,0,0,2023
SIC,EN,F 43,Lavori di costruzione specializzati                         ,0,0,0,0,0,2023
SIC,EN,G   ,Commercio all'ingrosso e al dettaglio; riparazione di aut...,0,0,0,0,0,2023
SIC,EN,G 45,Commercio all'ingrosso e al dettaglio e riparazione di au...,0,0,0,0,0,2023
SIC,EN,G 46,Commercio all'ingrosso (escluso quello di autoveicoli e d...,0,0,0,0,0,2023
SIC,EN,G 47,Commercio al dettaglio (escluso quello di autoveicoli e d...,0,0,0,0,0,2023
SIC,EN,H   ,Trasporto e magazzinaggio                                   ,0,0,0,0,0,2023
SIC,EN,H 49,Trasporto terrestre e mediante condotte                     ,0,0,0,0,0,2023
SIC,EN,H 50,Trasporto marittimo e per vie d'acqua                       ,0,0,0,0,0,2023
SIC,EN,H 51,Trasporto aereo                                             ,0,0,0,0,0,2023
SIC,EN,H 52,Magazzinaggio e attività di supporto ai trasporti           ,0,0,0,0,0,2023
SIC,EN,H 53,Servizi postali e attività di corriere                      ,0,0,0,0,0,2023
SIC,EN,I   ,Attività dei servizi alloggio e ristorazione                ,0,0,0,0,0,2023
SIC,EN,I 55,Alloggio                                                    ,0,0,0,0,0,2023
SIC,EN,I 56,Attività dei servizi di ristorazione                        ,0,0,0,0,0,2023
SIC,EN,J   ,Servizi di informazione e comunicazione                     ,0,0,0,0,0,2023
SIC,EN,J 58,Attività editoriali                                         ,0,0,0,0,0,2023
SIC,EN,J 59,"Attività di produzione cinematografica, di video e di pro...",0,0,0,0,0,2023
SIC,EN,J 60,Attività di programmazione e trasmissione                   ,0,0,0,0,0,2023
SIC,EN,J 61,Telecomunicazioni                                           ,0,0,0,0,0,2023
SIC,EN,J 62,"Produzione di software, consulenza informatica e attività...",0,0,0,0,0,2023
SIC,EN,J 63,Attività dei servizi d'informazione e altri servizi infor...,0,0,0,0,0,2023
SIC,EN,K   ,Attività finanziarie e assicurative                         ,0,0,0,0,0,2023
SIC,EN,K 64,Attività di servizi finanziari (escluse le assicurazioni ...,0,0,0,0,0,2023
SIC,EN,K 65,"Assicurazioni, riassicurazioni e fondi pensione (escluse ...",0,0,0,0,0,2023
SIC,EN,K 66,Attività ausiliarie dei servizi finanziari e delle attivi...,0,0,0,0,0,2023
SIC,EN,L   ,Attivita' immobiliari                                       ,0,0,0,0,0,2023
SIC,EN,L 68,Attivita' immobiliari                                       ,0,0,0,0,0,2023
SIC,EN,M   ,"Attività professionali, scientifiche e tecniche             ",0,0,0,0,0,2023
SIC,EN,M 69,Attività legali e contabilità                               ,0,0,0,0,0,2023
SIC,EN,M 70,Attività di direzione aziendale e di consulenza gestional...,0,0,0,0,0,2023
SIC,EN,M 71,Attività degli studi di architettura e d'ingegneria; coll...,0,0,0,0,0,2023
SIC,EN,M 72,Ricerca scientifica e sviluppo                              ,0,0,0,0,0,2023
SIC,EN,M 73,Pubblicità e ricerche di mercato                            ,0,0,0,0,0,2023
SIC,EN,M 74,"Altre attività professionali, scientifiche e tecniche       ",0,0,0,0,0,2023
SIC,EN,M 75,Servizi veterinari                                          ,0,0,0,0,0,2023
SIC,EN,N   ,"Noleggio, agenzie di viaggio, servizi di supporto alle im...",0,0,0,1,1,2023
SIC,EN,N 77,Attività di noleggio e leasing operativo                    ,0,0,0,0,0,2023
SIC,EN,N 78,"Attività di ricerca, selezione, fornitura di personale      ",0,0,0,0,0,2023
SIC,EN,N 79,"Attività dei servizi delle agenzie di viaggio, dei tour o...",0,0,0,0,0,2023
SIC,EN,N 80,Servizi di vigilanza e investigazione                       ,0,0,0,0,0,2023
SIC,EN,N 81,Attività di servizi per edifici e paesaggio                 ,0,0,0,1,1,2023
SIC,EN,N 82,Attività di supporto per le funzioni d'ufficio e altri se...,0,0,0,0,0,2023
SIC,EN,O   ,Amministrazione pubblica e difesa; assicurazione sociale ...,0,0,0,0,0,2023
SIC,EN,O 84,Amministrazione pubblica e difesa; assicurazione sociale ...,0,0,0,0,0,2023
SIC,EN,P   ,Istruzione                                                  ,0,0,0,0,0,2023
SIC,EN,P 85,Istruzione                                                  ,0,0,0,0,0,2023
SIC,EN,Q   ,Sanita' e assistenza sociale                                ,0,0,0,1,1,2023
SIC,EN,Q 86,Assistenza sanitaria                                        ,0,0,0,0,0,2023
SIC,EN,Q 87,Servizi di assistenza sociale residenziale                  ,0,0,0,0,0,2023
SIC,EN,Q 88,Assistenza sociale non residenziale                         ,0,0,0,1,1,2023
SIC,EN,R   ,"Attività artistiche, sportive, di intrattenimento e diver...",0,0,0,0,0,2023
SIC,EN,R 90,"Attività creative, artistiche e di intrattenimento          ",0,0,0,0,0,2023
SIC,EN,R 91,"Attività di biblioteche, archivi, musei ed altre attività...",0,0,0,0,0,2023
SIC,EN,R 92,"Attività riguardanti le lotterie, le scommesse, le case d...",0,0,0,0,0,2023
SIC,EN,R 93,"Attività sportive, di intrattenimento e di divertimento     ",0,0,0,0,0,2023
SIC,EN,S   ,Altre attività di servizi                                   ,0,0,0,0,0,2023
SIC,EN,S 94,Attività di organizzazioni associative                      ,0,0,0,0,0,2023
SIC,EN,S 95,Riparazione di computer e di beni per uso personale e per...,0,0,0,0,0,2023
SIC,EN,S 96,Altre attività di servizi per la persona                    ,0,0,0,0,0,2023
SIC,EN,T   ,Attività di famiglie e convivenze come datori di lavoro p...,0,0,0,0,0,2023
SIC,EN,T 97,Attività di famiglie e convivenze come datori di lavoro p...,0,0,0,0,0,2023
SIC,EN,T 98,Produzione di beni e servizi indifferenziati per uso prop...,0,0,0,0,0,2023
SIC,EN,U   ,Organizzazioni ed organismi extraterritoriali               ,0,0,0,0,0,2023
SIC,EN,U 99,Organizzazioni ed organismi extraterritoriali               ,0,0,0,0,0,2023
SIC,EN,XX  ,Imprese non classificate                                    ,0,0,0,0,0,2023
SIC,EN,TOT ,TOTALE                                                      ,0,0,0,2,2,2023
SIC,CT,A   ,"Agricoltura, silvicoltura pesca                             ",12,0,856,4,872,2023
SIC,CT,A 01,"Coltivazioni agricole e produzione di prodotti animali, c...",12,0,850,4,866,2023
SIC,CT,A 02,Silvicoltura ed utilizzo di aree forestali                  ,0,0,0,0,0,2023
SIC,CT,A 03,Pesca e acquacoltura                                        ,0,0,6,0,6,2023
SIC,CT,B   ,Estrazione di minerali da cave e miniere                    ,2,0,1,0,3,2023
SIC,CT,B 05,Estrazione di carbone (esclusa torba)                       ,0,0,0,0,0,2023
SIC,CT,B 06,Estraz.di petrolio greggio e di gas naturale                ,0,0,0,0,0,2023
SIC,CT,B 07,Estrazione di minerali metalliferi                          ,0,0,0,0,0,2023
SIC,CT,B 08,Altre attività di estrazione di minerali da cave e miniere  ,2,0,1,0,3,2023
SIC,CT,B 09,Attività dei servizi di supporto all'estrazione             ,0,0,0,0,0,2023
SIC,CT,C   ,Attività manifatturiere                                     ,119,0,19,0,138,2023
SIC,CT,C 10,Industrie alimentari                                        ,18,0,7,0,25,2023
SIC,CT,C 11,Industria delle bevande                                     ,1,0,0,0,1,2023
SIC,CT,C 12,Industria del tabacco                                       ,0,0,0,0,0,2023
SIC,CT,C 13,Industrie tessili                                           ,0,0,0,0,0,2023
SIC,CT,C 14,Confezione di articoli di abbigliamento; confezione di ar...,3,0,1,0,4,2023
SIC,CT,C 15,Fabbricazione di articoli in pelle e simili                 ,0,0,0,0,0,2023
SIC,CT,C 16,Industria del legno e dei prodotti in legno e sughero (es...,10,0,1,0,11,2023
SIC,CT,C 17,Fabbricazione di carta e di prodotti di carta               ,5,0,0,0,5,2023
SIC,CT,C 18,Stampa e riproduzione di supporti registrati                ,2,0,1,0,3,2023
SIC,CT,C 19,Fabbricazione di coke e prodotti derivanti dalla raffinaz...,0,0,0,0,0,2023
SIC,CT,C 20,Fabbricazione di prodotti chimici                           ,4,0,0,0,4,2023
SIC,CT,C 21,Fabbricazione di prodotti farmaceutici di base e di prepa...,1,0,0,0,1,2023
SIC,CT,C 22,Fabbricazione di articoli in gomma e materie plastiche      ,4,0,0,0,4,2023
SIC,CT,C 23,Fabbricazione di altri prodotti della lavorazione di miner..,10,0,1,0,11,2023
SIC,CT,C 24,Metallurgia                                                 ,3,0,0,0,3,2023
SIC,CT,C 25,Fabbricazione di prodotti in metallo (esclusi macchinari ...,20,0,4,0,24,2023
SIC,CT,C 26,Fabbricazione di computer e prodotti di elettronica e ott...,4,0,0,0,4,2023
SIC,CT,C 27,Fabbricazione di apparecchiature elettriche ed apparecchi...,3,0,1,0,4,2023
SIC,CT,C 28,Fabbricazione di macchinari ed apparecchiature nca          ,8,0,1,0,9,2023
SIC,CT,C 29,"Fabbricazione di autoveicoli, rimorchi e semirimorchi       ",3,0,0,0,3,2023
SIC,CT,C 30,Fabbricazione di altri mezzi di trasporto                   ,2,0,0,0,2,2023
SIC,CT,C 31,Fabbricazione di mobili                                     ,7,0,1,0,8,2023
SIC,CT,C 32,Altre industrie manifatturiere                              ,4,0,0,0,4,2023
SIC,CT,C 33,"Riparazione, manutenzione ed installazione di macchine ed...",7,0,1,0,8,2023
SIC,CT,D   ,"Fornitura di energia elettrica, gas, vapore e aria condiz...",0,0,0,0,0,2023
SIC,CT,D 35,"Fornitura di energia elettrica, gas, vapore e aria condiz...",0,0,0,0,0,2023
SIC,CT,E   ,"Fornitura di acqua; reti fognarie, attività di gestione d...",5,0,3,0,8,2023
SIC,CT,E 36,"Raccolta, trattamento e fornitura di acqua                  ",2,0,3,0,5,2023
SIC,CT,E 37,Gestione delle reti fognarie                                ,0,0,0,0,0,2023
SIC,CT,E 38,"Attività di raccolta, trattamento e smaltimento dei rifiu...",2,0,0,0,2,2023
SIC,CT,E 39,Attività di risanamento e altri servizi di gestione dei r...,1,0,0,0,1,2023
SIC,CT,F   ,Costruzioni                                                 ,235,0,29,36,300,2023
SIC,CT,F 41,Costruzione di edifici                                      ,158,0,25,22,205,2023
SIC,CT,F 42,Ingegneria civile                                           ,4,0,0,8,12,2023
SIC,CT,F 43,Lavori di costruzione specializzati                         ,73,0,4,6,83,2023
SIC,CT,G   ,Commercio all'ingrosso e al dettaglio; riparazione di aut...,471,0,173,3,647,2023
SIC,CT,G 45,Commercio all'ingrosso e al dettaglio e riparazione di au...,48,0,12,1,61,2023
SIC,CT,G 46,Commercio all'ingrosso (escluso quello di autoveicoli e d...,185,0,35,1,221,2023
SIC,CT,G 47,Commercio al dettaglio (escluso quello di autoveicoli e d...,238,0,126,1,365,2023
SIC,CT,H   ,Trasporto e magazzinaggio                                   ,62,0,24,0,86,2023
SIC,CT,H 49,Trasporto terrestre e mediante condotte                     ,41,0,23,0,64,2023
SIC,CT,H 50,Trasporto marittimo e per vie d'acqua                       ,0,0,0,0,0,2023
SIC,CT,H 51,Trasporto aereo                                             ,1,0,0,0,1,2023
SIC,CT,H 52,Magazzinaggio e attività di supporto ai trasporti           ,15,0,0,0,15,2023
SIC,CT,H 53,Servizi postali e attività di corriere                      ,5,0,1,0,6,2023
SIC,CT,I   ,Attività dei servizi alloggio e ristorazione                ,104,0,24,0,128,2023
SIC,CT,I 55,Alloggio                                                    ,8,0,4,0,12,2023
SIC,CT,I 56,Attività dei servizi di ristorazione                        ,96,0,20,0,116,2023
SIC,CT,J   ,Servizi di informazione e comunicazione                     ,32,0,5,1,38,2023
SIC,CT,J 58,Attività editoriali                                         ,2,0,3,0,5,2023
SIC,CT,J 59,"Attività di produzione cinematografica, di video e di pro...",0,0,2,1,3,2023
SIC,CT,J 60,Attività di programmazione e trasmissione                   ,0,0,0,0,0,2023
SIC,CT,J 61,Telecomunicazioni                                           ,3,0,0,0,3,2023
SIC,CT,J 62,"Produzione di software, consulenza informatica e attività...",12,0,0,0,12,2023
SIC,CT,J 63,Attività dei servizi d'informazione e altri servizi infor...,15,0,0,0,15,2023
SIC,CT,K   ,Attività finanziarie e assicurative                         ,20,0,3,0,23,2023
SIC,CT,K 64,Attività di servizi finanziari (escluse le assicurazioni ...,2,0,0,0,2,2023
SIC,CT,K 65,"Assicurazioni, riassicurazioni e fondi pensione (escluse ...",0,0,0,0,0,2023
SIC,CT,K 66,Attività ausiliarie dei servizi finanziari e delle attivi...,18,0,3,0,21,2023
SIC,CT,L   ,Attivita' immobiliari                                       ,18,0,0,0,18,2023
SIC,CT,L 68,Attivita' immobiliari                                       ,18,0,0,0,18,2023
SIC,CT,M   ,"Attività professionali, scientifiche e tecniche             ",49,0,0,3,52,2023
SIC,CT,M 69,Attività legali e contabilità                               ,3,0,0,0,3,2023
SIC,CT,M 70,Attività di direzione aziendale e di consulenza gestional...,11,0,0,1,12,2023
SIC,CT,M 71,Attività degli studi di architettura e d'ingegneria; coll...,17,0,0,1,18,2023
SIC,CT,M 72,Ricerca scientifica e sviluppo                              ,3,0,0,0,3,2023
SIC,CT,M 73,Pubblicità e ricerche di mercato                            ,7,0,0,1,8,2023
SIC,CT,M 74,"Altre attività professionali, scientifiche e tecniche       ",8,0,0,0,8,2023
SIC,CT,M 75,Servizi veterinari                                          ,0,0,0,0,0,2023
SIC,CT,N   ,"Noleggio, agenzie di viaggio, servizi di supporto alle im...",60,0,2,2,64,2023
SIC,CT,N 77,Attività di noleggio e leasing operativo                    ,10,0,0,0,10,2023
SIC,CT,N 78,"Attività di ricerca, selezione, fornitura di personale      ",0,0,0,0,0,2023
SIC,CT,N 79,"Attività dei servizi delle agenzie di viaggio, dei tour o...",12,0,2,0,14,2023
SIC,CT,N 80,Servizi di vigilanza e investigazione                       ,2,0,0,0,2,2023
SIC,CT,N 81,Attività di servizi per edifici e paesaggio                 ,8,0,0,1,9,2023
SIC,CT,N 82,Attività di supporto per le funzioni d'ufficio e altri se...,28,0,0,1,29,2023
SIC,CT,O   ,Amministrazione pubblica e difesa; assicurazione sociale ...,0,0,0,0,0,2023
SIC,CT,O 84,Amministrazione pubblica e difesa; assicurazione sociale ...,0,0,0,0,0,2023
SIC,CT,P   ,Istruzione                                                  ,13,0,1,1,15,2023
SIC,CT,P 85,Istruzione                                                  ,13,0,1,1,15,2023
SIC,CT,Q   ,Sanita' e assistenza sociale                                ,11,0,0,0,11,2023
SIC,CT,Q 86,Assistenza sanitaria                                        ,9,0,0,0,9,2023
SIC,CT,Q 87,Servizi di assistenza sociale residenziale                  ,2,0,0,0,2,2023
SIC,CT,Q 88,Assistenza sociale non residenziale                         ,0,0,0,0,0,2023
SIC,CT,R   ,"Attività artistiche, sportive, di intrattenimento e diver...",19,0,7,0,26,2023
SIC,CT,R 90,"Attività creative, artistiche e di intrattenimento          ",4,0,2,0,6,2023
SIC,CT,R 91,"Attività di biblioteche, archivi, musei ed altre attività...",0,0,0,0,0,2023
SIC,CT,R 92,"Attività riguardanti le lotterie, le scommesse, le case d...",5,0,1,0,6,2023
SIC,CT,R 93,"Attività sportive, di intrattenimento e di divertimento     ",10,0,4,0,14,2023
SIC,CT,S   ,Altre attività di servizi                                   ,21,0,2,1,24,2023
SIC,CT,S 94,Attività di organizzazioni associative                      ,0,0,0,0,0,2023
SIC,CT,S 95,Riparazione di computer e di beni per uso personale e per...,4,0,1,0,5,2023
SIC,CT,S 96,Altre attività di servizi per la persona                    ,17,0,1,1,19,2023
SIC,CT,T   ,Attività di famiglie e convivenze come datori di lavoro p...,0,0,0,0,0,2023
SIC,CT,T 97,Attività di famiglie e convivenze come datori di lavoro p...,0,0,0,0,0,2023
SIC,CT,T 98,Produzione di beni e servizi indifferenziati per uso prop...,0,0,0,0,0,2023
SIC,CT,U   ,Organizzazioni ed organismi extraterritoriali               ,0,0,0,0,0,2023
SIC,CT,U 99,Organizzazioni ed organismi extraterritoriali               ,0,0,0,0,0,2023
SIC,CT,XX  ,Imprese non classificate                                    ,597,0,19,48,664,2023
SIC,CT,TOT ,TOTALE                                                      ,1850,0,1168,99,3117,2023
SIC,RG,A   ,"Agricoltura, silvicoltura pesca                             ",28,0,219,2,249,2023
SIC,RG,A 01,"Coltivazioni agricole e produzione di prodotti animali, c...",28,0,215,2,245,2023
SIC,RG,A 02,Silvicoltura ed utilizzo di aree forestali                  ,0,0,0,0,0,2023
SIC,RG,A 03,Pesca e acquacoltura                                        ,0,0,4,0,4,2023
SIC,RG,B   ,Estrazione di minerali da cave e miniere                    ,2,0,0,0,2,2023
SIC,RG,B 05,Estrazione di carbone (esclusa torba)                       ,0,0,0,0,0,2023
SIC,RG,B 06,Estraz.di petrolio greggio e di gas naturale                ,0,0,0,0,0,2023
SIC,RG,B 07,Estrazione di minerali metalliferi                          ,0,0,0,0,0,2023
SIC,RG,B 08,Altre attività di estrazione di minerali da cave e miniere  ,2,0,0,0,2,2023
SIC,RG,B 09,Attività dei servizi di supporto all'estrazione             ,0,0,0,0,0,2023
SIC,RG,C   ,Attività manifatturiere                                     ,84,0,6,0,90,2023
SIC,RG,C 10,Industrie alimentari                                        ,11,0,2,0,13,2023
SIC,RG,C 11,Industria delle bevande                                     ,2,0,1,0,3,2023
SIC,RG,C 12,Industria del tabacco                                       ,0,0,0,0,0,2023
SIC,RG,C 13,Industrie tessili                                           ,3,0,0,0,3,2023
SIC,RG,C 14,Confezione di articoli di abbigliamento; confezione di ar...,2,0,0,0,2,2023
SIC,RG,C 15,Fabbricazione di articoli in pelle e simili                 ,1,0,0,0,1,2023
SIC,RG,C 16,Industria del legno e dei prodotti in legno e sughero (es...,7,0,1,0,8,2023
SIC,RG,C 17,Fabbricazione di carta e di prodotti di carta               ,1,0,0,0,1,2023
SIC,RG,C 18,Stampa e riproduzione di supporti registrati                ,4,0,0,0,4,2023
SIC,RG,C 19,Fabbricazione di coke e prodotti derivanti dalla raffinaz...,0,0,0,0,0,2023
SIC,RG,C 20,Fabbricazione di prodotti chimici                           ,3,0,0,0,3,2023
SIC,RG,C 21,Fabbricazione di prodotti farmaceutici di base e di prepa...,0,0,0,0,0,2023
SIC,RG,C 22,Fabbricazione di articoli in gomma e materie plastiche      ,2,0,0,0,2,2023
SIC,RG,C 23,Fabbricazione di altri prodotti della lavorazione di miner..,18,0,2,0,20,2023
SIC,RG,C 24,Metallurgia                                                 ,1,0,0,0,1,2023
SIC,RG,C 25,Fabbricazione di prodotti in metallo (esclusi macchinari ...,13,0,0,0,13,2023
SIC,RG,C 26,Fabbricazione di computer e prodotti di elettronica e ott...,1,0,0,0,1,2023
SIC,RG,C 27,Fabbricazione di apparecchiature elettriche ed apparecchi...,1,0,0,0,1,2023
SIC,RG,C 28,Fabbricazione di macchinari ed apparecchiature nca          ,4,0,0,0,4,2023
SIC,RG,C 29,"Fabbricazione di autoveicoli, rimorchi e semirimorchi       ",1,0,0,0,1,2023
SIC,RG,C 30,Fabbricazione di altri mezzi di trasporto                   ,6,0,0,0,6,2023
SIC,RG,C 31,Fabbricazione di mobili                                     ,1,0,0,0,1,2023
SIC,RG,C 32,Altre industrie manifatturiere                              ,1,0,0,0,1,2023
SIC,RG,C 33,"Riparazione, manutenzione ed installazione di macchine ed...",1,0,0,0,1,2023
SIC,RG,D   ,"Fornitura di energia elettrica, gas, vapore e aria condiz...",1,0,0,0,1,2023
SIC,RG,D 35,"Fornitura di energia elettrica, gas, vapore e aria condiz...",1,0,0,0,1,2023
SIC,RG,E   ,"Fornitura di acqua; reti fognarie, attività di gestione d...",3,0,0,0,3,2023
SIC,RG,E 36,"Raccolta, trattamento e fornitura di acqua                  ",0,0,0,0,0,2023
SIC,RG,E 37,Gestione delle reti fognarie                                ,1,0,0,0,1,2023
SIC,RG,E 38,"Attività di raccolta, trattamento e smaltimento dei rifiu...",2,0,0,0,2,2023
SIC,RG,E 39,Attività di risanamento e altri servizi di gestione dei r...,0,0,0,0,0,2023
SIC,RG,F   ,Costruzioni                                                 ,106,0,8,3,117,2023
SIC,RG,F 41,Costruzione di edifici                                      ,82,0,8,3,93,2023
SIC,RG,F 42,Ingegneria civile                                           ,1,0,0,0,1,2023
SIC,RG,F 43,Lavori di costruzione specializzati                         ,23,0,0,0,23,2023
SIC,RG,G   ,Commercio all'ingrosso e al dettaglio; riparazione di aut...,260,0,51,0,311,2023
SIC,RG,G 45,Commercio all'ingrosso e al dettaglio e riparazione di au...,20,0,5,0,25,2023
SIC,RG,G 46,Commercio all'ingrosso (escluso quello di autoveicoli e d...,142,0,13,0,155,2023
SIC,RG,G 47,Commercio al dettaglio (escluso quello di autoveicoli e d...,98,0,33,0,131,2023
SIC,RG,H   ,Trasporto e magazzinaggio                                   ,17,0,5,0,22,2023
SIC,RG,H 49,Trasporto terrestre e mediante condotte                     ,12,0,5,0,17,2023
SIC,RG,H 50,Trasporto marittimo e per vie d'acqua                       ,0,0,0,0,0,2023
SIC,RG,H 51,Trasporto aereo                                             ,0,0,0,0,0,2023
SIC,RG,H 52,Magazzinaggio e attività di supporto ai trasporti           ,4,0,0,0,4,2023
SIC,RG,H 53,Servizi postali e attività di corriere                      ,1,0,0,0,1,2023
SIC,RG,I   ,Attività dei servizi alloggio e ristorazione                ,38,0,9,0,47,2023
SIC,RG,I 55,Alloggio                                                    ,0,0,3,0,3,2023
SIC,RG,I 56,Attività dei servizi di ristorazione                        ,38,0,6,0,44,2023
SIC,RG,J   ,Servizi di informazione e comunicazione                     ,26,0,1,1,28,2023
SIC,RG,J 58,Attività editoriali                                         ,2,0,0,0,2,2023
SIC,RG,J 59,"Attività di produzione cinematografica, di video e di pro...",1,0,0,0,1,2023
SIC,RG,J 60,Attività di programmazione e trasmissione                   ,1,0,1,0,2,2023
SIC,RG,J 61,Telecomunicazioni                                           ,4,0,0,0,4,2023
SIC,RG,J 62,"Produzione di software, consulenza informatica e attività...",9,0,0,1,10,2023
SIC,RG,J 63,Attività dei servizi d'informazione e altri servizi infor...,9,0,0,0,9,2023
SIC,RG,K   ,Attività finanziarie e assicurative                         ,9,0,0,0,9,2023
SIC,RG,K 64,Attività di servizi finanziari (escluse le assicurazioni ...,3,0,0,0,3,2023
SIC,RG,K 65,"Assicurazioni, riassicurazioni e fondi pensione (escluse ...",0,0,0,0,0,2023
SIC,RG,K 66,Attività ausiliarie dei servizi finanziari e delle attivi...,6,0,0,0,6,2023
SIC,RG,L   ,Attivita' immobiliari                                       ,17,0,0,0,17,2023
SIC,RG,L 68,Attivita' immobiliari                                       ,17,0,0,0,17,2023
SIC,RG,M   ,"Attività professionali, scientifiche e tecniche             ",24,0,1,1,26,2023
SIC,RG,M 69,Attività legali e contabilità                               ,1,0,0,0,1,2023
SIC,RG,M 70,Attività di direzione aziendale e di consulenza gestional...,7,0,0,1,8,2023
SIC,RG,M 71,Attività degli studi di architettura e d'ingegneria; coll...,2,0,0,0,2,2023
SIC,RG,M 72,Ricerca scientifica e sviluppo                              ,1,0,0,0,1,2023
SIC,RG,M 73,Pubblicità e ricerche di mercato                            ,8,0,0,0,8,2023
SIC,RG,M 74,"Altre attività professionali, scientifiche e tecniche       ",5,0,1,0,6,2023
SIC,RG,M 75,Servizi veterinari                                          ,0,0,0,0,0,2023
SIC,RG,N   ,"Noleggio, agenzie di viaggio, servizi di supporto alle im...",25,0,6,1,32,2023
SIC,RG,N 77,Attività di noleggio e leasing operativo                    ,6,0,0,0,6,2023
SIC,RG,N 78,"Attività di ricerca, selezione, fornitura di personale      ",0,0,0,0,0,2023
SIC,RG,N 79,"Attività dei servizi delle agenzie di viaggio, dei tour o...",7,0,0,0,7,2023
SIC,RG,N 80,Servizi di vigilanza e investigazione                       ,0,0,0,0,0,2023
SIC,RG,N 81,Attività di servizi per edifici e paesaggio                 ,5,0,6,1,12,2023
SIC,RG,N 82,Attività di supporto per le funzioni d'ufficio e altri se...,7,0,0,0,7,2023
SIC,RG,O   ,Amministrazione pubblica e difesa; assicurazione sociale ...,0,0,0,0,0,2023
SIC,RG,O 84,Amministrazione pubblica e difesa; assicurazione sociale ...,0,0,0,0,0,2023
SIC,RG,P   ,Istruzione                                                  ,4,0,2,1,7,2023
SIC,RG,P 85,Istruzione                                                  ,4,0,2,1,7,2023
SIC,RG,Q   ,Sanita' e assistenza sociale                                ,7,0,1,2,10,2023
SIC,RG,Q 86,Assistenza sanitaria                                        ,4,0,0,1,5,2023
SIC,RG,Q 87,Servizi di assistenza sociale residenziale                  ,3,0,1,0,4,2023
SIC,RG,Q 88,Assistenza sociale non residenziale                         ,0,0,0,1,1,2023
SIC,RG,R   ,"Attività artistiche, sportive, di intrattenimento e diver...",9,0,1,1,11,2023
SIC,RG,R 90,"Attività creative, artistiche e di intrattenimento          ",0,0,0,0,0,2023
SIC,RG,R 91,"Attività di biblioteche, archivi, musei ed altre attività...",0,0,0,0,0,2023
SIC,RG,R 92,"Attività riguardanti le lotterie, le scommesse, le case d...",1,0,0,0,1,2023
SIC,RG,R 93,"Attività sportive, di intrattenimento e di divertimento     ",8,0,1,1,10,2023
SIC,RG,S   ,Altre attività di servizi                                   ,3,0,0,0,3,2023
SIC,RG,S 94,Attività di organizzazioni associative                      ,0,0,0,0,0,2023
SIC,RG,S 95,Riparazione di computer e di beni per uso personale e per...,2,0,0,0,2,2023
SIC,RG,S 96,Altre attività di servizi per la persona                    ,1,0,0,0,1,2023
SIC,RG,T   ,Attività di famiglie e convivenze come datori di lavoro p...,0,0,0,0,0,2023
SIC,RG,T 97,Attività di famiglie e convivenze come datori di lavoro p...,0,0,0,0,0,2023
SIC,RG,T 98,Produzione di beni e servizi indifferenziati per uso prop...,0,0,0,0,0,2023
SIC,RG,U   ,Organizzazioni ed organismi extraterritoriali               ,0,0,0,0,0,2023
SIC,RG,U 99,Organizzazioni ed organismi extraterritoriali               ,0,0,0,0,0,2023
SIC,RG,XX  ,Imprese non classificate                                    ,231,0,1,7,239,2023
SIC,RG,TOT ,TOTALE                                                      ,894,0,311,19,1224,2023
SIC,SR,A   ,"Agricoltura, silvicoltura pesca                             ",8,0,358,0,366,2023
SIC,SR,A 01,"Coltivazioni agricole e produzione di prodotti animali, c...",6,0,353,0,359,2023
SIC,SR,A 02,Silvicoltura ed utilizzo di aree forestali                  ,1,0,0,0,1,2023
SIC,SR,A 03,Pesca e acquacoltura                                        ,1,0,5,0,6,2023
SIC,SR,B   ,Estrazione di minerali da cave e miniere                    ,1,0,0,0,1,2023
SIC,SR,B 05,Estrazione di carbone (esclusa torba)                       ,0,0,0,0,0,2023
SIC,SR,B 06,Estraz.di petrolio greggio e di gas naturale                ,0,0,0,0,0,2023
SIC,SR,B 07,Estrazione di minerali metalliferi                          ,0,0,0,0,0,2023
SIC,SR,B 08,Altre attività di estrazione di minerali da cave e miniere  ,1,0,0,0,1,2023
SIC,SR,B 09,Attività dei servizi di supporto all'estrazione             ,0,0,0,0,0,2023
SIC,SR,C   ,Attività manifatturiere                                     ,77,0,4,0,81,2023
SIC,SR,C 10,Industrie alimentari                                        ,10,0,1,0,11,2023
SIC,SR,C 11,Industria delle bevande                                     ,0,0,0,0,0,2023
SIC,SR,C 12,Industria del tabacco                                       ,0,0,0,0,0,2023
SIC,SR,C 13,Industrie tessili                                           ,1,0,0,0,1,2023
SIC,SR,C 14,Confezione di articoli di abbigliamento; confezione di ar...,0,0,0,0,0,2023
SIC,SR,C 15,Fabbricazione di articoli in pelle e simili                 ,2,0,0,0,2,2023
SIC,SR,C 16,Industria del legno e dei prodotti in legno e sughero (es...,6,0,0,0,6,2023
SIC,SR,C 17,Fabbricazione di carta e di prodotti di carta               ,1,0,0,0,1,2023
SIC,SR,C 18,Stampa e riproduzione di supporti registrati                ,2,0,1,0,3,2023
SIC,SR,C 19,Fabbricazione di coke e prodotti derivanti dalla raffinaz...,0,0,0,0,0,2023
SIC,SR,C 20,Fabbricazione di prodotti chimici                           ,3,0,0,0,3,2023
SIC,SR,C 21,Fabbricazione di prodotti farmaceutici di base e di prepa...,0,0,0,0,0,2023
SIC,SR,C 22,Fabbricazione di articoli in gomma e materie plastiche      ,1,0,0,0,1,2023
SIC,SR,C 23,Fabbricazione di altri prodotti della lavorazione di miner..,3,0,0,0,3,2023
SIC,SR,C 24,Metallurgia                                                 ,1,0,0,0,1,2023
SIC,SR,C 25,Fabbricazione di prodotti in metallo (esclusi macchinari ...,28,0,1,0,29,2023
SIC,SR,C 26,Fabbricazione di computer e prodotti di elettronica e ott...,3,0,0,0,3,2023
SIC,SR,C 27,Fabbricazione di apparecchiature elettriche ed apparecchi...,2,0,0,0,2,2023
SIC,SR,C 28,Fabbricazione di macchinari ed apparecchiature nca          ,4,0,0,0,4,2023
SIC,SR,C 29,"Fabbricazione di autoveicoli, rimorchi e semirimorchi       ",0,0,0,0,0,2023
SIC,SR,C 30,Fabbricazione di altri mezzi di trasporto                   ,3,0,1,0,4,2023
SIC,SR,C 31,Fabbricazione di mobili                                     ,1,0,0,0,1,2023
SIC,SR,C 32,Altre industrie manifatturiere                              ,2,0,0,0,2,2023
SIC,SR,C 33,"Riparazione, manutenzione ed installazione di macchine ed...",4,0,0,0,4,2023
SIC,SR,D   ,"Fornitura di energia elettrica, gas, vapore e aria condiz...",2,0,0,0,2,2023
SIC,SR,D 35,"Fornitura di energia elettrica, gas, vapore e aria condiz...",2,0,0,0,2,2023
SIC,SR,E   ,"Fornitura di acqua; reti fognarie, attività di gestione d...",4,0,1,1,6,2023
SIC,SR,E 36,"Raccolta, trattamento e fornitura di acqua                  ",0,0,0,0,0,2023
SIC,SR,E 37,Gestione delle reti fognarie                                ,0,0,0,0,0,2023
SIC,SR,E 38,"Attività di raccolta, trattamento e smaltimento dei rifiu...",2,0,1,1,4,2023
SIC,SR,E 39,Attività di risanamento e altri servizi di gestione dei r...,2,0,0,0,2,2023
SIC,SR,F   ,Costruzioni                                                 ,152,0,12,6,170,2023
SIC,SR,F 41,Costruzione di edifici                                      ,110,0,10,5,125,2023
SIC,SR,F 42,Ingegneria civile                                           ,7,0,1,0,8,2023
SIC,SR,F 43,Lavori di costruzione specializzati                         ,35,0,1,1,37,2023
SIC,SR,G   ,Commercio all'ingrosso e al dettaglio; riparazione di aut...,159,0,66,1,226,2023
SIC,SR,G 45,Commercio all'ingrosso e al dettaglio e riparazione di au...,17,0,2,0,19,2023
SIC,SR,G 46,Commercio all'ingrosso (escluso quello di autoveicoli e d...,63,0,11,0,74,2023
SIC,SR,G 47,Commercio al dettaglio (escluso quello di autoveicoli e d...,79,0,53,1,133,2023
SIC,SR,H   ,Trasporto e magazzinaggio                                   ,16,0,9,0,25,2023
SIC,SR,H 49,Trasporto terrestre e mediante condotte                     ,10,0,8,0,18,2023
SIC,SR,H 50,Trasporto marittimo e per vie d'acqua                       ,1,0,0,0,1,2023
SIC,SR,H 51,Trasporto aereo                                             ,0,0,0,0,0,2023
SIC,SR,H 52,Magazzinaggio e attività di supporto ai trasporti           ,5,0,1,0,6,2023
SIC,SR,H 53,Servizi postali e attività di corriere                      ,0,0,0,0,0,2023
SIC,SR,I   ,Attività dei servizi alloggio e ristorazione                ,33,0,11,1,45,2023
SIC,SR,I 55,Alloggio                                                    ,4,0,2,0,6,2023
SIC,SR,I 56,Attività dei servizi di ristorazione                        ,29,0,9,1,39,2023
SIC,SR,J   ,Servizi di informazione e comunicazione                     ,23,0,3,0,26,2023
SIC,SR,J 58,Attività editoriali                                         ,4,0,2,0,6,2023
SIC,SR,J 59,"Attività di produzione cinematografica, di video e di pro...",0,0,0,0,0,2023
SIC,SR,J 60,Attività di programmazione e trasmissione                   ,1,0,0,0,1,2023
SIC,SR,J 61,Telecomunicazioni                                           ,2,0,0,0,2,2023
SIC,SR,J 62,"Produzione di software, consulenza informatica e attività...",7,0,0,0,7,2023
SIC,SR,J 63,Attività dei servizi d'informazione e altri servizi infor...,9,0,1,0,10,2023
SIC,SR,K   ,Attività finanziarie e assicurative                         ,8,0,0,0,8,2023
SIC,SR,K 64,Attività di servizi finanziari (escluse le assicurazioni ...,0,0,0,0,0,2023
SIC,SR,K 65,"Assicurazioni, riassicurazioni e fondi pensione (escluse ...",0,0,0,0,0,2023
SIC,SR,K 66,Attività ausiliarie dei servizi finanziari e delle attivi...,8,0,0,0,8,2023
SIC,SR,L   ,Attivita' immobiliari                                       ,17,0,0,0,17,2023
SIC,SR,L 68,Attivita' immobiliari                                       ,17,0,0,0,17,2023
SIC,SR,M   ,"Attività professionali, scientifiche e tecniche             ",36,0,2,3,41,2023
SIC,SR,M 69,Attività legali e contabilità                               ,3,0,0,1,4,2023
SIC,SR,M 70,Attività di direzione aziendale e di consulenza gestional...,6,0,0,1,7,2023
SIC,SR,M 71,Attività degli studi di architettura e d'ingegneria; coll...,16,0,1,0,17,2023
SIC,SR,M 72,Ricerca scientifica e sviluppo                              ,0,0,0,0,0,2023
SIC,SR,M 73,Pubblicità e ricerche di mercato                            ,2,0,1,1,4,2023
SIC,SR,M 74,"Altre attività professionali, scientifiche e tecniche       ",9,0,0,0,9,2023
SIC,SR,M 75,Servizi veterinari                                          ,0,0,0,0,0,2023
SIC,SR,N   ,"Noleggio, agenzie di viaggio, servizi di supporto alle im...",23,0,2,0,25,2023
SIC,SR,N 77,Attività di noleggio e leasing operativo                    ,9,0,0,0,9,2023
SIC,SR,N 78,"Attività di ricerca, selezione, fornitura di personale      ",0,0,0,0,0,2023
SIC,SR,N 79,"Attività dei servizi delle agenzie di viaggio, dei tour o...",5,0,1,0,6,2023
SIC,SR,N 80,Servizi di vigilanza e investigazione                       ,0,0,0,0,0,2023
SIC,SR,N 81,Attività di servizi per edifici e paesaggio                 ,3,0,1,0,4,2023
SIC,SR,N 82,Attività di supporto per le funzioni d'ufficio e altri se...,6,0,0,0,6,2023
SIC,SR,O   ,Amministrazione pubblica e difesa; assicurazione sociale ...,0,0,0,0,0,2023
SIC,SR,O 84,Amministrazione pubblica e difesa; assicurazione sociale ...,0,0,0,0,0,2023
SIC,SR,P   ,Istruzione                                                  ,5,0,0,3,8,2023
SIC,SR,P 85,Istruzione                                                  ,5,0,0,3,8,2023
SIC,SR,Q   ,Sanita' e assistenza sociale                                ,10,0,0,1,11,2023
SIC,SR,Q 86,Assistenza sanitaria                                        ,7,0,0,0,7,2023
SIC,SR,Q 87,Servizi di assistenza sociale residenziale                  ,3,0,0,0,3,2023
SIC,SR,Q 88,Assistenza sociale non residenziale                         ,0,0,0,1,1,2023
SIC,SR,R   ,"Attività artistiche, sportive, di intrattenimento e diver...",13,0,3,0,16,2023
SIC,SR,R 90,"Attività creative, artistiche e di intrattenimento          ",3,0,0,0,3,2023
SIC,SR,R 91,"Attività di biblioteche, archivi, musei ed altre attività...",1,0,0,0,1,2023
SIC,SR,R 92,"Attività riguardanti le lotterie, le scommesse, le case d...",2,0,1,0,3,2023
SIC,SR,R 93,"Attività sportive, di intrattenimento e di divertimento     ",7,0,2,0,9,2023
SIC,SR,S   ,Altre attività di servizi                                   ,9,0,1,1,11,2023
SIC,SR,S 94,Attività di organizzazioni associative                      ,0,0,0,0,0,2023
SIC,SR,S 95,Riparazione di computer e di beni per uso personale e per...,1,0,1,0,2,2023
SIC,SR,S 96,Altre attività di servizi per la persona                    ,8,0,0,1,9,2023
SIC,SR,T   ,Attività di famiglie e convivenze come datori di lavoro p...,0,0,0,0,0,2023
SIC,SR,T 97,Attività di famiglie e convivenze come datori di lavoro p...,0,0,0,0,0,2023
SIC,SR,T 98,Produzione di beni e servizi indifferenziati per uso prop...,0,0,0,0,0,2023
SIC,SR,U   ,Organizzazioni ed organismi extraterritoriali               ,0,0,0,0,0,2023
SIC,SR,U 99,Organizzazioni ed organismi extraterritoriali               ,0,0,0,0,0,2023
SIC,SR,XX  ,Imprese non classificate                                    ,237,0,10,21,268,2023
SIC,SR,TOT ,TOTALE                                                      ,833,0,482,38,1353,2023
SAR,  ,A   ,"Agricoltura, silvicoltura pesca                             ",6,1,247,18,272,2023
SAR,  ,A 01,"Coltivazioni agricole e produzione di prodotti animali, c...",3,1,239,10,253,2023
SAR,  ,A 02,Silvicoltura ed utilizzo di aree forestali                  ,0,0,3,2,5,2023
SAR,  ,A 03,Pesca e acquacoltura                                        ,3,0,5,6,14,2023
SAR,  ,B   ,Estrazione di minerali da cave e miniere                    ,7,1,1,0,9,2023
SAR,  ,B 05,Estrazione di carbone (esclusa torba)                       ,0,0,0,0,0,2023
SAR,  ,B 06,Estraz.di petrolio greggio e di gas naturale                ,0,0,0,0,0,2023
SAR,  ,B 07,Estrazione di minerali metalliferi                          ,0,0,0,0,0,2023
SAR,  ,B 08,Altre attività di estrazione di minerali da cave e miniere  ,7,1,1,0,9,2023
SAR,  ,B 09,Attività dei servizi di supporto all'estrazione             ,0,0,0,0,0,2023
SAR,  ,C   ,Attività manifatturiere                                     ,91,3,67,24,185,2023
SAR,  ,C 10,Industrie alimentari                                        ,18,3,6,13,40,2023
SAR,  ,C 11,Industria delle bevande                                     ,0,0,1,0,1,2023
SAR,  ,C 12,Industria del tabacco                                       ,0,0,0,0,0,2023
SAR,  ,C 13,Industrie tessili                                           ,1,0,2,2,5,2023
SAR,  ,C 14,Confezione di articoli di abbigliamento; confezione di ar...,6,0,2,0,8,2023
SAR,  ,C 15,Fabbricazione di articoli in pelle e simili                 ,1,0,0,0,1,2023
SAR,  ,C 16,Industria del legno e dei prodotti in legno e sughero (es...,13,0,9,3,25,2023
SAR,  ,C 17,Fabbricazione di carta e di prodotti di carta               ,0,0,0,0,0,2023
SAR,  ,C 18,Stampa e riproduzione di supporti registrati                ,3,0,3,1,7,2023
SAR,  ,C 19,Fabbricazione di coke e prodotti derivanti dalla raffinaz...,2,0,0,0,2,2023
SAR,  ,C 20,Fabbricazione di prodotti chimici                           ,3,0,0,0,3,2023
SAR,  ,C 21,Fabbricazione di prodotti farmaceutici di base e di prepa...,0,0,0,0,0,2023
SAR,  ,C 22,Fabbricazione di articoli in gomma e materie plastiche      ,2,0,0,0,2,2023
SAR,  ,C 23,Fabbricazione di altri prodotti della lavorazione di miner..,13,0,4,2,19,2023
SAR,  ,C 24,Metallurgia                                                 ,0,0,2,0,2,2023
SAR,  ,C 25,Fabbricazione di prodotti in metallo (esclusi macchinari ...,11,0,19,1,31,2023
SAR,  ,C 26,Fabbricazione di computer e prodotti di elettronica e ott...,1,0,0,0,1,2023
SAR,  ,C 27,Fabbricazione di apparecchiature elettriche ed apparecchi...,1,0,0,1,2,2023
SAR,  ,C 28,Fabbricazione di macchinari ed apparecchiature nca          ,5,0,0,0,5,2023
SAR,  ,C 29,"Fabbricazione di autoveicoli, rimorchi e semirimorchi       ",2,0,0,0,2,2023
SAR,  ,C 30,Fabbricazione di altri mezzi di trasporto                   ,3,0,1,1,5,2023
SAR,  ,C 31,Fabbricazione di mobili                                     ,2,0,3,0,5,2023
SAR,  ,C 32,Altre industrie manifatturiere                              ,1,0,8,0,9,2023
SAR,  ,C 33,"Riparazione, manutenzione ed installazione di macchine ed...",3,0,7,0,10,2023
SAR,  ,D   ,"Fornitura di energia elettrica, gas, vapore e aria condiz...",0,0,3,0,3,2023
SAR,  ,D 35,"Fornitura di energia elettrica, gas, vapore e aria condiz...",0,0,3,0,3,2023
SAR,  ,E   ,"Fornitura di acqua; reti fognarie, attività di gestione d...",0,0,0,2,2,2023
SAR,  ,E 36,"Raccolta, trattamento e fornitura di acqua                  ",0,0,0,0,0,2023
SAR,  ,E 37,Gestione delle reti fognarie                                ,0,0,0,0,0,2023
SAR,  ,E 38,"Attività di raccolta, trattamento e smaltimento dei rifiu...",0,0,0,2,2,2023
SAR,  ,E 39,Attività di risanamento e altri servizi di gestione dei r...,0,0,0,0,0,2023
SAR,  ,F   ,Costruzioni                                                 ,112,7,195,44,358,2023
SAR,  ,F 41,Costruzione di edifici                                      ,91,5,96,31,223,2023
SAR,  ,F 42,Ingegneria civile                                           ,2,0,0,2,4,2023
SAR,  ,F 43,Lavori di costruzione specializzati                         ,19,2,99,11,131,2023
SAR,  ,G   ,Commercio all'ingrosso e al dettaglio; riparazione di aut...,135,9,339,31,514,2023
SAR,  ,G 45,Commercio all'ingrosso e al dettaglio e riparazione di au...,13,0,12,3,28,2023
SAR,  ,G 46,Commercio all'ingrosso (escluso quello di autoveicoli e d...,59,5,60,7,131,2023
SAR,  ,G 47,Commercio al dettaglio (escluso quello di autoveicoli e d...,63,4,267,21,355,2023
SAR,  ,H   ,Trasporto e magazzinaggio                                   ,22,4,26,18,70,2023
SAR,  ,H 49,Trasporto terrestre e mediante condotte                     ,10,1,20,6,37,2023
SAR,  ,H 50,Trasporto marittimo e per vie d'acqua                       ,3,0,0,0,3,2023
SAR,  ,H 51,Trasporto aereo                                             ,1,0,0,0,1,2023
SAR,  ,H 52,Magazzinaggio e attività di supporto ai trasporti           ,6,3,3,9,21,2023
SAR,  ,H 53,Servizi postali e attività di corriere                      ,2,0,3,3,8,2023
SAR,  ,I   ,Attività dei servizi alloggio e ristorazione                ,63,6,86,18,173,2023
SAR,  ,I 55,Alloggio                                                    ,10,0,6,0,16,2023
SAR,  ,I 56,Attività dei servizi di ristorazione                        ,53,6,80,18,157,2023
SAR,  ,J   ,Servizi di informazione e comunicazione                     ,14,1,35,3,53,2023
SAR,  ,J 58,Attività editoriali                                         ,2,0,2,0,4,2023
SAR,  ,J 59,"Attività di produzione cinematografica, di video e di pro...",1,0,2,0,3,2023
SAR,  ,J 60,Attività di programmazione e trasmissione                   ,0,0,0,0,0,2023
SAR,  ,J 61,Telecomunicazioni                                           ,0,0,2,0,2,2023
SAR,  ,J 62,"Produzione di software, consulenza informatica e attività...",7,0,2,1,10,2023
SAR,  ,J 63,Attività dei servizi d'informazione e altri servizi infor...,4,1,27,2,34,2023
SAR,  ,K   ,Attività finanziarie e assicurative                         ,6,2,8,0,16,2023
SAR,  ,K 64,Attività di servizi finanziari (escluse le assicurazioni ...,2,0,0,0,2,2023
SAR,  ,K 65,"Assicurazioni, riassicurazioni e fondi pensione (escluse ...",0,0,0,0,0,2023
SAR,  ,K 66,Attività ausiliarie dei servizi finanziari e delle attivi...,4,2,8,0,14,2023
SAR,  ,L   ,Attivita' immobiliari                                       ,22,1,6,1,30,2023
SAR,  ,L 68,Attivita' immobiliari                                       ,22,1,6,1,30,2023
SAR,  ,M   ,"Attività professionali, scientifiche e tecniche             ",15,0,9,5,29,2023
SAR,  ,M 69,Attività legali e contabilità                               ,1,0,0,0,1,2023
SAR,  ,M 70,Attività di direzione aziendale e di consulenza gestional...,4,0,1,1,6,2023
SAR,  ,M 71,Attività degli studi di architettura e d'ingegneria; coll...,5,0,0,1,6,2023
SAR,  ,M 72,Ricerca scientifica e sviluppo                              ,0,0,0,0,0,2023
SAR,  ,M 73,Pubblicità e ricerche di mercato                            ,2,0,2,0,4,2023
SAR,  ,M 74,"Altre attività professionali, scientifiche e tecniche       ",3,0,6,3,12,2023
SAR,  ,M 75,Servizi veterinari                                          ,0,0,0,0,0,2023
SAR,  ,N   ,"Noleggio, agenzie di viaggio, servizi di supporto alle im...",26,1,30,29,86,2023
SAR,  ,N 77,Attività di noleggio e leasing operativo                    ,8,0,4,0,12,2023
SAR,  ,N 78,"Attività di ricerca, selezione, fornitura di personale      ",0,0,0,0,0,2023
SAR,  ,N 79,"Attività dei servizi delle agenzie di viaggio, dei tour o...",3,0,1,4,8,2023
SAR,  ,N 80,Servizi di vigilanza e investigazione                       ,0,0,0,0,0,2023
SAR,  ,N 81,Attività di servizi per edifici e paesaggio                 ,10,1,20,20,51,2023
SAR,  ,N 82,Attività di supporto per le funzioni d'ufficio e altri se...,5,0,5,5,15,2023
SAR,  ,O   ,Amministrazione pubblica e difesa; assicurazione sociale ...,0,0,0,0,0,2023
SAR,  ,O 84,Amministrazione pubblica e difesa; assicurazione sociale ...,0,0,0,0,0,2023
SAR,  ,P   ,Istruzione                                                  ,1,1,2,2,6,2023
SAR,  ,P 85,Istruzione                                                  ,1,1,2,2,6,2023
SAR,  ,Q   ,Sanita' e assistenza sociale                                ,8,0,0,18,26,2023
SAR,  ,Q 86,Assistenza sanitaria                                        ,8,0,0,1,9,2023
SAR,  ,Q 87,Servizi di assistenza sociale residenziale                  ,0,0,0,3,3,2023
SAR,  ,Q 88,Assistenza sociale non residenziale                         ,0,0,0,14,14,2023
SAR,  ,R   ,"Attività artistiche, sportive, di intrattenimento e diver...",16,0,2,5,23,2023
SAR,  ,R 90,"Attività creative, artistiche e di intrattenimento          ",7,0,1,2,10,2023
SAR,  ,R 91,"Attività di biblioteche, archivi, musei ed altre attività...",0,0,0,2,2,2023
SAR,  ,R 92,"Attività riguardanti le lotterie, le scommesse, le case d...",2,0,0,0,2,2023
SAR,  ,R 93,"Attività sportive, di intrattenimento e di divertimento     ",7,0,1,1,9,2023
SAR,  ,S   ,Altre attività di servizi                                   ,7,1,33,3,44,2023
SAR,  ,S 94,Attività di organizzazioni associative                      ,0,0,0,0,0,2023
SAR,  ,S 95,Riparazione di computer e di beni per uso personale e per...,2,0,7,1,10,2023
SAR,  ,S 96,Altre attività di servizi per la persona                    ,5,1,26,2,34,2023
SAR,  ,T   ,Attività di famiglie e convivenze come datori di lavoro p...,0,0,0,0,0,2023
SAR,  ,T 97,Attività di famiglie e convivenze come datori di lavoro p...,0,0,0,0,0,2023
SAR,  ,T 98,Produzione di beni e servizi indifferenziati per uso prop...,0,0,0,0,0,2023
SAR,  ,U   ,Organizzazioni ed organismi extraterritoriali               ,0,0,0,0,0,2023
SAR,  ,U 99,Organizzazioni ed organismi extraterritoriali               ,0,0,0,0,0,2023
SAR,  ,XX  ,Imprese non classificate                                    ,256,5,8,29,298,2023
SAR,  ,TOT ,TOTALE                                                      ,807,43,1097,250,2197,2023
SAR,SS,A   ,"Agricoltura, silvicoltura pesca                             ",6,1,24,6,37,2023
SAR,SS,A 01,"Coltivazioni agricole e produzione di prodotti animali, c...",3,1,22,5,31,2023
SAR,SS,A 02,Silvicoltura ed utilizzo di aree forestali                  ,0,0,0,0,0,2023
SAR,SS,A 03,Pesca e acquacoltura                                        ,3,0,2,1,6,2023
SAR,SS,B   ,Estrazione di minerali da cave e miniere                    ,7,1,0,0,8,2023
SAR,SS,B 05,Estrazione di carbone (esclusa torba)                       ,0,0,0,0,0,2023
SAR,SS,B 06,Estraz.di petrolio greggio e di gas naturale                ,0,0,0,0,0,2023
SAR,SS,B 07,Estrazione di minerali metalliferi                          ,0,0,0,0,0,2023
SAR,SS,B 08,Altre attività di estrazione di minerali da cave e miniere  ,7,1,0,0,8,2023
SAR,SS,B 09,Attività dei servizi di supporto all'estrazione             ,0,0,0,0,0,2023
SAR,SS,C   ,Attività manifatturiere                                     ,91,3,13,7,114,2023
SAR,SS,C 10,Industrie alimentari                                        ,18,3,0,4,25,2023
SAR,SS,C 11,Industria delle bevande                                     ,0,0,0,0,0,2023
SAR,SS,C 12,Industria del tabacco                                       ,0,0,0,0,0,2023
SAR,SS,C 13,Industrie tessili                                           ,1,0,1,0,2,2023
SAR,SS,C 14,Confezione di articoli di abbigliamento; confezione di ar...,6,0,0,0,6,2023
SAR,SS,C 15,Fabbricazione di articoli in pelle e simili                 ,1,0,0,0,1,2023
SAR,SS,C 16,Industria del legno e dei prodotti in legno e sughero (es...,13,0,1,1,15,2023
SAR,SS,C 17,Fabbricazione di carta e di prodotti di carta               ,0,0,0,0,0,2023
SAR,SS,C 18,Stampa e riproduzione di supporti registrati                ,3,0,0,1,4,2023
SAR,SS,C 19,Fabbricazione di coke e prodotti derivanti dalla raffinaz...,2,0,0,0,2,2023
SAR,SS,C 20,Fabbricazione di prodotti chimici                           ,3,0,0,0,3,2023
SAR,SS,C 21,Fabbricazione di prodotti farmaceutici di base e di prepa...,0,0,0,0,0,2023
SAR,SS,C 22,Fabbricazione di articoli in gomma e materie plastiche      ,2,0,0,0,2,2023
SAR,SS,C 23,Fabbricazione di altri prodotti della lavorazione di miner..,13,0,1,1,15,2023
SAR,SS,C 24,Metallurgia                                                 ,0,0,0,0,0,2023
SAR,SS,C 25,Fabbricazione di prodotti in metallo (esclusi macchinari ...,11,0,2,0,13,2023
SAR,SS,C 26,Fabbricazione di computer e prodotti di elettronica e ott...,1,0,0,0,1,2023
SAR,SS,C 27,Fabbricazione di apparecchiature elettriche ed apparecchi...,1,0,0,0,1,2023
SAR,SS,C 28,Fabbricazione di macchinari ed apparecchiature nca          ,5,0,0,0,5,2023
SAR,SS,C 29,"Fabbricazione di autoveicoli, rimorchi e semirimorchi       ",2,0,0,0,2,2023
SAR,SS,C 30,Fabbricazione di altri mezzi di trasporto                   ,3,0,0,0,3,2023
SAR,SS,C 31,Fabbricazione di mobili                                     ,2,0,3,0,5,2023
SAR,SS,C 32,Altre industrie manifatturiere                              ,1,0,1,0,2,2023
SAR,SS,C 33,"Riparazione, manutenzione ed installazione di macchine ed...",3,0,4,0,7,2023
SAR,SS,D   ,"Fornitura di energia elettrica, gas, vapore e aria condiz...",0,0,1,0,1,2023
SAR,SS,D 35,"Fornitura di energia elettrica, gas, vapore e aria condiz...",0,0,1,0,1,2023
SAR,SS,E   ,"Fornitura di acqua; reti fognarie, attività di gestione d...",0,0,0,1,1,2023
SAR,SS,E 36,"Raccolta, trattamento e fornitura di acqua                  ",0,0,0,0,0,2023
SAR,SS,E 37,Gestione delle reti fognarie                                ,0,0,0,0,0,2023
SAR,SS,E 38,"Attività di raccolta, trattamento e smaltimento dei rifiu...",0,0,0,1,1,2023
SAR,SS,E 39,Attività di risanamento e altri servizi di gestione dei r...,0,0,0,0,0,2023
SAR,SS,F   ,Costruzioni                                                 ,110,7,22,19,158,2023
SAR,SS,F 41,Costruzione di edifici                                      ,90,5,11,14,120,2023
SAR,SS,F 42,Ingegneria civile                                           ,2,0,0,0,2,2023
SAR,SS,F 43,Lavori di costruzione specializzati                         ,18,2,11,5,36,2023
SAR,SS,G   ,Commercio all'ingrosso e al dettaglio; riparazione di aut...,132,9,36,13,190,2023
SAR,SS,G 45,Commercio all'ingrosso e al dettaglio e riparazione di au...,13,0,2,1,16,2023
SAR,SS,G 46,Commercio all'ingrosso (escluso quello di autoveicoli e d...,57,5,9,3,74,2023
SAR,SS,G 47,Commercio al dettaglio (escluso quello di autoveicoli e d...,62,4,25,9,100,2023
SAR,SS,H   ,Trasporto e magazzinaggio                                   ,22,4,5,7,38,2023
SAR,SS,H 49,Trasporto terrestre e mediante condotte                     ,10,1,4,1,16,2023
SAR,SS,H 50,Trasporto marittimo e per vie d'acqua                       ,3,0,0,0,3,2023
SAR,SS,H 51,Trasporto aereo                                             ,1,0,0,0,1,2023
SAR,SS,H 52,Magazzinaggio e attività di supporto ai trasporti           ,6,3,1,5,15,2023
SAR,SS,H 53,Servizi postali e attività di corriere                      ,2,0,0,1,3,2023
SAR,SS,I   ,Attività dei servizi alloggio e ristorazione                ,63,6,13,4,86,2023
SAR,SS,I 55,Alloggio                                                    ,10,0,1,0,11,2023
SAR,SS,I 56,Attività dei servizi di ristorazione                        ,53,6,12,4,75,2023
SAR,SS,J   ,Servizi di informazione e comunicazione                     ,14,1,0,0,15,2023
SAR,SS,J 58,Attività editoriali                                         ,2,0,0,0,2,2023
SAR,SS,J 59,"Attività di produzione cinematografica, di video e di pro...",1,0,0,0,1,2023
SAR,SS,J 60,Attività di programmazione e trasmissione                   ,0,0,0,0,0,2023
SAR,SS,J 61,Telecomunicazioni                                           ,0,0,0,0,0,2023
SAR,SS,J 62,"Produzione di software, consulenza informatica e attività...",7,0,0,0,7,2023
SAR,SS,J 63,Attività dei servizi d'informazione e altri servizi infor...,4,1,0,0,5,2023
SAR,SS,K   ,Attività finanziarie e assicurative                         ,6,2,1,0,9,2023
SAR,SS,K 64,Attività di servizi finanziari (escluse le assicurazioni ...,2,0,0,0,2,2023
SAR,SS,K 65,"Assicurazioni, riassicurazioni e fondi pensione (escluse ...",0,0,0,0,0,2023
SAR,SS,K 66,Attività ausiliarie dei servizi finanziari e delle attivi...,4,2,1,0,7,2023
SAR,SS,L   ,Attivita' immobiliari                                       ,22,1,2,1,26,2023
SAR,SS,L 68,Attivita' immobiliari                                       ,22,1,2,1,26,2023
SAR,SS,M   ,"Attività professionali, scientifiche e tecniche             ",15,0,1,2,18,2023
SAR,SS,M 69,Attività legali e contabilità                               ,1,0,0,0,1,2023
SAR,SS,M 70,Attività di direzione aziendale e di consulenza gestional...,4,0,0,1,5,2023
SAR,SS,M 71,Attività degli studi di architettura e d'ingegneria; coll...,5,0,0,0,5,2023
SAR,SS,M 72,Ricerca scientifica e sviluppo                              ,0,0,0,0,0,2023
SAR,SS,M 73,Pubblicità e ricerche di mercato                            ,2,0,0,0,2,2023
SAR,SS,M 74,"Altre attività professionali, scientifiche e tecniche       ",3,0,1,1,5,2023
SAR,SS,M 75,Servizi veterinari                                          ,0,0,0,0,0,2023
SAR,SS,N   ,"Noleggio, agenzie di viaggio, servizi di supporto alle im...",25,1,2,14,42,2023
SAR,SS,N 77,Attività di noleggio e leasing operativo                    ,8,0,1,0,9,2023
SAR,SS,N 78,"Attività di ricerca, selezione, fornitura di personale      ",0,0,0,0,0,2023
SAR,SS,N 79,"Attività dei servizi delle agenzie di viaggio, dei tour o...",3,0,0,1,4,2023
SAR,SS,N 80,Servizi di vigilanza e investigazione                       ,0,0,0,0,0,2023
SAR,SS,N 81,Attività di servizi per edifici e paesaggio                 ,9,1,1,8,19,2023
SAR,SS,N 82,Attività di supporto per le funzioni d'ufficio e altri se...,5,0,0,5,10,2023
SAR,SS,O   ,Amministrazione pubblica e difesa; assicurazione sociale ...,0,0,0,0,0,2023
SAR,SS,O 84,Amministrazione pubblica e difesa; assicurazione sociale ...,0,0,0,0,0,2023
SAR,SS,P   ,Istruzione                                                  ,1,1,0,0,2,2023
SAR,SS,P 85,Istruzione                                                  ,1,1,0,0,2,2023
SAR,SS,Q   ,Sanita' e assistenza sociale                                ,8,0,0,7,15,2023
SAR,SS,Q 86,Assistenza sanitaria                                        ,8,0,0,1,9,2023
SAR,SS,Q 87,Servizi di assistenza sociale residenziale                  ,0,0,0,2,2,2023
SAR,SS,Q 88,Assistenza sociale non residenziale                         ,0,0,0,4,4,2023
SAR,SS,R   ,"Attività artistiche, sportive, di intrattenimento e diver...",16,0,0,2,18,2023
SAR,SS,R 90,"Attività creative, artistiche e di intrattenimento          ",7,0,0,1,8,2023
SAR,SS,R 91,"Attività di biblioteche, archivi, musei ed altre attività...",0,0,0,1,1,2023
SAR,SS,R 92,"Attività riguardanti le lotterie, le scommesse, le case d...",2,0,0,0,2,2023
SAR,SS,R 93,"Attività sportive, di intrattenimento e di divertimento     ",7,0,0,0,7,2023
SAR,SS,S   ,Altre attività di servizi                                   ,7,1,8,1,17,2023
SAR,SS,S 94,Attività di organizzazioni associative                      ,0,0,0,0,0,2023
SAR,SS,S 95,Riparazione di computer e di beni per uso personale e per...,2,0,0,0,2,2023
SAR,SS,S 96,Altre attività di servizi per la persona                    ,5,1,8,1,15,2023
SAR,SS,T   ,Attività di famiglie e convivenze come datori di lavoro p...,0,0,0,0,0,2023
SAR,SS,T 97,Attività di famiglie e convivenze come datori di lavoro p...,0,0,0,0,0,2023
SAR,SS,T 98,Produzione di beni e servizi indifferenziati per uso prop...,0,0,0,0,0,2023
SAR,SS,U   ,Organizzazioni ed organismi extraterritoriali               ,0,0,0,0,0,2023
SAR,SS,U 99,Organizzazioni ed organismi extraterritoriali               ,0,0,0,0,0,2023
SAR,SS,XX  ,Imprese non classificate                                    ,73,5,5,11,94,2023
SAR,SS,TOT ,TOTALE                                                      ,618,43,133,95,889,2023
SAR,NU,A   ,"Agricoltura, silvicoltura pesca                             ",0,0,0,2,2,2023
SAR,NU,A 01,"Coltivazioni agricole e produzione di prodotti animali, c...",0,0,0,0,0,2023
SAR,NU,A 02,Silvicoltura ed utilizzo di aree forestali                  ,0,0,0,1,1,2023
SAR,NU,A 03,Pesca e acquacoltura                                        ,0,0,0,1,1,2023
SAR,NU,B   ,Estrazione di minerali da cave e miniere                    ,0,0,0,0,0,2023
SAR,NU,B 05,Estrazione di carbone (esclusa torba)                       ,0,0,0,0,0,2023
SAR,NU,B 06,Estraz.di petrolio greggio e di gas naturale                ,0,0,0,0,0,2023
SAR,NU,B 07,Estrazione di minerali metalliferi                          ,0,0,0,0,0,2023
SAR,NU,B 08,Altre attività di estrazione di minerali da cave e miniere  ,0,0,0,0,0,2023
SAR,NU,B 09,Attività dei servizi di supporto all'estrazione             ,0,0,0,0,0,2023
SAR,NU,C   ,Attività manifatturiere                                     ,0,0,0,1,1,2023
SAR,NU,C 10,Industrie alimentari                                        ,0,0,0,0,0,2023
SAR,NU,C 11,Industria delle bevande                                     ,0,0,0,0,0,2023
SAR,NU,C 12,Industria del tabacco                                       ,0,0,0,0,0,2023
SAR,NU,C 13,Industrie tessili                                           ,0,0,0,1,1,2023
SAR,NU,C 14,Confezione di articoli di abbigliamento; confezione di ar...,0,0,0,0,0,2023
SAR,NU,C 15,Fabbricazione di articoli in pelle e simili                 ,0,0,0,0,0,2023
SAR,NU,C 16,Industria del legno e dei prodotti in legno e sughero (es...,0,0,0,0,0,2023
SAR,NU,C 17,Fabbricazione di carta e di prodotti di carta               ,0,0,0,0,0,2023
SAR,NU,C 18,Stampa e riproduzione di supporti registrati                ,0,0,0,0,0,2023
SAR,NU,C 19,Fabbricazione di coke e prodotti derivanti dalla raffinaz...,0,0,0,0,0,2023
SAR,NU,C 20,Fabbricazione di prodotti chimici                           ,0,0,0,0,0,2023
SAR,NU,C 21,Fabbricazione di prodotti farmaceutici di base e di prepa...,0,0,0,0,0,2023
SAR,NU,C 22,Fabbricazione di articoli in gomma e materie plastiche      ,0,0,0,0,0,2023
SAR,NU,C 23,Fabbricazione di altri prodotti della lavorazione di miner..,0,0,0,0,0,2023
SAR,NU,C 24,Metallurgia                                                 ,0,0,0,0,0,2023
SAR,NU,C 25,Fabbricazione di prodotti in metallo (esclusi macchinari ...,0,0,0,0,0,2023
SAR,NU,C 26,Fabbricazione di computer e prodotti di elettronica e ott...,0,0,0,0,0,2023
SAR,NU,C 27,Fabbricazione di apparecchiature elettriche ed apparecchi...,0,0,0,0,0,2023
SAR,NU,C 28,Fabbricazione di macchinari ed apparecchiature nca          ,0,0,0,0,0,2023
SAR,NU,C 29,"Fabbricazione di autoveicoli, rimorchi e semirimorchi       ",0,0,0,0,0,2023
SAR,NU,C 30,Fabbricazione di altri mezzi di trasporto                   ,0,0,0,0,0,2023
SAR,NU,C 31,Fabbricazione di mobili                                     ,0,0,0,0,0,2023
SAR,NU,C 32,Altre industrie manifatturiere                              ,0,0,0,0,0,2023
SAR,NU,C 33,"Riparazione, manutenzione ed installazione di macchine ed...",0,0,0,0,0,2023
SAR,NU,D   ,"Fornitura di energia elettrica, gas, vapore e aria condiz...",0,0,0,0,0,2023
SAR,NU,D 35,"Fornitura di energia elettrica, gas, vapore e aria condiz...",0,0,0,0,0,2023
SAR,NU,E   ,"Fornitura di acqua; reti fognarie, attività di gestione d...",0,0,0,1,1,2023
SAR,NU,E 36,"Raccolta, trattamento e fornitura di acqua                  ",0,0,0,0,0,2023
SAR,NU,E 37,Gestione delle reti fognarie                                ,0,0,0,0,0,2023
SAR,NU,E 38,"Attività di raccolta, trattamento e smaltimento dei rifiu...",0,0,0,1,1,2023
SAR,NU,E 39,Attività di risanamento e altri servizi di gestione dei r...,0,0,0,0,0,2023
SAR,NU,F   ,Costruzioni                                                 ,0,0,0,3,3,2023
SAR,NU,F 41,Costruzione di edifici                                      ,0,0,0,1,1,2023
SAR,NU,F 42,Ingegneria civile                                           ,0,0,0,1,1,2023
SAR,NU,F 43,Lavori di costruzione specializzati                         ,0,0,0,1,1,2023
SAR,NU,G   ,Commercio all'ingrosso e al dettaglio; riparazione di aut...,0,0,0,0,0,2023
SAR,NU,G 45,Commercio all'ingrosso e al dettaglio e riparazione di au...,0,0,0,0,0,2023
SAR,NU,G 46,Commercio all'ingrosso (escluso quello di autoveicoli e d...,0,0,0,0,0,2023
SAR,NU,G 47,Commercio al dettaglio (escluso quello di autoveicoli e d...,0,0,0,0,0,2023
SAR,NU,H   ,Trasporto e magazzinaggio                                   ,0,0,0,1,1,2023
SAR,NU,H 49,Trasporto terrestre e mediante condotte                     ,0,0,0,0,0,2023
SAR,NU,H 50,Trasporto marittimo e per vie d'acqua                       ,0,0,0,0,0,2023
SAR,NU,H 51,Trasporto aereo                                             ,0,0,0,0,0,2023
SAR,NU,H 52,Magazzinaggio e attività di supporto ai trasporti           ,0,0,0,0,0,2023
SAR,NU,H 53,Servizi postali e attività di corriere                      ,0,0,0,1,1,2023
SAR,NU,I   ,Attività dei servizi alloggio e ristorazione                ,0,0,0,0,0,2023
SAR,NU,I 55,Alloggio                                                    ,0,0,0,0,0,2023
SAR,NU,I 56,Attività dei servizi di ristorazione                        ,0,0,0,0,0,2023
SAR,NU,J   ,Servizi di informazione e comunicazione                     ,0,0,0,0,0,2023
SAR,NU,J 58,Attività editoriali                                         ,0,0,0,0,0,2023
SAR,NU,J 59,"Attività di produzione cinematografica, di video e di pro...",0,0,0,0,0,2023
SAR,NU,J 60,Attività di programmazione e trasmissione                   ,0,0,0,0,0,2023
SAR,NU,J 61,Telecomunicazioni                                           ,0,0,0,0,0,2023
SAR,NU,J 62,"Produzione di software, consulenza informatica e attività...",0,0,0,0,0,2023
SAR,NU,J 63,Attività dei servizi d'informazione e altri servizi infor...,0,0,0,0,0,2023
SAR,NU,K   ,Attività finanziarie e assicurative                         ,0,0,0,0,0,2023
SAR,NU,K 64,Attività di servizi finanziari (escluse le assicurazioni ...,0,0,0,0,0,2023
SAR,NU,K 65,"Assicurazioni, riassicurazioni e fondi pensione (escluse ...",0,0,0,0,0,2023
SAR,NU,K 66,Attività ausiliarie dei servizi finanziari e delle attivi...,0,0,0,0,0,2023
SAR,NU,L   ,Attivita' immobiliari                                       ,0,0,0,0,0,2023
SAR,NU,L 68,Attivita' immobiliari                                       ,0,0,0,0,0,2023
SAR,NU,M   ,"Attività professionali, scientifiche e tecniche             ",0,0,0,0,0,2023
SAR,NU,M 69,Attività legali e contabilità                               ,0,0,0,0,0,2023
SAR,NU,M 70,Attività di direzione aziendale e di consulenza gestional...,0,0,0,0,0,2023
SAR,NU,M 71,Attività degli studi di architettura e d'ingegneria; coll...,0,0,0,0,0,2023
SAR,NU,M 72,Ricerca scientifica e sviluppo                              ,0,0,0,0,0,2023
SAR,NU,M 73,Pubblicità e ricerche di mercato                            ,0,0,0,0,0,2023
SAR,NU,M 74,"Altre attività professionali, scientifiche e tecniche       ",0,0,0,0,0,2023
SAR,NU,M 75,Servizi veterinari                                          ,0,0,0,0,0,2023
SAR,NU,N   ,"Noleggio, agenzie di viaggio, servizi di supporto alle im...",0,0,0,2,2,2023
SAR,NU,N 77,Attività di noleggio e leasing operativo                    ,0,0,0,0,0,2023
SAR,NU,N 78,"Attività di ricerca, selezione, fornitura di personale      ",0,0,0,0,0,2023
SAR,NU,N 79,"Attività dei servizi delle agenzie di viaggio, dei tour o...",0,0,0,1,1,2023
SAR,NU,N 80,Servizi di vigilanza e investigazione                       ,0,0,0,0,0,2023
SAR,NU,N 81,Attività di servizi per edifici e paesaggio                 ,0,0,0,1,1,2023
SAR,NU,N 82,Attività di supporto per le funzioni d'ufficio e altri se...,0,0,0,0,0,2023
SAR,NU,O   ,Amministrazione pubblica e difesa; assicurazione sociale ...,0,0,0,0,0,2023
SAR,NU,O 84,Amministrazione pubblica e difesa; assicurazione sociale ...,0,0,0,0,0,2023
SAR,NU,P   ,Istruzione                                                  ,0,0,0,0,0,2023
SAR,NU,P 85,Istruzione                                                  ,0,0,0,0,0,2023
SAR,NU,Q   ,Sanita' e assistenza sociale                                ,0,0,0,1,1,2023
SAR,NU,Q 86,Assistenza sanitaria                                        ,0,0,0,0,0,2023
SAR,NU,Q 87,Servizi di assistenza sociale residenziale                  ,0,0,0,0,0,2023
SAR,NU,Q 88,Assistenza sociale non residenziale                         ,0,0,0,1,1,2023
SAR,NU,R   ,"Attività artistiche, sportive, di intrattenimento e diver...",0,0,0,1,1,2023
SAR,NU,R 90,"Attività creative, artistiche e di intrattenimento          ",0,0,0,0,0,2023
SAR,NU,R 91,"Attività di biblioteche, archivi, musei ed altre attività...",0,0,0,1,1,2023
SAR,NU,R 92,"Attività riguardanti le lotterie, le scommesse, le case d...",0,0,0,0,0,2023
SAR,NU,R 93,"Attività sportive, di intrattenimento e di divertimento     ",0,0,0,0,0,2023
SAR,NU,S   ,Altre attività di servizi                                   ,0,0,0,0,0,2023
SAR,NU,S 94,Attività di organizzazioni associative                      ,0,0,0,0,0,2023
SAR,NU,S 95,Riparazione di computer e di beni per uso personale e per...,0,0,0,0,0,2023
SAR,NU,S 96,Altre attività di servizi per la persona                    ,0,0,0,0,0,2023
SAR,NU,T   ,Attività di famiglie e convivenze come datori di lavoro p...,0,0,0,0,0,2023
SAR,NU,T 97,Attività di famiglie e convivenze come datori di lavoro p...,0,0,0,0,0,2023
SAR,NU,T 98,Produzione di beni e servizi indifferenziati per uso prop...,0,0,0,0,0,2023
SAR,NU,U   ,Organizzazioni ed organismi extraterritoriali               ,0,0,0,0,0,2023
SAR,NU,U 99,Organizzazioni ed organismi extraterritoriali               ,0,0,0,0,0,2023
SAR,NU,XX  ,Imprese non classificate                                    ,0,0,0,1,1,2023
SAR,NU,TOT ,TOTALE                                                      ,0,0,0,13,13,2023
SAR,CA,A   ,"Agricoltura, silvicoltura pesca                             ",0,0,161,3,164,2023
SAR,CA,A 01,"Coltivazioni agricole e produzione di prodotti animali, c...",0,0,156,2,158,2023
SAR,CA,A 02,Silvicoltura ed utilizzo di aree forestali                  ,0,0,2,1,3,2023
SAR,CA,A 03,Pesca e acquacoltura                                        ,0,0,3,0,3,2023
SAR,CA,B   ,Estrazione di minerali da cave e miniere                    ,0,0,1,0,1,2023
SAR,CA,B 05,Estrazione di carbone (esclusa torba)                       ,0,0,0,0,0,2023
SAR,CA,B 06,Estraz.di petrolio greggio e di gas naturale                ,0,0,0,0,0,2023
SAR,CA,B 07,Estrazione di minerali metalliferi                          ,0,0,0,0,0,2023
SAR,CA,B 08,Altre attività di estrazione di minerali da cave e miniere  ,0,0,1,0,1,2023
SAR,CA,B 09,Attività dei servizi di supporto all'estrazione             ,0,0,0,0,0,2023
SAR,CA,C   ,Attività manifatturiere                                     ,0,0,53,8,61,2023
SAR,CA,C 10,Industrie alimentari                                        ,0,0,6,3,9,2023
SAR,CA,C 11,Industria delle bevande                                     ,0,0,0,0,0,2023
SAR,CA,C 12,Industria del tabacco                                       ,0,0,0,0,0,2023
SAR,CA,C 13,Industrie tessili                                           ,0,0,1,0,1,2023
SAR,CA,C 14,Confezione di articoli di abbigliamento; confezione di ar...,0,0,2,0,2,2023
SAR,CA,C 15,Fabbricazione di articoli in pelle e simili                 ,0,0,0,0,0,2023
SAR,CA,C 16,Industria del legno e dei prodotti in legno e sughero (es...,0,0,8,2,10,2023
SAR,CA,C 17,Fabbricazione di carta e di prodotti di carta               ,0,0,0,0,0,2023
SAR,CA,C 18,Stampa e riproduzione di supporti registrati                ,0,0,3,0,3,2023
SAR,CA,C 19,Fabbricazione di coke e prodotti derivanti dalla raffinaz...,0,0,0,0,0,2023
SAR,CA,C 20,Fabbricazione di prodotti chimici                           ,0,0,0,0,0,2023
SAR,CA,C 21,Fabbricazione di prodotti farmaceutici di base e di prepa...,0,0,0,0,0,2023
SAR,CA,C 22,Fabbricazione di articoli in gomma e materie plastiche      ,0,0,0,0,0,2023
SAR,CA,C 23,Fabbricazione di altri prodotti della lavorazione di miner..,0,0,3,1,4,2023
SAR,CA,C 24,Metallurgia                                                 ,0,0,2,0,2,2023
SAR,CA,C 25,Fabbricazione di prodotti in metallo (esclusi macchinari ...,0,0,17,1,18,2023
SAR,CA,C 26,Fabbricazione di computer e prodotti di elettronica e ott...,0,0,0,0,0,2023
SAR,CA,C 27,Fabbricazione di apparecchiature elettriche ed apparecchi...,0,0,0,0,0,2023
SAR,CA,C 28,Fabbricazione di macchinari ed apparecchiature nca          ,0,0,0,0,0,2023
SAR,CA,C 29,"Fabbricazione di autoveicoli, rimorchi e semirimorchi       ",0,0,0,0,0,2023
SAR,CA,C 30,Fabbricazione di altri mezzi di trasporto                   ,0,0,1,1,2,2023
SAR,CA,C 31,Fabbricazione di mobili                                     ,0,0,0,0,0,2023
SAR,CA,C 32,Altre industrie manifatturiere                              ,0,0,7,0,7,2023
SAR,CA,C 33,"Riparazione, manutenzione ed installazione di macchine ed...",0,0,3,0,3,2023
SAR,CA,D   ,"Fornitura di energia elettrica, gas, vapore e aria condiz...",0,0,2,0,2,2023
SAR,CA,D 35,"Fornitura di energia elettrica, gas, vapore e aria condiz...",0,0,2,0,2,2023
SAR,CA,E   ,"Fornitura di acqua; reti fognarie, attività di gestione d...",0,0,0,0,0,2023
SAR,CA,E 36,"Raccolta, trattamento e fornitura di acqua                  ",0,0,0,0,0,2023
SAR,CA,E 37,Gestione delle reti fognarie                                ,0,0,0,0,0,2023
SAR,CA,E 38,"Attività di raccolta, trattamento e smaltimento dei rifiu...",0,0,0,0,0,2023
SAR,CA,E 39,Attività di risanamento e altri servizi di gestione dei r...,0,0,0,0,0,2023
SAR,CA,F   ,Costruzioni                                                 ,2,0,171,12,185,2023
SAR,CA,F 41,Costruzione di edifici                                      ,1,0,85,9,95,2023
SAR,CA,F 42,Ingegneria civile                                           ,0,0,0,1,1,2023
SAR,CA,F 43,Lavori di costruzione specializzati                         ,1,0,86,2,89,2023
SAR,CA,G   ,Commercio all'ingrosso e al dettaglio; riparazione di aut...,3,0,280,13,296,2023
SAR,CA,G 45,Commercio all'ingrosso e al dettaglio e riparazione di au...,0,0,8,2,10,2023
SAR,CA,G 46,Commercio all'ingrosso (escluso quello di autoveicoli e d...,2,0,48,3,53,2023
SAR,CA,G 47,Commercio al dettaglio (escluso quello di autoveicoli e d...,1,0,224,8,233,2023
SAR,CA,H   ,Trasporto e magazzinaggio                                   ,0,0,20,7,27,2023
SAR,CA,H 49,Trasporto terrestre e mediante condotte                     ,0,0,15,5,20,2023
SAR,CA,H 50,Trasporto marittimo e per vie d'acqua                       ,0,0,0,0,0,2023
SAR,CA,H 51,Trasporto aereo                                             ,0,0,0,0,0,2023
SAR,CA,H 52,Magazzinaggio e attività di supporto ai trasporti           ,0,0,2,1,3,2023
SAR,CA,H 53,Servizi postali e attività di corriere                      ,0,0,3,1,4,2023
SAR,CA,I   ,Attività dei servizi alloggio e ristorazione                ,0,0,71,9,80,2023
SAR,CA,I 55,Alloggio                                                    ,0,0,4,0,4,2023
SAR,CA,I 56,Attività dei servizi di ristorazione                        ,0,0,67,9,76,2023
SAR,CA,J   ,Servizi di informazione e comunicazione                     ,0,0,35,3,38,2023
SAR,CA,J 58,Attività editoriali                                         ,0,0,2,0,2,2023
SAR,CA,J 59,"Attività di produzione cinematografica, di video e di pro...",0,0,2,0,2,2023
SAR,CA,J 60,Attività di programmazione e trasmissione                   ,0,0,0,0,0,2023
SAR,CA,J 61,Telecomunicazioni                                           ,0,0,2,0,2,2023
SAR,CA,J 62,"Produzione di software, consulenza informatica e attività...",0,0,2,1,3,2023
SAR,CA,J 63,Attività dei servizi d'informazione e altri servizi infor...,0,0,27,2,29,2023
SAR,CA,K   ,Attività finanziarie e assicurative                         ,0,0,7,0,7,2023
SAR,CA,K 64,Attività di servizi finanziari (escluse le assicurazioni ...,0,0,0,0,0,2023
SAR,CA,K 65,"Assicurazioni, riassicurazioni e fondi pensione (escluse ...",0,0,0,0,0,2023
SAR,CA,K 66,Attività ausiliarie dei servizi finanziari e delle attivi...,0,0,7,0,7,2023
SAR,CA,L   ,Attivita' immobiliari                                       ,0,0,4,0,4,2023
SAR,CA,L 68,Attivita' immobiliari                                       ,0,0,4,0,4,2023
SAR,CA,M   ,"Attività professionali, scientifiche e tecniche             ",0,0,8,3,11,2023
SAR,CA,M 69,Attività legali e contabilità                               ,0,0,0,0,0,2023
SAR,CA,M 70,Attività di direzione aziendale e di consulenza gestional...,0,0,1,0,1,2023
SAR,CA,M 71,Attività degli studi di architettura e d'ingegneria; coll...,0,0,0,1,1,2023
SAR,CA,M 72,Ricerca scientifica e sviluppo                              ,0,0,0,0,0,2023
SAR,CA,M 73,Pubblicità e ricerche di mercato                            ,0,0,2,0,2,2023
SAR,CA,M 74,"Altre attività professionali, scientifiche e tecniche       ",0,0,5,2,7,2023
SAR,CA,M 75,Servizi veterinari                                          ,0,0,0,0,0,2023
SAR,CA,N   ,"Noleggio, agenzie di viaggio, servizi di supporto alle im...",1,0,28,8,37,2023
SAR,CA,N 77,Attività di noleggio e leasing operativo                    ,0,0,3,0,3,2023
SAR,CA,N 78,"Attività di ricerca, selezione, fornitura di personale      ",0,0,0,0,0,2023
SAR,CA,N 79,"Attività dei servizi delle agenzie di viaggio, dei tour o...",0,0,1,1,2,2023
SAR,CA,N 80,Servizi di vigilanza e investigazione                       ,0,0,0,0,0,2023
SAR,CA,N 81,Attività di servizi per edifici e paesaggio                 ,1,0,19,7,27,2023
SAR,CA,N 82,Attività di supporto per le funzioni d'ufficio e altri se...,0,0,5,0,5,2023
SAR,CA,O   ,Amministrazione pubblica e difesa; assicurazione sociale ...,0,0,0,0,0,2023
SAR,CA,O 84,Amministrazione pubblica e difesa; assicurazione sociale ...,0,0,0,0,0,2023
SAR,CA,P   ,Istruzione                                                  ,0,0,2,1,3,2023
SAR,CA,P 85,Istruzione                                                  ,0,0,2,1,3,2023
SAR,CA,Q   ,Sanita' e assistenza sociale                                ,0,0,0,9,9,2023
SAR,CA,Q 86,Assistenza sanitaria                                        ,0,0,0,0,0,2023
SAR,CA,Q 87,Servizi di assistenza sociale residenziale                  ,0,0,0,1,1,2023
SAR,CA,Q 88,Assistenza sociale non residenziale                         ,0,0,0,8,8,2023
SAR,CA,R   ,"Attività artistiche, sportive, di intrattenimento e diver...",0,0,2,2,4,2023
SAR,CA,R 90,"Attività creative, artistiche e di intrattenimento          ",0,0,1,1,2,2023
SAR,CA,R 91,"Attività di biblioteche, archivi, musei ed altre attività...",0,0,0,0,0,2023
SAR,CA,R 92,"Attività riguardanti le lotterie, le scommesse, le case d...",0,0,0,0,0,2023
SAR,CA,R 93,"Attività sportive, di intrattenimento e di divertimento     ",0,0,1,1,2,2023
SAR,CA,S   ,Altre attività di servizi                                   ,0,0,25,2,27,2023
SAR,CA,S 94,Attività di organizzazioni associative                      ,0,0,0,0,0,2023
SAR,CA,S 95,Riparazione di computer e di beni per uso personale e per...,0,0,7,1,8,2023
SAR,CA,S 96,Altre attività di servizi per la persona                    ,0,0,18,1,19,2023
SAR,CA,T   ,Attività di famiglie e convivenze come datori di lavoro p...,0,0,0,0,0,2023
SAR,CA,T 97,Attività di famiglie e convivenze come datori di lavoro p...,0,0,0,0,0,2023
SAR,CA,T 98,Produzione di beni e servizi indifferenziati per uso prop...,0,0,0,0,0,2023
SAR,CA,U   ,Organizzazioni ed organismi extraterritoriali               ,0,0,0,0,0,2023
SAR,CA,U 99,Organizzazioni ed organismi extraterritoriali               ,0,0,0,0,0,2023
SAR,CA,XX  ,Imprese non classificate                                    ,183,0,2,12,197,2023
SAR,CA,TOT ,TOTALE                                                      ,189,0,872,92,1153,2023
SAR,OR,A   ,"Agricoltura, silvicoltura pesca                             ",0,0,62,7,69,2023
SAR,OR,A 01,"Coltivazioni agricole e produzione di prodotti animali, c...",0,0,61,3,64,2023
SAR,OR,A 02,Silvicoltura ed utilizzo di aree forestali                  ,0,0,1,0,1,2023
SAR,OR,A 03,Pesca e acquacoltura                                        ,0,0,0,4,4,2023
SAR,OR,B   ,Estrazione di minerali da cave e miniere                    ,0,0,0,0,0,2023
SAR,OR,B 05,Estrazione di carbone (esclusa torba)                       ,0,0,0,0,0,2023
SAR,OR,B 06,Estraz.di petrolio greggio e di gas naturale                ,0,0,0,0,0,2023
SAR,OR,B 07,Estrazione di minerali metalliferi                          ,0,0,0,0,0,2023
SAR,OR,B 08,Altre attività di estrazione di minerali da cave e miniere  ,0,0,0,0,0,2023
SAR,OR,B 09,Attività dei servizi di supporto all'estrazione             ,0,0,0,0,0,2023
SAR,OR,C   ,Attività manifatturiere                                     ,0,0,1,8,9,2023
SAR,OR,C 10,Industrie alimentari                                        ,0,0,0,6,6,2023
SAR,OR,C 11,Industria delle bevande                                     ,0,0,1,0,1,2023
SAR,OR,C 12,Industria del tabacco                                       ,0,0,0,0,0,2023
SAR,OR,C 13,Industrie tessili                                           ,0,0,0,1,1,2023
SAR,OR,C 14,Confezione di articoli di abbigliamento; confezione di ar...,0,0,0,0,0,2023
SAR,OR,C 15,Fabbricazione di articoli in pelle e simili                 ,0,0,0,0,0,2023
SAR,OR,C 16,Industria del legno e dei prodotti in legno e sughero (es...,0,0,0,0,0,2023
SAR,OR,C 17,Fabbricazione di carta e di prodotti di carta               ,0,0,0,0,0,2023
SAR,OR,C 18,Stampa e riproduzione di supporti registrati                ,0,0,0,0,0,2023
SAR,OR,C 19,Fabbricazione di coke e prodotti derivanti dalla raffinaz...,0,0,0,0,0,2023
SAR,OR,C 20,Fabbricazione di prodotti chimici                           ,0,0,0,0,0,2023
SAR,OR,C 21,Fabbricazione di prodotti farmaceutici di base e di prepa...,0,0,0,0,0,2023
SAR,OR,C 22,Fabbricazione di articoli in gomma e materie plastiche      ,0,0,0,0,0,2023
SAR,OR,C 23,Fabbricazione di altri prodotti della lavorazione di miner..,0,0,0,0,0,2023
SAR,OR,C 24,Metallurgia                                                 ,0,0,0,0,0,2023
SAR,OR,C 25,Fabbricazione di prodotti in metallo (esclusi macchinari ...,0,0,0,0,0,2023
SAR,OR,C 26,Fabbricazione di computer e prodotti di elettronica e ott...,0,0,0,0,0,2023
SAR,OR,C 27,Fabbricazione di apparecchiature elettriche ed apparecchi...,0,0,0,1,1,2023
SAR,OR,C 28,Fabbricazione di macchinari ed apparecchiature nca          ,0,0,0,0,0,2023
SAR,OR,C 29,"Fabbricazione di autoveicoli, rimorchi e semirimorchi       ",0,0,0,0,0,2023
SAR,OR,C 30,Fabbricazione di altri mezzi di trasporto                   ,0,0,0,0,0,2023
SAR,OR,C 31,Fabbricazione di mobili                                     ,0,0,0,0,0,2023
SAR,OR,C 32,Altre industrie manifatturiere                              ,0,0,0,0,0,2023
SAR,OR,C 33,"Riparazione, manutenzione ed installazione di macchine ed...",0,0,0,0,0,2023
SAR,OR,D   ,"Fornitura di energia elettrica, gas, vapore e aria condiz...",0,0,0,0,0,2023
SAR,OR,D 35,"Fornitura di energia elettrica, gas, vapore e aria condiz...",0,0,0,0,0,2023
SAR,OR,E   ,"Fornitura di acqua; reti fognarie, attività di gestione d...",0,0,0,0,0,2023
SAR,OR,E 36,"Raccolta, trattamento e fornitura di acqua                  ",0,0,0,0,0,2023
SAR,OR,E 37,Gestione delle reti fognarie                                ,0,0,0,0,0,2023
SAR,OR,E 38,"Attività di raccolta, trattamento e smaltimento dei rifiu...",0,0,0,0,0,2023
SAR,OR,E 39,Attività di risanamento e altri servizi di gestione dei r...,0,0,0,0,0,2023
SAR,OR,F   ,Costruzioni                                                 ,0,0,2,10,12,2023
SAR,OR,F 41,Costruzione di edifici                                      ,0,0,0,7,7,2023
SAR,OR,F 42,Ingegneria civile                                           ,0,0,0,0,0,2023
SAR,OR,F 43,Lavori di costruzione specializzati                         ,0,0,2,3,5,2023
SAR,OR,G   ,Commercio all'ingrosso e al dettaglio; riparazione di aut...,0,0,23,5,28,2023
SAR,OR,G 45,Commercio all'ingrosso e al dettaglio e riparazione di au...,0,0,2,0,2,2023
SAR,OR,G 46,Commercio all'ingrosso (escluso quello di autoveicoli e d...,0,0,3,1,4,2023
SAR,OR,G 47,Commercio al dettaglio (escluso quello di autoveicoli e d...,0,0,18,4,22,2023
SAR,OR,H   ,Trasporto e magazzinaggio                                   ,0,0,1,3,4,2023
SAR,OR,H 49,Trasporto terrestre e mediante condotte                     ,0,0,1,0,1,2023
SAR,OR,H 50,Trasporto marittimo e per vie d'acqua                       ,0,0,0,0,0,2023
SAR,OR,H 51,Trasporto aereo                                             ,0,0,0,0,0,2023
SAR,OR,H 52,Magazzinaggio e attività di supporto ai trasporti           ,0,0,0,3,3,2023
SAR,OR,H 53,Servizi postali e attività di corriere                      ,0,0,0,0,0,2023
SAR,OR,I   ,Attività dei servizi alloggio e ristorazione                ,0,0,2,5,7,2023
SAR,OR,I 55,Alloggio                                                    ,0,0,1,0,1,2023
SAR,OR,I 56,Attività dei servizi di ristorazione                        ,0,0,1,5,6,2023
SAR,OR,J   ,Servizi di informazione e comunicazione                     ,0,0,0,0,0,2023
SAR,OR,J 58,Attività editoriali                                         ,0,0,0,0,0,2023
SAR,OR,J 59,"Attività di produzione cinematografica, di video e di pro...",0,0,0,0,0,2023
SAR,OR,J 60,Attività di programmazione e trasmissione                   ,0,0,0,0,0,2023
SAR,OR,J 61,Telecomunicazioni                                           ,0,0,0,0,0,2023
SAR,OR,J 62,"Produzione di software, consulenza informatica e attività...",0,0,0,0,0,2023
SAR,OR,J 63,Attività dei servizi d'informazione e altri servizi infor...,0,0,0,0,0,2023
SAR,OR,K   ,Attività finanziarie e assicurative                         ,0,0,0,0,0,2023
SAR,OR,K 64,Attività di servizi finanziari (escluse le assicurazioni ...,0,0,0,0,0,2023
SAR,OR,K 65,"Assicurazioni, riassicurazioni e fondi pensione (escluse ...",0,0,0,0,0,2023
SAR,OR,K 66,Attività ausiliarie dei servizi finanziari e delle attivi...,0,0,0,0,0,2023
SAR,OR,L   ,Attivita' immobiliari                                       ,0,0,0,0,0,2023
SAR,OR,L 68,Attivita' immobiliari                                       ,0,0,0,0,0,2023
SAR,OR,M   ,"Attività professionali, scientifiche e tecniche             ",0,0,0,0,0,2023
SAR,OR,M 69,Attività legali e contabilità                               ,0,0,0,0,0,2023
SAR,OR,M 70,Attività di direzione aziendale e di consulenza gestional...,0,0,0,0,0,2023
SAR,OR,M 71,Attività degli studi di architettura e d'ingegneria; coll...,0,0,0,0,0,2023
SAR,OR,M 72,Ricerca scientifica e sviluppo                              ,0,0,0,0,0,2023
SAR,OR,M 73,Pubblicità e ricerche di mercato                            ,0,0,0,0,0,2023
SAR,OR,M 74,"Altre attività professionali, scientifiche e tecniche       ",0,0,0,0,0,2023
SAR,OR,M 75,Servizi veterinari                                          ,0,0,0,0,0,2023
SAR,OR,N   ,"Noleggio, agenzie di viaggio, servizi di supporto alle im...",0,0,0,5,5,2023
SAR,OR,N 77,Attività di noleggio e leasing operativo                    ,0,0,0,0,0,2023
SAR,OR,N 78,"Attività di ricerca, selezione, fornitura di personale      ",0,0,0,0,0,2023
SAR,OR,N 79,"Attività dei servizi delle agenzie di viaggio, dei tour o...",0,0,0,1,1,2023
SAR,OR,N 80,Servizi di vigilanza e investigazione                       ,0,0,0,0,0,2023
SAR,OR,N 81,Attività di servizi per edifici e paesaggio                 ,0,0,0,4,4,2023
SAR,OR,N 82,Attività di supporto per le funzioni d'ufficio e altri se...,0,0,0,0,0,2023
SAR,OR,O   ,Amministrazione pubblica e difesa; assicurazione sociale ...,0,0,0,0,0,2023
SAR,OR,O 84,Amministrazione pubblica e difesa; assicurazione sociale ...,0,0,0,0,0,2023
SAR,OR,P   ,Istruzione                                                  ,0,0,0,1,1,2023
SAR,OR,P 85,Istruzione                                                  ,0,0,0,1,1,2023
SAR,OR,Q   ,Sanita' e assistenza sociale                                ,0,0,0,1,1,2023
SAR,OR,Q 86,Assistenza sanitaria                                        ,0,0,0,0,0,2023
SAR,OR,Q 87,Servizi di assistenza sociale residenziale                  ,0,0,0,0,0,2023
SAR,OR,Q 88,Assistenza sociale non residenziale                         ,0,0,0,1,1,2023
SAR,OR,R   ,"Attività artistiche, sportive, di intrattenimento e diver...",0,0,0,0,0,2023
SAR,OR,R 90,"Attività creative, artistiche e di intrattenimento          ",0,0,0,0,0,2023
SAR,OR,R 91,"Attività di biblioteche, archivi, musei ed altre attività...",0,0,0,0,0,2023
SAR,OR,R 92,"Attività riguardanti le lotterie, le scommesse, le case d...",0,0,0,0,0,2023
SAR,OR,R 93,"Attività sportive, di intrattenimento e di divertimento     ",0,0,0,0,0,2023
SAR,OR,S   ,Altre attività di servizi                                   ,0,0,0,0,0,2023
SAR,OR,S 94,Attività di organizzazioni associative                      ,0,0,0,0,0,2023
SAR,OR,S 95,Riparazione di computer e di beni per uso personale e per...,0,0,0,0,0,2023
SAR,OR,S 96,Altre attività di servizi per la persona                    ,0,0,0,0,0,2023
SAR,OR,T   ,Attività di famiglie e convivenze come datori di lavoro p...,0,0,0,0,0,2023
SAR,OR,T 97,Attività di famiglie e convivenze come datori di lavoro p...,0,0,0,0,0,2023
SAR,OR,T 98,Produzione di beni e servizi indifferenziati per uso prop...,0,0,0,0,0,2023
SAR,OR,U   ,Organizzazioni ed organismi extraterritoriali               ,0,0,0,0,0,2023
SAR,OR,U 99,Organizzazioni ed organismi extraterritoriali               ,0,0,0,0,0,2023
SAR,OR,XX  ,Imprese non classificate                                    ,0,0,1,5,6,2023
SAR,OR,TOT ,TOTALE                                                      ,0,0,92,50,142,2023
