REG,PROV,CODAT,DESC,CESSUFFSC,CESSUFFSP,CESSUFFDI,CESSUFFAF,CESSUFFTOT,Anno
PIE,  ,A   ,"Agricoltura, silvicoltura pesca                             ",2,8,102,1,113,2021
PIE,  ,A 01,"Coltivazioni agricole e produzione di prodotti animali, c...",2,6,100,1,109,2021
PIE,  ,A 02,Silvicoltura ed utilizzo di aree forestali                  ,0,2,2,0,4,2021
PIE,  ,A 03,Pesca e acquacoltura                                        ,0,0,0,0,0,2021
PIE,  ,B   ,Estrazione di minerali da cave e miniere                    ,1,0,0,0,1,2021
PIE,  ,B 05,Estrazione di carbone (esclusa torba)                       ,0,0,0,0,0,2021
PIE,  ,B 06,Estraz.di petrolio greggio e di gas naturale                ,0,0,0,0,0,2021
PIE,  ,B 07,Estrazione di minerali metalliferi                          ,0,0,0,0,0,2021
PIE,  ,B 08,Altre attività di estrazione di minerali da cave e miniere  ,1,0,0,0,1,2021
PIE,  ,B 09,Attività dei servizi di supporto all'estrazione             ,0,0,0,0,0,2021
PIE,  ,C   ,Attività manifatturiere                                     ,88,147,136,2,373,2021
PIE,  ,C 10,Industrie alimentari                                        ,3,3,9,0,15,2021
PIE,  ,C 11,Industria delle bevande                                     ,0,0,1,0,1,2021
PIE,  ,C 12,Industria del tabacco                                       ,0,0,0,0,0,2021
PIE,  ,C 13,Industrie tessili                                           ,12,25,4,0,41,2021
PIE,  ,C 14,Confezione di articoli di abbigliamento; confezione di ar...,4,11,8,0,23,2021
PIE,  ,C 15,Fabbricazione di articoli in pelle e simili                 ,1,4,0,0,5,2021
PIE,  ,C 16,Industria del legno e dei prodotti in legno e sughero (es...,2,6,11,0,19,2021
PIE,  ,C 17,Fabbricazione di carta e di prodotti di carta               ,2,2,0,0,4,2021
PIE,  ,C 18,Stampa e riproduzione di supporti registrati                ,6,6,2,0,14,2021
PIE,  ,C 19,Fabbricazione di coke e prodotti derivanti dalla raffinaz...,0,1,0,0,1,2021
PIE,  ,C 20,Fabbricazione di prodotti chimici                           ,1,3,1,0,5,2021
PIE,  ,C 21,Fabbricazione di prodotti farmaceutici di base e di prepa...,0,0,0,0,0,2021
PIE,  ,C 22,Fabbricazione di articoli in gomma e materie plastiche      ,7,2,4,0,13,2021
PIE,  ,C 23,Fabbricazione di altri prodotti della lavorazione di miner..,3,3,7,0,13,2021
PIE,  ,C 24,Metallurgia                                                 ,2,0,0,0,2,2021
PIE,  ,C 25,Fabbricazione di prodotti in metallo (esclusi macchinari ...,17,42,48,0,107,2021
PIE,  ,C 26,Fabbricazione di computer e prodotti di elettronica e ott...,1,9,3,0,13,2021
PIE,  ,C 27,Fabbricazione di apparecchiature elettriche ed apparecchi...,3,7,0,0,10,2021
PIE,  ,C 28,Fabbricazione di macchinari ed apparecchiature nca          ,11,9,10,0,30,2021
PIE,  ,C 29,"Fabbricazione di autoveicoli, rimorchi e semirimorchi       ",2,8,1,1,12,2021
PIE,  ,C 30,Fabbricazione di altri mezzi di trasporto                   ,0,0,3,0,3,2021
PIE,  ,C 31,Fabbricazione di mobili                                     ,2,1,6,0,9,2021
PIE,  ,C 32,Altre industrie manifatturiere                              ,3,3,4,0,10,2021
PIE,  ,C 33,"Riparazione, manutenzione ed installazione di macchine ed...",6,2,14,1,23,2021
PIE,  ,D   ,"Fornitura di energia elettrica, gas, vapore e aria condiz...",1,0,0,0,1,2021
PIE,  ,D 35,"Fornitura di energia elettrica, gas, vapore e aria condiz...",1,0,0,0,1,2021
PIE,  ,E   ,"Fornitura di acqua; reti fognarie, attività di gestione d...",1,1,0,0,2,2021
PIE,  ,E 36,"Raccolta, trattamento e fornitura di acqua                  ",0,0,0,0,0,2021
PIE,  ,E 37,Gestione delle reti fognarie                                ,0,0,0,0,0,2021
PIE,  ,E 38,"Attività di raccolta, trattamento e smaltimento dei rifiu...",1,1,0,0,2,2021
PIE,  ,E 39,Attività di risanamento e altri servizi di gestione dei r...,0,0,0,0,0,2021
PIE,  ,F   ,Costruzioni                                                 ,68,45,448,10,571,2021
PIE,  ,F 41,Costruzione di edifici                                      ,42,29,94,3,168,2021
PIE,  ,F 42,Ingegneria civile                                           ,1,2,3,0,6,2021
PIE,  ,F 43,Lavori di costruzione specializzati                         ,25,14,351,7,397,2021
PIE,  ,G   ,Commercio all'ingrosso e al dettaglio; riparazione di aut...,75,206,411,3,695,2021
PIE,  ,G 45,Commercio all'ingrosso e al dettaglio e riparazione di au...,6,18,27,0,51,2021
PIE,  ,G 46,Commercio all'ingrosso (escluso quello di autoveicoli e d...,35,94,99,0,228,2021
PIE,  ,G 47,Commercio al dettaglio (escluso quello di autoveicoli e d...,34,94,285,3,416,2021
PIE,  ,H   ,Trasporto e magazzinaggio                                   ,4,14,24,14,56,2021
PIE,  ,H 49,Trasporto terrestre e mediante condotte                     ,4,11,17,3,35,2021
PIE,  ,H 50,Trasporto marittimo e per vie d'acqua                       ,0,0,0,0,0,2021
PIE,  ,H 51,Trasporto aereo                                             ,0,0,0,0,0,2021
PIE,  ,H 52,Magazzinaggio e attività di supporto ai trasporti           ,0,3,1,11,15,2021
PIE,  ,H 53,Servizi postali e attività di corriere                      ,0,0,6,0,6,2021
PIE,  ,I   ,Attività dei servizi alloggio e ristorazione                ,30,95,75,1,201,2021
PIE,  ,I 55,Alloggio                                                    ,2,2,7,0,11,2021
PIE,  ,I 56,Attività dei servizi di ristorazione                        ,28,93,68,1,190,2021
PIE,  ,J   ,Servizi di informazione e comunicazione                     ,25,10,20,1,56,2021
PIE,  ,J 58,Attività editoriali                                         ,3,3,3,0,9,2021
PIE,  ,J 59,"Attività di produzione cinematografica, di video e di pro...",0,0,1,0,1,2021
PIE,  ,J 60,Attività di programmazione e trasmissione                   ,0,0,0,0,0,2021
PIE,  ,J 61,Telecomunicazioni                                           ,1,0,5,0,6,2021
PIE,  ,J 62,"Produzione di software, consulenza informatica e attività...",12,1,7,0,20,2021
PIE,  ,J 63,Attività dei servizi d'informazione e altri servizi infor...,9,6,4,1,20,2021
PIE,  ,K   ,Attività finanziarie e assicurative                         ,5,6,12,0,23,2021
PIE,  ,K 64,Attività di servizi finanziari (escluse le assicurazioni ...,2,2,0,0,4,2021
PIE,  ,K 65,"Assicurazioni, riassicurazioni e fondi pensione (escluse ...",0,0,0,0,0,2021
PIE,  ,K 66,Attività ausiliarie dei servizi finanziari e delle attivi...,3,4,12,0,19,2021
PIE,  ,L   ,Attivita' immobiliari                                       ,40,15,11,0,66,2021
PIE,  ,L 68,Attivita' immobiliari                                       ,40,15,11,0,66,2021
PIE,  ,M   ,"Attività professionali, scientifiche e tecniche             ",38,25,28,3,94,2021
PIE,  ,M 69,Attività legali e contabilità                               ,5,1,2,0,8,2021
PIE,  ,M 70,Attività di direzione aziendale e di consulenza gestional...,12,11,8,0,31,2021
PIE,  ,M 71,Attività degli studi di architettura e d'ingegneria; coll...,9,2,2,1,14,2021
PIE,  ,M 72,Ricerca scientifica e sviluppo                              ,0,0,0,1,1,2021
PIE,  ,M 73,Pubblicità e ricerche di mercato                            ,7,4,6,0,17,2021
PIE,  ,M 74,"Altre attività professionali, scientifiche e tecniche       ",5,7,10,1,23,2021
PIE,  ,M 75,Servizi veterinari                                          ,0,0,0,0,0,2021
PIE,  ,N   ,"Noleggio, agenzie di viaggio, servizi di supporto alle im...",20,11,65,3,99,2021
PIE,  ,N 77,Attività di noleggio e leasing operativo                    ,1,3,2,0,6,2021
PIE,  ,N 78,"Attività di ricerca, selezione, fornitura di personale      ",0,0,1,0,1,2021
PIE,  ,N 79,"Attività dei servizi delle agenzie di viaggio, dei tour o...",5,2,1,0,8,2021
PIE,  ,N 80,Servizi di vigilanza e investigazione                       ,2,1,0,0,3,2021
PIE,  ,N 81,Attività di servizi per edifici e paesaggio                 ,1,2,23,3,29,2021
PIE,  ,N 82,Attività di supporto per le funzioni d'ufficio e altri se...,11,3,38,0,52,2021
PIE,  ,O   ,Amministrazione pubblica e difesa; assicurazione sociale ...,0,0,0,0,0,2021
PIE,  ,O 84,Amministrazione pubblica e difesa; assicurazione sociale ...,0,0,0,0,0,2021
PIE,  ,P   ,Istruzione                                                  ,0,6,3,1,10,2021
PIE,  ,P 85,Istruzione                                                  ,0,6,3,1,10,2021
PIE,  ,Q   ,Sanita' e assistenza sociale                                ,1,0,2,5,8,2021
PIE,  ,Q 86,Assistenza sanitaria                                        ,1,0,0,0,1,2021
PIE,  ,Q 87,Servizi di assistenza sociale residenziale                  ,0,0,0,1,1,2021
PIE,  ,Q 88,Assistenza sociale non residenziale                         ,0,0,2,4,6,2021
PIE,  ,R   ,"Attività artistiche, sportive, di intrattenimento e diver...",15,2,11,1,29,2021
PIE,  ,R 90,"Attività creative, artistiche e di intrattenimento          ",1,0,3,1,5,2021
PIE,  ,R 91,"Attività di biblioteche, archivi, musei ed altre attività...",0,0,0,0,0,2021
PIE,  ,R 92,"Attività riguardanti le lotterie, le scommesse, le case d...",1,0,0,0,1,2021
PIE,  ,R 93,"Attività sportive, di intrattenimento e di divertimento     ",13,2,8,0,23,2021
PIE,  ,S   ,Altre attività di servizi                                   ,8,8,27,2,45,2021
PIE,  ,S 94,Attività di organizzazioni associative                      ,0,0,0,0,0,2021
PIE,  ,S 95,Riparazione di computer e di beni per uso personale e per...,2,2,4,1,9,2021
PIE,  ,S 96,Altre attività di servizi per la persona                    ,6,6,23,1,36,2021
PIE,  ,T   ,Attività di famiglie e convivenze come datori di lavoro p...,0,0,0,0,0,2021
PIE,  ,T 97,Attività di famiglie e convivenze come datori di lavoro p...,0,0,0,0,0,2021
PIE,  ,T 98,Produzione di beni e servizi indifferenziati per uso prop...,0,0,0,0,0,2021
PIE,  ,U   ,Organizzazioni ed organismi extraterritoriali               ,0,0,0,0,0,2021
PIE,  ,U 99,Organizzazioni ed organismi extraterritoriali               ,0,0,0,0,0,2021
PIE,  ,XX  ,Imprese non classificate                                    ,67,46,30,12,155,2021
PIE,  ,TOT ,TOTALE                                                      ,489,645,1405,59,2598,2021
PIE,TO,A   ,"Agricoltura, silvicoltura pesca                             ",0,0,7,0,7,2021
PIE,TO,A 01,"Coltivazioni agricole e produzione di prodotti animali, c...",0,0,7,0,7,2021
PIE,TO,A 02,Silvicoltura ed utilizzo di aree forestali                  ,0,0,0,0,0,2021
PIE,TO,A 03,Pesca e acquacoltura                                        ,0,0,0,0,0,2021
PIE,TO,B   ,Estrazione di minerali da cave e miniere                    ,0,0,0,0,0,2021
PIE,TO,B 05,Estrazione di carbone (esclusa torba)                       ,0,0,0,0,0,2021
PIE,TO,B 06,Estraz.di petrolio greggio e di gas naturale                ,0,0,0,0,0,2021
PIE,TO,B 07,Estrazione di minerali metalliferi                          ,0,0,0,0,0,2021
PIE,TO,B 08,Altre attività di estrazione di minerali da cave e miniere  ,0,0,0,0,0,2021
PIE,TO,B 09,Attività dei servizi di supporto all'estrazione             ,0,0,0,0,0,2021
PIE,TO,C   ,Attività manifatturiere                                     ,27,81,26,1,135,2021
PIE,TO,C 10,Industrie alimentari                                        ,1,0,4,0,5,2021
PIE,TO,C 11,Industria delle bevande                                     ,0,0,0,0,0,2021
PIE,TO,C 12,Industria del tabacco                                       ,0,0,0,0,0,2021
PIE,TO,C 13,Industrie tessili                                           ,0,1,0,0,1,2021
PIE,TO,C 14,Confezione di articoli di abbigliamento; confezione di ar...,1,3,1,0,5,2021
PIE,TO,C 15,Fabbricazione di articoli in pelle e simili                 ,0,1,0,0,1,2021
PIE,TO,C 16,Industria del legno e dei prodotti in legno e sughero (es...,0,2,2,0,4,2021
PIE,TO,C 17,Fabbricazione di carta e di prodotti di carta               ,1,1,0,0,2,2021
PIE,TO,C 18,Stampa e riproduzione di supporti registrati                ,3,5,0,0,8,2021
PIE,TO,C 19,Fabbricazione di coke e prodotti derivanti dalla raffinaz...,0,0,0,0,0,2021
PIE,TO,C 20,Fabbricazione di prodotti chimici                           ,0,3,0,0,3,2021
PIE,TO,C 21,Fabbricazione di prodotti farmaceutici di base e di prepa...,0,0,0,0,0,2021
PIE,TO,C 22,Fabbricazione di articoli in gomma e materie plastiche      ,4,2,1,0,7,2021
PIE,TO,C 23,Fabbricazione di altri prodotti della lavorazione di miner..,1,1,0,0,2,2021
PIE,TO,C 24,Metallurgia                                                 ,0,0,0,0,0,2021
PIE,TO,C 25,Fabbricazione di prodotti in metallo (esclusi macchinari ...,7,30,8,0,45,2021
PIE,TO,C 26,Fabbricazione di computer e prodotti di elettronica e ott...,1,8,1,0,10,2021
PIE,TO,C 27,Fabbricazione di apparecchiature elettriche ed apparecchi...,1,6,0,0,7,2021
PIE,TO,C 28,Fabbricazione di macchinari ed apparecchiature nca          ,3,8,4,0,15,2021
PIE,TO,C 29,"Fabbricazione di autoveicoli, rimorchi e semirimorchi       ",1,5,0,1,7,2021
PIE,TO,C 30,Fabbricazione di altri mezzi di trasporto                   ,0,0,2,0,2,2021
PIE,TO,C 31,Fabbricazione di mobili                                     ,1,1,0,0,2,2021
PIE,TO,C 32,Altre industrie manifatturiere                              ,1,3,2,0,6,2021
PIE,TO,C 33,"Riparazione, manutenzione ed installazione di macchine ed...",1,1,1,0,3,2021
PIE,TO,D   ,"Fornitura di energia elettrica, gas, vapore e aria condiz...",0,0,0,0,0,2021
PIE,TO,D 35,"Fornitura di energia elettrica, gas, vapore e aria condiz...",0,0,0,0,0,2021
PIE,TO,E   ,"Fornitura di acqua; reti fognarie, attività di gestione d...",0,1,0,0,1,2021
PIE,TO,E 36,"Raccolta, trattamento e fornitura di acqua                  ",0,0,0,0,0,2021
PIE,TO,E 37,Gestione delle reti fognarie                                ,0,0,0,0,0,2021
PIE,TO,E 38,"Attività di raccolta, trattamento e smaltimento dei rifiu...",0,1,0,0,1,2021
PIE,TO,E 39,Attività di risanamento e altri servizi di gestione dei r...,0,0,0,0,0,2021
PIE,TO,F   ,Costruzioni                                                 ,30,20,45,7,102,2021
PIE,TO,F 41,Costruzione di edifici                                      ,22,13,11,2,48,2021
PIE,TO,F 42,Ingegneria civile                                           ,1,1,0,0,2,2021
PIE,TO,F 43,Lavori di costruzione specializzati                         ,7,6,34,5,52,2021
PIE,TO,G   ,Commercio all'ingrosso e al dettaglio; riparazione di aut...,30,135,90,0,255,2021
PIE,TO,G 45,Commercio all'ingrosso e al dettaglio e riparazione di au...,1,11,3,0,15,2021
PIE,TO,G 46,Commercio all'ingrosso (escluso quello di autoveicoli e d...,12,67,18,0,97,2021
PIE,TO,G 47,Commercio al dettaglio (escluso quello di autoveicoli e d...,17,57,69,0,143,2021
PIE,TO,H   ,Trasporto e magazzinaggio                                   ,3,9,12,8,32,2021
PIE,TO,H 49,Trasporto terrestre e mediante condotte                     ,3,8,9,3,23,2021
PIE,TO,H 50,Trasporto marittimo e per vie d'acqua                       ,0,0,0,0,0,2021
PIE,TO,H 51,Trasporto aereo                                             ,0,0,0,0,0,2021
PIE,TO,H 52,Magazzinaggio e attività di supporto ai trasporti           ,0,1,1,5,7,2021
PIE,TO,H 53,Servizi postali e attività di corriere                      ,0,0,2,0,2,2021
PIE,TO,I   ,Attività dei servizi alloggio e ristorazione                ,18,22,10,0,50,2021
PIE,TO,I 55,Alloggio                                                    ,2,0,3,0,5,2021
PIE,TO,I 56,Attività dei servizi di ristorazione                        ,16,22,7,0,45,2021
PIE,TO,J   ,Servizi di informazione e comunicazione                     ,16,8,5,0,29,2021
PIE,TO,J 58,Attività editoriali                                         ,0,1,1,0,2,2021
PIE,TO,J 59,"Attività di produzione cinematografica, di video e di pro...",0,0,1,0,1,2021
PIE,TO,J 60,Attività di programmazione e trasmissione                   ,0,0,0,0,0,2021
PIE,TO,J 61,Telecomunicazioni                                           ,1,0,2,0,3,2021
PIE,TO,J 62,"Produzione di software, consulenza informatica e attività...",8,1,0,0,9,2021
PIE,TO,J 63,Attività dei servizi d'informazione e altri servizi infor...,7,6,1,0,14,2021
PIE,TO,K   ,Attività finanziarie e assicurative                         ,2,3,1,0,6,2021
PIE,TO,K 64,Attività di servizi finanziari (escluse le assicurazioni ...,0,1,0,0,1,2021
PIE,TO,K 65,"Assicurazioni, riassicurazioni e fondi pensione (escluse ...",0,0,0,0,0,2021
PIE,TO,K 66,Attività ausiliarie dei servizi finanziari e delle attivi...,2,2,1,0,5,2021
PIE,TO,L   ,Attivita' immobiliari                                       ,14,8,2,0,24,2021
PIE,TO,L 68,Attivita' immobiliari                                       ,14,8,2,0,24,2021
PIE,TO,M   ,"Attività professionali, scientifiche e tecniche             ",18,18,5,1,42,2021
PIE,TO,M 69,Attività legali e contabilità                               ,3,1,1,0,5,2021
PIE,TO,M 70,Attività di direzione aziendale e di consulenza gestional...,6,8,0,0,14,2021
PIE,TO,M 71,Attività degli studi di architettura e d'ingegneria; coll...,4,2,1,0,7,2021
PIE,TO,M 72,Ricerca scientifica e sviluppo                              ,0,0,0,1,1,2021
PIE,TO,M 73,Pubblicità e ricerche di mercato                            ,3,2,2,0,7,2021
PIE,TO,M 74,"Altre attività professionali, scientifiche e tecniche       ",2,5,1,0,8,2021
PIE,TO,M 75,Servizi veterinari                                          ,0,0,0,0,0,2021
PIE,TO,N   ,"Noleggio, agenzie di viaggio, servizi di supporto alle im...",12,5,7,1,25,2021
PIE,TO,N 77,Attività di noleggio e leasing operativo                    ,0,1,2,0,3,2021
PIE,TO,N 78,"Attività di ricerca, selezione, fornitura di personale      ",0,0,1,0,1,2021
PIE,TO,N 79,"Attività dei servizi delle agenzie di viaggio, dei tour o...",3,2,0,0,5,2021
PIE,TO,N 80,Servizi di vigilanza e investigazione                       ,1,0,0,0,1,2021
PIE,TO,N 81,Attività di servizi per edifici e paesaggio                 ,0,1,2,1,4,2021
PIE,TO,N 82,Attività di supporto per le funzioni d'ufficio e altri se...,8,1,2,0,11,2021
PIE,TO,O   ,Amministrazione pubblica e difesa; assicurazione sociale ...,0,0,0,0,0,2021
PIE,TO,O 84,Amministrazione pubblica e difesa; assicurazione sociale ...,0,0,0,0,0,2021
PIE,TO,P   ,Istruzione                                                  ,0,5,1,0,6,2021
PIE,TO,P 85,Istruzione                                                  ,0,5,1,0,6,2021
PIE,TO,Q   ,Sanita' e assistenza sociale                                ,0,0,0,4,4,2021
PIE,TO,Q 86,Assistenza sanitaria                                        ,0,0,0,0,0,2021
PIE,TO,Q 87,Servizi di assistenza sociale residenziale                  ,0,0,0,1,1,2021
PIE,TO,Q 88,Assistenza sociale non residenziale                         ,0,0,0,3,3,2021
PIE,TO,R   ,"Attività artistiche, sportive, di intrattenimento e diver...",7,1,3,1,12,2021
PIE,TO,R 90,"Attività creative, artistiche e di intrattenimento          ",1,0,2,1,4,2021
PIE,TO,R 91,"Attività di biblioteche, archivi, musei ed altre attività...",0,0,0,0,0,2021
PIE,TO,R 92,"Attività riguardanti le lotterie, le scommesse, le case d...",0,0,0,0,0,2021
PIE,TO,R 93,"Attività sportive, di intrattenimento e di divertimento     ",6,1,1,0,8,2021
PIE,TO,S   ,Altre attività di servizi                                   ,5,3,4,1,13,2021
PIE,TO,S 94,Attività di organizzazioni associative                      ,0,0,0,0,0,2021
PIE,TO,S 95,Riparazione di computer e di beni per uso personale e per...,1,1,1,0,3,2021
PIE,TO,S 96,Altre attività di servizi per la persona                    ,4,2,3,1,10,2021
PIE,TO,T   ,Attività di famiglie e convivenze come datori di lavoro p...,0,0,0,0,0,2021
PIE,TO,T 97,Attività di famiglie e convivenze come datori di lavoro p...,0,0,0,0,0,2021
PIE,TO,T 98,Produzione di beni e servizi indifferenziati per uso prop...,0,0,0,0,0,2021
PIE,TO,U   ,Organizzazioni ed organismi extraterritoriali               ,0,0,0,0,0,2021
PIE,TO,U 99,Organizzazioni ed organismi extraterritoriali               ,0,0,0,0,0,2021
PIE,TO,XX  ,Imprese non classificate                                    ,25,0,0,4,29,2021
PIE,TO,TOT ,TOTALE                                                      ,207,319,218,28,772,2021
PIE,VC,A   ,"Agricoltura, silvicoltura pesca                             ",2,3,19,0,24,2021
PIE,VC,A 01,"Coltivazioni agricole e produzione di prodotti animali, c...",2,1,19,0,22,2021
PIE,VC,A 02,Silvicoltura ed utilizzo di aree forestali                  ,0,2,0,0,2,2021
PIE,VC,A 03,Pesca e acquacoltura                                        ,0,0,0,0,0,2021
PIE,VC,B   ,Estrazione di minerali da cave e miniere                    ,0,0,0,0,0,2021
PIE,VC,B 05,Estrazione di carbone (esclusa torba)                       ,0,0,0,0,0,2021
PIE,VC,B 06,Estraz.di petrolio greggio e di gas naturale                ,0,0,0,0,0,2021
PIE,VC,B 07,Estrazione di minerali metalliferi                          ,0,0,0,0,0,2021
PIE,VC,B 08,Altre attività di estrazione di minerali da cave e miniere  ,0,0,0,0,0,2021
PIE,VC,B 09,Attività dei servizi di supporto all'estrazione             ,0,0,0,0,0,2021
PIE,VC,C   ,Attività manifatturiere                                     ,16,28,19,0,63,2021
PIE,VC,C 10,Industrie alimentari                                        ,0,2,2,0,4,2021
PIE,VC,C 11,Industria delle bevande                                     ,0,0,0,0,0,2021
PIE,VC,C 12,Industria del tabacco                                       ,0,0,0,0,0,2021
PIE,VC,C 13,Industrie tessili                                           ,4,7,0,0,11,2021
PIE,VC,C 14,Confezione di articoli di abbigliamento; confezione di ar...,0,4,0,0,4,2021
PIE,VC,C 15,Fabbricazione di articoli in pelle e simili                 ,1,3,0,0,4,2021
PIE,VC,C 16,Industria del legno e dei prodotti in legno e sughero (es...,1,3,2,0,6,2021
PIE,VC,C 17,Fabbricazione di carta e di prodotti di carta               ,0,1,0,0,1,2021
PIE,VC,C 18,Stampa e riproduzione di supporti registrati                ,0,0,1,0,1,2021
PIE,VC,C 19,Fabbricazione di coke e prodotti derivanti dalla raffinaz...,0,0,0,0,0,2021
PIE,VC,C 20,Fabbricazione di prodotti chimici                           ,1,0,0,0,1,2021
PIE,VC,C 21,Fabbricazione di prodotti farmaceutici di base e di prepa...,0,0,0,0,0,2021
PIE,VC,C 22,Fabbricazione di articoli in gomma e materie plastiche      ,1,0,1,0,2,2021
PIE,VC,C 23,Fabbricazione di altri prodotti della lavorazione di miner..,0,1,0,0,1,2021
PIE,VC,C 24,Metallurgia                                                 ,0,0,0,0,0,2021
PIE,VC,C 25,Fabbricazione di prodotti in metallo (esclusi macchinari ...,1,3,6,0,10,2021
PIE,VC,C 26,Fabbricazione di computer e prodotti di elettronica e ott...,0,0,1,0,1,2021
PIE,VC,C 27,Fabbricazione di apparecchiature elettriche ed apparecchi...,1,1,0,0,2,2021
PIE,VC,C 28,Fabbricazione di macchinari ed apparecchiature nca          ,3,1,3,0,7,2021
PIE,VC,C 29,"Fabbricazione di autoveicoli, rimorchi e semirimorchi       ",0,2,0,0,2,2021
PIE,VC,C 30,Fabbricazione di altri mezzi di trasporto                   ,0,0,0,0,0,2021
PIE,VC,C 31,Fabbricazione di mobili                                     ,1,0,1,0,2,2021
PIE,VC,C 32,Altre industrie manifatturiere                              ,0,0,1,0,1,2021
PIE,VC,C 33,"Riparazione, manutenzione ed installazione di macchine ed...",2,0,1,0,3,2021
PIE,VC,D   ,"Fornitura di energia elettrica, gas, vapore e aria condiz...",0,0,0,0,0,2021
PIE,VC,D 35,"Fornitura di energia elettrica, gas, vapore e aria condiz...",0,0,0,0,0,2021
PIE,VC,E   ,"Fornitura di acqua; reti fognarie, attività di gestione d...",0,0,0,0,0,2021
PIE,VC,E 36,"Raccolta, trattamento e fornitura di acqua                  ",0,0,0,0,0,2021
PIE,VC,E 37,Gestione delle reti fognarie                                ,0,0,0,0,0,2021
PIE,VC,E 38,"Attività di raccolta, trattamento e smaltimento dei rifiu...",0,0,0,0,0,2021
PIE,VC,E 39,Attività di risanamento e altri servizi di gestione dei r...,0,0,0,0,0,2021
PIE,VC,F   ,Costruzioni                                                 ,11,10,50,0,71,2021
PIE,VC,F 41,Costruzione di edifici                                      ,7,6,4,0,17,2021
PIE,VC,F 42,Ingegneria civile                                           ,0,0,0,0,0,2021
PIE,VC,F 43,Lavori di costruzione specializzati                         ,4,4,46,0,54,2021
PIE,VC,G   ,Commercio all'ingrosso e al dettaglio; riparazione di aut...,18,24,54,0,96,2021
PIE,VC,G 45,Commercio all'ingrosso e al dettaglio e riparazione di au...,4,4,5,0,13,2021
PIE,VC,G 46,Commercio all'ingrosso (escluso quello di autoveicoli e d...,10,11,7,0,28,2021
PIE,VC,G 47,Commercio al dettaglio (escluso quello di autoveicoli e d...,4,9,42,0,55,2021
PIE,VC,H   ,Trasporto e magazzinaggio                                   ,0,0,2,1,3,2021
PIE,VC,H 49,Trasporto terrestre e mediante condotte                     ,0,0,2,0,2,2021
PIE,VC,H 50,Trasporto marittimo e per vie d'acqua                       ,0,0,0,0,0,2021
PIE,VC,H 51,Trasporto aereo                                             ,0,0,0,0,0,2021
PIE,VC,H 52,Magazzinaggio e attività di supporto ai trasporti           ,0,0,0,1,1,2021
PIE,VC,H 53,Servizi postali e attività di corriere                      ,0,0,0,0,0,2021
PIE,VC,I   ,Attività dei servizi alloggio e ristorazione                ,4,10,6,0,20,2021
PIE,VC,I 55,Alloggio                                                    ,0,0,0,0,0,2021
PIE,VC,I 56,Attività dei servizi di ristorazione                        ,4,10,6,0,20,2021
PIE,VC,J   ,Servizi di informazione e comunicazione                     ,3,0,2,0,5,2021
PIE,VC,J 58,Attività editoriali                                         ,1,0,0,0,1,2021
PIE,VC,J 59,"Attività di produzione cinematografica, di video e di pro...",0,0,0,0,0,2021
PIE,VC,J 60,Attività di programmazione e trasmissione                   ,0,0,0,0,0,2021
PIE,VC,J 61,Telecomunicazioni                                           ,0,0,0,0,0,2021
PIE,VC,J 62,"Produzione di software, consulenza informatica e attività...",0,0,0,0,0,2021
PIE,VC,J 63,Attività dei servizi d'informazione e altri servizi infor...,2,0,2,0,4,2021
PIE,VC,K   ,Attività finanziarie e assicurative                         ,0,0,4,0,4,2021
PIE,VC,K 64,Attività di servizi finanziari (escluse le assicurazioni ...,0,0,0,0,0,2021
PIE,VC,K 65,"Assicurazioni, riassicurazioni e fondi pensione (escluse ...",0,0,0,0,0,2021
PIE,VC,K 66,Attività ausiliarie dei servizi finanziari e delle attivi...,0,0,4,0,4,2021
PIE,VC,L   ,Attivita' immobiliari                                       ,12,1,0,0,13,2021
PIE,VC,L 68,Attivita' immobiliari                                       ,12,1,0,0,13,2021
PIE,VC,M   ,"Attività professionali, scientifiche e tecniche             ",4,1,5,0,10,2021
PIE,VC,M 69,Attività legali e contabilità                               ,1,0,0,0,1,2021
PIE,VC,M 70,Attività di direzione aziendale e di consulenza gestional...,2,0,1,0,3,2021
PIE,VC,M 71,Attività degli studi di architettura e d'ingegneria; coll...,0,0,0,0,0,2021
PIE,VC,M 72,Ricerca scientifica e sviluppo                              ,0,0,0,0,0,2021
PIE,VC,M 73,Pubblicità e ricerche di mercato                            ,0,1,1,0,2,2021
PIE,VC,M 74,"Altre attività professionali, scientifiche e tecniche       ",1,0,3,0,4,2021
PIE,VC,M 75,Servizi veterinari                                          ,0,0,0,0,0,2021
PIE,VC,N   ,"Noleggio, agenzie di viaggio, servizi di supporto alle im...",3,2,3,0,8,2021
PIE,VC,N 77,Attività di noleggio e leasing operativo                    ,1,0,0,0,1,2021
PIE,VC,N 78,"Attività di ricerca, selezione, fornitura di personale      ",0,0,0,0,0,2021
PIE,VC,N 79,"Attività dei servizi delle agenzie di viaggio, dei tour o...",1,0,0,0,1,2021
PIE,VC,N 80,Servizi di vigilanza e investigazione                       ,0,0,0,0,0,2021
PIE,VC,N 81,Attività di servizi per edifici e paesaggio                 ,1,0,2,0,3,2021
PIE,VC,N 82,Attività di supporto per le funzioni d'ufficio e altri se...,0,2,1,0,3,2021
PIE,VC,O   ,Amministrazione pubblica e difesa; assicurazione sociale ...,0,0,0,0,0,2021
PIE,VC,O 84,Amministrazione pubblica e difesa; assicurazione sociale ...,0,0,0,0,0,2021
PIE,VC,P   ,Istruzione                                                  ,0,1,0,0,1,2021
PIE,VC,P 85,Istruzione                                                  ,0,1,0,0,1,2021
PIE,VC,Q   ,Sanita' e assistenza sociale                                ,1,0,0,0,1,2021
PIE,VC,Q 86,Assistenza sanitaria                                        ,1,0,0,0,1,2021
PIE,VC,Q 87,Servizi di assistenza sociale residenziale                  ,0,0,0,0,0,2021
PIE,VC,Q 88,Assistenza sociale non residenziale                         ,0,0,0,0,0,2021
PIE,VC,R   ,"Attività artistiche, sportive, di intrattenimento e diver...",3,1,4,0,8,2021
PIE,VC,R 90,"Attività creative, artistiche e di intrattenimento          ",0,0,1,0,1,2021
PIE,VC,R 91,"Attività di biblioteche, archivi, musei ed altre attività...",0,0,0,0,0,2021
PIE,VC,R 92,"Attività riguardanti le lotterie, le scommesse, le case d...",0,0,0,0,0,2021
PIE,VC,R 93,"Attività sportive, di intrattenimento e di divertimento     ",3,1,3,0,7,2021
PIE,VC,S   ,Altre attività di servizi                                   ,2,1,1,0,4,2021
PIE,VC,S 94,Attività di organizzazioni associative                      ,0,0,0,0,0,2021
PIE,VC,S 95,Riparazione di computer e di beni per uso personale e per...,1,0,0,0,1,2021
PIE,VC,S 96,Altre attività di servizi per la persona                    ,1,1,1,0,3,2021
PIE,VC,T   ,Attività di famiglie e convivenze come datori di lavoro p...,0,0,0,0,0,2021
PIE,VC,T 97,Attività di famiglie e convivenze come datori di lavoro p...,0,0,0,0,0,2021
PIE,VC,T 98,Produzione di beni e servizi indifferenziati per uso prop...,0,0,0,0,0,2021
PIE,VC,U   ,Organizzazioni ed organismi extraterritoriali               ,0,0,0,0,0,2021
PIE,VC,U 99,Organizzazioni ed organismi extraterritoriali               ,0,0,0,0,0,2021
PIE,VC,XX  ,Imprese non classificate                                    ,24,14,0,1,39,2021
PIE,VC,TOT ,TOTALE                                                      ,103,96,169,2,370,2021
PIE,NO,A   ,"Agricoltura, silvicoltura pesca                             ",0,0,1,0,1,2021
PIE,NO,A 01,"Coltivazioni agricole e produzione di prodotti animali, c...",0,0,1,0,1,2021
PIE,NO,A 02,Silvicoltura ed utilizzo di aree forestali                  ,0,0,0,0,0,2021
PIE,NO,A 03,Pesca e acquacoltura                                        ,0,0,0,0,0,2021
PIE,NO,B   ,Estrazione di minerali da cave e miniere                    ,0,0,0,0,0,2021
PIE,NO,B 05,Estrazione di carbone (esclusa torba)                       ,0,0,0,0,0,2021
PIE,NO,B 06,Estraz.di petrolio greggio e di gas naturale                ,0,0,0,0,0,2021
PIE,NO,B 07,Estrazione di minerali metalliferi                          ,0,0,0,0,0,2021
PIE,NO,B 08,Altre attività di estrazione di minerali da cave e miniere  ,0,0,0,0,0,2021
PIE,NO,B 09,Attività dei servizi di supporto all'estrazione             ,0,0,0,0,0,2021
PIE,NO,C   ,Attività manifatturiere                                     ,17,3,12,0,32,2021
PIE,NO,C 10,Industrie alimentari                                        ,0,0,1,0,1,2021
PIE,NO,C 11,Industria delle bevande                                     ,0,0,0,0,0,2021
PIE,NO,C 12,Industria del tabacco                                       ,0,0,0,0,0,2021
PIE,NO,C 13,Industrie tessili                                           ,0,0,0,0,0,2021
PIE,NO,C 14,Confezione di articoli di abbigliamento; confezione di ar...,1,2,1,0,4,2021
PIE,NO,C 15,Fabbricazione di articoli in pelle e simili                 ,0,0,0,0,0,2021
PIE,NO,C 16,Industria del legno e dei prodotti in legno e sughero (es...,0,0,0,0,0,2021
PIE,NO,C 17,Fabbricazione di carta e di prodotti di carta               ,1,0,0,0,1,2021
PIE,NO,C 18,Stampa e riproduzione di supporti registrati                ,2,0,0,0,2,2021
PIE,NO,C 19,Fabbricazione di coke e prodotti derivanti dalla raffinaz...,0,0,0,0,0,2021
PIE,NO,C 20,Fabbricazione di prodotti chimici                           ,0,0,0,0,0,2021
PIE,NO,C 21,Fabbricazione di prodotti farmaceutici di base e di prepa...,0,0,0,0,0,2021
PIE,NO,C 22,Fabbricazione di articoli in gomma e materie plastiche      ,1,0,0,0,1,2021
PIE,NO,C 23,Fabbricazione di altri prodotti della lavorazione di miner..,0,0,0,0,0,2021
PIE,NO,C 24,Metallurgia                                                 ,2,0,0,0,2,2021
PIE,NO,C 25,Fabbricazione di prodotti in metallo (esclusi macchinari ...,6,0,6,0,12,2021
PIE,NO,C 26,Fabbricazione di computer e prodotti di elettronica e ott...,0,0,0,0,0,2021
PIE,NO,C 27,Fabbricazione di apparecchiature elettriche ed apparecchi...,1,0,0,0,1,2021
PIE,NO,C 28,Fabbricazione di macchinari ed apparecchiature nca          ,2,0,1,0,3,2021
PIE,NO,C 29,"Fabbricazione di autoveicoli, rimorchi e semirimorchi       ",0,0,0,0,0,2021
PIE,NO,C 30,Fabbricazione di altri mezzi di trasporto                   ,0,0,0,0,0,2021
PIE,NO,C 31,Fabbricazione di mobili                                     ,0,0,0,0,0,2021
PIE,NO,C 32,Altre industrie manifatturiere                              ,0,0,0,0,0,2021
PIE,NO,C 33,"Riparazione, manutenzione ed installazione di macchine ed...",1,1,3,0,5,2021
PIE,NO,D   ,"Fornitura di energia elettrica, gas, vapore e aria condiz...",1,0,0,0,1,2021
PIE,NO,D 35,"Fornitura di energia elettrica, gas, vapore e aria condiz...",1,0,0,0,1,2021
PIE,NO,E   ,"Fornitura di acqua; reti fognarie, attività di gestione d...",1,0,0,0,1,2021
PIE,NO,E 36,"Raccolta, trattamento e fornitura di acqua                  ",0,0,0,0,0,2021
PIE,NO,E 37,Gestione delle reti fognarie                                ,0,0,0,0,0,2021
PIE,NO,E 38,"Attività di raccolta, trattamento e smaltimento dei rifiu...",1,0,0,0,1,2021
PIE,NO,E 39,Attività di risanamento e altri servizi di gestione dei r...,0,0,0,0,0,2021
PIE,NO,F   ,Costruzioni                                                 ,9,3,72,1,85,2021
PIE,NO,F 41,Costruzione di edifici                                      ,4,2,20,1,27,2021
PIE,NO,F 42,Ingegneria civile                                           ,0,0,1,0,1,2021
PIE,NO,F 43,Lavori di costruzione specializzati                         ,5,1,51,0,57,2021
PIE,NO,G   ,Commercio all'ingrosso e al dettaglio; riparazione di aut...,8,6,33,2,49,2021
PIE,NO,G 45,Commercio all'ingrosso e al dettaglio e riparazione di au...,0,1,3,0,4,2021
PIE,NO,G 46,Commercio all'ingrosso (escluso quello di autoveicoli e d...,3,3,3,0,9,2021
PIE,NO,G 47,Commercio al dettaglio (escluso quello di autoveicoli e d...,5,2,27,2,36,2021
PIE,NO,H   ,Trasporto e magazzinaggio                                   ,1,1,0,2,4,2021
PIE,NO,H 49,Trasporto terrestre e mediante condotte                     ,1,0,0,0,1,2021
PIE,NO,H 50,Trasporto marittimo e per vie d'acqua                       ,0,0,0,0,0,2021
PIE,NO,H 51,Trasporto aereo                                             ,0,0,0,0,0,2021
PIE,NO,H 52,Magazzinaggio e attività di supporto ai trasporti           ,0,1,0,2,3,2021
PIE,NO,H 53,Servizi postali e attività di corriere                      ,0,0,0,0,0,2021
PIE,NO,I   ,Attività dei servizi alloggio e ristorazione                ,1,9,11,1,22,2021
PIE,NO,I 55,Alloggio                                                    ,0,0,0,0,0,2021
PIE,NO,I 56,Attività dei servizi di ristorazione                        ,1,9,11,1,22,2021
PIE,NO,J   ,Servizi di informazione e comunicazione                     ,2,0,1,1,4,2021
PIE,NO,J 58,Attività editoriali                                         ,1,0,1,0,2,2021
PIE,NO,J 59,"Attività di produzione cinematografica, di video e di pro...",0,0,0,0,0,2021
PIE,NO,J 60,Attività di programmazione e trasmissione                   ,0,0,0,0,0,2021
PIE,NO,J 61,Telecomunicazioni                                           ,0,0,0,0,0,2021
PIE,NO,J 62,"Produzione di software, consulenza informatica e attività...",1,0,0,0,1,2021
PIE,NO,J 63,Attività dei servizi d'informazione e altri servizi infor...,0,0,0,1,1,2021
PIE,NO,K   ,Attività finanziarie e assicurative                         ,0,3,0,0,3,2021
PIE,NO,K 64,Attività di servizi finanziari (escluse le assicurazioni ...,0,1,0,0,1,2021
PIE,NO,K 65,"Assicurazioni, riassicurazioni e fondi pensione (escluse ...",0,0,0,0,0,2021
PIE,NO,K 66,Attività ausiliarie dei servizi finanziari e delle attivi...,0,2,0,0,2,2021
PIE,NO,L   ,Attivita' immobiliari                                       ,4,1,1,0,6,2021
PIE,NO,L 68,Attivita' immobiliari                                       ,4,1,1,0,6,2021
PIE,NO,M   ,"Attività professionali, scientifiche e tecniche             ",6,2,0,2,10,2021
PIE,NO,M 69,Attività legali e contabilità                               ,1,0,0,0,1,2021
PIE,NO,M 70,Attività di direzione aziendale e di consulenza gestional...,1,1,0,0,2,2021
PIE,NO,M 71,Attività degli studi di architettura e d'ingegneria; coll...,3,0,0,1,4,2021
PIE,NO,M 72,Ricerca scientifica e sviluppo                              ,0,0,0,0,0,2021
PIE,NO,M 73,Pubblicità e ricerche di mercato                            ,1,0,0,0,1,2021
PIE,NO,M 74,"Altre attività professionali, scientifiche e tecniche       ",0,1,0,1,2,2021
PIE,NO,M 75,Servizi veterinari                                          ,0,0,0,0,0,2021
PIE,NO,N   ,"Noleggio, agenzie di viaggio, servizi di supporto alle im...",3,1,12,1,17,2021
PIE,NO,N 77,Attività di noleggio e leasing operativo                    ,0,1,0,0,1,2021
PIE,NO,N 78,"Attività di ricerca, selezione, fornitura di personale      ",0,0,0,0,0,2021
PIE,NO,N 79,"Attività dei servizi delle agenzie di viaggio, dei tour o...",0,0,0,0,0,2021
PIE,NO,N 80,Servizi di vigilanza e investigazione                       ,0,0,0,0,0,2021
PIE,NO,N 81,Attività di servizi per edifici e paesaggio                 ,0,0,0,1,1,2021
PIE,NO,N 82,Attività di supporto per le funzioni d'ufficio e altri se...,3,0,12,0,15,2021
PIE,NO,O   ,Amministrazione pubblica e difesa; assicurazione sociale ...,0,0,0,0,0,2021
PIE,NO,O 84,Amministrazione pubblica e difesa; assicurazione sociale ...,0,0,0,0,0,2021
PIE,NO,P   ,Istruzione                                                  ,0,0,0,1,1,2021
PIE,NO,P 85,Istruzione                                                  ,0,0,0,1,1,2021
PIE,NO,Q   ,Sanita' e assistenza sociale                                ,0,0,1,1,2,2021
PIE,NO,Q 86,Assistenza sanitaria                                        ,0,0,0,0,0,2021
PIE,NO,Q 87,Servizi di assistenza sociale residenziale                  ,0,0,0,0,0,2021
PIE,NO,Q 88,Assistenza sociale non residenziale                         ,0,0,1,1,2,2021
PIE,NO,R   ,"Attività artistiche, sportive, di intrattenimento e diver...",1,0,1,0,2,2021
PIE,NO,R 90,"Attività creative, artistiche e di intrattenimento          ",0,0,0,0,0,2021
PIE,NO,R 91,"Attività di biblioteche, archivi, musei ed altre attività...",0,0,0,0,0,2021
PIE,NO,R 92,"Attività riguardanti le lotterie, le scommesse, le case d...",0,0,0,0,0,2021
PIE,NO,R 93,"Attività sportive, di intrattenimento e di divertimento     ",1,0,1,0,2,2021
PIE,NO,S   ,Altre attività di servizi                                   ,0,1,2,1,4,2021
PIE,NO,S 94,Attività di organizzazioni associative                      ,0,0,0,0,0,2021
PIE,NO,S 95,Riparazione di computer e di beni per uso personale e per...,0,0,0,1,1,2021
PIE,NO,S 96,Altre attività di servizi per la persona                    ,0,1,2,0,3,2021
PIE,NO,T   ,Attività di famiglie e convivenze come datori di lavoro p...,0,0,0,0,0,2021
PIE,NO,T 97,Attività di famiglie e convivenze come datori di lavoro p...,0,0,0,0,0,2021
PIE,NO,T 98,Produzione di beni e servizi indifferenziati per uso prop...,0,0,0,0,0,2021
PIE,NO,U   ,Organizzazioni ed organismi extraterritoriali               ,0,0,0,0,0,2021
PIE,NO,U 99,Organizzazioni ed organismi extraterritoriali               ,0,0,0,0,0,2021
PIE,NO,XX  ,Imprese non classificate                                    ,5,3,0,1,9,2021
PIE,NO,TOT ,TOTALE                                                      ,59,33,147,14,253,2021
PIE,CN,A   ,"Agricoltura, silvicoltura pesca                             ",0,5,58,0,63,2021
PIE,CN,A 01,"Coltivazioni agricole e produzione di prodotti animali, c...",0,5,57,0,62,2021
PIE,CN,A 02,Silvicoltura ed utilizzo di aree forestali                  ,0,0,1,0,1,2021
PIE,CN,A 03,Pesca e acquacoltura                                        ,0,0,0,0,0,2021
PIE,CN,B   ,Estrazione di minerali da cave e miniere                    ,0,0,0,0,0,2021
PIE,CN,B 05,Estrazione di carbone (esclusa torba)                       ,0,0,0,0,0,2021
PIE,CN,B 06,Estraz.di petrolio greggio e di gas naturale                ,0,0,0,0,0,2021
PIE,CN,B 07,Estrazione di minerali metalliferi                          ,0,0,0,0,0,2021
PIE,CN,B 08,Altre attività di estrazione di minerali da cave e miniere  ,0,0,0,0,0,2021
PIE,CN,B 09,Attività dei servizi di supporto all'estrazione             ,0,0,0,0,0,2021
PIE,CN,C   ,Attività manifatturiere                                     ,1,0,49,0,50,2021
PIE,CN,C 10,Industrie alimentari                                        ,0,0,1,0,1,2021
PIE,CN,C 11,Industria delle bevande                                     ,0,0,1,0,1,2021
PIE,CN,C 12,Industria del tabacco                                       ,0,0,0,0,0,2021
PIE,CN,C 13,Industrie tessili                                           ,0,0,0,0,0,2021
PIE,CN,C 14,Confezione di articoli di abbigliamento; confezione di ar...,0,0,5,0,5,2021
PIE,CN,C 15,Fabbricazione di articoli in pelle e simili                 ,0,0,0,0,0,2021
PIE,CN,C 16,Industria del legno e dei prodotti in legno e sughero (es...,0,0,3,0,3,2021
PIE,CN,C 17,Fabbricazione di carta e di prodotti di carta               ,0,0,0,0,0,2021
PIE,CN,C 18,Stampa e riproduzione di supporti registrati                ,0,0,1,0,1,2021
PIE,CN,C 19,Fabbricazione di coke e prodotti derivanti dalla raffinaz...,0,0,0,0,0,2021
PIE,CN,C 20,Fabbricazione di prodotti chimici                           ,0,0,1,0,1,2021
PIE,CN,C 21,Fabbricazione di prodotti farmaceutici di base e di prepa...,0,0,0,0,0,2021
PIE,CN,C 22,Fabbricazione di articoli in gomma e materie plastiche      ,1,0,2,0,3,2021
PIE,CN,C 23,Fabbricazione di altri prodotti della lavorazione di miner..,0,0,6,0,6,2021
PIE,CN,C 24,Metallurgia                                                 ,0,0,0,0,0,2021
PIE,CN,C 25,Fabbricazione di prodotti in metallo (esclusi macchinari ...,0,0,16,0,16,2021
PIE,CN,C 26,Fabbricazione di computer e prodotti di elettronica e ott...,0,0,1,0,1,2021
PIE,CN,C 27,Fabbricazione di apparecchiature elettriche ed apparecchi...,0,0,0,0,0,2021
PIE,CN,C 28,Fabbricazione di macchinari ed apparecchiature nca          ,0,0,0,0,0,2021
PIE,CN,C 29,"Fabbricazione di autoveicoli, rimorchi e semirimorchi       ",0,0,1,0,1,2021
PIE,CN,C 30,Fabbricazione di altri mezzi di trasporto                   ,0,0,1,0,1,2021
PIE,CN,C 31,Fabbricazione di mobili                                     ,0,0,2,0,2,2021
PIE,CN,C 32,Altre industrie manifatturiere                              ,0,0,0,0,0,2021
PIE,CN,C 33,"Riparazione, manutenzione ed installazione di macchine ed...",0,0,8,0,8,2021
PIE,CN,D   ,"Fornitura di energia elettrica, gas, vapore e aria condiz...",0,0,0,0,0,2021
PIE,CN,D 35,"Fornitura di energia elettrica, gas, vapore e aria condiz...",0,0,0,0,0,2021
PIE,CN,E   ,"Fornitura di acqua; reti fognarie, attività di gestione d...",0,0,0,0,0,2021
PIE,CN,E 36,"Raccolta, trattamento e fornitura di acqua                  ",0,0,0,0,0,2021
PIE,CN,E 37,Gestione delle reti fognarie                                ,0,0,0,0,0,2021
PIE,CN,E 38,"Attività di raccolta, trattamento e smaltimento dei rifiu...",0,0,0,0,0,2021
PIE,CN,E 39,Attività di risanamento e altri servizi di gestione dei r...,0,0,0,0,0,2021
PIE,CN,F   ,Costruzioni                                                 ,0,0,168,0,168,2021
PIE,CN,F 41,Costruzione di edifici                                      ,0,0,30,0,30,2021
PIE,CN,F 42,Ingegneria civile                                           ,0,0,0,0,0,2021
PIE,CN,F 43,Lavori di costruzione specializzati                         ,0,0,138,0,138,2021
PIE,CN,G   ,Commercio all'ingrosso e al dettaglio; riparazione di aut...,1,0,175,0,176,2021
PIE,CN,G 45,Commercio all'ingrosso e al dettaglio e riparazione di au...,0,0,14,0,14,2021
PIE,CN,G 46,Commercio all'ingrosso (escluso quello di autoveicoli e d...,1,0,61,0,62,2021
PIE,CN,G 47,Commercio al dettaglio (escluso quello di autoveicoli e d...,0,0,100,0,100,2021
PIE,CN,H   ,Trasporto e magazzinaggio                                   ,0,0,6,0,6,2021
PIE,CN,H 49,Trasporto terrestre e mediante condotte                     ,0,0,2,0,2,2021
PIE,CN,H 50,Trasporto marittimo e per vie d'acqua                       ,0,0,0,0,0,2021
PIE,CN,H 51,Trasporto aereo                                             ,0,0,0,0,0,2021
PIE,CN,H 52,Magazzinaggio e attività di supporto ai trasporti           ,0,0,0,0,0,2021
PIE,CN,H 53,Servizi postali e attività di corriere                      ,0,0,4,0,4,2021
PIE,CN,I   ,Attività dei servizi alloggio e ristorazione                ,0,1,33,0,34,2021
PIE,CN,I 55,Alloggio                                                    ,0,0,1,0,1,2021
PIE,CN,I 56,Attività dei servizi di ristorazione                        ,0,1,32,0,33,2021
PIE,CN,J   ,Servizi di informazione e comunicazione                     ,0,0,9,0,9,2021
PIE,CN,J 58,Attività editoriali                                         ,0,0,1,0,1,2021
PIE,CN,J 59,"Attività di produzione cinematografica, di video e di pro...",0,0,0,0,0,2021
PIE,CN,J 60,Attività di programmazione e trasmissione                   ,0,0,0,0,0,2021
PIE,CN,J 61,Telecomunicazioni                                           ,0,0,2,0,2,2021
PIE,CN,J 62,"Produzione di software, consulenza informatica e attività...",0,0,5,0,5,2021
PIE,CN,J 63,Attività dei servizi d'informazione e altri servizi infor...,0,0,1,0,1,2021
PIE,CN,K   ,Attività finanziarie e assicurative                         ,0,0,4,0,4,2021
PIE,CN,K 64,Attività di servizi finanziari (escluse le assicurazioni ...,0,0,0,0,0,2021
PIE,CN,K 65,"Assicurazioni, riassicurazioni e fondi pensione (escluse ...",0,0,0,0,0,2021
PIE,CN,K 66,Attività ausiliarie dei servizi finanziari e delle attivi...,0,0,4,0,4,2021
PIE,CN,L   ,Attivita' immobiliari                                       ,0,2,6,0,8,2021
PIE,CN,L 68,Attivita' immobiliari                                       ,0,2,6,0,8,2021
PIE,CN,M   ,"Attività professionali, scientifiche e tecniche             ",0,1,14,0,15,2021
PIE,CN,M 69,Attività legali e contabilità                               ,0,0,1,0,1,2021
PIE,CN,M 70,Attività di direzione aziendale e di consulenza gestional...,0,1,7,0,8,2021
PIE,CN,M 71,Attività degli studi di architettura e d'ingegneria; coll...,0,0,1,0,1,2021
PIE,CN,M 72,Ricerca scientifica e sviluppo                              ,0,0,0,0,0,2021
PIE,CN,M 73,Pubblicità e ricerche di mercato                            ,0,0,1,0,1,2021
PIE,CN,M 74,"Altre attività professionali, scientifiche e tecniche       ",0,0,4,0,4,2021
PIE,CN,M 75,Servizi veterinari                                          ,0,0,0,0,0,2021
PIE,CN,N   ,"Noleggio, agenzie di viaggio, servizi di supporto alle im...",0,0,33,0,33,2021
PIE,CN,N 77,Attività di noleggio e leasing operativo                    ,0,0,0,0,0,2021
PIE,CN,N 78,"Attività di ricerca, selezione, fornitura di personale      ",0,0,0,0,0,2021
PIE,CN,N 79,"Attività dei servizi delle agenzie di viaggio, dei tour o...",0,0,1,0,1,2021
PIE,CN,N 80,Servizi di vigilanza e investigazione                       ,0,0,0,0,0,2021
PIE,CN,N 81,Attività di servizi per edifici e paesaggio                 ,0,0,13,0,13,2021
PIE,CN,N 82,Attività di supporto per le funzioni d'ufficio e altri se...,0,0,19,0,19,2021
PIE,CN,O   ,Amministrazione pubblica e difesa; assicurazione sociale ...,0,0,0,0,0,2021
PIE,CN,O 84,Amministrazione pubblica e difesa; assicurazione sociale ...,0,0,0,0,0,2021
PIE,CN,P   ,Istruzione                                                  ,0,0,1,0,1,2021
PIE,CN,P 85,Istruzione                                                  ,0,0,1,0,1,2021
PIE,CN,Q   ,Sanita' e assistenza sociale                                ,0,0,1,0,1,2021
PIE,CN,Q 86,Assistenza sanitaria                                        ,0,0,0,0,0,2021
PIE,CN,Q 87,Servizi di assistenza sociale residenziale                  ,0,0,0,0,0,2021
PIE,CN,Q 88,Assistenza sociale non residenziale                         ,0,0,1,0,1,2021
PIE,CN,R   ,"Attività artistiche, sportive, di intrattenimento e diver...",0,0,3,0,3,2021
PIE,CN,R 90,"Attività creative, artistiche e di intrattenimento          ",0,0,0,0,0,2021
PIE,CN,R 91,"Attività di biblioteche, archivi, musei ed altre attività...",0,0,0,0,0,2021
PIE,CN,R 92,"Attività riguardanti le lotterie, le scommesse, le case d...",0,0,0,0,0,2021
PIE,CN,R 93,"Attività sportive, di intrattenimento e di divertimento     ",0,0,3,0,3,2021
PIE,CN,S   ,Altre attività di servizi                                   ,0,0,16,0,16,2021
PIE,CN,S 94,Attività di organizzazioni associative                      ,0,0,0,0,0,2021
PIE,CN,S 95,Riparazione di computer e di beni per uso personale e per...,0,0,3,0,3,2021
PIE,CN,S 96,Altre attività di servizi per la persona                    ,0,0,13,0,13,2021
PIE,CN,T   ,Attività di famiglie e convivenze come datori di lavoro p...,0,0,0,0,0,2021
PIE,CN,T 97,Attività di famiglie e convivenze come datori di lavoro p...,0,0,0,0,0,2021
PIE,CN,T 98,Produzione di beni e servizi indifferenziati per uso prop...,0,0,0,0,0,2021
PIE,CN,U   ,Organizzazioni ed organismi extraterritoriali               ,0,0,0,0,0,2021
PIE,CN,U 99,Organizzazioni ed organismi extraterritoriali               ,0,0,0,0,0,2021
PIE,CN,XX  ,Imprese non classificate                                    ,0,7,30,0,37,2021
PIE,CN,TOT ,TOTALE                                                      ,2,16,606,0,624,2021
PIE,AT,A   ,"Agricoltura, silvicoltura pesca                             ",0,0,1,1,2,2021
PIE,AT,A 01,"Coltivazioni agricole e produzione di prodotti animali, c...",0,0,0,1,1,2021
PIE,AT,A 02,Silvicoltura ed utilizzo di aree forestali                  ,0,0,1,0,1,2021
PIE,AT,A 03,Pesca e acquacoltura                                        ,0,0,0,0,0,2021
PIE,AT,B   ,Estrazione di minerali da cave e miniere                    ,0,0,0,0,0,2021
PIE,AT,B 05,Estrazione di carbone (esclusa torba)                       ,0,0,0,0,0,2021
PIE,AT,B 06,Estraz.di petrolio greggio e di gas naturale                ,0,0,0,0,0,2021
PIE,AT,B 07,Estrazione di minerali metalliferi                          ,0,0,0,0,0,2021
PIE,AT,B 08,Altre attività di estrazione di minerali da cave e miniere  ,0,0,0,0,0,2021
PIE,AT,B 09,Attività dei servizi di supporto all'estrazione             ,0,0,0,0,0,2021
PIE,AT,C   ,Attività manifatturiere                                     ,0,0,0,0,0,2021
PIE,AT,C 10,Industrie alimentari                                        ,0,0,0,0,0,2021
PIE,AT,C 11,Industria delle bevande                                     ,0,0,0,0,0,2021
PIE,AT,C 12,Industria del tabacco                                       ,0,0,0,0,0,2021
PIE,AT,C 13,Industrie tessili                                           ,0,0,0,0,0,2021
PIE,AT,C 14,Confezione di articoli di abbigliamento; confezione di ar...,0,0,0,0,0,2021
PIE,AT,C 15,Fabbricazione di articoli in pelle e simili                 ,0,0,0,0,0,2021
PIE,AT,C 16,Industria del legno e dei prodotti in legno e sughero (es...,0,0,0,0,0,2021
PIE,AT,C 17,Fabbricazione di carta e di prodotti di carta               ,0,0,0,0,0,2021
PIE,AT,C 18,Stampa e riproduzione di supporti registrati                ,0,0,0,0,0,2021
PIE,AT,C 19,Fabbricazione di coke e prodotti derivanti dalla raffinaz...,0,0,0,0,0,2021
PIE,AT,C 20,Fabbricazione di prodotti chimici                           ,0,0,0,0,0,2021
PIE,AT,C 21,Fabbricazione di prodotti farmaceutici di base e di prepa...,0,0,0,0,0,2021
PIE,AT,C 22,Fabbricazione di articoli in gomma e materie plastiche      ,0,0,0,0,0,2021
PIE,AT,C 23,Fabbricazione di altri prodotti della lavorazione di miner..,0,0,0,0,0,2021
PIE,AT,C 24,Metallurgia                                                 ,0,0,0,0,0,2021
PIE,AT,C 25,Fabbricazione di prodotti in metallo (esclusi macchinari ...,0,0,0,0,0,2021
PIE,AT,C 26,Fabbricazione di computer e prodotti di elettronica e ott...,0,0,0,0,0,2021
PIE,AT,C 27,Fabbricazione di apparecchiature elettriche ed apparecchi...,0,0,0,0,0,2021
PIE,AT,C 28,Fabbricazione di macchinari ed apparecchiature nca          ,0,0,0,0,0,2021
PIE,AT,C 29,"Fabbricazione di autoveicoli, rimorchi e semirimorchi       ",0,0,0,0,0,2021
PIE,AT,C 30,Fabbricazione di altri mezzi di trasporto                   ,0,0,0,0,0,2021
PIE,AT,C 31,Fabbricazione di mobili                                     ,0,0,0,0,0,2021
PIE,AT,C 32,Altre industrie manifatturiere                              ,0,0,0,0,0,2021
PIE,AT,C 33,"Riparazione, manutenzione ed installazione di macchine ed...",0,0,0,0,0,2021
PIE,AT,D   ,"Fornitura di energia elettrica, gas, vapore e aria condiz...",0,0,0,0,0,2021
PIE,AT,D 35,"Fornitura di energia elettrica, gas, vapore e aria condiz...",0,0,0,0,0,2021
PIE,AT,E   ,"Fornitura di acqua; reti fognarie, attività di gestione d...",0,0,0,0,0,2021
PIE,AT,E 36,"Raccolta, trattamento e fornitura di acqua                  ",0,0,0,0,0,2021
PIE,AT,E 37,Gestione delle reti fognarie                                ,0,0,0,0,0,2021
PIE,AT,E 38,"Attività di raccolta, trattamento e smaltimento dei rifiu...",0,0,0,0,0,2021
PIE,AT,E 39,Attività di risanamento e altri servizi di gestione dei r...,0,0,0,0,0,2021
PIE,AT,F   ,Costruzioni                                                 ,0,0,1,0,1,2021
PIE,AT,F 41,Costruzione di edifici                                      ,0,0,1,0,1,2021
PIE,AT,F 42,Ingegneria civile                                           ,0,0,0,0,0,2021
PIE,AT,F 43,Lavori di costruzione specializzati                         ,0,0,0,0,0,2021
PIE,AT,G   ,Commercio all'ingrosso e al dettaglio; riparazione di aut...,0,0,0,0,0,2021
PIE,AT,G 45,Commercio all'ingrosso e al dettaglio e riparazione di au...,0,0,0,0,0,2021
PIE,AT,G 46,Commercio all'ingrosso (escluso quello di autoveicoli e d...,0,0,0,0,0,2021
PIE,AT,G 47,Commercio al dettaglio (escluso quello di autoveicoli e d...,0,0,0,0,0,2021
PIE,AT,H   ,Trasporto e magazzinaggio                                   ,0,0,0,0,0,2021
PIE,AT,H 49,Trasporto terrestre e mediante condotte                     ,0,0,0,0,0,2021
PIE,AT,H 50,Trasporto marittimo e per vie d'acqua                       ,0,0,0,0,0,2021
PIE,AT,H 51,Trasporto aereo                                             ,0,0,0,0,0,2021
PIE,AT,H 52,Magazzinaggio e attività di supporto ai trasporti           ,0,0,0,0,0,2021
PIE,AT,H 53,Servizi postali e attività di corriere                      ,0,0,0,0,0,2021
PIE,AT,I   ,Attività dei servizi alloggio e ristorazione                ,0,0,0,0,0,2021
PIE,AT,I 55,Alloggio                                                    ,0,0,0,0,0,2021
PIE,AT,I 56,Attività dei servizi di ristorazione                        ,0,0,0,0,0,2021
PIE,AT,J   ,Servizi di informazione e comunicazione                     ,0,0,0,0,0,2021
PIE,AT,J 58,Attività editoriali                                         ,0,0,0,0,0,2021
PIE,AT,J 59,"Attività di produzione cinematografica, di video e di pro...",0,0,0,0,0,2021
PIE,AT,J 60,Attività di programmazione e trasmissione                   ,0,0,0,0,0,2021
PIE,AT,J 61,Telecomunicazioni                                           ,0,0,0,0,0,2021
PIE,AT,J 62,"Produzione di software, consulenza informatica e attività...",0,0,0,0,0,2021
PIE,AT,J 63,Attività dei servizi d'informazione e altri servizi infor...,0,0,0,0,0,2021
PIE,AT,K   ,Attività finanziarie e assicurative                         ,0,0,0,0,0,2021
PIE,AT,K 64,Attività di servizi finanziari (escluse le assicurazioni ...,0,0,0,0,0,2021
PIE,AT,K 65,"Assicurazioni, riassicurazioni e fondi pensione (escluse ...",0,0,0,0,0,2021
PIE,AT,K 66,Attività ausiliarie dei servizi finanziari e delle attivi...,0,0,0,0,0,2021
PIE,AT,L   ,Attivita' immobiliari                                       ,0,0,0,0,0,2021
PIE,AT,L 68,Attivita' immobiliari                                       ,0,0,0,0,0,2021
PIE,AT,M   ,"Attività professionali, scientifiche e tecniche             ",0,0,0,0,0,2021
PIE,AT,M 69,Attività legali e contabilità                               ,0,0,0,0,0,2021
PIE,AT,M 70,Attività di direzione aziendale e di consulenza gestional...,0,0,0,0,0,2021
PIE,AT,M 71,Attività degli studi di architettura e d'ingegneria; coll...,0,0,0,0,0,2021
PIE,AT,M 72,Ricerca scientifica e sviluppo                              ,0,0,0,0,0,2021
PIE,AT,M 73,Pubblicità e ricerche di mercato                            ,0,0,0,0,0,2021
PIE,AT,M 74,"Altre attività professionali, scientifiche e tecniche       ",0,0,0,0,0,2021
PIE,AT,M 75,Servizi veterinari                                          ,0,0,0,0,0,2021
PIE,AT,N   ,"Noleggio, agenzie di viaggio, servizi di supporto alle im...",0,0,3,0,3,2021
PIE,AT,N 77,Attività di noleggio e leasing operativo                    ,0,0,0,0,0,2021
PIE,AT,N 78,"Attività di ricerca, selezione, fornitura di personale      ",0,0,0,0,0,2021
PIE,AT,N 79,"Attività dei servizi delle agenzie di viaggio, dei tour o...",0,0,0,0,0,2021
PIE,AT,N 80,Servizi di vigilanza e investigazione                       ,0,0,0,0,0,2021
PIE,AT,N 81,Attività di servizi per edifici e paesaggio                 ,0,0,3,0,3,2021
PIE,AT,N 82,Attività di supporto per le funzioni d'ufficio e altri se...,0,0,0,0,0,2021
PIE,AT,O   ,Amministrazione pubblica e difesa; assicurazione sociale ...,0,0,0,0,0,2021
PIE,AT,O 84,Amministrazione pubblica e difesa; assicurazione sociale ...,0,0,0,0,0,2021
PIE,AT,P   ,Istruzione                                                  ,0,0,0,0,0,2021
PIE,AT,P 85,Istruzione                                                  ,0,0,0,0,0,2021
PIE,AT,Q   ,Sanita' e assistenza sociale                                ,0,0,0,0,0,2021
PIE,AT,Q 86,Assistenza sanitaria                                        ,0,0,0,0,0,2021
PIE,AT,Q 87,Servizi di assistenza sociale residenziale                  ,0,0,0,0,0,2021
PIE,AT,Q 88,Assistenza sociale non residenziale                         ,0,0,0,0,0,2021
PIE,AT,R   ,"Attività artistiche, sportive, di intrattenimento e diver...",0,0,0,0,0,2021
PIE,AT,R 90,"Attività creative, artistiche e di intrattenimento          ",0,0,0,0,0,2021
PIE,AT,R 91,"Attività di biblioteche, archivi, musei ed altre attività...",0,0,0,0,0,2021
PIE,AT,R 92,"Attività riguardanti le lotterie, le scommesse, le case d...",0,0,0,0,0,2021
PIE,AT,R 93,"Attività sportive, di intrattenimento e di divertimento     ",0,0,0,0,0,2021
PIE,AT,S   ,Altre attività di servizi                                   ,0,0,0,0,0,2021
PIE,AT,S 94,Attività di organizzazioni associative                      ,0,0,0,0,0,2021
PIE,AT,S 95,Riparazione di computer e di beni per uso personale e per...,0,0,0,0,0,2021
PIE,AT,S 96,Altre attività di servizi per la persona                    ,0,0,0,0,0,2021
PIE,AT,T   ,Attività di famiglie e convivenze come datori di lavoro p...,0,0,0,0,0,2021
PIE,AT,T 97,Attività di famiglie e convivenze come datori di lavoro p...,0,0,0,0,0,2021
PIE,AT,T 98,Produzione di beni e servizi indifferenziati per uso prop...,0,0,0,0,0,2021
PIE,AT,U   ,Organizzazioni ed organismi extraterritoriali               ,0,0,0,0,0,2021
PIE,AT,U 99,Organizzazioni ed organismi extraterritoriali               ,0,0,0,0,0,2021
PIE,AT,XX  ,Imprese non classificate                                    ,0,0,0,1,1,2021
PIE,AT,TOT ,TOTALE                                                      ,0,0,5,2,7,2021
PIE,AL,A   ,"Agricoltura, silvicoltura pesca                             ",0,0,0,0,0,2021
PIE,AL,A 01,"Coltivazioni agricole e produzione di prodotti animali, c...",0,0,0,0,0,2021
PIE,AL,A 02,Silvicoltura ed utilizzo di aree forestali                  ,0,0,0,0,0,2021
PIE,AL,A 03,Pesca e acquacoltura                                        ,0,0,0,0,0,2021
PIE,AL,B   ,Estrazione di minerali da cave e miniere                    ,0,0,0,0,0,2021
PIE,AL,B 05,Estrazione di carbone (esclusa torba)                       ,0,0,0,0,0,2021
PIE,AL,B 06,Estraz.di petrolio greggio e di gas naturale                ,0,0,0,0,0,2021
PIE,AL,B 07,Estrazione di minerali metalliferi                          ,0,0,0,0,0,2021
PIE,AL,B 08,Altre attività di estrazione di minerali da cave e miniere  ,0,0,0,0,0,2021
PIE,AL,B 09,Attività dei servizi di supporto all'estrazione             ,0,0,0,0,0,2021
PIE,AL,C   ,Attività manifatturiere                                     ,0,0,0,1,1,2021
PIE,AL,C 10,Industrie alimentari                                        ,0,0,0,0,0,2021
PIE,AL,C 11,Industria delle bevande                                     ,0,0,0,0,0,2021
PIE,AL,C 12,Industria del tabacco                                       ,0,0,0,0,0,2021
PIE,AL,C 13,Industrie tessili                                           ,0,0,0,0,0,2021
PIE,AL,C 14,Confezione di articoli di abbigliamento; confezione di ar...,0,0,0,0,0,2021
PIE,AL,C 15,Fabbricazione di articoli in pelle e simili                 ,0,0,0,0,0,2021
PIE,AL,C 16,Industria del legno e dei prodotti in legno e sughero (es...,0,0,0,0,0,2021
PIE,AL,C 17,Fabbricazione di carta e di prodotti di carta               ,0,0,0,0,0,2021
PIE,AL,C 18,Stampa e riproduzione di supporti registrati                ,0,0,0,0,0,2021
PIE,AL,C 19,Fabbricazione di coke e prodotti derivanti dalla raffinaz...,0,0,0,0,0,2021
PIE,AL,C 20,Fabbricazione di prodotti chimici                           ,0,0,0,0,0,2021
PIE,AL,C 21,Fabbricazione di prodotti farmaceutici di base e di prepa...,0,0,0,0,0,2021
PIE,AL,C 22,Fabbricazione di articoli in gomma e materie plastiche      ,0,0,0,0,0,2021
PIE,AL,C 23,Fabbricazione di altri prodotti della lavorazione di miner..,0,0,0,0,0,2021
PIE,AL,C 24,Metallurgia                                                 ,0,0,0,0,0,2021
PIE,AL,C 25,Fabbricazione di prodotti in metallo (esclusi macchinari ...,0,0,0,0,0,2021
PIE,AL,C 26,Fabbricazione di computer e prodotti di elettronica e ott...,0,0,0,0,0,2021
PIE,AL,C 27,Fabbricazione di apparecchiature elettriche ed apparecchi...,0,0,0,0,0,2021
PIE,AL,C 28,Fabbricazione di macchinari ed apparecchiature nca          ,0,0,0,0,0,2021
PIE,AL,C 29,"Fabbricazione di autoveicoli, rimorchi e semirimorchi       ",0,0,0,0,0,2021
PIE,AL,C 30,Fabbricazione di altri mezzi di trasporto                   ,0,0,0,0,0,2021
PIE,AL,C 31,Fabbricazione di mobili                                     ,0,0,0,0,0,2021
PIE,AL,C 32,Altre industrie manifatturiere                              ,0,0,0,0,0,2021
PIE,AL,C 33,"Riparazione, manutenzione ed installazione di macchine ed...",0,0,0,1,1,2021
PIE,AL,D   ,"Fornitura di energia elettrica, gas, vapore e aria condiz...",0,0,0,0,0,2021
PIE,AL,D 35,"Fornitura di energia elettrica, gas, vapore e aria condiz...",0,0,0,0,0,2021
PIE,AL,E   ,"Fornitura di acqua; reti fognarie, attività di gestione d...",0,0,0,0,0,2021
PIE,AL,E 36,"Raccolta, trattamento e fornitura di acqua                  ",0,0,0,0,0,2021
PIE,AL,E 37,Gestione delle reti fognarie                                ,0,0,0,0,0,2021
PIE,AL,E 38,"Attività di raccolta, trattamento e smaltimento dei rifiu...",0,0,0,0,0,2021
PIE,AL,E 39,Attività di risanamento e altri servizi di gestione dei r...,0,0,0,0,0,2021
PIE,AL,F   ,Costruzioni                                                 ,0,0,0,1,1,2021
PIE,AL,F 41,Costruzione di edifici                                      ,0,0,0,0,0,2021
PIE,AL,F 42,Ingegneria civile                                           ,0,0,0,0,0,2021
PIE,AL,F 43,Lavori di costruzione specializzati                         ,0,0,0,1,1,2021
PIE,AL,G   ,Commercio all'ingrosso e al dettaglio; riparazione di aut...,0,0,0,0,0,2021
PIE,AL,G 45,Commercio all'ingrosso e al dettaglio e riparazione di au...,0,0,0,0,0,2021
PIE,AL,G 46,Commercio all'ingrosso (escluso quello di autoveicoli e d...,0,0,0,0,0,2021
PIE,AL,G 47,Commercio al dettaglio (escluso quello di autoveicoli e d...,0,0,0,0,0,2021
PIE,AL,H   ,Trasporto e magazzinaggio                                   ,0,0,0,2,2,2021
PIE,AL,H 49,Trasporto terrestre e mediante condotte                     ,0,0,0,0,0,2021
PIE,AL,H 50,Trasporto marittimo e per vie d'acqua                       ,0,0,0,0,0,2021
PIE,AL,H 51,Trasporto aereo                                             ,0,0,0,0,0,2021
PIE,AL,H 52,Magazzinaggio e attività di supporto ai trasporti           ,0,0,0,2,2,2021
PIE,AL,H 53,Servizi postali e attività di corriere                      ,0,0,0,0,0,2021
PIE,AL,I   ,Attività dei servizi alloggio e ristorazione                ,0,0,0,0,0,2021
PIE,AL,I 55,Alloggio                                                    ,0,0,0,0,0,2021
PIE,AL,I 56,Attività dei servizi di ristorazione                        ,0,0,0,0,0,2021
PIE,AL,J   ,Servizi di informazione e comunicazione                     ,0,0,0,0,0,2021
PIE,AL,J 58,Attività editoriali                                         ,0,0,0,0,0,2021
PIE,AL,J 59,"Attività di produzione cinematografica, di video e di pro...",0,0,0,0,0,2021
PIE,AL,J 60,Attività di programmazione e trasmissione                   ,0,0,0,0,0,2021
PIE,AL,J 61,Telecomunicazioni                                           ,0,0,0,0,0,2021
PIE,AL,J 62,"Produzione di software, consulenza informatica e attività...",0,0,0,0,0,2021
PIE,AL,J 63,Attività dei servizi d'informazione e altri servizi infor...,0,0,0,0,0,2021
PIE,AL,K   ,Attività finanziarie e assicurative                         ,0,0,0,0,0,2021
PIE,AL,K 64,Attività di servizi finanziari (escluse le assicurazioni ...,0,0,0,0,0,2021
PIE,AL,K 65,"Assicurazioni, riassicurazioni e fondi pensione (escluse ...",0,0,0,0,0,2021
PIE,AL,K 66,Attività ausiliarie dei servizi finanziari e delle attivi...,0,0,0,0,0,2021
PIE,AL,L   ,Attivita' immobiliari                                       ,0,0,0,0,0,2021
PIE,AL,L 68,Attivita' immobiliari                                       ,0,0,0,0,0,2021
PIE,AL,M   ,"Attività professionali, scientifiche e tecniche             ",0,0,0,0,0,2021
PIE,AL,M 69,Attività legali e contabilità                               ,0,0,0,0,0,2021
PIE,AL,M 70,Attività di direzione aziendale e di consulenza gestional...,0,0,0,0,0,2021
PIE,AL,M 71,Attività degli studi di architettura e d'ingegneria; coll...,0,0,0,0,0,2021
PIE,AL,M 72,Ricerca scientifica e sviluppo                              ,0,0,0,0,0,2021
PIE,AL,M 73,Pubblicità e ricerche di mercato                            ,0,0,0,0,0,2021
PIE,AL,M 74,"Altre attività professionali, scientifiche e tecniche       ",0,0,0,0,0,2021
PIE,AL,M 75,Servizi veterinari                                          ,0,0,0,0,0,2021
PIE,AL,N   ,"Noleggio, agenzie di viaggio, servizi di supporto alle im...",0,0,0,0,0,2021
PIE,AL,N 77,Attività di noleggio e leasing operativo                    ,0,0,0,0,0,2021
PIE,AL,N 78,"Attività di ricerca, selezione, fornitura di personale      ",0,0,0,0,0,2021
PIE,AL,N 79,"Attività dei servizi delle agenzie di viaggio, dei tour o...",0,0,0,0,0,2021
PIE,AL,N 80,Servizi di vigilanza e investigazione                       ,0,0,0,0,0,2021
PIE,AL,N 81,Attività di servizi per edifici e paesaggio                 ,0,0,0,0,0,2021
PIE,AL,N 82,Attività di supporto per le funzioni d'ufficio e altri se...,0,0,0,0,0,2021
PIE,AL,O   ,Amministrazione pubblica e difesa; assicurazione sociale ...,0,0,0,0,0,2021
PIE,AL,O 84,Amministrazione pubblica e difesa; assicurazione sociale ...,0,0,0,0,0,2021
PIE,AL,P   ,Istruzione                                                  ,0,0,0,0,0,2021
PIE,AL,P 85,Istruzione                                                  ,0,0,0,0,0,2021
PIE,AL,Q   ,Sanita' e assistenza sociale                                ,0,0,0,0,0,2021
PIE,AL,Q 86,Assistenza sanitaria                                        ,0,0,0,0,0,2021
PIE,AL,Q 87,Servizi di assistenza sociale residenziale                  ,0,0,0,0,0,2021
PIE,AL,Q 88,Assistenza sociale non residenziale                         ,0,0,0,0,0,2021
PIE,AL,R   ,"Attività artistiche, sportive, di intrattenimento e diver...",0,0,0,0,0,2021
PIE,AL,R 90,"Attività creative, artistiche e di intrattenimento          ",0,0,0,0,0,2021
PIE,AL,R 91,"Attività di biblioteche, archivi, musei ed altre attività...",0,0,0,0,0,2021
PIE,AL,R 92,"Attività riguardanti le lotterie, le scommesse, le case d...",0,0,0,0,0,2021
PIE,AL,R 93,"Attività sportive, di intrattenimento e di divertimento     ",0,0,0,0,0,2021
PIE,AL,S   ,Altre attività di servizi                                   ,0,0,0,0,0,2021
PIE,AL,S 94,Attività di organizzazioni associative                      ,0,0,0,0,0,2021
PIE,AL,S 95,Riparazione di computer e di beni per uso personale e per...,0,0,0,0,0,2021
PIE,AL,S 96,Altre attività di servizi per la persona                    ,0,0,0,0,0,2021
PIE,AL,T   ,Attività di famiglie e convivenze come datori di lavoro p...,0,0,0,0,0,2021
PIE,AL,T 97,Attività di famiglie e convivenze come datori di lavoro p...,0,0,0,0,0,2021
PIE,AL,T 98,Produzione di beni e servizi indifferenziati per uso prop...,0,0,0,0,0,2021
PIE,AL,U   ,Organizzazioni ed organismi extraterritoriali               ,0,0,0,0,0,2021
PIE,AL,U 99,Organizzazioni ed organismi extraterritoriali               ,0,0,0,0,0,2021
PIE,AL,XX  ,Imprese non classificate                                    ,1,0,0,0,1,2021
PIE,AL,TOT ,TOTALE                                                      ,1,0,0,4,5,2021
PIE,BI,A   ,"Agricoltura, silvicoltura pesca                             ",0,0,10,0,10,2021
PIE,BI,A 01,"Coltivazioni agricole e produzione di prodotti animali, c...",0,0,10,0,10,2021
PIE,BI,A 02,Silvicoltura ed utilizzo di aree forestali                  ,0,0,0,0,0,2021
PIE,BI,A 03,Pesca e acquacoltura                                        ,0,0,0,0,0,2021
PIE,BI,B   ,Estrazione di minerali da cave e miniere                    ,0,0,0,0,0,2021
PIE,BI,B 05,Estrazione di carbone (esclusa torba)                       ,0,0,0,0,0,2021
PIE,BI,B 06,Estraz.di petrolio greggio e di gas naturale                ,0,0,0,0,0,2021
PIE,BI,B 07,Estrazione di minerali metalliferi                          ,0,0,0,0,0,2021
PIE,BI,B 08,Altre attività di estrazione di minerali da cave e miniere  ,0,0,0,0,0,2021
PIE,BI,B 09,Attività dei servizi di supporto all'estrazione             ,0,0,0,0,0,2021
PIE,BI,C   ,Attività manifatturiere                                     ,22,26,18,0,66,2021
PIE,BI,C 10,Industrie alimentari                                        ,2,1,0,0,3,2021
PIE,BI,C 11,Industria delle bevande                                     ,0,0,0,0,0,2021
PIE,BI,C 12,Industria del tabacco                                       ,0,0,0,0,0,2021
PIE,BI,C 13,Industrie tessili                                           ,8,17,4,0,29,2021
PIE,BI,C 14,Confezione di articoli di abbigliamento; confezione di ar...,2,2,1,0,5,2021
PIE,BI,C 15,Fabbricazione di articoli in pelle e simili                 ,0,0,0,0,0,2021
PIE,BI,C 16,Industria del legno e dei prodotti in legno e sughero (es...,1,0,3,0,4,2021
PIE,BI,C 17,Fabbricazione di carta e di prodotti di carta               ,0,0,0,0,0,2021
PIE,BI,C 18,Stampa e riproduzione di supporti registrati                ,0,1,0,0,1,2021
PIE,BI,C 19,Fabbricazione di coke e prodotti derivanti dalla raffinaz...,0,1,0,0,1,2021
PIE,BI,C 20,Fabbricazione di prodotti chimici                           ,0,0,0,0,0,2021
PIE,BI,C 21,Fabbricazione di prodotti farmaceutici di base e di prepa...,0,0,0,0,0,2021
PIE,BI,C 22,Fabbricazione di articoli in gomma e materie plastiche      ,0,0,0,0,0,2021
PIE,BI,C 23,Fabbricazione di altri prodotti della lavorazione di miner..,0,1,0,0,1,2021
PIE,BI,C 24,Metallurgia                                                 ,0,0,0,0,0,2021
PIE,BI,C 25,Fabbricazione di prodotti in metallo (esclusi macchinari ...,2,3,6,0,11,2021
PIE,BI,C 26,Fabbricazione di computer e prodotti di elettronica e ott...,0,0,0,0,0,2021
PIE,BI,C 27,Fabbricazione di apparecchiature elettriche ed apparecchi...,0,0,0,0,0,2021
PIE,BI,C 28,Fabbricazione di macchinari ed apparecchiature nca          ,3,0,1,0,4,2021
PIE,BI,C 29,"Fabbricazione di autoveicoli, rimorchi e semirimorchi       ",1,0,0,0,1,2021
PIE,BI,C 30,Fabbricazione di altri mezzi di trasporto                   ,0,0,0,0,0,2021
PIE,BI,C 31,Fabbricazione di mobili                                     ,0,0,2,0,2,2021
PIE,BI,C 32,Altre industrie manifatturiere                              ,2,0,0,0,2,2021
PIE,BI,C 33,"Riparazione, manutenzione ed installazione di macchine ed...",1,0,1,0,2,2021
PIE,BI,D   ,"Fornitura di energia elettrica, gas, vapore e aria condiz...",0,0,0,0,0,2021
PIE,BI,D 35,"Fornitura di energia elettrica, gas, vapore e aria condiz...",0,0,0,0,0,2021
PIE,BI,E   ,"Fornitura di acqua; reti fognarie, attività di gestione d...",0,0,0,0,0,2021
PIE,BI,E 36,"Raccolta, trattamento e fornitura di acqua                  ",0,0,0,0,0,2021
PIE,BI,E 37,Gestione delle reti fognarie                                ,0,0,0,0,0,2021
PIE,BI,E 38,"Attività di raccolta, trattamento e smaltimento dei rifiu...",0,0,0,0,0,2021
PIE,BI,E 39,Attività di risanamento e altri servizi di gestione dei r...,0,0,0,0,0,2021
PIE,BI,F   ,Costruzioni                                                 ,13,9,65,1,88,2021
PIE,BI,F 41,Costruzione di edifici                                      ,6,6,12,0,24,2021
PIE,BI,F 42,Ingegneria civile                                           ,0,1,0,0,1,2021
PIE,BI,F 43,Lavori di costruzione specializzati                         ,7,2,53,1,63,2021
PIE,BI,G   ,Commercio all'ingrosso e al dettaglio; riparazione di aut...,14,31,34,0,79,2021
PIE,BI,G 45,Commercio all'ingrosso e al dettaglio e riparazione di au...,0,1,2,0,3,2021
PIE,BI,G 46,Commercio all'ingrosso (escluso quello di autoveicoli e d...,7,11,6,0,24,2021
PIE,BI,G 47,Commercio al dettaglio (escluso quello di autoveicoli e d...,7,19,26,0,52,2021
PIE,BI,H   ,Trasporto e magazzinaggio                                   ,0,3,3,1,7,2021
PIE,BI,H 49,Trasporto terrestre e mediante condotte                     ,0,2,3,0,5,2021
PIE,BI,H 50,Trasporto marittimo e per vie d'acqua                       ,0,0,0,0,0,2021
PIE,BI,H 51,Trasporto aereo                                             ,0,0,0,0,0,2021
PIE,BI,H 52,Magazzinaggio e attività di supporto ai trasporti           ,0,1,0,1,2,2021
PIE,BI,H 53,Servizi postali e attività di corriere                      ,0,0,0,0,0,2021
PIE,BI,I   ,Attività dei servizi alloggio e ristorazione                ,6,41,4,0,51,2021
PIE,BI,I 55,Alloggio                                                    ,0,1,0,0,1,2021
PIE,BI,I 56,Attività dei servizi di ristorazione                        ,6,40,4,0,50,2021
PIE,BI,J   ,Servizi di informazione e comunicazione                     ,4,2,1,0,7,2021
PIE,BI,J 58,Attività editoriali                                         ,1,2,0,0,3,2021
PIE,BI,J 59,"Attività di produzione cinematografica, di video e di pro...",0,0,0,0,0,2021
PIE,BI,J 60,Attività di programmazione e trasmissione                   ,0,0,0,0,0,2021
PIE,BI,J 61,Telecomunicazioni                                           ,0,0,0,0,0,2021
PIE,BI,J 62,"Produzione di software, consulenza informatica e attività...",3,0,1,0,4,2021
PIE,BI,J 63,Attività dei servizi d'informazione e altri servizi infor...,0,0,0,0,0,2021
PIE,BI,K   ,Attività finanziarie e assicurative                         ,3,0,1,0,4,2021
PIE,BI,K 64,Attività di servizi finanziari (escluse le assicurazioni ...,2,0,0,0,2,2021
PIE,BI,K 65,"Assicurazioni, riassicurazioni e fondi pensione (escluse ...",0,0,0,0,0,2021
PIE,BI,K 66,Attività ausiliarie dei servizi finanziari e delle attivi...,1,0,1,0,2,2021
PIE,BI,L   ,Attivita' immobiliari                                       ,9,1,2,0,12,2021
PIE,BI,L 68,Attivita' immobiliari                                       ,9,1,2,0,12,2021
PIE,BI,M   ,"Attività professionali, scientifiche e tecniche             ",10,2,2,0,14,2021
PIE,BI,M 69,Attività legali e contabilità                               ,0,0,0,0,0,2021
PIE,BI,M 70,Attività di direzione aziendale e di consulenza gestional...,3,0,0,0,3,2021
PIE,BI,M 71,Attività degli studi di architettura e d'ingegneria; coll...,2,0,0,0,2,2021
PIE,BI,M 72,Ricerca scientifica e sviluppo                              ,0,0,0,0,0,2021
PIE,BI,M 73,Pubblicità e ricerche di mercato                            ,3,1,1,0,5,2021
PIE,BI,M 74,"Altre attività professionali, scientifiche e tecniche       ",2,1,1,0,4,2021
PIE,BI,M 75,Servizi veterinari                                          ,0,0,0,0,0,2021
PIE,BI,N   ,"Noleggio, agenzie di viaggio, servizi di supporto alle im...",2,2,4,1,9,2021
PIE,BI,N 77,Attività di noleggio e leasing operativo                    ,0,1,0,0,1,2021
PIE,BI,N 78,"Attività di ricerca, selezione, fornitura di personale      ",0,0,0,0,0,2021
PIE,BI,N 79,"Attività dei servizi delle agenzie di viaggio, dei tour o...",1,0,0,0,1,2021
PIE,BI,N 80,Servizi di vigilanza e investigazione                       ,1,0,0,0,1,2021
PIE,BI,N 81,Attività di servizi per edifici e paesaggio                 ,0,1,2,1,4,2021
PIE,BI,N 82,Attività di supporto per le funzioni d'ufficio e altri se...,0,0,2,0,2,2021
PIE,BI,O   ,Amministrazione pubblica e difesa; assicurazione sociale ...,0,0,0,0,0,2021
PIE,BI,O 84,Amministrazione pubblica e difesa; assicurazione sociale ...,0,0,0,0,0,2021
PIE,BI,P   ,Istruzione                                                  ,0,0,1,0,1,2021
PIE,BI,P 85,Istruzione                                                  ,0,0,1,0,1,2021
PIE,BI,Q   ,Sanita' e assistenza sociale                                ,0,0,0,0,0,2021
PIE,BI,Q 86,Assistenza sanitaria                                        ,0,0,0,0,0,2021
PIE,BI,Q 87,Servizi di assistenza sociale residenziale                  ,0,0,0,0,0,2021
PIE,BI,Q 88,Assistenza sociale non residenziale                         ,0,0,0,0,0,2021
PIE,BI,R   ,"Attività artistiche, sportive, di intrattenimento e diver...",4,0,0,0,4,2021
PIE,BI,R 90,"Attività creative, artistiche e di intrattenimento          ",0,0,0,0,0,2021
PIE,BI,R 91,"Attività di biblioteche, archivi, musei ed altre attività...",0,0,0,0,0,2021
PIE,BI,R 92,"Attività riguardanti le lotterie, le scommesse, le case d...",1,0,0,0,1,2021
PIE,BI,R 93,"Attività sportive, di intrattenimento e di divertimento     ",3,0,0,0,3,2021
PIE,BI,S   ,Altre attività di servizi                                   ,1,3,2,0,6,2021
PIE,BI,S 94,Attività di organizzazioni associative                      ,0,0,0,0,0,2021
PIE,BI,S 95,Riparazione di computer e di beni per uso personale e per...,0,1,0,0,1,2021
PIE,BI,S 96,Altre attività di servizi per la persona                    ,1,2,2,0,5,2021
PIE,BI,T   ,Attività di famiglie e convivenze come datori di lavoro p...,0,0,0,0,0,2021
PIE,BI,T 97,Attività di famiglie e convivenze come datori di lavoro p...,0,0,0,0,0,2021
PIE,BI,T 98,Produzione di beni e servizi indifferenziati per uso prop...,0,0,0,0,0,2021
PIE,BI,U   ,Organizzazioni ed organismi extraterritoriali               ,0,0,0,0,0,2021
PIE,BI,U 99,Organizzazioni ed organismi extraterritoriali               ,0,0,0,0,0,2021
PIE,BI,XX  ,Imprese non classificate                                    ,12,21,0,4,37,2021
PIE,BI,TOT ,TOTALE                                                      ,100,141,147,7,395,2021
PIE,VB,A   ,"Agricoltura, silvicoltura pesca                             ",0,0,6,0,6,2021
PIE,VB,A 01,"Coltivazioni agricole e produzione di prodotti animali, c...",0,0,6,0,6,2021
PIE,VB,A 02,Silvicoltura ed utilizzo di aree forestali                  ,0,0,0,0,0,2021
PIE,VB,A 03,Pesca e acquacoltura                                        ,0,0,0,0,0,2021
PIE,VB,B   ,Estrazione di minerali da cave e miniere                    ,1,0,0,0,1,2021
PIE,VB,B 05,Estrazione di carbone (esclusa torba)                       ,0,0,0,0,0,2021
PIE,VB,B 06,Estraz.di petrolio greggio e di gas naturale                ,0,0,0,0,0,2021
PIE,VB,B 07,Estrazione di minerali metalliferi                          ,0,0,0,0,0,2021
PIE,VB,B 08,Altre attività di estrazione di minerali da cave e miniere  ,1,0,0,0,1,2021
PIE,VB,B 09,Attività dei servizi di supporto all'estrazione             ,0,0,0,0,0,2021
PIE,VB,C   ,Attività manifatturiere                                     ,5,9,12,0,26,2021
PIE,VB,C 10,Industrie alimentari                                        ,0,0,1,0,1,2021
PIE,VB,C 11,Industria delle bevande                                     ,0,0,0,0,0,2021
PIE,VB,C 12,Industria del tabacco                                       ,0,0,0,0,0,2021
PIE,VB,C 13,Industrie tessili                                           ,0,0,0,0,0,2021
PIE,VB,C 14,Confezione di articoli di abbigliamento; confezione di ar...,0,0,0,0,0,2021
PIE,VB,C 15,Fabbricazione di articoli in pelle e simili                 ,0,0,0,0,0,2021
PIE,VB,C 16,Industria del legno e dei prodotti in legno e sughero (es...,0,1,1,0,2,2021
PIE,VB,C 17,Fabbricazione di carta e di prodotti di carta               ,0,0,0,0,0,2021
PIE,VB,C 18,Stampa e riproduzione di supporti registrati                ,1,0,0,0,1,2021
PIE,VB,C 19,Fabbricazione di coke e prodotti derivanti dalla raffinaz...,0,0,0,0,0,2021
PIE,VB,C 20,Fabbricazione di prodotti chimici                           ,0,0,0,0,0,2021
PIE,VB,C 21,Fabbricazione di prodotti farmaceutici di base e di prepa...,0,0,0,0,0,2021
PIE,VB,C 22,Fabbricazione di articoli in gomma e materie plastiche      ,0,0,0,0,0,2021
PIE,VB,C 23,Fabbricazione di altri prodotti della lavorazione di miner..,2,0,1,0,3,2021
PIE,VB,C 24,Metallurgia                                                 ,0,0,0,0,0,2021
PIE,VB,C 25,Fabbricazione di prodotti in metallo (esclusi macchinari ...,1,6,6,0,13,2021
PIE,VB,C 26,Fabbricazione di computer e prodotti di elettronica e ott...,0,1,0,0,1,2021
PIE,VB,C 27,Fabbricazione di apparecchiature elettriche ed apparecchi...,0,0,0,0,0,2021
PIE,VB,C 28,Fabbricazione di macchinari ed apparecchiature nca          ,0,0,1,0,1,2021
PIE,VB,C 29,"Fabbricazione di autoveicoli, rimorchi e semirimorchi       ",0,1,0,0,1,2021
PIE,VB,C 30,Fabbricazione di altri mezzi di trasporto                   ,0,0,0,0,0,2021
PIE,VB,C 31,Fabbricazione di mobili                                     ,0,0,1,0,1,2021
PIE,VB,C 32,Altre industrie manifatturiere                              ,0,0,1,0,1,2021
PIE,VB,C 33,"Riparazione, manutenzione ed installazione di macchine ed...",1,0,0,0,1,2021
PIE,VB,D   ,"Fornitura di energia elettrica, gas, vapore e aria condiz...",0,0,0,0,0,2021
PIE,VB,D 35,"Fornitura di energia elettrica, gas, vapore e aria condiz...",0,0,0,0,0,2021
PIE,VB,E   ,"Fornitura di acqua; reti fognarie, attività di gestione d...",0,0,0,0,0,2021
PIE,VB,E 36,"Raccolta, trattamento e fornitura di acqua                  ",0,0,0,0,0,2021
PIE,VB,E 37,Gestione delle reti fognarie                                ,0,0,0,0,0,2021
PIE,VB,E 38,"Attività di raccolta, trattamento e smaltimento dei rifiu...",0,0,0,0,0,2021
PIE,VB,E 39,Attività di risanamento e altri servizi di gestione dei r...,0,0,0,0,0,2021
PIE,VB,F   ,Costruzioni                                                 ,5,3,47,0,55,2021
PIE,VB,F 41,Costruzione di edifici                                      ,3,2,16,0,21,2021
PIE,VB,F 42,Ingegneria civile                                           ,0,0,2,0,2,2021
PIE,VB,F 43,Lavori di costruzione specializzati                         ,2,1,29,0,32,2021
PIE,VB,G   ,Commercio all'ingrosso e al dettaglio; riparazione di aut...,4,10,25,1,40,2021
PIE,VB,G 45,Commercio all'ingrosso e al dettaglio e riparazione di au...,1,1,0,0,2,2021
PIE,VB,G 46,Commercio all'ingrosso (escluso quello di autoveicoli e d...,2,2,4,0,8,2021
PIE,VB,G 47,Commercio al dettaglio (escluso quello di autoveicoli e d...,1,7,21,1,30,2021
PIE,VB,H   ,Trasporto e magazzinaggio                                   ,0,1,1,0,2,2021
PIE,VB,H 49,Trasporto terrestre e mediante condotte                     ,0,1,1,0,2,2021
PIE,VB,H 50,Trasporto marittimo e per vie d'acqua                       ,0,0,0,0,0,2021
PIE,VB,H 51,Trasporto aereo                                             ,0,0,0,0,0,2021
PIE,VB,H 52,Magazzinaggio e attività di supporto ai trasporti           ,0,0,0,0,0,2021
PIE,VB,H 53,Servizi postali e attività di corriere                      ,0,0,0,0,0,2021
PIE,VB,I   ,Attività dei servizi alloggio e ristorazione                ,1,12,11,0,24,2021
PIE,VB,I 55,Alloggio                                                    ,0,1,3,0,4,2021
PIE,VB,I 56,Attività dei servizi di ristorazione                        ,1,11,8,0,20,2021
PIE,VB,J   ,Servizi di informazione e comunicazione                     ,0,0,2,0,2,2021
PIE,VB,J 58,Attività editoriali                                         ,0,0,0,0,0,2021
PIE,VB,J 59,"Attività di produzione cinematografica, di video e di pro...",0,0,0,0,0,2021
PIE,VB,J 60,Attività di programmazione e trasmissione                   ,0,0,0,0,0,2021
PIE,VB,J 61,Telecomunicazioni                                           ,0,0,1,0,1,2021
PIE,VB,J 62,"Produzione di software, consulenza informatica e attività...",0,0,1,0,1,2021
PIE,VB,J 63,Attività dei servizi d'informazione e altri servizi infor...,0,0,0,0,0,2021
PIE,VB,K   ,Attività finanziarie e assicurative                         ,0,0,2,0,2,2021
PIE,VB,K 64,Attività di servizi finanziari (escluse le assicurazioni ...,0,0,0,0,0,2021
PIE,VB,K 65,"Assicurazioni, riassicurazioni e fondi pensione (escluse ...",0,0,0,0,0,2021
PIE,VB,K 66,Attività ausiliarie dei servizi finanziari e delle attivi...,0,0,2,0,2,2021
PIE,VB,L   ,Attivita' immobiliari                                       ,1,2,0,0,3,2021
PIE,VB,L 68,Attivita' immobiliari                                       ,1,2,0,0,3,2021
PIE,VB,M   ,"Attività professionali, scientifiche e tecniche             ",0,1,2,0,3,2021
PIE,VB,M 69,Attività legali e contabilità                               ,0,0,0,0,0,2021
PIE,VB,M 70,Attività di direzione aziendale e di consulenza gestional...,0,1,0,0,1,2021
PIE,VB,M 71,Attività degli studi di architettura e d'ingegneria; coll...,0,0,0,0,0,2021
PIE,VB,M 72,Ricerca scientifica e sviluppo                              ,0,0,0,0,0,2021
PIE,VB,M 73,Pubblicità e ricerche di mercato                            ,0,0,1,0,1,2021
PIE,VB,M 74,"Altre attività professionali, scientifiche e tecniche       ",0,0,1,0,1,2021
PIE,VB,M 75,Servizi veterinari                                          ,0,0,0,0,0,2021
PIE,VB,N   ,"Noleggio, agenzie di viaggio, servizi di supporto alle im...",0,1,3,0,4,2021
PIE,VB,N 77,Attività di noleggio e leasing operativo                    ,0,0,0,0,0,2021
PIE,VB,N 78,"Attività di ricerca, selezione, fornitura di personale      ",0,0,0,0,0,2021
PIE,VB,N 79,"Attività dei servizi delle agenzie di viaggio, dei tour o...",0,0,0,0,0,2021
PIE,VB,N 80,Servizi di vigilanza e investigazione                       ,0,1,0,0,1,2021
PIE,VB,N 81,Attività di servizi per edifici e paesaggio                 ,0,0,1,0,1,2021
PIE,VB,N 82,Attività di supporto per le funzioni d'ufficio e altri se...,0,0,2,0,2,2021
PIE,VB,O   ,Amministrazione pubblica e difesa; assicurazione sociale ...,0,0,0,0,0,2021
PIE,VB,O 84,Amministrazione pubblica e difesa; assicurazione sociale ...,0,0,0,0,0,2021
PIE,VB,P   ,Istruzione                                                  ,0,0,0,0,0,2021
PIE,VB,P 85,Istruzione                                                  ,0,0,0,0,0,2021
PIE,VB,Q   ,Sanita' e assistenza sociale                                ,0,0,0,0,0,2021
PIE,VB,Q 86,Assistenza sanitaria                                        ,0,0,0,0,0,2021
PIE,VB,Q 87,Servizi di assistenza sociale residenziale                  ,0,0,0,0,0,2021
PIE,VB,Q 88,Assistenza sociale non residenziale                         ,0,0,0,0,0,2021
PIE,VB,R   ,"Attività artistiche, sportive, di intrattenimento e diver...",0,0,0,0,0,2021
PIE,VB,R 90,"Attività creative, artistiche e di intrattenimento          ",0,0,0,0,0,2021
PIE,VB,R 91,"Attività di biblioteche, archivi, musei ed altre attività...",0,0,0,0,0,2021
PIE,VB,R 92,"Attività riguardanti le lotterie, le scommesse, le case d...",0,0,0,0,0,2021
PIE,VB,R 93,"Attività sportive, di intrattenimento e di divertimento     ",0,0,0,0,0,2021
PIE,VB,S   ,Altre attività di servizi                                   ,0,0,2,0,2,2021
PIE,VB,S 94,Attività di organizzazioni associative                      ,0,0,0,0,0,2021
PIE,VB,S 95,Riparazione di computer e di beni per uso personale e per...,0,0,0,0,0,2021
PIE,VB,S 96,Altre attività di servizi per la persona                    ,0,0,2,0,2,2021
PIE,VB,T   ,Attività di famiglie e convivenze come datori di lavoro p...,0,0,0,0,0,2021
PIE,VB,T 97,Attività di famiglie e convivenze come datori di lavoro p...,0,0,0,0,0,2021
PIE,VB,T 98,Produzione di beni e servizi indifferenziati per uso prop...,0,0,0,0,0,2021
PIE,VB,U   ,Organizzazioni ed organismi extraterritoriali               ,0,0,0,0,0,2021
PIE,VB,U 99,Organizzazioni ed organismi extraterritoriali               ,0,0,0,0,0,2021
PIE,VB,XX  ,Imprese non classificate                                    ,0,1,0,1,2,2021
PIE,VB,TOT ,TOTALE                                                      ,17,40,113,2,172,2021
VAO,  ,A   ,"Agricoltura, silvicoltura pesca                             ",0,0,3,0,3,2021
VAO,  ,A 01,"Coltivazioni agricole e produzione di prodotti animali, c...",0,0,3,0,3,2021
VAO,  ,A 02,Silvicoltura ed utilizzo di aree forestali                  ,0,0,0,0,0,2021
VAO,  ,A 03,Pesca e acquacoltura                                        ,0,0,0,0,0,2021
VAO,  ,B   ,Estrazione di minerali da cave e miniere                    ,0,0,0,0,0,2021
VAO,  ,B 05,Estrazione di carbone (esclusa torba)                       ,0,0,0,0,0,2021
VAO,  ,B 06,Estraz.di petrolio greggio e di gas naturale                ,0,0,0,0,0,2021
VAO,  ,B 07,Estrazione di minerali metalliferi                          ,0,0,0,0,0,2021
VAO,  ,B 08,Altre attività di estrazione di minerali da cave e miniere  ,0,0,0,0,0,2021
VAO,  ,B 09,Attività dei servizi di supporto all'estrazione             ,0,0,0,0,0,2021
VAO,  ,C   ,Attività manifatturiere                                     ,1,0,0,0,1,2021
VAO,  ,C 10,Industrie alimentari                                        ,1,0,0,0,1,2021
VAO,  ,C 11,Industria delle bevande                                     ,0,0,0,0,0,2021
VAO,  ,C 12,Industria del tabacco                                       ,0,0,0,0,0,2021
VAO,  ,C 13,Industrie tessili                                           ,0,0,0,0,0,2021
VAO,  ,C 14,Confezione di articoli di abbigliamento; confezione di ar...,0,0,0,0,0,2021
VAO,  ,C 15,Fabbricazione di articoli in pelle e simili                 ,0,0,0,0,0,2021
VAO,  ,C 16,Industria del legno e dei prodotti in legno e sughero (es...,0,0,0,0,0,2021
VAO,  ,C 17,Fabbricazione di carta e di prodotti di carta               ,0,0,0,0,0,2021
VAO,  ,C 18,Stampa e riproduzione di supporti registrati                ,0,0,0,0,0,2021
VAO,  ,C 19,Fabbricazione di coke e prodotti derivanti dalla raffinaz...,0,0,0,0,0,2021
VAO,  ,C 20,Fabbricazione di prodotti chimici                           ,0,0,0,0,0,2021
VAO,  ,C 21,Fabbricazione di prodotti farmaceutici di base e di prepa...,0,0,0,0,0,2021
VAO,  ,C 22,Fabbricazione di articoli in gomma e materie plastiche      ,0,0,0,0,0,2021
VAO,  ,C 23,Fabbricazione di altri prodotti della lavorazione di miner..,0,0,0,0,0,2021
VAO,  ,C 24,Metallurgia                                                 ,0,0,0,0,0,2021
VAO,  ,C 25,Fabbricazione di prodotti in metallo (esclusi macchinari ...,0,0,0,0,0,2021
VAO,  ,C 26,Fabbricazione di computer e prodotti di elettronica e ott...,0,0,0,0,0,2021
VAO,  ,C 27,Fabbricazione di apparecchiature elettriche ed apparecchi...,0,0,0,0,0,2021
VAO,  ,C 28,Fabbricazione di macchinari ed apparecchiature nca          ,0,0,0,0,0,2021
VAO,  ,C 29,"Fabbricazione di autoveicoli, rimorchi e semirimorchi       ",0,0,0,0,0,2021
VAO,  ,C 30,Fabbricazione di altri mezzi di trasporto                   ,0,0,0,0,0,2021
VAO,  ,C 31,Fabbricazione di mobili                                     ,0,0,0,0,0,2021
VAO,  ,C 32,Altre industrie manifatturiere                              ,0,0,0,0,0,2021
VAO,  ,C 33,"Riparazione, manutenzione ed installazione di macchine ed...",0,0,0,0,0,2021
VAO,  ,D   ,"Fornitura di energia elettrica, gas, vapore e aria condiz...",0,0,0,0,0,2021
VAO,  ,D 35,"Fornitura di energia elettrica, gas, vapore e aria condiz...",0,0,0,0,0,2021
VAO,  ,E   ,"Fornitura di acqua; reti fognarie, attività di gestione d...",0,0,0,0,0,2021
VAO,  ,E 36,"Raccolta, trattamento e fornitura di acqua                  ",0,0,0,0,0,2021
VAO,  ,E 37,Gestione delle reti fognarie                                ,0,0,0,0,0,2021
VAO,  ,E 38,"Attività di raccolta, trattamento e smaltimento dei rifiu...",0,0,0,0,0,2021
VAO,  ,E 39,Attività di risanamento e altri servizi di gestione dei r...,0,0,0,0,0,2021
VAO,  ,F   ,Costruzioni                                                 ,4,0,4,0,8,2021
VAO,  ,F 41,Costruzione di edifici                                      ,4,0,2,0,6,2021
VAO,  ,F 42,Ingegneria civile                                           ,0,0,0,0,0,2021
VAO,  ,F 43,Lavori di costruzione specializzati                         ,0,0,2,0,2,2021
VAO,  ,G   ,Commercio all'ingrosso e al dettaglio; riparazione di aut...,4,0,9,0,13,2021
VAO,  ,G 45,Commercio all'ingrosso e al dettaglio e riparazione di au...,0,0,2,0,2,2021
VAO,  ,G 46,Commercio all'ingrosso (escluso quello di autoveicoli e d...,2,0,2,0,4,2021
VAO,  ,G 47,Commercio al dettaglio (escluso quello di autoveicoli e d...,2,0,5,0,7,2021
VAO,  ,H   ,Trasporto e magazzinaggio                                   ,0,0,1,0,1,2021
VAO,  ,H 49,Trasporto terrestre e mediante condotte                     ,0,0,1,0,1,2021
VAO,  ,H 50,Trasporto marittimo e per vie d'acqua                       ,0,0,0,0,0,2021
VAO,  ,H 51,Trasporto aereo                                             ,0,0,0,0,0,2021
VAO,  ,H 52,Magazzinaggio e attività di supporto ai trasporti           ,0,0,0,0,0,2021
VAO,  ,H 53,Servizi postali e attività di corriere                      ,0,0,0,0,0,2021
VAO,  ,I   ,Attività dei servizi alloggio e ristorazione                ,1,1,4,0,6,2021
VAO,  ,I 55,Alloggio                                                    ,0,0,0,0,0,2021
VAO,  ,I 56,Attività dei servizi di ristorazione                        ,1,1,4,0,6,2021
VAO,  ,J   ,Servizi di informazione e comunicazione                     ,0,0,0,0,0,2021
VAO,  ,J 58,Attività editoriali                                         ,0,0,0,0,0,2021
VAO,  ,J 59,"Attività di produzione cinematografica, di video e di pro...",0,0,0,0,0,2021
VAO,  ,J 60,Attività di programmazione e trasmissione                   ,0,0,0,0,0,2021
VAO,  ,J 61,Telecomunicazioni                                           ,0,0,0,0,0,2021
VAO,  ,J 62,"Produzione di software, consulenza informatica e attività...",0,0,0,0,0,2021
VAO,  ,J 63,Attività dei servizi d'informazione e altri servizi infor...,0,0,0,0,0,2021
VAO,  ,K   ,Attività finanziarie e assicurative                         ,0,0,0,0,0,2021
VAO,  ,K 64,Attività di servizi finanziari (escluse le assicurazioni ...,0,0,0,0,0,2021
VAO,  ,K 65,"Assicurazioni, riassicurazioni e fondi pensione (escluse ...",0,0,0,0,0,2021
VAO,  ,K 66,Attività ausiliarie dei servizi finanziari e delle attivi...,0,0,0,0,0,2021
VAO,  ,L   ,Attivita' immobiliari                                       ,2,1,0,0,3,2021
VAO,  ,L 68,Attivita' immobiliari                                       ,2,1,0,0,3,2021
VAO,  ,M   ,"Attività professionali, scientifiche e tecniche             ",2,0,1,0,3,2021
VAO,  ,M 69,Attività legali e contabilità                               ,0,0,0,0,0,2021
VAO,  ,M 70,Attività di direzione aziendale e di consulenza gestional...,1,0,0,0,1,2021
VAO,  ,M 71,Attività degli studi di architettura e d'ingegneria; coll...,0,0,0,0,0,2021
VAO,  ,M 72,Ricerca scientifica e sviluppo                              ,0,0,0,0,0,2021
VAO,  ,M 73,Pubblicità e ricerche di mercato                            ,1,0,0,0,1,2021
VAO,  ,M 74,"Altre attività professionali, scientifiche e tecniche       ",0,0,1,0,1,2021
VAO,  ,M 75,Servizi veterinari                                          ,0,0,0,0,0,2021
VAO,  ,N   ,"Noleggio, agenzie di viaggio, servizi di supporto alle im...",0,0,0,0,0,2021
VAO,  ,N 77,Attività di noleggio e leasing operativo                    ,0,0,0,0,0,2021
VAO,  ,N 78,"Attività di ricerca, selezione, fornitura di personale      ",0,0,0,0,0,2021
VAO,  ,N 79,"Attività dei servizi delle agenzie di viaggio, dei tour o...",0,0,0,0,0,2021
VAO,  ,N 80,Servizi di vigilanza e investigazione                       ,0,0,0,0,0,2021
VAO,  ,N 81,Attività di servizi per edifici e paesaggio                 ,0,0,0,0,0,2021
VAO,  ,N 82,Attività di supporto per le funzioni d'ufficio e altri se...,0,0,0,0,0,2021
VAO,  ,O   ,Amministrazione pubblica e difesa; assicurazione sociale ...,0,0,0,0,0,2021
VAO,  ,O 84,Amministrazione pubblica e difesa; assicurazione sociale ...,0,0,0,0,0,2021
VAO,  ,P   ,Istruzione                                                  ,0,0,0,0,0,2021
VAO,  ,P 85,Istruzione                                                  ,0,0,0,0,0,2021
VAO,  ,Q   ,Sanita' e assistenza sociale                                ,0,0,0,0,0,2021
VAO,  ,Q 86,Assistenza sanitaria                                        ,0,0,0,0,0,2021
VAO,  ,Q 87,Servizi di assistenza sociale residenziale                  ,0,0,0,0,0,2021
VAO,  ,Q 88,Assistenza sociale non residenziale                         ,0,0,0,0,0,2021
VAO,  ,R   ,"Attività artistiche, sportive, di intrattenimento e diver...",1,0,0,0,1,2021
VAO,  ,R 90,"Attività creative, artistiche e di intrattenimento          ",0,0,0,0,0,2021
VAO,  ,R 91,"Attività di biblioteche, archivi, musei ed altre attività...",0,0,0,0,0,2021
VAO,  ,R 92,"Attività riguardanti le lotterie, le scommesse, le case d...",0,0,0,0,0,2021
VAO,  ,R 93,"Attività sportive, di intrattenimento e di divertimento     ",1,0,0,0,1,2021
VAO,  ,S   ,Altre attività di servizi                                   ,0,0,0,0,0,2021
VAO,  ,S 94,Attività di organizzazioni associative                      ,0,0,0,0,0,2021
VAO,  ,S 95,Riparazione di computer e di beni per uso personale e per...,0,0,0,0,0,2021
VAO,  ,S 96,Altre attività di servizi per la persona                    ,0,0,0,0,0,2021
VAO,  ,T   ,Attività di famiglie e convivenze come datori di lavoro p...,0,0,0,0,0,2021
VAO,  ,T 97,Attività di famiglie e convivenze come datori di lavoro p...,0,0,0,0,0,2021
VAO,  ,T 98,Produzione di beni e servizi indifferenziati per uso prop...,0,0,0,0,0,2021
VAO,  ,U   ,Organizzazioni ed organismi extraterritoriali               ,0,0,0,0,0,2021
VAO,  ,U 99,Organizzazioni ed organismi extraterritoriali               ,0,0,0,0,0,2021
VAO,  ,XX  ,Imprese non classificate                                    ,0,0,19,0,19,2021
VAO,  ,TOT ,TOTALE                                                      ,15,2,41,0,58,2021
VAO,AO,A   ,"Agricoltura, silvicoltura pesca                             ",0,0,3,0,3,2021
VAO,AO,A 01,"Coltivazioni agricole e produzione di prodotti animali, c...",0,0,3,0,3,2021
VAO,AO,A 02,Silvicoltura ed utilizzo di aree forestali                  ,0,0,0,0,0,2021
VAO,AO,A 03,Pesca e acquacoltura                                        ,0,0,0,0,0,2021
VAO,AO,B   ,Estrazione di minerali da cave e miniere                    ,0,0,0,0,0,2021
VAO,AO,B 05,Estrazione di carbone (esclusa torba)                       ,0,0,0,0,0,2021
VAO,AO,B 06,Estraz.di petrolio greggio e di gas naturale                ,0,0,0,0,0,2021
VAO,AO,B 07,Estrazione di minerali metalliferi                          ,0,0,0,0,0,2021
VAO,AO,B 08,Altre attività di estrazione di minerali da cave e miniere  ,0,0,0,0,0,2021
VAO,AO,B 09,Attività dei servizi di supporto all'estrazione             ,0,0,0,0,0,2021
VAO,AO,C   ,Attività manifatturiere                                     ,1,0,0,0,1,2021
VAO,AO,C 10,Industrie alimentari                                        ,1,0,0,0,1,2021
VAO,AO,C 11,Industria delle bevande                                     ,0,0,0,0,0,2021
VAO,AO,C 12,Industria del tabacco                                       ,0,0,0,0,0,2021
VAO,AO,C 13,Industrie tessili                                           ,0,0,0,0,0,2021
VAO,AO,C 14,Confezione di articoli di abbigliamento; confezione di ar...,0,0,0,0,0,2021
VAO,AO,C 15,Fabbricazione di articoli in pelle e simili                 ,0,0,0,0,0,2021
VAO,AO,C 16,Industria del legno e dei prodotti in legno e sughero (es...,0,0,0,0,0,2021
VAO,AO,C 17,Fabbricazione di carta e di prodotti di carta               ,0,0,0,0,0,2021
VAO,AO,C 18,Stampa e riproduzione di supporti registrati                ,0,0,0,0,0,2021
VAO,AO,C 19,Fabbricazione di coke e prodotti derivanti dalla raffinaz...,0,0,0,0,0,2021
VAO,AO,C 20,Fabbricazione di prodotti chimici                           ,0,0,0,0,0,2021
VAO,AO,C 21,Fabbricazione di prodotti farmaceutici di base e di prepa...,0,0,0,0,0,2021
VAO,AO,C 22,Fabbricazione di articoli in gomma e materie plastiche      ,0,0,0,0,0,2021
VAO,AO,C 23,Fabbricazione di altri prodotti della lavorazione di miner..,0,0,0,0,0,2021
VAO,AO,C 24,Metallurgia                                                 ,0,0,0,0,0,2021
VAO,AO,C 25,Fabbricazione di prodotti in metallo (esclusi macchinari ...,0,0,0,0,0,2021
VAO,AO,C 26,Fabbricazione di computer e prodotti di elettronica e ott...,0,0,0,0,0,2021
VAO,AO,C 27,Fabbricazione di apparecchiature elettriche ed apparecchi...,0,0,0,0,0,2021
VAO,AO,C 28,Fabbricazione di macchinari ed apparecchiature nca          ,0,0,0,0,0,2021
VAO,AO,C 29,"Fabbricazione di autoveicoli, rimorchi e semirimorchi       ",0,0,0,0,0,2021
VAO,AO,C 30,Fabbricazione di altri mezzi di trasporto                   ,0,0,0,0,0,2021
VAO,AO,C 31,Fabbricazione di mobili                                     ,0,0,0,0,0,2021
VAO,AO,C 32,Altre industrie manifatturiere                              ,0,0,0,0,0,2021
VAO,AO,C 33,"Riparazione, manutenzione ed installazione di macchine ed...",0,0,0,0,0,2021
VAO,AO,D   ,"Fornitura di energia elettrica, gas, vapore e aria condiz...",0,0,0,0,0,2021
VAO,AO,D 35,"Fornitura di energia elettrica, gas, vapore e aria condiz...",0,0,0,0,0,2021
VAO,AO,E   ,"Fornitura di acqua; reti fognarie, attività di gestione d...",0,0,0,0,0,2021
VAO,AO,E 36,"Raccolta, trattamento e fornitura di acqua                  ",0,0,0,0,0,2021
VAO,AO,E 37,Gestione delle reti fognarie                                ,0,0,0,0,0,2021
VAO,AO,E 38,"Attività di raccolta, trattamento e smaltimento dei rifiu...",0,0,0,0,0,2021
VAO,AO,E 39,Attività di risanamento e altri servizi di gestione dei r...,0,0,0,0,0,2021
VAO,AO,F   ,Costruzioni                                                 ,4,0,4,0,8,2021
VAO,AO,F 41,Costruzione di edifici                                      ,4,0,2,0,6,2021
VAO,AO,F 42,Ingegneria civile                                           ,0,0,0,0,0,2021
VAO,AO,F 43,Lavori di costruzione specializzati                         ,0,0,2,0,2,2021
VAO,AO,G   ,Commercio all'ingrosso e al dettaglio; riparazione di aut...,4,0,9,0,13,2021
VAO,AO,G 45,Commercio all'ingrosso e al dettaglio e riparazione di au...,0,0,2,0,2,2021
VAO,AO,G 46,Commercio all'ingrosso (escluso quello di autoveicoli e d...,2,0,2,0,4,2021
VAO,AO,G 47,Commercio al dettaglio (escluso quello di autoveicoli e d...,2,0,5,0,7,2021
VAO,AO,H   ,Trasporto e magazzinaggio                                   ,0,0,1,0,1,2021
VAO,AO,H 49,Trasporto terrestre e mediante condotte                     ,0,0,1,0,1,2021
VAO,AO,H 50,Trasporto marittimo e per vie d'acqua                       ,0,0,0,0,0,2021
VAO,AO,H 51,Trasporto aereo                                             ,0,0,0,0,0,2021
VAO,AO,H 52,Magazzinaggio e attività di supporto ai trasporti           ,0,0,0,0,0,2021
VAO,AO,H 53,Servizi postali e attività di corriere                      ,0,0,0,0,0,2021
VAO,AO,I   ,Attività dei servizi alloggio e ristorazione                ,1,1,4,0,6,2021
VAO,AO,I 55,Alloggio                                                    ,0,0,0,0,0,2021
VAO,AO,I 56,Attività dei servizi di ristorazione                        ,1,1,4,0,6,2021
VAO,AO,J   ,Servizi di informazione e comunicazione                     ,0,0,0,0,0,2021
VAO,AO,J 58,Attività editoriali                                         ,0,0,0,0,0,2021
VAO,AO,J 59,"Attività di produzione cinematografica, di video e di pro...",0,0,0,0,0,2021
VAO,AO,J 60,Attività di programmazione e trasmissione                   ,0,0,0,0,0,2021
VAO,AO,J 61,Telecomunicazioni                                           ,0,0,0,0,0,2021
VAO,AO,J 62,"Produzione di software, consulenza informatica e attività...",0,0,0,0,0,2021
VAO,AO,J 63,Attività dei servizi d'informazione e altri servizi infor...,0,0,0,0,0,2021
VAO,AO,K   ,Attività finanziarie e assicurative                         ,0,0,0,0,0,2021
VAO,AO,K 64,Attività di servizi finanziari (escluse le assicurazioni ...,0,0,0,0,0,2021
VAO,AO,K 65,"Assicurazioni, riassicurazioni e fondi pensione (escluse ...",0,0,0,0,0,2021
VAO,AO,K 66,Attività ausiliarie dei servizi finanziari e delle attivi...,0,0,0,0,0,2021
VAO,AO,L   ,Attivita' immobiliari                                       ,2,1,0,0,3,2021
VAO,AO,L 68,Attivita' immobiliari                                       ,2,1,0,0,3,2021
VAO,AO,M   ,"Attività professionali, scientifiche e tecniche             ",2,0,1,0,3,2021
VAO,AO,M 69,Attività legali e contabilità                               ,0,0,0,0,0,2021
VAO,AO,M 70,Attività di direzione aziendale e di consulenza gestional...,1,0,0,0,1,2021
VAO,AO,M 71,Attività degli studi di architettura e d'ingegneria; coll...,0,0,0,0,0,2021
VAO,AO,M 72,Ricerca scientifica e sviluppo                              ,0,0,0,0,0,2021
VAO,AO,M 73,Pubblicità e ricerche di mercato                            ,1,0,0,0,1,2021
VAO,AO,M 74,"Altre attività professionali, scientifiche e tecniche       ",0,0,1,0,1,2021
VAO,AO,M 75,Servizi veterinari                                          ,0,0,0,0,0,2021
VAO,AO,N   ,"Noleggio, agenzie di viaggio, servizi di supporto alle im...",0,0,0,0,0,2021
VAO,AO,N 77,Attività di noleggio e leasing operativo                    ,0,0,0,0,0,2021
VAO,AO,N 78,"Attività di ricerca, selezione, fornitura di personale      ",0,0,0,0,0,2021
VAO,AO,N 79,"Attività dei servizi delle agenzie di viaggio, dei tour o...",0,0,0,0,0,2021
VAO,AO,N 80,Servizi di vigilanza e investigazione                       ,0,0,0,0,0,2021
VAO,AO,N 81,Attività di servizi per edifici e paesaggio                 ,0,0,0,0,0,2021
VAO,AO,N 82,Attività di supporto per le funzioni d'ufficio e altri se...,0,0,0,0,0,2021
VAO,AO,O   ,Amministrazione pubblica e difesa; assicurazione sociale ...,0,0,0,0,0,2021
VAO,AO,O 84,Amministrazione pubblica e difesa; assicurazione sociale ...,0,0,0,0,0,2021
VAO,AO,P   ,Istruzione                                                  ,0,0,0,0,0,2021
VAO,AO,P 85,Istruzione                                                  ,0,0,0,0,0,2021
VAO,AO,Q   ,Sanita' e assistenza sociale                                ,0,0,0,0,0,2021
VAO,AO,Q 86,Assistenza sanitaria                                        ,0,0,0,0,0,2021
VAO,AO,Q 87,Servizi di assistenza sociale residenziale                  ,0,0,0,0,0,2021
VAO,AO,Q 88,Assistenza sociale non residenziale                         ,0,0,0,0,0,2021
VAO,AO,R   ,"Attività artistiche, sportive, di intrattenimento e diver...",1,0,0,0,1,2021
VAO,AO,R 90,"Attività creative, artistiche e di intrattenimento          ",0,0,0,0,0,2021
VAO,AO,R 91,"Attività di biblioteche, archivi, musei ed altre attività...",0,0,0,0,0,2021
VAO,AO,R 92,"Attività riguardanti le lotterie, le scommesse, le case d...",0,0,0,0,0,2021
VAO,AO,R 93,"Attività sportive, di intrattenimento e di divertimento     ",1,0,0,0,1,2021
VAO,AO,S   ,Altre attività di servizi                                   ,0,0,0,0,0,2021
VAO,AO,S 94,Attività di organizzazioni associative                      ,0,0,0,0,0,2021
VAO,AO,S 95,Riparazione di computer e di beni per uso personale e per...,0,0,0,0,0,2021
VAO,AO,S 96,Altre attività di servizi per la persona                    ,0,0,0,0,0,2021
VAO,AO,T   ,Attività di famiglie e convivenze come datori di lavoro p...,0,0,0,0,0,2021
VAO,AO,T 97,Attività di famiglie e convivenze come datori di lavoro p...,0,0,0,0,0,2021
VAO,AO,T 98,Produzione di beni e servizi indifferenziati per uso prop...,0,0,0,0,0,2021
VAO,AO,U   ,Organizzazioni ed organismi extraterritoriali               ,0,0,0,0,0,2021
VAO,AO,U 99,Organizzazioni ed organismi extraterritoriali               ,0,0,0,0,0,2021
VAO,AO,XX  ,Imprese non classificate                                    ,0,0,19,0,19,2021
VAO,AO,TOT ,TOTALE                                                      ,15,2,41,0,58,2021
LOM,  ,A   ,"Agricoltura, silvicoltura pesca                             ",4,2,98,5,109,2021
LOM,  ,A 01,"Coltivazioni agricole e produzione di prodotti animali, c...",4,2,97,5,108,2021
LOM,  ,A 02,Silvicoltura ed utilizzo di aree forestali                  ,0,0,1,0,1,2021
LOM,  ,A 03,Pesca e acquacoltura                                        ,0,0,0,0,0,2021
LOM,  ,B   ,Estrazione di minerali da cave e miniere                    ,1,0,1,0,2,2021
LOM,  ,B 05,Estrazione di carbone (esclusa torba)                       ,0,0,0,0,0,2021
LOM,  ,B 06,Estraz.di petrolio greggio e di gas naturale                ,0,0,0,0,0,2021
LOM,  ,B 07,Estrazione di minerali metalliferi                          ,0,0,0,0,0,2021
LOM,  ,B 08,Altre attività di estrazione di minerali da cave e miniere  ,1,0,1,0,2,2021
LOM,  ,B 09,Attività dei servizi di supporto all'estrazione             ,0,0,0,0,0,2021
LOM,  ,C   ,Attività manifatturiere                                     ,110,24,787,7,928,2021
LOM,  ,C 10,Industrie alimentari                                        ,11,3,41,1,56,2021
LOM,  ,C 11,Industria delle bevande                                     ,2,0,0,0,2,2021
LOM,  ,C 12,Industria del tabacco                                       ,0,0,0,0,0,2021
LOM,  ,C 13,Industrie tessili                                           ,3,1,40,0,44,2021
LOM,  ,C 14,Confezione di articoli di abbigliamento; confezione di ar...,9,3,152,0,164,2021
LOM,  ,C 15,Fabbricazione di articoli in pelle e simili                 ,3,0,26,0,29,2021
LOM,  ,C 16,Industria del legno e dei prodotti in legno e sughero (es...,1,3,43,2,49,2021
LOM,  ,C 17,Fabbricazione di carta e di prodotti di carta               ,5,0,7,0,12,2021
LOM,  ,C 18,Stampa e riproduzione di supporti registrati                ,7,2,25,0,34,2021
LOM,  ,C 19,Fabbricazione di coke e prodotti derivanti dalla raffinaz...,0,0,0,0,0,2021
LOM,  ,C 20,Fabbricazione di prodotti chimici                           ,4,0,1,1,6,2021
LOM,  ,C 21,Fabbricazione di prodotti farmaceutici di base e di prepa...,0,0,0,0,0,2021
LOM,  ,C 22,Fabbricazione di articoli in gomma e materie plastiche      ,8,2,12,0,22,2021
LOM,  ,C 23,Fabbricazione di altri prodotti della lavorazione di miner..,7,0,19,0,26,2021
LOM,  ,C 24,Metallurgia                                                 ,4,0,7,0,11,2021
LOM,  ,C 25,Fabbricazione di prodotti in metallo (esclusi macchinari ...,17,4,208,1,230,2021
LOM,  ,C 26,Fabbricazione di computer e prodotti di elettronica e ott...,8,3,16,0,27,2021
LOM,  ,C 27,Fabbricazione di apparecchiature elettriche ed apparecchi...,5,1,17,1,24,2021
LOM,  ,C 28,Fabbricazione di macchinari ed apparecchiature nca          ,10,1,33,0,44,2021
LOM,  ,C 29,"Fabbricazione di autoveicoli, rimorchi e semirimorchi       ",1,0,1,0,2,2021
LOM,  ,C 30,Fabbricazione di altri mezzi di trasporto                   ,1,0,5,0,6,2021
LOM,  ,C 31,Fabbricazione di mobili                                     ,2,0,39,0,41,2021
LOM,  ,C 32,Altre industrie manifatturiere                              ,0,1,48,0,49,2021
LOM,  ,C 33,"Riparazione, manutenzione ed installazione di macchine ed...",2,0,47,1,50,2021
LOM,  ,D   ,"Fornitura di energia elettrica, gas, vapore e aria condiz...",1,0,2,0,3,2021
LOM,  ,D 35,"Fornitura di energia elettrica, gas, vapore e aria condiz...",1,0,2,0,3,2021
LOM,  ,E   ,"Fornitura di acqua; reti fognarie, attività di gestione d...",2,0,6,0,8,2021
LOM,  ,E 36,"Raccolta, trattamento e fornitura di acqua                  ",0,0,0,0,0,2021
LOM,  ,E 37,Gestione delle reti fognarie                                ,0,0,0,0,0,2021
LOM,  ,E 38,"Attività di raccolta, trattamento e smaltimento dei rifiu...",2,0,6,0,8,2021
LOM,  ,E 39,Attività di risanamento e altri servizi di gestione dei r...,0,0,0,0,0,2021
LOM,  ,F   ,Costruzioni                                                 ,74,13,4186,25,4298,2021
LOM,  ,F 41,Costruzione di edifici                                      ,55,7,723,14,799,2021
LOM,  ,F 42,Ingegneria civile                                           ,1,0,14,1,16,2021
LOM,  ,F 43,Lavori di costruzione specializzati                         ,18,6,3449,10,3483,2021
LOM,  ,G   ,Commercio all'ingrosso e al dettaglio; riparazione di aut...,141,18,2493,1,2653,2021
LOM,  ,G 45,Commercio all'ingrosso e al dettaglio e riparazione di au...,9,2,201,0,212,2021
LOM,  ,G 46,Commercio all'ingrosso (escluso quello di autoveicoli e d...,87,9,748,0,844,2021
LOM,  ,G 47,Commercio al dettaglio (escluso quello di autoveicoli e d...,45,7,1544,1,1597,2021
LOM,  ,H   ,Trasporto e magazzinaggio                                   ,17,0,626,21,664,2021
LOM,  ,H 49,Trasporto terrestre e mediante condotte                     ,8,0,470,4,482,2021
LOM,  ,H 50,Trasporto marittimo e per vie d'acqua                       ,0,0,0,0,0,2021
LOM,  ,H 51,Trasporto aereo                                             ,0,0,0,0,0,2021
LOM,  ,H 52,Magazzinaggio e attività di supporto ai trasporti           ,8,0,40,17,65,2021
LOM,  ,H 53,Servizi postali e attività di corriere                      ,1,0,116,0,117,2021
LOM,  ,I   ,Attività dei servizi alloggio e ristorazione                ,37,9,584,0,630,2021
LOM,  ,I 55,Alloggio                                                    ,5,2,10,0,17,2021
LOM,  ,I 56,Attività dei servizi di ristorazione                        ,32,7,574,0,613,2021
LOM,  ,J   ,Servizi di informazione e comunicazione                     ,43,2,273,2,320,2021
LOM,  ,J 58,Attività editoriali                                         ,3,0,21,0,24,2021
LOM,  ,J 59,"Attività di produzione cinematografica, di video e di pro...",5,0,19,0,24,2021
LOM,  ,J 60,Attività di programmazione e trasmissione                   ,0,0,1,0,1,2021
LOM,  ,J 61,Telecomunicazioni                                           ,0,0,149,0,149,2021
LOM,  ,J 62,"Produzione di software, consulenza informatica e attività...",26,0,56,0,82,2021
LOM,  ,J 63,Attività dei servizi d'informazione e altri servizi infor...,9,2,27,2,40,2021
LOM,  ,K   ,Attività finanziarie e assicurative                         ,15,1,95,0,111,2021
LOM,  ,K 64,Attività di servizi finanziari (escluse le assicurazioni ...,7,0,2,0,9,2021
LOM,  ,K 65,"Assicurazioni, riassicurazioni e fondi pensione (escluse ...",0,0,0,0,0,2021
LOM,  ,K 66,Attività ausiliarie dei servizi finanziari e delle attivi...,8,1,93,0,102,2021
LOM,  ,L   ,Attivita' immobiliari                                       ,96,8,49,0,153,2021
LOM,  ,L 68,Attivita' immobiliari                                       ,96,8,49,0,153,2021
LOM,  ,M   ,"Attività professionali, scientifiche e tecniche             ",57,13,331,8,409,2021
LOM,  ,M 69,Attività legali e contabilità                               ,3,0,17,1,21,2021
LOM,  ,M 70,Attività di direzione aziendale e di consulenza gestional...,24,5,61,2,92,2021
LOM,  ,M 71,Attività degli studi di architettura e d'ingegneria; coll...,0,1,24,0,25,2021
LOM,  ,M 72,Ricerca scientifica e sviluppo                              ,1,1,1,1,4,2021
LOM,  ,M 73,Pubblicità e ricerche di mercato                            ,12,2,112,2,128,2021
LOM,  ,M 74,"Altre attività professionali, scientifiche e tecniche       ",17,4,116,2,139,2021
LOM,  ,M 75,Servizi veterinari                                          ,0,0,0,0,0,2021
LOM,  ,N   ,"Noleggio, agenzie di viaggio, servizi di supporto alle im...",43,7,477,20,547,2021
LOM,  ,N 77,Attività di noleggio e leasing operativo                    ,6,1,24,0,31,2021
LOM,  ,N 78,"Attività di ricerca, selezione, fornitura di personale      ",2,0,1,0,3,2021
LOM,  ,N 79,"Attività dei servizi delle agenzie di viaggio, dei tour o...",7,1,9,0,17,2021
LOM,  ,N 80,Servizi di vigilanza e investigazione                       ,2,0,4,1,7,2021
LOM,  ,N 81,Attività di servizi per edifici e paesaggio                 ,11,2,260,10,283,2021
LOM,  ,N 82,Attività di supporto per le funzioni d'ufficio e altri se...,15,3,179,9,206,2021
LOM,  ,O   ,Amministrazione pubblica e difesa; assicurazione sociale ...,0,0,0,0,0,2021
LOM,  ,O 84,Amministrazione pubblica e difesa; assicurazione sociale ...,0,0,0,0,0,2021
LOM,  ,P   ,Istruzione                                                  ,3,0,11,1,15,2021
LOM,  ,P 85,Istruzione                                                  ,3,0,11,1,15,2021
LOM,  ,Q   ,Sanita' e assistenza sociale                                ,3,0,5,14,22,2021
LOM,  ,Q 86,Assistenza sanitaria                                        ,3,0,2,1,6,2021
LOM,  ,Q 87,Servizi di assistenza sociale residenziale                  ,0,0,0,3,3,2021
LOM,  ,Q 88,Assistenza sociale non residenziale                         ,0,0,3,10,13,2021
LOM,  ,R   ,"Attività artistiche, sportive, di intrattenimento e diver...",12,2,73,1,88,2021
LOM,  ,R 90,"Attività creative, artistiche e di intrattenimento          ",6,1,26,0,33,2021
LOM,  ,R 91,"Attività di biblioteche, archivi, musei ed altre attività...",0,0,0,0,0,2021
LOM,  ,R 92,"Attività riguardanti le lotterie, le scommesse, le case d...",0,0,6,0,6,2021
LOM,  ,R 93,"Attività sportive, di intrattenimento e di divertimento     ",6,1,41,1,49,2021
LOM,  ,S   ,Altre attività di servizi                                   ,7,8,305,1,321,2021
LOM,  ,S 94,Attività di organizzazioni associative                      ,0,0,0,0,0,2021
LOM,  ,S 95,Riparazione di computer e di beni per uso personale e per...,2,3,79,1,85,2021
LOM,  ,S 96,Altre attività di servizi per la persona                    ,5,5,226,0,236,2021
LOM,  ,T   ,Attività di famiglie e convivenze come datori di lavoro p...,0,0,0,0,0,2021
LOM,  ,T 97,Attività di famiglie e convivenze come datori di lavoro p...,0,0,0,0,0,2021
LOM,  ,T 98,Produzione di beni e servizi indifferenziati per uso prop...,0,0,0,0,0,2021
LOM,  ,U   ,Organizzazioni ed organismi extraterritoriali               ,0,0,0,0,0,2021
LOM,  ,U 99,Organizzazioni ed organismi extraterritoriali               ,0,0,0,0,0,2021
LOM,  ,XX  ,Imprese non classificate                                    ,121,12,23,36,192,2021
LOM,  ,TOT ,TOTALE                                                      ,787,119,10425,142,11473,2021
LOM,VA,A   ,"Agricoltura, silvicoltura pesca                             ",0,0,0,0,0,2021
LOM,VA,A 01,"Coltivazioni agricole e produzione di prodotti animali, c...",0,0,0,0,0,2021
LOM,VA,A 02,Silvicoltura ed utilizzo di aree forestali                  ,0,0,0,0,0,2021
LOM,VA,A 03,Pesca e acquacoltura                                        ,0,0,0,0,0,2021
LOM,VA,B   ,Estrazione di minerali da cave e miniere                    ,0,0,0,0,0,2021
LOM,VA,B 05,Estrazione di carbone (esclusa torba)                       ,0,0,0,0,0,2021
LOM,VA,B 06,Estraz.di petrolio greggio e di gas naturale                ,0,0,0,0,0,2021
LOM,VA,B 07,Estrazione di minerali metalliferi                          ,0,0,0,0,0,2021
LOM,VA,B 08,Altre attività di estrazione di minerali da cave e miniere  ,0,0,0,0,0,2021
LOM,VA,B 09,Attività dei servizi di supporto all'estrazione             ,0,0,0,0,0,2021
LOM,VA,C   ,Attività manifatturiere                                     ,0,0,0,0,0,2021
LOM,VA,C 10,Industrie alimentari                                        ,0,0,0,0,0,2021
LOM,VA,C 11,Industria delle bevande                                     ,0,0,0,0,0,2021
LOM,VA,C 12,Industria del tabacco                                       ,0,0,0,0,0,2021
LOM,VA,C 13,Industrie tessili                                           ,0,0,0,0,0,2021
LOM,VA,C 14,Confezione di articoli di abbigliamento; confezione di ar...,0,0,0,0,0,2021
LOM,VA,C 15,Fabbricazione di articoli in pelle e simili                 ,0,0,0,0,0,2021
LOM,VA,C 16,Industria del legno e dei prodotti in legno e sughero (es...,0,0,0,0,0,2021
LOM,VA,C 17,Fabbricazione di carta e di prodotti di carta               ,0,0,0,0,0,2021
LOM,VA,C 18,Stampa e riproduzione di supporti registrati                ,0,0,0,0,0,2021
LOM,VA,C 19,Fabbricazione di coke e prodotti derivanti dalla raffinaz...,0,0,0,0,0,2021
LOM,VA,C 20,Fabbricazione di prodotti chimici                           ,0,0,0,0,0,2021
LOM,VA,C 21,Fabbricazione di prodotti farmaceutici di base e di prepa...,0,0,0,0,0,2021
LOM,VA,C 22,Fabbricazione di articoli in gomma e materie plastiche      ,0,0,0,0,0,2021
LOM,VA,C 23,Fabbricazione di altri prodotti della lavorazione di miner..,0,0,0,0,0,2021
LOM,VA,C 24,Metallurgia                                                 ,0,0,0,0,0,2021
LOM,VA,C 25,Fabbricazione di prodotti in metallo (esclusi macchinari ...,0,0,0,0,0,2021
LOM,VA,C 26,Fabbricazione di computer e prodotti di elettronica e ott...,0,0,0,0,0,2021
LOM,VA,C 27,Fabbricazione di apparecchiature elettriche ed apparecchi...,0,0,0,0,0,2021
LOM,VA,C 28,Fabbricazione di macchinari ed apparecchiature nca          ,0,0,0,0,0,2021
LOM,VA,C 29,"Fabbricazione di autoveicoli, rimorchi e semirimorchi       ",0,0,0,0,0,2021
LOM,VA,C 30,Fabbricazione di altri mezzi di trasporto                   ,0,0,0,0,0,2021
LOM,VA,C 31,Fabbricazione di mobili                                     ,0,0,0,0,0,2021
LOM,VA,C 32,Altre industrie manifatturiere                              ,0,0,0,0,0,2021
LOM,VA,C 33,"Riparazione, manutenzione ed installazione di macchine ed...",0,0,0,0,0,2021
LOM,VA,D   ,"Fornitura di energia elettrica, gas, vapore e aria condiz...",0,0,0,0,0,2021
LOM,VA,D 35,"Fornitura di energia elettrica, gas, vapore e aria condiz...",0,0,0,0,0,2021
LOM,VA,E   ,"Fornitura di acqua; reti fognarie, attività di gestione d...",0,0,0,0,0,2021
LOM,VA,E 36,"Raccolta, trattamento e fornitura di acqua                  ",0,0,0,0,0,2021
LOM,VA,E 37,Gestione delle reti fognarie                                ,0,0,0,0,0,2021
LOM,VA,E 38,"Attività di raccolta, trattamento e smaltimento dei rifiu...",0,0,0,0,0,2021
LOM,VA,E 39,Attività di risanamento e altri servizi di gestione dei r...,0,0,0,0,0,2021
LOM,VA,F   ,Costruzioni                                                 ,0,0,0,0,0,2021
LOM,VA,F 41,Costruzione di edifici                                      ,0,0,0,0,0,2021
LOM,VA,F 42,Ingegneria civile                                           ,0,0,0,0,0,2021
LOM,VA,F 43,Lavori di costruzione specializzati                         ,0,0,0,0,0,2021
LOM,VA,G   ,Commercio all'ingrosso e al dettaglio; riparazione di aut...,0,0,0,0,0,2021
LOM,VA,G 45,Commercio all'ingrosso e al dettaglio e riparazione di au...,0,0,0,0,0,2021
LOM,VA,G 46,Commercio all'ingrosso (escluso quello di autoveicoli e d...,0,0,0,0,0,2021
LOM,VA,G 47,Commercio al dettaglio (escluso quello di autoveicoli e d...,0,0,0,0,0,2021
LOM,VA,H   ,Trasporto e magazzinaggio                                   ,0,0,0,0,0,2021
LOM,VA,H 49,Trasporto terrestre e mediante condotte                     ,0,0,0,0,0,2021
LOM,VA,H 50,Trasporto marittimo e per vie d'acqua                       ,0,0,0,0,0,2021
LOM,VA,H 51,Trasporto aereo                                             ,0,0,0,0,0,2021
LOM,VA,H 52,Magazzinaggio e attività di supporto ai trasporti           ,0,0,0,0,0,2021
LOM,VA,H 53,Servizi postali e attività di corriere                      ,0,0,0,0,0,2021
LOM,VA,I   ,Attività dei servizi alloggio e ristorazione                ,0,0,0,0,0,2021
LOM,VA,I 55,Alloggio                                                    ,0,0,0,0,0,2021
LOM,VA,I 56,Attività dei servizi di ristorazione                        ,0,0,0,0,0,2021
LOM,VA,J   ,Servizi di informazione e comunicazione                     ,0,0,0,0,0,2021
LOM,VA,J 58,Attività editoriali                                         ,0,0,0,0,0,2021
LOM,VA,J 59,"Attività di produzione cinematografica, di video e di pro...",0,0,0,0,0,2021
LOM,VA,J 60,Attività di programmazione e trasmissione                   ,0,0,0,0,0,2021
LOM,VA,J 61,Telecomunicazioni                                           ,0,0,0,0,0,2021
LOM,VA,J 62,"Produzione di software, consulenza informatica e attività...",0,0,0,0,0,2021
LOM,VA,J 63,Attività dei servizi d'informazione e altri servizi infor...,0,0,0,0,0,2021
LOM,VA,K   ,Attività finanziarie e assicurative                         ,0,0,0,0,0,2021
LOM,VA,K 64,Attività di servizi finanziari (escluse le assicurazioni ...,0,0,0,0,0,2021
LOM,VA,K 65,"Assicurazioni, riassicurazioni e fondi pensione (escluse ...",0,0,0,0,0,2021
LOM,VA,K 66,Attività ausiliarie dei servizi finanziari e delle attivi...,0,0,0,0,0,2021
LOM,VA,L   ,Attivita' immobiliari                                       ,0,0,0,0,0,2021
LOM,VA,L 68,Attivita' immobiliari                                       ,0,0,0,0,0,2021
LOM,VA,M   ,"Attività professionali, scientifiche e tecniche             ",0,0,0,0,0,2021
LOM,VA,M 69,Attività legali e contabilità                               ,0,0,0,0,0,2021
LOM,VA,M 70,Attività di direzione aziendale e di consulenza gestional...,0,0,0,0,0,2021
LOM,VA,M 71,Attività degli studi di architettura e d'ingegneria; coll...,0,0,0,0,0,2021
LOM,VA,M 72,Ricerca scientifica e sviluppo                              ,0,0,0,0,0,2021
LOM,VA,M 73,Pubblicità e ricerche di mercato                            ,0,0,0,0,0,2021
LOM,VA,M 74,"Altre attività professionali, scientifiche e tecniche       ",0,0,0,0,0,2021
LOM,VA,M 75,Servizi veterinari                                          ,0,0,0,0,0,2021
LOM,VA,N   ,"Noleggio, agenzie di viaggio, servizi di supporto alle im...",0,0,0,2,2,2021
LOM,VA,N 77,Attività di noleggio e leasing operativo                    ,0,0,0,0,0,2021
LOM,VA,N 78,"Attività di ricerca, selezione, fornitura di personale      ",0,0,0,0,0,2021
LOM,VA,N 79,"Attività dei servizi delle agenzie di viaggio, dei tour o...",0,0,0,0,0,2021
LOM,VA,N 80,Servizi di vigilanza e investigazione                       ,0,0,0,0,0,2021
LOM,VA,N 81,Attività di servizi per edifici e paesaggio                 ,0,0,0,2,2,2021
LOM,VA,N 82,Attività di supporto per le funzioni d'ufficio e altri se...,0,0,0,0,0,2021
LOM,VA,O   ,Amministrazione pubblica e difesa; assicurazione sociale ...,0,0,0,0,0,2021
LOM,VA,O 84,Amministrazione pubblica e difesa; assicurazione sociale ...,0,0,0,0,0,2021
LOM,VA,P   ,Istruzione                                                  ,0,0,0,0,0,2021
LOM,VA,P 85,Istruzione                                                  ,0,0,0,0,0,2021
LOM,VA,Q   ,Sanita' e assistenza sociale                                ,0,0,0,2,2,2021
LOM,VA,Q 86,Assistenza sanitaria                                        ,0,0,0,0,0,2021
LOM,VA,Q 87,Servizi di assistenza sociale residenziale                  ,0,0,0,0,0,2021
LOM,VA,Q 88,Assistenza sociale non residenziale                         ,0,0,0,2,2,2021
LOM,VA,R   ,"Attività artistiche, sportive, di intrattenimento e diver...",0,0,0,0,0,2021
LOM,VA,R 90,"Attività creative, artistiche e di intrattenimento          ",0,0,0,0,0,2021
LOM,VA,R 91,"Attività di biblioteche, archivi, musei ed altre attività...",0,0,0,0,0,2021
LOM,VA,R 92,"Attività riguardanti le lotterie, le scommesse, le case d...",0,0,0,0,0,2021
LOM,VA,R 93,"Attività sportive, di intrattenimento e di divertimento     ",0,0,0,0,0,2021
LOM,VA,S   ,Altre attività di servizi                                   ,0,0,0,0,0,2021
LOM,VA,S 94,Attività di organizzazioni associative                      ,0,0,0,0,0,2021
LOM,VA,S 95,Riparazione di computer e di beni per uso personale e per...,0,0,0,0,0,2021
LOM,VA,S 96,Altre attività di servizi per la persona                    ,0,0,0,0,0,2021
LOM,VA,T   ,Attività di famiglie e convivenze come datori di lavoro p...,0,0,0,0,0,2021
LOM,VA,T 97,Attività di famiglie e convivenze come datori di lavoro p...,0,0,0,0,0,2021
LOM,VA,T 98,Produzione di beni e servizi indifferenziati per uso prop...,0,0,0,0,0,2021
LOM,VA,U   ,Organizzazioni ed organismi extraterritoriali               ,0,0,0,0,0,2021
LOM,VA,U 99,Organizzazioni ed organismi extraterritoriali               ,0,0,0,0,0,2021
LOM,VA,XX  ,Imprese non classificate                                    ,0,0,0,3,3,2021
LOM,VA,TOT ,TOTALE                                                      ,0,0,0,7,7,2021
LOM,CO,A   ,"Agricoltura, silvicoltura pesca                             ",0,0,0,0,0,2021
LOM,CO,A 01,"Coltivazioni agricole e produzione di prodotti animali, c...",0,0,0,0,0,2021
LOM,CO,A 02,Silvicoltura ed utilizzo di aree forestali                  ,0,0,0,0,0,2021
LOM,CO,A 03,Pesca e acquacoltura                                        ,0,0,0,0,0,2021
LOM,CO,B   ,Estrazione di minerali da cave e miniere                    ,0,0,0,0,0,2021
LOM,CO,B 05,Estrazione di carbone (esclusa torba)                       ,0,0,0,0,0,2021
LOM,CO,B 06,Estraz.di petrolio greggio e di gas naturale                ,0,0,0,0,0,2021
LOM,CO,B 07,Estrazione di minerali metalliferi                          ,0,0,0,0,0,2021
LOM,CO,B 08,Altre attività di estrazione di minerali da cave e miniere  ,0,0,0,0,0,2021
LOM,CO,B 09,Attività dei servizi di supporto all'estrazione             ,0,0,0,0,0,2021
LOM,CO,C   ,Attività manifatturiere                                     ,1,0,0,0,1,2021
LOM,CO,C 10,Industrie alimentari                                        ,0,0,0,0,0,2021
LOM,CO,C 11,Industria delle bevande                                     ,0,0,0,0,0,2021
LOM,CO,C 12,Industria del tabacco                                       ,0,0,0,0,0,2021
LOM,CO,C 13,Industrie tessili                                           ,0,0,0,0,0,2021
LOM,CO,C 14,Confezione di articoli di abbigliamento; confezione di ar...,0,0,0,0,0,2021
LOM,CO,C 15,Fabbricazione di articoli in pelle e simili                 ,0,0,0,0,0,2021
LOM,CO,C 16,Industria del legno e dei prodotti in legno e sughero (es...,0,0,0,0,0,2021
LOM,CO,C 17,Fabbricazione di carta e di prodotti di carta               ,0,0,0,0,0,2021
LOM,CO,C 18,Stampa e riproduzione di supporti registrati                ,0,0,0,0,0,2021
LOM,CO,C 19,Fabbricazione di coke e prodotti derivanti dalla raffinaz...,0,0,0,0,0,2021
LOM,CO,C 20,Fabbricazione di prodotti chimici                           ,0,0,0,0,0,2021
LOM,CO,C 21,Fabbricazione di prodotti farmaceutici di base e di prepa...,0,0,0,0,0,2021
LOM,CO,C 22,Fabbricazione di articoli in gomma e materie plastiche      ,0,0,0,0,0,2021
LOM,CO,C 23,Fabbricazione di altri prodotti della lavorazione di miner..,0,0,0,0,0,2021
LOM,CO,C 24,Metallurgia                                                 ,0,0,0,0,0,2021
LOM,CO,C 25,Fabbricazione di prodotti in metallo (esclusi macchinari ...,1,0,0,0,1,2021
LOM,CO,C 26,Fabbricazione di computer e prodotti di elettronica e ott...,0,0,0,0,0,2021
LOM,CO,C 27,Fabbricazione di apparecchiature elettriche ed apparecchi...,0,0,0,0,0,2021
LOM,CO,C 28,Fabbricazione di macchinari ed apparecchiature nca          ,0,0,0,0,0,2021
LOM,CO,C 29,"Fabbricazione di autoveicoli, rimorchi e semirimorchi       ",0,0,0,0,0,2021
LOM,CO,C 30,Fabbricazione di altri mezzi di trasporto                   ,0,0,0,0,0,2021
LOM,CO,C 31,Fabbricazione di mobili                                     ,0,0,0,0,0,2021
LOM,CO,C 32,Altre industrie manifatturiere                              ,0,0,0,0,0,2021
LOM,CO,C 33,"Riparazione, manutenzione ed installazione di macchine ed...",0,0,0,0,0,2021
LOM,CO,D   ,"Fornitura di energia elettrica, gas, vapore e aria condiz...",0,0,0,0,0,2021
LOM,CO,D 35,"Fornitura di energia elettrica, gas, vapore e aria condiz...",0,0,0,0,0,2021
LOM,CO,E   ,"Fornitura di acqua; reti fognarie, attività di gestione d...",0,0,0,0,0,2021
LOM,CO,E 36,"Raccolta, trattamento e fornitura di acqua                  ",0,0,0,0,0,2021
LOM,CO,E 37,Gestione delle reti fognarie                                ,0,0,0,0,0,2021
LOM,CO,E 38,"Attività di raccolta, trattamento e smaltimento dei rifiu...",0,0,0,0,0,2021
LOM,CO,E 39,Attività di risanamento e altri servizi di gestione dei r...,0,0,0,0,0,2021
LOM,CO,F   ,Costruzioni                                                 ,0,0,0,0,0,2021
LOM,CO,F 41,Costruzione di edifici                                      ,0,0,0,0,0,2021
LOM,CO,F 42,Ingegneria civile                                           ,0,0,0,0,0,2021
LOM,CO,F 43,Lavori di costruzione specializzati                         ,0,0,0,0,0,2021
LOM,CO,G   ,Commercio all'ingrosso e al dettaglio; riparazione di aut...,8,0,0,0,8,2021
LOM,CO,G 45,Commercio all'ingrosso e al dettaglio e riparazione di au...,1,0,0,0,1,2021
LOM,CO,G 46,Commercio all'ingrosso (escluso quello di autoveicoli e d...,5,0,0,0,5,2021
LOM,CO,G 47,Commercio al dettaglio (escluso quello di autoveicoli e d...,2,0,0,0,2,2021
LOM,CO,H   ,Trasporto e magazzinaggio                                   ,1,0,0,1,2,2021
LOM,CO,H 49,Trasporto terrestre e mediante condotte                     ,0,0,0,1,1,2021
LOM,CO,H 50,Trasporto marittimo e per vie d'acqua                       ,0,0,0,0,0,2021
LOM,CO,H 51,Trasporto aereo                                             ,0,0,0,0,0,2021
LOM,CO,H 52,Magazzinaggio e attività di supporto ai trasporti           ,1,0,0,0,1,2021
LOM,CO,H 53,Servizi postali e attività di corriere                      ,0,0,0,0,0,2021
LOM,CO,I   ,Attività dei servizi alloggio e ristorazione                ,1,0,0,0,1,2021
LOM,CO,I 55,Alloggio                                                    ,1,0,0,0,1,2021
LOM,CO,I 56,Attività dei servizi di ristorazione                        ,0,0,0,0,0,2021
LOM,CO,J   ,Servizi di informazione e comunicazione                     ,3,0,0,0,3,2021
LOM,CO,J 58,Attività editoriali                                         ,0,0,0,0,0,2021
LOM,CO,J 59,"Attività di produzione cinematografica, di video e di pro...",0,0,0,0,0,2021
LOM,CO,J 60,Attività di programmazione e trasmissione                   ,0,0,0,0,0,2021
LOM,CO,J 61,Telecomunicazioni                                           ,0,0,0,0,0,2021
LOM,CO,J 62,"Produzione di software, consulenza informatica e attività...",2,0,0,0,2,2021
LOM,CO,J 63,Attività dei servizi d'informazione e altri servizi infor...,1,0,0,0,1,2021
LOM,CO,K   ,Attività finanziarie e assicurative                         ,0,0,0,0,0,2021
LOM,CO,K 64,Attività di servizi finanziari (escluse le assicurazioni ...,0,0,0,0,0,2021
LOM,CO,K 65,"Assicurazioni, riassicurazioni e fondi pensione (escluse ...",0,0,0,0,0,2021
LOM,CO,K 66,Attività ausiliarie dei servizi finanziari e delle attivi...,0,0,0,0,0,2021
LOM,CO,L   ,Attivita' immobiliari                                       ,4,1,0,0,5,2021
LOM,CO,L 68,Attivita' immobiliari                                       ,4,1,0,0,5,2021
LOM,CO,M   ,"Attività professionali, scientifiche e tecniche             ",0,0,0,0,0,2021
LOM,CO,M 69,Attività legali e contabilità                               ,0,0,0,0,0,2021
LOM,CO,M 70,Attività di direzione aziendale e di consulenza gestional...,0,0,0,0,0,2021
LOM,CO,M 71,Attività degli studi di architettura e d'ingegneria; coll...,0,0,0,0,0,2021
LOM,CO,M 72,Ricerca scientifica e sviluppo                              ,0,0,0,0,0,2021
LOM,CO,M 73,Pubblicità e ricerche di mercato                            ,0,0,0,0,0,2021
LOM,CO,M 74,"Altre attività professionali, scientifiche e tecniche       ",0,0,0,0,0,2021
LOM,CO,M 75,Servizi veterinari                                          ,0,0,0,0,0,2021
LOM,CO,N   ,"Noleggio, agenzie di viaggio, servizi di supporto alle im...",4,0,0,0,4,2021
LOM,CO,N 77,Attività di noleggio e leasing operativo                    ,1,0,0,0,1,2021
LOM,CO,N 78,"Attività di ricerca, selezione, fornitura di personale      ",0,0,0,0,0,2021
LOM,CO,N 79,"Attività dei servizi delle agenzie di viaggio, dei tour o...",1,0,0,0,1,2021
LOM,CO,N 80,Servizi di vigilanza e investigazione                       ,0,0,0,0,0,2021
LOM,CO,N 81,Attività di servizi per edifici e paesaggio                 ,2,0,0,0,2,2021
LOM,CO,N 82,Attività di supporto per le funzioni d'ufficio e altri se...,0,0,0,0,0,2021
LOM,CO,O   ,Amministrazione pubblica e difesa; assicurazione sociale ...,0,0,0,0,0,2021
LOM,CO,O 84,Amministrazione pubblica e difesa; assicurazione sociale ...,0,0,0,0,0,2021
LOM,CO,P   ,Istruzione                                                  ,0,0,0,0,0,2021
LOM,CO,P 85,Istruzione                                                  ,0,0,0,0,0,2021
LOM,CO,Q   ,Sanita' e assistenza sociale                                ,0,0,0,1,1,2021
LOM,CO,Q 86,Assistenza sanitaria                                        ,0,0,0,0,0,2021
LOM,CO,Q 87,Servizi di assistenza sociale residenziale                  ,0,0,0,0,0,2021
LOM,CO,Q 88,Assistenza sociale non residenziale                         ,0,0,0,1,1,2021
LOM,CO,R   ,"Attività artistiche, sportive, di intrattenimento e diver...",0,0,0,0,0,2021
LOM,CO,R 90,"Attività creative, artistiche e di intrattenimento          ",0,0,0,0,0,2021
LOM,CO,R 91,"Attività di biblioteche, archivi, musei ed altre attività...",0,0,0,0,0,2021
LOM,CO,R 92,"Attività riguardanti le lotterie, le scommesse, le case d...",0,0,0,0,0,2021
LOM,CO,R 93,"Attività sportive, di intrattenimento e di divertimento     ",0,0,0,0,0,2021
LOM,CO,S   ,Altre attività di servizi                                   ,0,0,0,0,0,2021
LOM,CO,S 94,Attività di organizzazioni associative                      ,0,0,0,0,0,2021
LOM,CO,S 95,Riparazione di computer e di beni per uso personale e per...,0,0,0,0,0,2021
LOM,CO,S 96,Altre attività di servizi per la persona                    ,0,0,0,0,0,2021
LOM,CO,T   ,Attività di famiglie e convivenze come datori di lavoro p...,0,0,0,0,0,2021
LOM,CO,T 97,Attività di famiglie e convivenze come datori di lavoro p...,0,0,0,0,0,2021
LOM,CO,T 98,Produzione di beni e servizi indifferenziati per uso prop...,0,0,0,0,0,2021
LOM,CO,U   ,Organizzazioni ed organismi extraterritoriali               ,0,0,0,0,0,2021
LOM,CO,U 99,Organizzazioni ed organismi extraterritoriali               ,0,0,0,0,0,2021
LOM,CO,XX  ,Imprese non classificate                                    ,3,0,0,1,4,2021
LOM,CO,TOT ,TOTALE                                                      ,25,1,0,3,29,2021
LOM,SO,A   ,"Agricoltura, silvicoltura pesca                             ",0,0,0,0,0,2021
LOM,SO,A 01,"Coltivazioni agricole e produzione di prodotti animali, c...",0,0,0,0,0,2021
LOM,SO,A 02,Silvicoltura ed utilizzo di aree forestali                  ,0,0,0,0,0,2021
LOM,SO,A 03,Pesca e acquacoltura                                        ,0,0,0,0,0,2021
LOM,SO,B   ,Estrazione di minerali da cave e miniere                    ,0,0,0,0,0,2021
LOM,SO,B 05,Estrazione di carbone (esclusa torba)                       ,0,0,0,0,0,2021
LOM,SO,B 06,Estraz.di petrolio greggio e di gas naturale                ,0,0,0,0,0,2021
LOM,SO,B 07,Estrazione di minerali metalliferi                          ,0,0,0,0,0,2021
LOM,SO,B 08,Altre attività di estrazione di minerali da cave e miniere  ,0,0,0,0,0,2021
LOM,SO,B 09,Attività dei servizi di supporto all'estrazione             ,0,0,0,0,0,2021
LOM,SO,C   ,Attività manifatturiere                                     ,0,0,0,0,0,2021
LOM,SO,C 10,Industrie alimentari                                        ,0,0,0,0,0,2021
LOM,SO,C 11,Industria delle bevande                                     ,0,0,0,0,0,2021
LOM,SO,C 12,Industria del tabacco                                       ,0,0,0,0,0,2021
LOM,SO,C 13,Industrie tessili                                           ,0,0,0,0,0,2021
LOM,SO,C 14,Confezione di articoli di abbigliamento; confezione di ar...,0,0,0,0,0,2021
LOM,SO,C 15,Fabbricazione di articoli in pelle e simili                 ,0,0,0,0,0,2021
LOM,SO,C 16,Industria del legno e dei prodotti in legno e sughero (es...,0,0,0,0,0,2021
LOM,SO,C 17,Fabbricazione di carta e di prodotti di carta               ,0,0,0,0,0,2021
LOM,SO,C 18,Stampa e riproduzione di supporti registrati                ,0,0,0,0,0,2021
LOM,SO,C 19,Fabbricazione di coke e prodotti derivanti dalla raffinaz...,0,0,0,0,0,2021
LOM,SO,C 20,Fabbricazione di prodotti chimici                           ,0,0,0,0,0,2021
LOM,SO,C 21,Fabbricazione di prodotti farmaceutici di base e di prepa...,0,0,0,0,0,2021
LOM,SO,C 22,Fabbricazione di articoli in gomma e materie plastiche      ,0,0,0,0,0,2021
LOM,SO,C 23,Fabbricazione di altri prodotti della lavorazione di miner..,0,0,0,0,0,2021
LOM,SO,C 24,Metallurgia                                                 ,0,0,0,0,0,2021
LOM,SO,C 25,Fabbricazione di prodotti in metallo (esclusi macchinari ...,0,0,0,0,0,2021
LOM,SO,C 26,Fabbricazione di computer e prodotti di elettronica e ott...,0,0,0,0,0,2021
LOM,SO,C 27,Fabbricazione di apparecchiature elettriche ed apparecchi...,0,0,0,0,0,2021
LOM,SO,C 28,Fabbricazione di macchinari ed apparecchiature nca          ,0,0,0,0,0,2021
LOM,SO,C 29,"Fabbricazione di autoveicoli, rimorchi e semirimorchi       ",0,0,0,0,0,2021
LOM,SO,C 30,Fabbricazione di altri mezzi di trasporto                   ,0,0,0,0,0,2021
LOM,SO,C 31,Fabbricazione di mobili                                     ,0,0,0,0,0,2021
LOM,SO,C 32,Altre industrie manifatturiere                              ,0,0,0,0,0,2021
LOM,SO,C 33,"Riparazione, manutenzione ed installazione di macchine ed...",0,0,0,0,0,2021
LOM,SO,D   ,"Fornitura di energia elettrica, gas, vapore e aria condiz...",0,0,0,0,0,2021
LOM,SO,D 35,"Fornitura di energia elettrica, gas, vapore e aria condiz...",0,0,0,0,0,2021
LOM,SO,E   ,"Fornitura di acqua; reti fognarie, attività di gestione d...",0,0,0,0,0,2021
LOM,SO,E 36,"Raccolta, trattamento e fornitura di acqua                  ",0,0,0,0,0,2021
LOM,SO,E 37,Gestione delle reti fognarie                                ,0,0,0,0,0,2021
LOM,SO,E 38,"Attività di raccolta, trattamento e smaltimento dei rifiu...",0,0,0,0,0,2021
LOM,SO,E 39,Attività di risanamento e altri servizi di gestione dei r...,0,0,0,0,0,2021
LOM,SO,F   ,Costruzioni                                                 ,0,0,0,0,0,2021
LOM,SO,F 41,Costruzione di edifici                                      ,0,0,0,0,0,2021
LOM,SO,F 42,Ingegneria civile                                           ,0,0,0,0,0,2021
LOM,SO,F 43,Lavori di costruzione specializzati                         ,0,0,0,0,0,2021
LOM,SO,G   ,Commercio all'ingrosso e al dettaglio; riparazione di aut...,0,0,0,0,0,2021
LOM,SO,G 45,Commercio all'ingrosso e al dettaglio e riparazione di au...,0,0,0,0,0,2021
LOM,SO,G 46,Commercio all'ingrosso (escluso quello di autoveicoli e d...,0,0,0,0,0,2021
LOM,SO,G 47,Commercio al dettaglio (escluso quello di autoveicoli e d...,0,0,0,0,0,2021
LOM,SO,H   ,Trasporto e magazzinaggio                                   ,0,0,0,0,0,2021
LOM,SO,H 49,Trasporto terrestre e mediante condotte                     ,0,0,0,0,0,2021
LOM,SO,H 50,Trasporto marittimo e per vie d'acqua                       ,0,0,0,0,0,2021
LOM,SO,H 51,Trasporto aereo                                             ,0,0,0,0,0,2021
LOM,SO,H 52,Magazzinaggio e attività di supporto ai trasporti           ,0,0,0,0,0,2021
LOM,SO,H 53,Servizi postali e attività di corriere                      ,0,0,0,0,0,2021
LOM,SO,I   ,Attività dei servizi alloggio e ristorazione                ,0,0,0,0,0,2021
LOM,SO,I 55,Alloggio                                                    ,0,0,0,0,0,2021
LOM,SO,I 56,Attività dei servizi di ristorazione                        ,0,0,0,0,0,2021
LOM,SO,J   ,Servizi di informazione e comunicazione                     ,0,0,0,0,0,2021
LOM,SO,J 58,Attività editoriali                                         ,0,0,0,0,0,2021
LOM,SO,J 59,"Attività di produzione cinematografica, di video e di pro...",0,0,0,0,0,2021
LOM,SO,J 60,Attività di programmazione e trasmissione                   ,0,0,0,0,0,2021
LOM,SO,J 61,Telecomunicazioni                                           ,0,0,0,0,0,2021
LOM,SO,J 62,"Produzione di software, consulenza informatica e attività...",0,0,0,0,0,2021
LOM,SO,J 63,Attività dei servizi d'informazione e altri servizi infor...,0,0,0,0,0,2021
LOM,SO,K   ,Attività finanziarie e assicurative                         ,0,0,0,0,0,2021
LOM,SO,K 64,Attività di servizi finanziari (escluse le assicurazioni ...,0,0,0,0,0,2021
LOM,SO,K 65,"Assicurazioni, riassicurazioni e fondi pensione (escluse ...",0,0,0,0,0,2021
LOM,SO,K 66,Attività ausiliarie dei servizi finanziari e delle attivi...,0,0,0,0,0,2021
LOM,SO,L   ,Attivita' immobiliari                                       ,0,0,0,0,0,2021
LOM,SO,L 68,Attivita' immobiliari                                       ,0,0,0,0,0,2021
LOM,SO,M   ,"Attività professionali, scientifiche e tecniche             ",0,0,0,0,0,2021
LOM,SO,M 69,Attività legali e contabilità                               ,0,0,0,0,0,2021
LOM,SO,M 70,Attività di direzione aziendale e di consulenza gestional...,0,0,0,0,0,2021
LOM,SO,M 71,Attività degli studi di architettura e d'ingegneria; coll...,0,0,0,0,0,2021
LOM,SO,M 72,Ricerca scientifica e sviluppo                              ,0,0,0,0,0,2021
LOM,SO,M 73,Pubblicità e ricerche di mercato                            ,0,0,0,0,0,2021
LOM,SO,M 74,"Altre attività professionali, scientifiche e tecniche       ",0,0,0,0,0,2021
LOM,SO,M 75,Servizi veterinari                                          ,0,0,0,0,0,2021
LOM,SO,N   ,"Noleggio, agenzie di viaggio, servizi di supporto alle im...",0,0,0,0,0,2021
LOM,SO,N 77,Attività di noleggio e leasing operativo                    ,0,0,0,0,0,2021
LOM,SO,N 78,"Attività di ricerca, selezione, fornitura di personale      ",0,0,0,0,0,2021
LOM,SO,N 79,"Attività dei servizi delle agenzie di viaggio, dei tour o...",0,0,0,0,0,2021
LOM,SO,N 80,Servizi di vigilanza e investigazione                       ,0,0,0,0,0,2021
LOM,SO,N 81,Attività di servizi per edifici e paesaggio                 ,0,0,0,0,0,2021
LOM,SO,N 82,Attività di supporto per le funzioni d'ufficio e altri se...,0,0,0,0,0,2021
LOM,SO,O   ,Amministrazione pubblica e difesa; assicurazione sociale ...,0,0,0,0,0,2021
LOM,SO,O 84,Amministrazione pubblica e difesa; assicurazione sociale ...,0,0,0,0,0,2021
LOM,SO,P   ,Istruzione                                                  ,0,0,0,0,0,2021
LOM,SO,P 85,Istruzione                                                  ,0,0,0,0,0,2021
LOM,SO,Q   ,Sanita' e assistenza sociale                                ,0,0,0,0,0,2021
LOM,SO,Q 86,Assistenza sanitaria                                        ,0,0,0,0,0,2021
LOM,SO,Q 87,Servizi di assistenza sociale residenziale                  ,0,0,0,0,0,2021
LOM,SO,Q 88,Assistenza sociale non residenziale                         ,0,0,0,0,0,2021
LOM,SO,R   ,"Attività artistiche, sportive, di intrattenimento e diver...",0,0,0,0,0,2021
LOM,SO,R 90,"Attività creative, artistiche e di intrattenimento          ",0,0,0,0,0,2021
LOM,SO,R 91,"Attività di biblioteche, archivi, musei ed altre attività...",0,0,0,0,0,2021
LOM,SO,R 92,"Attività riguardanti le lotterie, le scommesse, le case d...",0,0,0,0,0,2021
LOM,SO,R 93,"Attività sportive, di intrattenimento e di divertimento     ",0,0,0,0,0,2021
LOM,SO,S   ,Altre attività di servizi                                   ,0,0,0,0,0,2021
LOM,SO,S 94,Attività di organizzazioni associative                      ,0,0,0,0,0,2021
LOM,SO,S 95,Riparazione di computer e di beni per uso personale e per...,0,0,0,0,0,2021
LOM,SO,S 96,Altre attività di servizi per la persona                    ,0,0,0,0,0,2021
LOM,SO,T   ,Attività di famiglie e convivenze come datori di lavoro p...,0,0,0,0,0,2021
LOM,SO,T 97,Attività di famiglie e convivenze come datori di lavoro p...,0,0,0,0,0,2021
LOM,SO,T 98,Produzione di beni e servizi indifferenziati per uso prop...,0,0,0,0,0,2021
LOM,SO,U   ,Organizzazioni ed organismi extraterritoriali               ,0,0,0,0,0,2021
LOM,SO,U 99,Organizzazioni ed organismi extraterritoriali               ,0,0,0,0,0,2021
LOM,SO,XX  ,Imprese non classificate                                    ,0,0,0,0,0,2021
LOM,SO,TOT ,TOTALE                                                      ,0,0,0,0,0,2021
LOM,MI,A   ,"Agricoltura, silvicoltura pesca                             ",0,1,34,1,36,2021
LOM,MI,A 01,"Coltivazioni agricole e produzione di prodotti animali, c...",0,1,33,1,35,2021
LOM,MI,A 02,Silvicoltura ed utilizzo di aree forestali                  ,0,0,1,0,1,2021
LOM,MI,A 03,Pesca e acquacoltura                                        ,0,0,0,0,0,2021
LOM,MI,B   ,Estrazione di minerali da cave e miniere                    ,0,0,0,0,0,2021
LOM,MI,B 05,Estrazione di carbone (esclusa torba)                       ,0,0,0,0,0,2021
LOM,MI,B 06,Estraz.di petrolio greggio e di gas naturale                ,0,0,0,0,0,2021
LOM,MI,B 07,Estrazione di minerali metalliferi                          ,0,0,0,0,0,2021
LOM,MI,B 08,Altre attività di estrazione di minerali da cave e miniere  ,0,0,0,0,0,2021
LOM,MI,B 09,Attività dei servizi di supporto all'estrazione             ,0,0,0,0,0,2021
LOM,MI,C   ,Attività manifatturiere                                     ,62,16,425,3,506,2021
LOM,MI,C 10,Industrie alimentari                                        ,6,2,21,0,29,2021
LOM,MI,C 11,Industria delle bevande                                     ,1,0,0,0,1,2021
LOM,MI,C 12,Industria del tabacco                                       ,0,0,0,0,0,2021
LOM,MI,C 13,Industrie tessili                                           ,0,1,21,0,22,2021
LOM,MI,C 14,Confezione di articoli di abbigliamento; confezione di ar...,6,1,86,0,93,2021
LOM,MI,C 15,Fabbricazione di articoli in pelle e simili                 ,1,0,22,0,23,2021
LOM,MI,C 16,Industria del legno e dei prodotti in legno e sughero (es...,0,3,25,2,30,2021
LOM,MI,C 17,Fabbricazione di carta e di prodotti di carta               ,4,0,6,0,10,2021
LOM,MI,C 18,Stampa e riproduzione di supporti registrati                ,4,2,19,0,25,2021
LOM,MI,C 19,Fabbricazione di coke e prodotti derivanti dalla raffinaz...,0,0,0,0,0,2021
LOM,MI,C 20,Fabbricazione di prodotti chimici                           ,3,0,1,1,5,2021
LOM,MI,C 21,Fabbricazione di prodotti farmaceutici di base e di prepa...,0,0,0,0,0,2021
LOM,MI,C 22,Fabbricazione di articoli in gomma e materie plastiche      ,3,1,5,0,9,2021
LOM,MI,C 23,Fabbricazione di altri prodotti della lavorazione di miner..,3,0,14,0,17,2021
LOM,MI,C 24,Metallurgia                                                 ,1,0,1,0,2,2021
LOM,MI,C 25,Fabbricazione di prodotti in metallo (esclusi macchinari ...,12,2,101,0,115,2021
LOM,MI,C 26,Fabbricazione di computer e prodotti di elettronica e ott...,6,1,8,0,15,2021
LOM,MI,C 27,Fabbricazione di apparecchiature elettriche ed apparecchi...,2,1,11,0,14,2021
LOM,MI,C 28,Fabbricazione di macchinari ed apparecchiature nca          ,6,1,9,0,16,2021
LOM,MI,C 29,"Fabbricazione di autoveicoli, rimorchi e semirimorchi       ",0,0,1,0,1,2021
LOM,MI,C 30,Fabbricazione di altri mezzi di trasporto                   ,1,0,3,0,4,2021
LOM,MI,C 31,Fabbricazione di mobili                                     ,1,0,13,0,14,2021
LOM,MI,C 32,Altre industrie manifatturiere                              ,0,1,33,0,34,2021
LOM,MI,C 33,"Riparazione, manutenzione ed installazione di macchine ed...",2,0,25,0,27,2021
LOM,MI,D   ,"Fornitura di energia elettrica, gas, vapore e aria condiz...",1,0,2,0,3,2021
LOM,MI,D 35,"Fornitura di energia elettrica, gas, vapore e aria condiz...",1,0,2,0,3,2021
LOM,MI,E   ,"Fornitura di acqua; reti fognarie, attività di gestione d...",1,0,4,0,5,2021
LOM,MI,E 36,"Raccolta, trattamento e fornitura di acqua                  ",0,0,0,0,0,2021
LOM,MI,E 37,Gestione delle reti fognarie                                ,0,0,0,0,0,2021
LOM,MI,E 38,"Attività di raccolta, trattamento e smaltimento dei rifiu...",1,0,4,0,5,2021
LOM,MI,E 39,Attività di risanamento e altri servizi di gestione dei r...,0,0,0,0,0,2021
LOM,MI,F   ,Costruzioni                                                 ,49,9,2434,12,2504,2021
LOM,MI,F 41,Costruzione di edifici                                      ,35,6,363,6,410,2021
LOM,MI,F 42,Ingegneria civile                                           ,1,0,6,1,8,2021
LOM,MI,F 43,Lavori di costruzione specializzati                         ,13,3,2065,5,2086,2021
LOM,MI,G   ,Commercio all'ingrosso e al dettaglio; riparazione di aut...,92,11,1958,0,2061,2021
LOM,MI,G 45,Commercio all'ingrosso e al dettaglio e riparazione di au...,4,2,138,0,144,2021
LOM,MI,G 46,Commercio all'ingrosso (escluso quello di autoveicoli e d...,64,4,605,0,673,2021
LOM,MI,G 47,Commercio al dettaglio (escluso quello di autoveicoli e d...,24,5,1215,0,1244,2021
LOM,MI,H   ,Trasporto e magazzinaggio                                   ,11,0,491,17,519,2021
LOM,MI,H 49,Trasporto terrestre e mediante condotte                     ,6,0,354,2,362,2021
LOM,MI,H 50,Trasporto marittimo e per vie d'acqua                       ,0,0,0,0,0,2021
LOM,MI,H 51,Trasporto aereo                                             ,0,0,0,0,0,2021
LOM,MI,H 52,Magazzinaggio e attività di supporto ai trasporti           ,5,0,31,15,51,2021
LOM,MI,H 53,Servizi postali e attività di corriere                      ,0,0,106,0,106,2021
LOM,MI,I   ,Attività dei servizi alloggio e ristorazione                ,29,4,402,0,435,2021
LOM,MI,I 55,Alloggio                                                    ,3,1,9,0,13,2021
LOM,MI,I 56,Attività dei servizi di ristorazione                        ,26,3,393,0,422,2021
LOM,MI,J   ,Servizi di informazione e comunicazione                     ,35,2,239,2,278,2021
LOM,MI,J 58,Attività editoriali                                         ,2,0,21,0,23,2021
LOM,MI,J 59,"Attività di produzione cinematografica, di video e di pro...",4,0,17,0,21,2021
LOM,MI,J 60,Attività di programmazione e trasmissione                   ,0,0,1,0,1,2021
LOM,MI,J 61,Telecomunicazioni                                           ,0,0,136,0,136,2021
LOM,MI,J 62,"Produzione di software, consulenza informatica e attività...",23,0,44,0,67,2021
LOM,MI,J 63,Attività dei servizi d'informazione e altri servizi infor...,6,2,20,2,30,2021
LOM,MI,K   ,Attività finanziarie e assicurative                         ,14,1,63,0,78,2021
LOM,MI,K 64,Attività di servizi finanziari (escluse le assicurazioni ...,7,0,2,0,9,2021
LOM,MI,K 65,"Assicurazioni, riassicurazioni e fondi pensione (escluse ...",0,0,0,0,0,2021
LOM,MI,K 66,Attività ausiliarie dei servizi finanziari e delle attivi...,7,1,61,0,69,2021
LOM,MI,L   ,Attivita' immobiliari                                       ,72,6,36,0,114,2021
LOM,MI,L 68,Attivita' immobiliari                                       ,72,6,36,0,114,2021
LOM,MI,M   ,"Attività professionali, scientifiche e tecniche             ",53,13,277,4,347,2021
LOM,MI,M 69,Attività legali e contabilità                               ,3,0,16,1,20,2021
LOM,MI,M 70,Attività di direzione aziendale e di consulenza gestional...,23,5,52,1,81,2021
LOM,MI,M 71,Attività degli studi di architettura e d'ingegneria; coll...,0,1,18,0,19,2021
LOM,MI,M 72,Ricerca scientifica e sviluppo                              ,1,1,1,0,3,2021
LOM,MI,M 73,Pubblicità e ricerche di mercato                            ,11,2,96,1,110,2021
LOM,MI,M 74,"Altre attività professionali, scientifiche e tecniche       ",15,4,94,1,114,2021
LOM,MI,M 75,Servizi veterinari                                          ,0,0,0,0,0,2021
LOM,MI,N   ,"Noleggio, agenzie di viaggio, servizi di supporto alle im...",35,7,368,13,423,2021
LOM,MI,N 77,Attività di noleggio e leasing operativo                    ,5,1,20,0,26,2021
LOM,MI,N 78,"Attività di ricerca, selezione, fornitura di personale      ",2,0,1,0,3,2021
LOM,MI,N 79,"Attività dei servizi delle agenzie di viaggio, dei tour o...",5,1,7,0,13,2021
LOM,MI,N 80,Servizi di vigilanza e investigazione                       ,2,0,4,1,7,2021
LOM,MI,N 81,Attività di servizi per edifici e paesaggio                 ,7,2,209,5,223,2021
LOM,MI,N 82,Attività di supporto per le funzioni d'ufficio e altri se...,14,3,127,7,151,2021
LOM,MI,O   ,Amministrazione pubblica e difesa; assicurazione sociale ...,0,0,0,0,0,2021
LOM,MI,O 84,Amministrazione pubblica e difesa; assicurazione sociale ...,0,0,0,0,0,2021
LOM,MI,P   ,Istruzione                                                  ,1,0,8,1,10,2021
LOM,MI,P 85,Istruzione                                                  ,1,0,8,1,10,2021
LOM,MI,Q   ,Sanita' e assistenza sociale                                ,2,0,5,7,14,2021
LOM,MI,Q 86,Assistenza sanitaria                                        ,2,0,2,1,5,2021
LOM,MI,Q 87,Servizi di assistenza sociale residenziale                  ,0,0,0,3,3,2021
LOM,MI,Q 88,Assistenza sociale non residenziale                         ,0,0,3,3,6,2021
LOM,MI,R   ,"Attività artistiche, sportive, di intrattenimento e diver...",7,2,53,1,63,2021
LOM,MI,R 90,"Attività creative, artistiche e di intrattenimento          ",3,1,22,0,26,2021
LOM,MI,R 91,"Attività di biblioteche, archivi, musei ed altre attività...",0,0,0,0,0,2021
LOM,MI,R 92,"Attività riguardanti le lotterie, le scommesse, le case d...",0,0,4,0,4,2021
LOM,MI,R 93,"Attività sportive, di intrattenimento e di divertimento     ",4,1,27,1,33,2021
LOM,MI,S   ,Altre attività di servizi                                   ,5,8,216,1,230,2021
LOM,MI,S 94,Attività di organizzazioni associative                      ,0,0,0,0,0,2021
LOM,MI,S 95,Riparazione di computer e di beni per uso personale e per...,2,3,55,1,61,2021
LOM,MI,S 96,Altre attività di servizi per la persona                    ,3,5,161,0,169,2021
LOM,MI,T   ,Attività di famiglie e convivenze come datori di lavoro p...,0,0,0,0,0,2021
LOM,MI,T 97,Attività di famiglie e convivenze come datori di lavoro p...,0,0,0,0,0,2021
LOM,MI,T 98,Produzione di beni e servizi indifferenziati per uso prop...,0,0,0,0,0,2021
LOM,MI,U   ,Organizzazioni ed organismi extraterritoriali               ,0,0,0,0,0,2021
LOM,MI,U 99,Organizzazioni ed organismi extraterritoriali               ,0,0,0,0,0,2021
LOM,MI,XX  ,Imprese non classificate                                    ,92,10,3,17,122,2021
LOM,MI,TOT ,TOTALE                                                      ,561,90,7018,79,7748,2021
LOM,BG,A   ,"Agricoltura, silvicoltura pesca                             ",3,0,0,2,5,2021
LOM,BG,A 01,"Coltivazioni agricole e produzione di prodotti animali, c...",3,0,0,2,5,2021
LOM,BG,A 02,Silvicoltura ed utilizzo di aree forestali                  ,0,0,0,0,0,2021
LOM,BG,A 03,Pesca e acquacoltura                                        ,0,0,0,0,0,2021
LOM,BG,B   ,Estrazione di minerali da cave e miniere                    ,1,0,1,0,2,2021
LOM,BG,B 05,Estrazione di carbone (esclusa torba)                       ,0,0,0,0,0,2021
LOM,BG,B 06,Estraz.di petrolio greggio e di gas naturale                ,0,0,0,0,0,2021
LOM,BG,B 07,Estrazione di minerali metalliferi                          ,0,0,0,0,0,2021
LOM,BG,B 08,Altre attività di estrazione di minerali da cave e miniere  ,1,0,1,0,2,2021
LOM,BG,B 09,Attività dei servizi di supporto all'estrazione             ,0,0,0,0,0,2021
LOM,BG,C   ,Attività manifatturiere                                     ,30,2,14,3,49,2021
LOM,BG,C 10,Industrie alimentari                                        ,4,1,0,1,6,2021
LOM,BG,C 11,Industria delle bevande                                     ,1,0,0,0,1,2021
LOM,BG,C 12,Industria del tabacco                                       ,0,0,0,0,0,2021
LOM,BG,C 13,Industrie tessili                                           ,2,0,2,0,4,2021
LOM,BG,C 14,Confezione di articoli di abbigliamento; confezione di ar...,2,0,1,0,3,2021
LOM,BG,C 15,Fabbricazione di articoli in pelle e simili                 ,1,0,0,0,1,2021
LOM,BG,C 16,Industria del legno e dei prodotti in legno e sughero (es...,0,0,0,0,0,2021
LOM,BG,C 17,Fabbricazione di carta e di prodotti di carta               ,0,0,0,0,0,2021
LOM,BG,C 18,Stampa e riproduzione di supporti registrati                ,2,0,0,0,2,2021
LOM,BG,C 19,Fabbricazione di coke e prodotti derivanti dalla raffinaz...,0,0,0,0,0,2021
LOM,BG,C 20,Fabbricazione di prodotti chimici                           ,1,0,0,0,1,2021
LOM,BG,C 21,Fabbricazione di prodotti farmaceutici di base e di prepa...,0,0,0,0,0,2021
LOM,BG,C 22,Fabbricazione di articoli in gomma e materie plastiche      ,4,1,2,0,7,2021
LOM,BG,C 23,Fabbricazione di altri prodotti della lavorazione di miner..,3,0,1,0,4,2021
LOM,BG,C 24,Metallurgia                                                 ,2,0,1,0,3,2021
LOM,BG,C 25,Fabbricazione di prodotti in metallo (esclusi macchinari ...,1,0,2,1,4,2021
LOM,BG,C 26,Fabbricazione di computer e prodotti di elettronica e ott...,2,0,0,0,2,2021
LOM,BG,C 27,Fabbricazione di apparecchiature elettriche ed apparecchi...,3,0,1,1,5,2021
LOM,BG,C 28,Fabbricazione di macchinari ed apparecchiature nca          ,1,0,0,0,1,2021
LOM,BG,C 29,"Fabbricazione di autoveicoli, rimorchi e semirimorchi       ",0,0,0,0,0,2021
LOM,BG,C 30,Fabbricazione di altri mezzi di trasporto                   ,0,0,0,0,0,2021
LOM,BG,C 31,Fabbricazione di mobili                                     ,1,0,1,0,2,2021
LOM,BG,C 32,Altre industrie manifatturiere                              ,0,0,0,0,0,2021
LOM,BG,C 33,"Riparazione, manutenzione ed installazione di macchine ed...",0,0,3,0,3,2021
LOM,BG,D   ,"Fornitura di energia elettrica, gas, vapore e aria condiz...",0,0,0,0,0,2021
LOM,BG,D 35,"Fornitura di energia elettrica, gas, vapore e aria condiz...",0,0,0,0,0,2021
LOM,BG,E   ,"Fornitura di acqua; reti fognarie, attività di gestione d...",0,0,0,0,0,2021
LOM,BG,E 36,"Raccolta, trattamento e fornitura di acqua                  ",0,0,0,0,0,2021
LOM,BG,E 37,Gestione delle reti fognarie                                ,0,0,0,0,0,2021
LOM,BG,E 38,"Attività di raccolta, trattamento e smaltimento dei rifiu...",0,0,0,0,0,2021
LOM,BG,E 39,Attività di risanamento e altri servizi di gestione dei r...,0,0,0,0,0,2021
LOM,BG,F   ,Costruzioni                                                 ,3,0,43,2,48,2021
LOM,BG,F 41,Costruzione di edifici                                      ,3,0,6,1,10,2021
LOM,BG,F 42,Ingegneria civile                                           ,0,0,1,0,1,2021
LOM,BG,F 43,Lavori di costruzione specializzati                         ,0,0,36,1,37,2021
LOM,BG,G   ,Commercio all'ingrosso e al dettaglio; riparazione di aut...,20,0,20,1,41,2021
LOM,BG,G 45,Commercio all'ingrosso e al dettaglio e riparazione di au...,1,0,2,0,3,2021
LOM,BG,G 46,Commercio all'ingrosso (escluso quello di autoveicoli e d...,10,0,7,0,17,2021
LOM,BG,G 47,Commercio al dettaglio (escluso quello di autoveicoli e d...,9,0,11,1,21,2021
LOM,BG,H   ,Trasporto e magazzinaggio                                   ,2,0,8,1,11,2021
LOM,BG,H 49,Trasporto terrestre e mediante condotte                     ,1,0,7,0,8,2021
LOM,BG,H 50,Trasporto marittimo e per vie d'acqua                       ,0,0,0,0,0,2021
LOM,BG,H 51,Trasporto aereo                                             ,0,0,0,0,0,2021
LOM,BG,H 52,Magazzinaggio e attività di supporto ai trasporti           ,1,0,1,1,3,2021
LOM,BG,H 53,Servizi postali e attività di corriere                      ,0,0,0,0,0,2021
LOM,BG,I   ,Attività dei servizi alloggio e ristorazione                ,0,0,5,0,5,2021
LOM,BG,I 55,Alloggio                                                    ,0,0,0,0,0,2021
LOM,BG,I 56,Attività dei servizi di ristorazione                        ,0,0,5,0,5,2021
LOM,BG,J   ,Servizi di informazione e comunicazione                     ,1,0,0,0,1,2021
LOM,BG,J 58,Attività editoriali                                         ,0,0,0,0,0,2021
LOM,BG,J 59,"Attività di produzione cinematografica, di video e di pro...",1,0,0,0,1,2021
LOM,BG,J 60,Attività di programmazione e trasmissione                   ,0,0,0,0,0,2021
LOM,BG,J 61,Telecomunicazioni                                           ,0,0,0,0,0,2021
LOM,BG,J 62,"Produzione di software, consulenza informatica e attività...",0,0,0,0,0,2021
LOM,BG,J 63,Attività dei servizi d'informazione e altri servizi infor...,0,0,0,0,0,2021
LOM,BG,K   ,Attività finanziarie e assicurative                         ,1,0,0,0,1,2021
LOM,BG,K 64,Attività di servizi finanziari (escluse le assicurazioni ...,0,0,0,0,0,2021
LOM,BG,K 65,"Assicurazioni, riassicurazioni e fondi pensione (escluse ...",0,0,0,0,0,2021
LOM,BG,K 66,Attività ausiliarie dei servizi finanziari e delle attivi...,1,0,0,0,1,2021
LOM,BG,L   ,Attivita' immobiliari                                       ,12,0,1,0,13,2021
LOM,BG,L 68,Attivita' immobiliari                                       ,12,0,1,0,13,2021
LOM,BG,M   ,"Attività professionali, scientifiche e tecniche             ",2,0,0,2,4,2021
LOM,BG,M 69,Attività legali e contabilità                               ,0,0,0,0,0,2021
LOM,BG,M 70,Attività di direzione aziendale e di consulenza gestional...,0,0,0,0,0,2021
LOM,BG,M 71,Attività degli studi di architettura e d'ingegneria; coll...,0,0,0,0,0,2021
LOM,BG,M 72,Ricerca scientifica e sviluppo                              ,0,0,0,0,0,2021
LOM,BG,M 73,Pubblicità e ricerche di mercato                            ,0,0,0,1,1,2021
LOM,BG,M 74,"Altre attività professionali, scientifiche e tecniche       ",2,0,0,1,3,2021
LOM,BG,M 75,Servizi veterinari                                          ,0,0,0,0,0,2021
LOM,BG,N   ,"Noleggio, agenzie di viaggio, servizi di supporto alle im...",0,0,2,2,4,2021
LOM,BG,N 77,Attività di noleggio e leasing operativo                    ,0,0,0,0,0,2021
LOM,BG,N 78,"Attività di ricerca, selezione, fornitura di personale      ",0,0,0,0,0,2021
LOM,BG,N 79,"Attività dei servizi delle agenzie di viaggio, dei tour o...",0,0,0,0,0,2021
LOM,BG,N 80,Servizi di vigilanza e investigazione                       ,0,0,0,0,0,2021
LOM,BG,N 81,Attività di servizi per edifici e paesaggio                 ,0,0,1,0,1,2021
LOM,BG,N 82,Attività di supporto per le funzioni d'ufficio e altri se...,0,0,1,2,3,2021
LOM,BG,O   ,Amministrazione pubblica e difesa; assicurazione sociale ...,0,0,0,0,0,2021
LOM,BG,O 84,Amministrazione pubblica e difesa; assicurazione sociale ...,0,0,0,0,0,2021
LOM,BG,P   ,Istruzione                                                  ,0,0,0,0,0,2021
LOM,BG,P 85,Istruzione                                                  ,0,0,0,0,0,2021
LOM,BG,Q   ,Sanita' e assistenza sociale                                ,0,0,0,2,2,2021
LOM,BG,Q 86,Assistenza sanitaria                                        ,0,0,0,0,0,2021
LOM,BG,Q 87,Servizi di assistenza sociale residenziale                  ,0,0,0,0,0,2021
LOM,BG,Q 88,Assistenza sociale non residenziale                         ,0,0,0,2,2,2021
LOM,BG,R   ,"Attività artistiche, sportive, di intrattenimento e diver...",3,0,0,0,3,2021
LOM,BG,R 90,"Attività creative, artistiche e di intrattenimento          ",3,0,0,0,3,2021
LOM,BG,R 91,"Attività di biblioteche, archivi, musei ed altre attività...",0,0,0,0,0,2021
LOM,BG,R 92,"Attività riguardanti le lotterie, le scommesse, le case d...",0,0,0,0,0,2021
LOM,BG,R 93,"Attività sportive, di intrattenimento e di divertimento     ",0,0,0,0,0,2021
LOM,BG,S   ,Altre attività di servizi                                   ,0,0,0,0,0,2021
LOM,BG,S 94,Attività di organizzazioni associative                      ,0,0,0,0,0,2021
LOM,BG,S 95,Riparazione di computer e di beni per uso personale e per...,0,0,0,0,0,2021
LOM,BG,S 96,Altre attività di servizi per la persona                    ,0,0,0,0,0,2021
LOM,BG,T   ,Attività di famiglie e convivenze come datori di lavoro p...,0,0,0,0,0,2021
LOM,BG,T 97,Attività di famiglie e convivenze come datori di lavoro p...,0,0,0,0,0,2021
LOM,BG,T 98,Produzione di beni e servizi indifferenziati per uso prop...,0,0,0,0,0,2021
LOM,BG,U   ,Organizzazioni ed organismi extraterritoriali               ,0,0,0,0,0,2021
LOM,BG,U 99,Organizzazioni ed organismi extraterritoriali               ,0,0,0,0,0,2021
LOM,BG,XX  ,Imprese non classificate                                    ,9,2,0,5,16,2021
LOM,BG,TOT ,TOTALE                                                      ,87,4,94,20,205,2021
LOM,BS,A   ,"Agricoltura, silvicoltura pesca                             ",0,0,23,0,23,2021
LOM,BS,A 01,"Coltivazioni agricole e produzione di prodotti animali, c...",0,0,23,0,23,2021
LOM,BS,A 02,Silvicoltura ed utilizzo di aree forestali                  ,0,0,0,0,0,2021
LOM,BS,A 03,Pesca e acquacoltura                                        ,0,0,0,0,0,2021
LOM,BS,B   ,Estrazione di minerali da cave e miniere                    ,0,0,0,0,0,2021
LOM,BS,B 05,Estrazione di carbone (esclusa torba)                       ,0,0,0,0,0,2021
LOM,BS,B 06,Estraz.di petrolio greggio e di gas naturale                ,0,0,0,0,0,2021
LOM,BS,B 07,Estrazione di minerali metalliferi                          ,0,0,0,0,0,2021
LOM,BS,B 08,Altre attività di estrazione di minerali da cave e miniere  ,0,0,0,0,0,2021
LOM,BS,B 09,Attività dei servizi di supporto all'estrazione             ,0,0,0,0,0,2021
LOM,BS,C   ,Attività manifatturiere                                     ,8,0,47,0,55,2021
LOM,BS,C 10,Industrie alimentari                                        ,1,0,3,0,4,2021
LOM,BS,C 11,Industria delle bevande                                     ,0,0,0,0,0,2021
LOM,BS,C 12,Industria del tabacco                                       ,0,0,0,0,0,2021
LOM,BS,C 13,Industrie tessili                                           ,0,0,3,0,3,2021
LOM,BS,C 14,Confezione di articoli di abbigliamento; confezione di ar...,0,0,4,0,4,2021
LOM,BS,C 15,Fabbricazione di articoli in pelle e simili                 ,1,0,1,0,2,2021
LOM,BS,C 16,Industria del legno e dei prodotti in legno e sughero (es...,1,0,1,0,2,2021
LOM,BS,C 17,Fabbricazione di carta e di prodotti di carta               ,0,0,0,0,0,2021
LOM,BS,C 18,Stampa e riproduzione di supporti registrati                ,0,0,0,0,0,2021
LOM,BS,C 19,Fabbricazione di coke e prodotti derivanti dalla raffinaz...,0,0,0,0,0,2021
LOM,BS,C 20,Fabbricazione di prodotti chimici                           ,0,0,0,0,0,2021
LOM,BS,C 21,Fabbricazione di prodotti farmaceutici di base e di prepa...,0,0,0,0,0,2021
LOM,BS,C 22,Fabbricazione di articoli in gomma e materie plastiche      ,1,0,2,0,3,2021
LOM,BS,C 23,Fabbricazione di altri prodotti della lavorazione di miner..,1,0,2,0,3,2021
LOM,BS,C 24,Metallurgia                                                 ,1,0,1,0,2,2021
LOM,BS,C 25,Fabbricazione di prodotti in metallo (esclusi macchinari ...,1,0,18,0,19,2021
LOM,BS,C 26,Fabbricazione di computer e prodotti di elettronica e ott...,0,0,0,0,0,2021
LOM,BS,C 27,Fabbricazione di apparecchiature elettriche ed apparecchi...,0,0,1,0,1,2021
LOM,BS,C 28,Fabbricazione di macchinari ed apparecchiature nca          ,0,0,7,0,7,2021
LOM,BS,C 29,"Fabbricazione di autoveicoli, rimorchi e semirimorchi       ",1,0,0,0,1,2021
LOM,BS,C 30,Fabbricazione di altri mezzi di trasporto                   ,0,0,0,0,0,2021
LOM,BS,C 31,Fabbricazione di mobili                                     ,0,0,0,0,0,2021
LOM,BS,C 32,Altre industrie manifatturiere                              ,0,0,3,0,3,2021
LOM,BS,C 33,"Riparazione, manutenzione ed installazione di macchine ed...",0,0,1,0,1,2021
LOM,BS,D   ,"Fornitura di energia elettrica, gas, vapore e aria condiz...",0,0,0,0,0,2021
LOM,BS,D 35,"Fornitura di energia elettrica, gas, vapore e aria condiz...",0,0,0,0,0,2021
LOM,BS,E   ,"Fornitura di acqua; reti fognarie, attività di gestione d...",0,0,1,0,1,2021
LOM,BS,E 36,"Raccolta, trattamento e fornitura di acqua                  ",0,0,0,0,0,2021
LOM,BS,E 37,Gestione delle reti fognarie                                ,0,0,0,0,0,2021
LOM,BS,E 38,"Attività di raccolta, trattamento e smaltimento dei rifiu...",0,0,1,0,1,2021
LOM,BS,E 39,Attività di risanamento e altri servizi di gestione dei r...,0,0,0,0,0,2021
LOM,BS,F   ,Costruzioni                                                 ,4,0,90,3,97,2021
LOM,BS,F 41,Costruzione di edifici                                      ,2,0,29,3,34,2021
LOM,BS,F 42,Ingegneria civile                                           ,0,0,1,0,1,2021
LOM,BS,F 43,Lavori di costruzione specializzati                         ,2,0,60,0,62,2021
LOM,BS,G   ,Commercio all'ingrosso e al dettaglio; riparazione di aut...,6,0,56,0,62,2021
LOM,BS,G 45,Commercio all'ingrosso e al dettaglio e riparazione di au...,0,0,7,0,7,2021
LOM,BS,G 46,Commercio all'ingrosso (escluso quello di autoveicoli e d...,3,0,15,0,18,2021
LOM,BS,G 47,Commercio al dettaglio (escluso quello di autoveicoli e d...,3,0,34,0,37,2021
LOM,BS,H   ,Trasporto e magazzinaggio                                   ,0,0,5,0,5,2021
LOM,BS,H 49,Trasporto terrestre e mediante condotte                     ,0,0,5,0,5,2021
LOM,BS,H 50,Trasporto marittimo e per vie d'acqua                       ,0,0,0,0,0,2021
LOM,BS,H 51,Trasporto aereo                                             ,0,0,0,0,0,2021
LOM,BS,H 52,Magazzinaggio e attività di supporto ai trasporti           ,0,0,0,0,0,2021
LOM,BS,H 53,Servizi postali e attività di corriere                      ,0,0,0,0,0,2021
LOM,BS,I   ,Attività dei servizi alloggio e ristorazione                ,1,1,22,0,24,2021
LOM,BS,I 55,Alloggio                                                    ,1,0,0,0,1,2021
LOM,BS,I 56,Attività dei servizi di ristorazione                        ,0,1,22,0,23,2021
LOM,BS,J   ,Servizi di informazione e comunicazione                     ,0,0,3,0,3,2021
LOM,BS,J 58,Attività editoriali                                         ,0,0,0,0,0,2021
LOM,BS,J 59,"Attività di produzione cinematografica, di video e di pro...",0,0,0,0,0,2021
LOM,BS,J 60,Attività di programmazione e trasmissione                   ,0,0,0,0,0,2021
LOM,BS,J 61,Telecomunicazioni                                           ,0,0,1,0,1,2021
LOM,BS,J 62,"Produzione di software, consulenza informatica e attività...",0,0,2,0,2,2021
LOM,BS,J 63,Attività dei servizi d'informazione e altri servizi infor...,0,0,0,0,0,2021
LOM,BS,K   ,Attività finanziarie e assicurative                         ,0,0,6,0,6,2021
LOM,BS,K 64,Attività di servizi finanziari (escluse le assicurazioni ...,0,0,0,0,0,2021
LOM,BS,K 65,"Assicurazioni, riassicurazioni e fondi pensione (escluse ...",0,0,0,0,0,2021
LOM,BS,K 66,Attività ausiliarie dei servizi finanziari e delle attivi...,0,0,6,0,6,2021
LOM,BS,L   ,Attivita' immobiliari                                       ,2,0,1,0,3,2021
LOM,BS,L 68,Attivita' immobiliari                                       ,2,0,1,0,3,2021
LOM,BS,M   ,"Attività professionali, scientifiche e tecniche             ",0,0,10,0,10,2021
LOM,BS,M 69,Attività legali e contabilità                               ,0,0,0,0,0,2021
LOM,BS,M 70,Attività di direzione aziendale e di consulenza gestional...,0,0,1,0,1,2021
LOM,BS,M 71,Attività degli studi di architettura e d'ingegneria; coll...,0,0,2,0,2,2021
LOM,BS,M 72,Ricerca scientifica e sviluppo                              ,0,0,0,0,0,2021
LOM,BS,M 73,Pubblicità e ricerche di mercato                            ,0,0,4,0,4,2021
LOM,BS,M 74,"Altre attività professionali, scientifiche e tecniche       ",0,0,3,0,3,2021
LOM,BS,M 75,Servizi veterinari                                          ,0,0,0,0,0,2021
LOM,BS,N   ,"Noleggio, agenzie di viaggio, servizi di supporto alle im...",1,0,11,0,12,2021
LOM,BS,N 77,Attività di noleggio e leasing operativo                    ,0,0,0,0,0,2021
LOM,BS,N 78,"Attività di ricerca, selezione, fornitura di personale      ",0,0,0,0,0,2021
LOM,BS,N 79,"Attività dei servizi delle agenzie di viaggio, dei tour o...",0,0,0,0,0,2021
LOM,BS,N 80,Servizi di vigilanza e investigazione                       ,0,0,0,0,0,2021
LOM,BS,N 81,Attività di servizi per edifici e paesaggio                 ,1,0,1,0,2,2021
LOM,BS,N 82,Attività di supporto per le funzioni d'ufficio e altri se...,0,0,10,0,10,2021
LOM,BS,O   ,Amministrazione pubblica e difesa; assicurazione sociale ...,0,0,0,0,0,2021
LOM,BS,O 84,Amministrazione pubblica e difesa; assicurazione sociale ...,0,0,0,0,0,2021
LOM,BS,P   ,Istruzione                                                  ,0,0,0,0,0,2021
LOM,BS,P 85,Istruzione                                                  ,0,0,0,0,0,2021
LOM,BS,Q   ,Sanita' e assistenza sociale                                ,1,0,0,0,1,2021
LOM,BS,Q 86,Assistenza sanitaria                                        ,1,0,0,0,1,2021
LOM,BS,Q 87,Servizi di assistenza sociale residenziale                  ,0,0,0,0,0,2021
LOM,BS,Q 88,Assistenza sociale non residenziale                         ,0,0,0,0,0,2021
LOM,BS,R   ,"Attività artistiche, sportive, di intrattenimento e diver...",0,0,6,0,6,2021
LOM,BS,R 90,"Attività creative, artistiche e di intrattenimento          ",0,0,1,0,1,2021
LOM,BS,R 91,"Attività di biblioteche, archivi, musei ed altre attività...",0,0,0,0,0,2021
LOM,BS,R 92,"Attività riguardanti le lotterie, le scommesse, le case d...",0,0,1,0,1,2021
LOM,BS,R 93,"Attività sportive, di intrattenimento e di divertimento     ",0,0,4,0,4,2021
LOM,BS,S   ,Altre attività di servizi                                   ,0,0,9,0,9,2021
LOM,BS,S 94,Attività di organizzazioni associative                      ,0,0,0,0,0,2021
LOM,BS,S 95,Riparazione di computer e di beni per uso personale e per...,0,0,6,0,6,2021
LOM,BS,S 96,Altre attività di servizi per la persona                    ,0,0,3,0,3,2021
LOM,BS,T   ,Attività di famiglie e convivenze come datori di lavoro p...,0,0,0,0,0,2021
LOM,BS,T 97,Attività di famiglie e convivenze come datori di lavoro p...,0,0,0,0,0,2021
LOM,BS,T 98,Produzione di beni e servizi indifferenziati per uso prop...,0,0,0,0,0,2021
LOM,BS,U   ,Organizzazioni ed organismi extraterritoriali               ,0,0,0,0,0,2021
LOM,BS,U 99,Organizzazioni ed organismi extraterritoriali               ,0,0,0,0,0,2021
LOM,BS,XX  ,Imprese non classificate                                    ,0,0,8,1,9,2021
LOM,BS,TOT ,TOTALE                                                      ,23,1,298,4,326,2021
LOM,PV,A   ,"Agricoltura, silvicoltura pesca                             ",0,0,0,0,0,2021
LOM,PV,A 01,"Coltivazioni agricole e produzione di prodotti animali, c...",0,0,0,0,0,2021
LOM,PV,A 02,Silvicoltura ed utilizzo di aree forestali                  ,0,0,0,0,0,2021
LOM,PV,A 03,Pesca e acquacoltura                                        ,0,0,0,0,0,2021
LOM,PV,B   ,Estrazione di minerali da cave e miniere                    ,0,0,0,0,0,2021
LOM,PV,B 05,Estrazione di carbone (esclusa torba)                       ,0,0,0,0,0,2021
LOM,PV,B 06,Estraz.di petrolio greggio e di gas naturale                ,0,0,0,0,0,2021
LOM,PV,B 07,Estrazione di minerali metalliferi                          ,0,0,0,0,0,2021
LOM,PV,B 08,Altre attività di estrazione di minerali da cave e miniere  ,0,0,0,0,0,2021
LOM,PV,B 09,Attività dei servizi di supporto all'estrazione             ,0,0,0,0,0,2021
LOM,PV,C   ,Attività manifatturiere                                     ,0,0,0,0,0,2021
LOM,PV,C 10,Industrie alimentari                                        ,0,0,0,0,0,2021
LOM,PV,C 11,Industria delle bevande                                     ,0,0,0,0,0,2021
LOM,PV,C 12,Industria del tabacco                                       ,0,0,0,0,0,2021
LOM,PV,C 13,Industrie tessili                                           ,0,0,0,0,0,2021
LOM,PV,C 14,Confezione di articoli di abbigliamento; confezione di ar...,0,0,0,0,0,2021
LOM,PV,C 15,Fabbricazione di articoli in pelle e simili                 ,0,0,0,0,0,2021
LOM,PV,C 16,Industria del legno e dei prodotti in legno e sughero (es...,0,0,0,0,0,2021
LOM,PV,C 17,Fabbricazione di carta e di prodotti di carta               ,0,0,0,0,0,2021
LOM,PV,C 18,Stampa e riproduzione di supporti registrati                ,0,0,0,0,0,2021
LOM,PV,C 19,Fabbricazione di coke e prodotti derivanti dalla raffinaz...,0,0,0,0,0,2021
LOM,PV,C 20,Fabbricazione di prodotti chimici                           ,0,0,0,0,0,2021
LOM,PV,C 21,Fabbricazione di prodotti farmaceutici di base e di prepa...,0,0,0,0,0,2021
LOM,PV,C 22,Fabbricazione di articoli in gomma e materie plastiche      ,0,0,0,0,0,2021
LOM,PV,C 23,Fabbricazione di altri prodotti della lavorazione di miner..,0,0,0,0,0,2021
LOM,PV,C 24,Metallurgia                                                 ,0,0,0,0,0,2021
LOM,PV,C 25,Fabbricazione di prodotti in metallo (esclusi macchinari ...,0,0,0,0,0,2021
LOM,PV,C 26,Fabbricazione di computer e prodotti di elettronica e ott...,0,0,0,0,0,2021
LOM,PV,C 27,Fabbricazione di apparecchiature elettriche ed apparecchi...,0,0,0,0,0,2021
LOM,PV,C 28,Fabbricazione di macchinari ed apparecchiature nca          ,0,0,0,0,0,2021
LOM,PV,C 29,"Fabbricazione di autoveicoli, rimorchi e semirimorchi       ",0,0,0,0,0,2021
LOM,PV,C 30,Fabbricazione di altri mezzi di trasporto                   ,0,0,0,0,0,2021
LOM,PV,C 31,Fabbricazione di mobili                                     ,0,0,0,0,0,2021
LOM,PV,C 32,Altre industrie manifatturiere                              ,0,0,0,0,0,2021
LOM,PV,C 33,"Riparazione, manutenzione ed installazione di macchine ed...",0,0,0,0,0,2021
LOM,PV,D   ,"Fornitura di energia elettrica, gas, vapore e aria condiz...",0,0,0,0,0,2021
LOM,PV,D 35,"Fornitura di energia elettrica, gas, vapore e aria condiz...",0,0,0,0,0,2021
LOM,PV,E   ,"Fornitura di acqua; reti fognarie, attività di gestione d...",0,0,0,0,0,2021
LOM,PV,E 36,"Raccolta, trattamento e fornitura di acqua                  ",0,0,0,0,0,2021
LOM,PV,E 37,Gestione delle reti fognarie                                ,0,0,0,0,0,2021
LOM,PV,E 38,"Attività di raccolta, trattamento e smaltimento dei rifiu...",0,0,0,0,0,2021
LOM,PV,E 39,Attività di risanamento e altri servizi di gestione dei r...,0,0,0,0,0,2021
LOM,PV,F   ,Costruzioni                                                 ,0,0,0,0,0,2021
LOM,PV,F 41,Costruzione di edifici                                      ,0,0,0,0,0,2021
LOM,PV,F 42,Ingegneria civile                                           ,0,0,0,0,0,2021
LOM,PV,F 43,Lavori di costruzione specializzati                         ,0,0,0,0,0,2021
LOM,PV,G   ,Commercio all'ingrosso e al dettaglio; riparazione di aut...,0,0,0,0,0,2021
LOM,PV,G 45,Commercio all'ingrosso e al dettaglio e riparazione di au...,0,0,0,0,0,2021
LOM,PV,G 46,Commercio all'ingrosso (escluso quello di autoveicoli e d...,0,0,0,0,0,2021
LOM,PV,G 47,Commercio al dettaglio (escluso quello di autoveicoli e d...,0,0,0,0,0,2021
LOM,PV,H   ,Trasporto e magazzinaggio                                   ,0,0,0,0,0,2021
LOM,PV,H 49,Trasporto terrestre e mediante condotte                     ,0,0,0,0,0,2021
LOM,PV,H 50,Trasporto marittimo e per vie d'acqua                       ,0,0,0,0,0,2021
LOM,PV,H 51,Trasporto aereo                                             ,0,0,0,0,0,2021
LOM,PV,H 52,Magazzinaggio e attività di supporto ai trasporti           ,0,0,0,0,0,2021
LOM,PV,H 53,Servizi postali e attività di corriere                      ,0,0,0,0,0,2021
LOM,PV,I   ,Attività dei servizi alloggio e ristorazione                ,0,0,0,0,0,2021
LOM,PV,I 55,Alloggio                                                    ,0,0,0,0,0,2021
LOM,PV,I 56,Attività dei servizi di ristorazione                        ,0,0,0,0,0,2021
LOM,PV,J   ,Servizi di informazione e comunicazione                     ,0,0,0,0,0,2021
LOM,PV,J 58,Attività editoriali                                         ,0,0,0,0,0,2021
LOM,PV,J 59,"Attività di produzione cinematografica, di video e di pro...",0,0,0,0,0,2021
LOM,PV,J 60,Attività di programmazione e trasmissione                   ,0,0,0,0,0,2021
LOM,PV,J 61,Telecomunicazioni                                           ,0,0,0,0,0,2021
LOM,PV,J 62,"Produzione di software, consulenza informatica e attività...",0,0,0,0,0,2021
LOM,PV,J 63,Attività dei servizi d'informazione e altri servizi infor...,0,0,0,0,0,2021
LOM,PV,K   ,Attività finanziarie e assicurative                         ,0,0,0,0,0,2021
LOM,PV,K 64,Attività di servizi finanziari (escluse le assicurazioni ...,0,0,0,0,0,2021
LOM,PV,K 65,"Assicurazioni, riassicurazioni e fondi pensione (escluse ...",0,0,0,0,0,2021
LOM,PV,K 66,Attività ausiliarie dei servizi finanziari e delle attivi...,0,0,0,0,0,2021
LOM,PV,L   ,Attivita' immobiliari                                       ,0,0,0,0,0,2021
LOM,PV,L 68,Attivita' immobiliari                                       ,0,0,0,0,0,2021
LOM,PV,M   ,"Attività professionali, scientifiche e tecniche             ",0,0,0,0,0,2021
LOM,PV,M 69,Attività legali e contabilità                               ,0,0,0,0,0,2021
LOM,PV,M 70,Attività di direzione aziendale e di consulenza gestional...,0,0,0,0,0,2021
LOM,PV,M 71,Attività degli studi di architettura e d'ingegneria; coll...,0,0,0,0,0,2021
LOM,PV,M 72,Ricerca scientifica e sviluppo                              ,0,0,0,0,0,2021
LOM,PV,M 73,Pubblicità e ricerche di mercato                            ,0,0,0,0,0,2021
LOM,PV,M 74,"Altre attività professionali, scientifiche e tecniche       ",0,0,0,0,0,2021
LOM,PV,M 75,Servizi veterinari                                          ,0,0,0,0,0,2021
LOM,PV,N   ,"Noleggio, agenzie di viaggio, servizi di supporto alle im...",0,0,0,0,0,2021
LOM,PV,N 77,Attività di noleggio e leasing operativo                    ,0,0,0,0,0,2021
LOM,PV,N 78,"Attività di ricerca, selezione, fornitura di personale      ",0,0,0,0,0,2021
LOM,PV,N 79,"Attività dei servizi delle agenzie di viaggio, dei tour o...",0,0,0,0,0,2021
LOM,PV,N 80,Servizi di vigilanza e investigazione                       ,0,0,0,0,0,2021
LOM,PV,N 81,Attività di servizi per edifici e paesaggio                 ,0,0,0,0,0,2021
LOM,PV,N 82,Attività di supporto per le funzioni d'ufficio e altri se...,0,0,0,0,0,2021
LOM,PV,O   ,Amministrazione pubblica e difesa; assicurazione sociale ...,0,0,0,0,0,2021
LOM,PV,O 84,Amministrazione pubblica e difesa; assicurazione sociale ...,0,0,0,0,0,2021
LOM,PV,P   ,Istruzione                                                  ,0,0,0,0,0,2021
LOM,PV,P 85,Istruzione                                                  ,0,0,0,0,0,2021
LOM,PV,Q   ,Sanita' e assistenza sociale                                ,0,0,0,0,0,2021
LOM,PV,Q 86,Assistenza sanitaria                                        ,0,0,0,0,0,2021
LOM,PV,Q 87,Servizi di assistenza sociale residenziale                  ,0,0,0,0,0,2021
LOM,PV,Q 88,Assistenza sociale non residenziale                         ,0,0,0,0,0,2021
LOM,PV,R   ,"Attività artistiche, sportive, di intrattenimento e diver...",0,0,0,0,0,2021
LOM,PV,R 90,"Attività creative, artistiche e di intrattenimento          ",0,0,0,0,0,2021
LOM,PV,R 91,"Attività di biblioteche, archivi, musei ed altre attività...",0,0,0,0,0,2021
LOM,PV,R 92,"Attività riguardanti le lotterie, le scommesse, le case d...",0,0,0,0,0,2021
LOM,PV,R 93,"Attività sportive, di intrattenimento e di divertimento     ",0,0,0,0,0,2021
LOM,PV,S   ,Altre attività di servizi                                   ,0,0,0,0,0,2021
LOM,PV,S 94,Attività di organizzazioni associative                      ,0,0,0,0,0,2021
LOM,PV,S 95,Riparazione di computer e di beni per uso personale e per...,0,0,0,0,0,2021
LOM,PV,S 96,Altre attività di servizi per la persona                    ,0,0,0,0,0,2021
LOM,PV,T   ,Attività di famiglie e convivenze come datori di lavoro p...,0,0,0,0,0,2021
LOM,PV,T 97,Attività di famiglie e convivenze come datori di lavoro p...,0,0,0,0,0,2021
LOM,PV,T 98,Produzione di beni e servizi indifferenziati per uso prop...,0,0,0,0,0,2021
LOM,PV,U   ,Organizzazioni ed organismi extraterritoriali               ,0,0,0,0,0,2021
LOM,PV,U 99,Organizzazioni ed organismi extraterritoriali               ,0,0,0,0,0,2021
LOM,PV,XX  ,Imprese non classificate                                    ,0,0,0,0,0,2021
LOM,PV,TOT ,TOTALE                                                      ,0,0,0,0,0,2021
LOM,CR,A   ,"Agricoltura, silvicoltura pesca                             ",0,0,0,0,0,2021
LOM,CR,A 01,"Coltivazioni agricole e produzione di prodotti animali, c...",0,0,0,0,0,2021
LOM,CR,A 02,Silvicoltura ed utilizzo di aree forestali                  ,0,0,0,0,0,2021
LOM,CR,A 03,Pesca e acquacoltura                                        ,0,0,0,0,0,2021
LOM,CR,B   ,Estrazione di minerali da cave e miniere                    ,0,0,0,0,0,2021
LOM,CR,B 05,Estrazione di carbone (esclusa torba)                       ,0,0,0,0,0,2021
LOM,CR,B 06,Estraz.di petrolio greggio e di gas naturale                ,0,0,0,0,0,2021
LOM,CR,B 07,Estrazione di minerali metalliferi                          ,0,0,0,0,0,2021
LOM,CR,B 08,Altre attività di estrazione di minerali da cave e miniere  ,0,0,0,0,0,2021
LOM,CR,B 09,Attività dei servizi di supporto all'estrazione             ,0,0,0,0,0,2021
LOM,CR,C   ,Attività manifatturiere                                     ,0,0,0,0,0,2021
LOM,CR,C 10,Industrie alimentari                                        ,0,0,0,0,0,2021
LOM,CR,C 11,Industria delle bevande                                     ,0,0,0,0,0,2021
LOM,CR,C 12,Industria del tabacco                                       ,0,0,0,0,0,2021
LOM,CR,C 13,Industrie tessili                                           ,0,0,0,0,0,2021
LOM,CR,C 14,Confezione di articoli di abbigliamento; confezione di ar...,0,0,0,0,0,2021
LOM,CR,C 15,Fabbricazione di articoli in pelle e simili                 ,0,0,0,0,0,2021
LOM,CR,C 16,Industria del legno e dei prodotti in legno e sughero (es...,0,0,0,0,0,2021
LOM,CR,C 17,Fabbricazione di carta e di prodotti di carta               ,0,0,0,0,0,2021
LOM,CR,C 18,Stampa e riproduzione di supporti registrati                ,0,0,0,0,0,2021
LOM,CR,C 19,Fabbricazione di coke e prodotti derivanti dalla raffinaz...,0,0,0,0,0,2021
LOM,CR,C 20,Fabbricazione di prodotti chimici                           ,0,0,0,0,0,2021
LOM,CR,C 21,Fabbricazione di prodotti farmaceutici di base e di prepa...,0,0,0,0,0,2021
LOM,CR,C 22,Fabbricazione di articoli in gomma e materie plastiche      ,0,0,0,0,0,2021
LOM,CR,C 23,Fabbricazione di altri prodotti della lavorazione di miner..,0,0,0,0,0,2021
LOM,CR,C 24,Metallurgia                                                 ,0,0,0,0,0,2021
LOM,CR,C 25,Fabbricazione di prodotti in metallo (esclusi macchinari ...,0,0,0,0,0,2021
LOM,CR,C 26,Fabbricazione di computer e prodotti di elettronica e ott...,0,0,0,0,0,2021
LOM,CR,C 27,Fabbricazione di apparecchiature elettriche ed apparecchi...,0,0,0,0,0,2021
LOM,CR,C 28,Fabbricazione di macchinari ed apparecchiature nca          ,0,0,0,0,0,2021
LOM,CR,C 29,"Fabbricazione di autoveicoli, rimorchi e semirimorchi       ",0,0,0,0,0,2021
LOM,CR,C 30,Fabbricazione di altri mezzi di trasporto                   ,0,0,0,0,0,2021
LOM,CR,C 31,Fabbricazione di mobili                                     ,0,0,0,0,0,2021
LOM,CR,C 32,Altre industrie manifatturiere                              ,0,0,0,0,0,2021
LOM,CR,C 33,"Riparazione, manutenzione ed installazione di macchine ed...",0,0,0,0,0,2021
LOM,CR,D   ,"Fornitura di energia elettrica, gas, vapore e aria condiz...",0,0,0,0,0,2021
LOM,CR,D 35,"Fornitura di energia elettrica, gas, vapore e aria condiz...",0,0,0,0,0,2021
LOM,CR,E   ,"Fornitura di acqua; reti fognarie, attività di gestione d...",0,0,0,0,0,2021
LOM,CR,E 36,"Raccolta, trattamento e fornitura di acqua                  ",0,0,0,0,0,2021
LOM,CR,E 37,Gestione delle reti fognarie                                ,0,0,0,0,0,2021
LOM,CR,E 38,"Attività di raccolta, trattamento e smaltimento dei rifiu...",0,0,0,0,0,2021
LOM,CR,E 39,Attività di risanamento e altri servizi di gestione dei r...,0,0,0,0,0,2021
LOM,CR,F   ,Costruzioni                                                 ,0,0,0,2,2,2021
LOM,CR,F 41,Costruzione di edifici                                      ,0,0,0,1,1,2021
LOM,CR,F 42,Ingegneria civile                                           ,0,0,0,0,0,2021
LOM,CR,F 43,Lavori di costruzione specializzati                         ,0,0,0,1,1,2021
LOM,CR,G   ,Commercio all'ingrosso e al dettaglio; riparazione di aut...,0,0,1,0,1,2021
LOM,CR,G 45,Commercio all'ingrosso e al dettaglio e riparazione di au...,0,0,1,0,1,2021
LOM,CR,G 46,Commercio all'ingrosso (escluso quello di autoveicoli e d...,0,0,0,0,0,2021
LOM,CR,G 47,Commercio al dettaglio (escluso quello di autoveicoli e d...,0,0,0,0,0,2021
LOM,CR,H   ,Trasporto e magazzinaggio                                   ,0,0,0,1,1,2021
LOM,CR,H 49,Trasporto terrestre e mediante condotte                     ,0,0,0,0,0,2021
LOM,CR,H 50,Trasporto marittimo e per vie d'acqua                       ,0,0,0,0,0,2021
LOM,CR,H 51,Trasporto aereo                                             ,0,0,0,0,0,2021
LOM,CR,H 52,Magazzinaggio e attività di supporto ai trasporti           ,0,0,0,1,1,2021
LOM,CR,H 53,Servizi postali e attività di corriere                      ,0,0,0,0,0,2021
LOM,CR,I   ,Attività dei servizi alloggio e ristorazione                ,0,0,0,0,0,2021
LOM,CR,I 55,Alloggio                                                    ,0,0,0,0,0,2021
LOM,CR,I 56,Attività dei servizi di ristorazione                        ,0,0,0,0,0,2021
LOM,CR,J   ,Servizi di informazione e comunicazione                     ,0,0,0,0,0,2021
LOM,CR,J 58,Attività editoriali                                         ,0,0,0,0,0,2021
LOM,CR,J 59,"Attività di produzione cinematografica, di video e di pro...",0,0,0,0,0,2021
LOM,CR,J 60,Attività di programmazione e trasmissione                   ,0,0,0,0,0,2021
LOM,CR,J 61,Telecomunicazioni                                           ,0,0,0,0,0,2021
LOM,CR,J 62,"Produzione di software, consulenza informatica e attività...",0,0,0,0,0,2021
LOM,CR,J 63,Attività dei servizi d'informazione e altri servizi infor...,0,0,0,0,0,2021
LOM,CR,K   ,Attività finanziarie e assicurative                         ,0,0,0,0,0,2021
LOM,CR,K 64,Attività di servizi finanziari (escluse le assicurazioni ...,0,0,0,0,0,2021
LOM,CR,K 65,"Assicurazioni, riassicurazioni e fondi pensione (escluse ...",0,0,0,0,0,2021
LOM,CR,K 66,Attività ausiliarie dei servizi finanziari e delle attivi...,0,0,0,0,0,2021
LOM,CR,L   ,Attivita' immobiliari                                       ,0,0,0,0,0,2021
LOM,CR,L 68,Attivita' immobiliari                                       ,0,0,0,0,0,2021
LOM,CR,M   ,"Attività professionali, scientifiche e tecniche             ",0,0,0,0,0,2021
LOM,CR,M 69,Attività legali e contabilità                               ,0,0,0,0,0,2021
LOM,CR,M 70,Attività di direzione aziendale e di consulenza gestional...,0,0,0,0,0,2021
LOM,CR,M 71,Attività degli studi di architettura e d'ingegneria; coll...,0,0,0,0,0,2021
LOM,CR,M 72,Ricerca scientifica e sviluppo                              ,0,0,0,0,0,2021
LOM,CR,M 73,Pubblicità e ricerche di mercato                            ,0,0,0,0,0,2021
LOM,CR,M 74,"Altre attività professionali, scientifiche e tecniche       ",0,0,0,0,0,2021
LOM,CR,M 75,Servizi veterinari                                          ,0,0,0,0,0,2021
LOM,CR,N   ,"Noleggio, agenzie di viaggio, servizi di supporto alle im...",0,0,0,2,2,2021
LOM,CR,N 77,Attività di noleggio e leasing operativo                    ,0,0,0,0,0,2021
LOM,CR,N 78,"Attività di ricerca, selezione, fornitura di personale      ",0,0,0,0,0,2021
LOM,CR,N 79,"Attività dei servizi delle agenzie di viaggio, dei tour o...",0,0,0,0,0,2021
LOM,CR,N 80,Servizi di vigilanza e investigazione                       ,0,0,0,0,0,2021
LOM,CR,N 81,Attività di servizi per edifici e paesaggio                 ,0,0,0,2,2,2021
LOM,CR,N 82,Attività di supporto per le funzioni d'ufficio e altri se...,0,0,0,0,0,2021
LOM,CR,O   ,Amministrazione pubblica e difesa; assicurazione sociale ...,0,0,0,0,0,2021
LOM,CR,O 84,Amministrazione pubblica e difesa; assicurazione sociale ...,0,0,0,0,0,2021
LOM,CR,P   ,Istruzione                                                  ,0,0,0,0,0,2021
LOM,CR,P 85,Istruzione                                                  ,0,0,0,0,0,2021
LOM,CR,Q   ,Sanita' e assistenza sociale                                ,0,0,0,0,0,2021
LOM,CR,Q 86,Assistenza sanitaria                                        ,0,0,0,0,0,2021
LOM,CR,Q 87,Servizi di assistenza sociale residenziale                  ,0,0,0,0,0,2021
LOM,CR,Q 88,Assistenza sociale non residenziale                         ,0,0,0,0,0,2021
LOM,CR,R   ,"Attività artistiche, sportive, di intrattenimento e diver...",0,0,0,0,0,2021
LOM,CR,R 90,"Attività creative, artistiche e di intrattenimento          ",0,0,0,0,0,2021
LOM,CR,R 91,"Attività di biblioteche, archivi, musei ed altre attività...",0,0,0,0,0,2021
LOM,CR,R 92,"Attività riguardanti le lotterie, le scommesse, le case d...",0,0,0,0,0,2021
LOM,CR,R 93,"Attività sportive, di intrattenimento e di divertimento     ",0,0,0,0,0,2021
LOM,CR,S   ,Altre attività di servizi                                   ,0,0,0,0,0,2021
LOM,CR,S 94,Attività di organizzazioni associative                      ,0,0,0,0,0,2021
LOM,CR,S 95,Riparazione di computer e di beni per uso personale e per...,0,0,0,0,0,2021
LOM,CR,S 96,Altre attività di servizi per la persona                    ,0,0,0,0,0,2021
LOM,CR,T   ,Attività di famiglie e convivenze come datori di lavoro p...,0,0,0,0,0,2021
LOM,CR,T 97,Attività di famiglie e convivenze come datori di lavoro p...,0,0,0,0,0,2021
LOM,CR,T 98,Produzione di beni e servizi indifferenziati per uso prop...,0,0,0,0,0,2021
LOM,CR,U   ,Organizzazioni ed organismi extraterritoriali               ,0,0,0,0,0,2021
LOM,CR,U 99,Organizzazioni ed organismi extraterritoriali               ,0,0,0,0,0,2021
LOM,CR,XX  ,Imprese non classificate                                    ,0,0,0,1,1,2021
LOM,CR,TOT ,TOTALE                                                      ,0,0,1,6,7,2021
LOM,MN,A   ,"Agricoltura, silvicoltura pesca                             ",1,1,17,2,21,2021
LOM,MN,A 01,"Coltivazioni agricole e produzione di prodotti animali, c...",1,1,17,2,21,2021
LOM,MN,A 02,Silvicoltura ed utilizzo di aree forestali                  ,0,0,0,0,0,2021
LOM,MN,A 03,Pesca e acquacoltura                                        ,0,0,0,0,0,2021
LOM,MN,B   ,Estrazione di minerali da cave e miniere                    ,0,0,0,0,0,2021
LOM,MN,B 05,Estrazione di carbone (esclusa torba)                       ,0,0,0,0,0,2021
LOM,MN,B 06,Estraz.di petrolio greggio e di gas naturale                ,0,0,0,0,0,2021
LOM,MN,B 07,Estrazione di minerali metalliferi                          ,0,0,0,0,0,2021
LOM,MN,B 08,Altre attività di estrazione di minerali da cave e miniere  ,0,0,0,0,0,2021
LOM,MN,B 09,Attività dei servizi di supporto all'estrazione             ,0,0,0,0,0,2021
LOM,MN,C   ,Attività manifatturiere                                     ,4,5,90,0,99,2021
LOM,MN,C 10,Industrie alimentari                                        ,0,0,2,0,2,2021
LOM,MN,C 11,Industria delle bevande                                     ,0,0,0,0,0,2021
LOM,MN,C 12,Industria del tabacco                                       ,0,0,0,0,0,2021
LOM,MN,C 13,Industrie tessili                                           ,0,0,7,0,7,2021
LOM,MN,C 14,Confezione di articoli di abbigliamento; confezione di ar...,0,2,45,0,47,2021
LOM,MN,C 15,Fabbricazione di articoli in pelle e simili                 ,0,0,3,0,3,2021
LOM,MN,C 16,Industria del legno e dei prodotti in legno e sughero (es...,0,0,3,0,3,2021
LOM,MN,C 17,Fabbricazione di carta e di prodotti di carta               ,0,0,0,0,0,2021
LOM,MN,C 18,Stampa e riproduzione di supporti registrati                ,1,0,1,0,2,2021
LOM,MN,C 19,Fabbricazione di coke e prodotti derivanti dalla raffinaz...,0,0,0,0,0,2021
LOM,MN,C 20,Fabbricazione di prodotti chimici                           ,0,0,0,0,0,2021
LOM,MN,C 21,Fabbricazione di prodotti farmaceutici di base e di prepa...,0,0,0,0,0,2021
LOM,MN,C 22,Fabbricazione di articoli in gomma e materie plastiche      ,0,0,0,0,0,2021
LOM,MN,C 23,Fabbricazione di altri prodotti della lavorazione di miner..,0,0,0,0,0,2021
LOM,MN,C 24,Metallurgia                                                 ,0,0,1,0,1,2021
LOM,MN,C 25,Fabbricazione di prodotti in metallo (esclusi macchinari ...,0,1,16,0,17,2021
LOM,MN,C 26,Fabbricazione di computer e prodotti di elettronica e ott...,0,2,0,0,2,2021
LOM,MN,C 27,Fabbricazione di apparecchiature elettriche ed apparecchi...,0,0,1,0,1,2021
LOM,MN,C 28,Fabbricazione di macchinari ed apparecchiature nca          ,3,0,5,0,8,2021
LOM,MN,C 29,"Fabbricazione di autoveicoli, rimorchi e semirimorchi       ",0,0,0,0,0,2021
LOM,MN,C 30,Fabbricazione di altri mezzi di trasporto                   ,0,0,0,0,0,2021
LOM,MN,C 31,Fabbricazione di mobili                                     ,0,0,0,0,0,2021
LOM,MN,C 32,Altre industrie manifatturiere                              ,0,0,1,0,1,2021
LOM,MN,C 33,"Riparazione, manutenzione ed installazione di macchine ed...",0,0,5,0,5,2021
LOM,MN,D   ,"Fornitura di energia elettrica, gas, vapore e aria condiz...",0,0,0,0,0,2021
LOM,MN,D 35,"Fornitura di energia elettrica, gas, vapore e aria condiz...",0,0,0,0,0,2021
LOM,MN,E   ,"Fornitura di acqua; reti fognarie, attività di gestione d...",1,0,0,0,1,2021
LOM,MN,E 36,"Raccolta, trattamento e fornitura di acqua                  ",0,0,0,0,0,2021
LOM,MN,E 37,Gestione delle reti fognarie                                ,0,0,0,0,0,2021
LOM,MN,E 38,"Attività di raccolta, trattamento e smaltimento dei rifiu...",1,0,0,0,1,2021
LOM,MN,E 39,Attività di risanamento e altri servizi di gestione dei r...,0,0,0,0,0,2021
LOM,MN,F   ,Costruzioni                                                 ,13,1,449,2,465,2021
LOM,MN,F 41,Costruzione di edifici                                      ,10,0,87,1,98,2021
LOM,MN,F 42,Ingegneria civile                                           ,0,0,0,0,0,2021
LOM,MN,F 43,Lavori di costruzione specializzati                         ,3,1,362,1,367,2021
LOM,MN,G   ,Commercio all'ingrosso e al dettaglio; riparazione di aut...,8,7,101,0,116,2021
LOM,MN,G 45,Commercio all'ingrosso e al dettaglio e riparazione di au...,1,0,8,0,9,2021
LOM,MN,G 46,Commercio all'ingrosso (escluso quello di autoveicoli e d...,4,5,20,0,29,2021
LOM,MN,G 47,Commercio al dettaglio (escluso quello di autoveicoli e d...,3,2,73,0,78,2021
LOM,MN,H   ,Trasporto e magazzinaggio                                   ,3,0,14,0,17,2021
LOM,MN,H 49,Trasporto terrestre e mediante condotte                     ,1,0,12,0,13,2021
LOM,MN,H 50,Trasporto marittimo e per vie d'acqua                       ,0,0,0,0,0,2021
LOM,MN,H 51,Trasporto aereo                                             ,0,0,0,0,0,2021
LOM,MN,H 52,Magazzinaggio e attività di supporto ai trasporti           ,1,0,2,0,3,2021
LOM,MN,H 53,Servizi postali e attività di corriere                      ,1,0,0,0,1,2021
LOM,MN,I   ,Attività dei servizi alloggio e ristorazione                ,4,4,37,0,45,2021
LOM,MN,I 55,Alloggio                                                    ,0,1,0,0,1,2021
LOM,MN,I 56,Attività dei servizi di ristorazione                        ,4,3,37,0,44,2021
LOM,MN,J   ,Servizi di informazione e comunicazione                     ,3,0,5,0,8,2021
LOM,MN,J 58,Attività editoriali                                         ,1,0,0,0,1,2021
LOM,MN,J 59,"Attività di produzione cinematografica, di video e di pro...",0,0,0,0,0,2021
LOM,MN,J 60,Attività di programmazione e trasmissione                   ,0,0,0,0,0,2021
LOM,MN,J 61,Telecomunicazioni                                           ,0,0,1,0,1,2021
LOM,MN,J 62,"Produzione di software, consulenza informatica e attività...",1,0,1,0,2,2021
LOM,MN,J 63,Attività dei servizi d'informazione e altri servizi infor...,1,0,3,0,4,2021
LOM,MN,K   ,Attività finanziarie e assicurative                         ,0,0,9,0,9,2021
LOM,MN,K 64,Attività di servizi finanziari (escluse le assicurazioni ...,0,0,0,0,0,2021
LOM,MN,K 65,"Assicurazioni, riassicurazioni e fondi pensione (escluse ...",0,0,0,0,0,2021
LOM,MN,K 66,Attività ausiliarie dei servizi finanziari e delle attivi...,0,0,9,0,9,2021
LOM,MN,L   ,Attivita' immobiliari                                       ,2,1,2,0,5,2021
LOM,MN,L 68,Attivita' immobiliari                                       ,2,1,2,0,5,2021
LOM,MN,M   ,"Attività professionali, scientifiche e tecniche             ",2,0,6,2,10,2021
LOM,MN,M 69,Attività legali e contabilità                               ,0,0,0,0,0,2021
LOM,MN,M 70,Attività di direzione aziendale e di consulenza gestional...,1,0,1,1,3,2021
LOM,MN,M 71,Attività degli studi di architettura e d'ingegneria; coll...,0,0,1,0,1,2021
LOM,MN,M 72,Ricerca scientifica e sviluppo                              ,0,0,0,1,1,2021
LOM,MN,M 73,Pubblicità e ricerche di mercato                            ,1,0,3,0,4,2021
LOM,MN,M 74,"Altre attività professionali, scientifiche e tecniche       ",0,0,1,0,1,2021
LOM,MN,M 75,Servizi veterinari                                          ,0,0,0,0,0,2021
LOM,MN,N   ,"Noleggio, agenzie di viaggio, servizi di supporto alle im...",2,0,20,0,22,2021
LOM,MN,N 77,Attività di noleggio e leasing operativo                    ,0,0,2,0,2,2021
LOM,MN,N 78,"Attività di ricerca, selezione, fornitura di personale      ",0,0,0,0,0,2021
LOM,MN,N 79,"Attività dei servizi delle agenzie di viaggio, dei tour o...",1,0,0,0,1,2021
LOM,MN,N 80,Servizi di vigilanza e investigazione                       ,0,0,0,0,0,2021
LOM,MN,N 81,Attività di servizi per edifici e paesaggio                 ,1,0,9,0,10,2021
LOM,MN,N 82,Attività di supporto per le funzioni d'ufficio e altri se...,0,0,9,0,9,2021
LOM,MN,O   ,Amministrazione pubblica e difesa; assicurazione sociale ...,0,0,0,0,0,2021
LOM,MN,O 84,Amministrazione pubblica e difesa; assicurazione sociale ...,0,0,0,0,0,2021
LOM,MN,P   ,Istruzione                                                  ,2,0,1,0,3,2021
LOM,MN,P 85,Istruzione                                                  ,2,0,1,0,3,2021
LOM,MN,Q   ,Sanita' e assistenza sociale                                ,0,0,0,0,0,2021
LOM,MN,Q 86,Assistenza sanitaria                                        ,0,0,0,0,0,2021
LOM,MN,Q 87,Servizi di assistenza sociale residenziale                  ,0,0,0,0,0,2021
LOM,MN,Q 88,Assistenza sociale non residenziale                         ,0,0,0,0,0,2021
LOM,MN,R   ,"Attività artistiche, sportive, di intrattenimento e diver...",2,0,1,0,3,2021
LOM,MN,R 90,"Attività creative, artistiche e di intrattenimento          ",0,0,0,0,0,2021
LOM,MN,R 91,"Attività di biblioteche, archivi, musei ed altre attività...",0,0,0,0,0,2021
LOM,MN,R 92,"Attività riguardanti le lotterie, le scommesse, le case d...",0,0,0,0,0,2021
LOM,MN,R 93,"Attività sportive, di intrattenimento e di divertimento     ",2,0,1,0,3,2021
LOM,MN,S   ,Altre attività di servizi                                   ,2,0,13,0,15,2021
LOM,MN,S 94,Attività di organizzazioni associative                      ,0,0,0,0,0,2021
LOM,MN,S 95,Riparazione di computer e di beni per uso personale e per...,0,0,3,0,3,2021
LOM,MN,S 96,Altre attività di servizi per la persona                    ,2,0,10,0,12,2021
LOM,MN,T   ,Attività di famiglie e convivenze come datori di lavoro p...,0,0,0,0,0,2021
LOM,MN,T 97,Attività di famiglie e convivenze come datori di lavoro p...,0,0,0,0,0,2021
LOM,MN,T 98,Produzione di beni e servizi indifferenziati per uso prop...,0,0,0,0,0,2021
LOM,MN,U   ,Organizzazioni ed organismi extraterritoriali               ,0,0,0,0,0,2021
LOM,MN,U 99,Organizzazioni ed organismi extraterritoriali               ,0,0,0,0,0,2021
LOM,MN,XX  ,Imprese non classificate                                    ,12,0,10,3,25,2021
LOM,MN,TOT ,TOTALE                                                      ,61,19,775,9,864,2021
LOM,LC,A   ,"Agricoltura, silvicoltura pesca                             ",0,0,0,0,0,2021
LOM,LC,A 01,"Coltivazioni agricole e produzione di prodotti animali, c...",0,0,0,0,0,2021
LOM,LC,A 02,Silvicoltura ed utilizzo di aree forestali                  ,0,0,0,0,0,2021
LOM,LC,A 03,Pesca e acquacoltura                                        ,0,0,0,0,0,2021
LOM,LC,B   ,Estrazione di minerali da cave e miniere                    ,0,0,0,0,0,2021
LOM,LC,B 05,Estrazione di carbone (esclusa torba)                       ,0,0,0,0,0,2021
LOM,LC,B 06,Estraz.di petrolio greggio e di gas naturale                ,0,0,0,0,0,2021
LOM,LC,B 07,Estrazione di minerali metalliferi                          ,0,0,0,0,0,2021
LOM,LC,B 08,Altre attività di estrazione di minerali da cave e miniere  ,0,0,0,0,0,2021
LOM,LC,B 09,Attività dei servizi di supporto all'estrazione             ,0,0,0,0,0,2021
LOM,LC,C   ,Attività manifatturiere                                     ,4,0,0,0,4,2021
LOM,LC,C 10,Industrie alimentari                                        ,0,0,0,0,0,2021
LOM,LC,C 11,Industria delle bevande                                     ,0,0,0,0,0,2021
LOM,LC,C 12,Industria del tabacco                                       ,0,0,0,0,0,2021
LOM,LC,C 13,Industrie tessili                                           ,1,0,0,0,1,2021
LOM,LC,C 14,Confezione di articoli di abbigliamento; confezione di ar...,0,0,0,0,0,2021
LOM,LC,C 15,Fabbricazione di articoli in pelle e simili                 ,0,0,0,0,0,2021
LOM,LC,C 16,Industria del legno e dei prodotti in legno e sughero (es...,0,0,0,0,0,2021
LOM,LC,C 17,Fabbricazione di carta e di prodotti di carta               ,1,0,0,0,1,2021
LOM,LC,C 18,Stampa e riproduzione di supporti registrati                ,0,0,0,0,0,2021
LOM,LC,C 19,Fabbricazione di coke e prodotti derivanti dalla raffinaz...,0,0,0,0,0,2021
LOM,LC,C 20,Fabbricazione di prodotti chimici                           ,0,0,0,0,0,2021
LOM,LC,C 21,Fabbricazione di prodotti farmaceutici di base e di prepa...,0,0,0,0,0,2021
LOM,LC,C 22,Fabbricazione di articoli in gomma e materie plastiche      ,0,0,0,0,0,2021
LOM,LC,C 23,Fabbricazione di altri prodotti della lavorazione di miner..,0,0,0,0,0,2021
LOM,LC,C 24,Metallurgia                                                 ,0,0,0,0,0,2021
LOM,LC,C 25,Fabbricazione di prodotti in metallo (esclusi macchinari ...,2,0,0,0,2,2021
LOM,LC,C 26,Fabbricazione di computer e prodotti di elettronica e ott...,0,0,0,0,0,2021
LOM,LC,C 27,Fabbricazione di apparecchiature elettriche ed apparecchi...,0,0,0,0,0,2021
LOM,LC,C 28,Fabbricazione di macchinari ed apparecchiature nca          ,0,0,0,0,0,2021
LOM,LC,C 29,"Fabbricazione di autoveicoli, rimorchi e semirimorchi       ",0,0,0,0,0,2021
LOM,LC,C 30,Fabbricazione di altri mezzi di trasporto                   ,0,0,0,0,0,2021
LOM,LC,C 31,Fabbricazione di mobili                                     ,0,0,0,0,0,2021
LOM,LC,C 32,Altre industrie manifatturiere                              ,0,0,0,0,0,2021
LOM,LC,C 33,"Riparazione, manutenzione ed installazione di macchine ed...",0,0,0,0,0,2021
LOM,LC,D   ,"Fornitura di energia elettrica, gas, vapore e aria condiz...",0,0,0,0,0,2021
LOM,LC,D 35,"Fornitura di energia elettrica, gas, vapore e aria condiz...",0,0,0,0,0,2021
LOM,LC,E   ,"Fornitura di acqua; reti fognarie, attività di gestione d...",0,0,0,0,0,2021
LOM,LC,E 36,"Raccolta, trattamento e fornitura di acqua                  ",0,0,0,0,0,2021
LOM,LC,E 37,Gestione delle reti fognarie                                ,0,0,0,0,0,2021
LOM,LC,E 38,"Attività di raccolta, trattamento e smaltimento dei rifiu...",0,0,0,0,0,2021
LOM,LC,E 39,Attività di risanamento e altri servizi di gestione dei r...,0,0,0,0,0,2021
LOM,LC,F   ,Costruzioni                                                 ,4,0,0,1,5,2021
LOM,LC,F 41,Costruzione di edifici                                      ,4,0,0,0,4,2021
LOM,LC,F 42,Ingegneria civile                                           ,0,0,0,0,0,2021
LOM,LC,F 43,Lavori di costruzione specializzati                         ,0,0,0,1,1,2021
LOM,LC,G   ,Commercio all'ingrosso e al dettaglio; riparazione di aut...,5,0,0,0,5,2021
LOM,LC,G 45,Commercio all'ingrosso e al dettaglio e riparazione di au...,1,0,0,0,1,2021
LOM,LC,G 46,Commercio all'ingrosso (escluso quello di autoveicoli e d...,1,0,0,0,1,2021
LOM,LC,G 47,Commercio al dettaglio (escluso quello di autoveicoli e d...,3,0,0,0,3,2021
LOM,LC,H   ,Trasporto e magazzinaggio                                   ,0,0,0,0,0,2021
LOM,LC,H 49,Trasporto terrestre e mediante condotte                     ,0,0,0,0,0,2021
LOM,LC,H 50,Trasporto marittimo e per vie d'acqua                       ,0,0,0,0,0,2021
LOM,LC,H 51,Trasporto aereo                                             ,0,0,0,0,0,2021
LOM,LC,H 52,Magazzinaggio e attività di supporto ai trasporti           ,0,0,0,0,0,2021
LOM,LC,H 53,Servizi postali e attività di corriere                      ,0,0,0,0,0,2021
LOM,LC,I   ,Attività dei servizi alloggio e ristorazione                ,1,0,0,0,1,2021
LOM,LC,I 55,Alloggio                                                    ,0,0,0,0,0,2021
LOM,LC,I 56,Attività dei servizi di ristorazione                        ,1,0,0,0,1,2021
LOM,LC,J   ,Servizi di informazione e comunicazione                     ,1,0,0,0,1,2021
LOM,LC,J 58,Attività editoriali                                         ,0,0,0,0,0,2021
LOM,LC,J 59,"Attività di produzione cinematografica, di video e di pro...",0,0,0,0,0,2021
LOM,LC,J 60,Attività di programmazione e trasmissione                   ,0,0,0,0,0,2021
LOM,LC,J 61,Telecomunicazioni                                           ,0,0,0,0,0,2021
LOM,LC,J 62,"Produzione di software, consulenza informatica e attività...",0,0,0,0,0,2021
LOM,LC,J 63,Attività dei servizi d'informazione e altri servizi infor...,1,0,0,0,1,2021
LOM,LC,K   ,Attività finanziarie e assicurative                         ,0,0,0,0,0,2021
LOM,LC,K 64,Attività di servizi finanziari (escluse le assicurazioni ...,0,0,0,0,0,2021
LOM,LC,K 65,"Assicurazioni, riassicurazioni e fondi pensione (escluse ...",0,0,0,0,0,2021
LOM,LC,K 66,Attività ausiliarie dei servizi finanziari e delle attivi...,0,0,0,0,0,2021
LOM,LC,L   ,Attivita' immobiliari                                       ,4,0,0,0,4,2021
LOM,LC,L 68,Attivita' immobiliari                                       ,4,0,0,0,4,2021
LOM,LC,M   ,"Attività professionali, scientifiche e tecniche             ",0,0,0,0,0,2021
LOM,LC,M 69,Attività legali e contabilità                               ,0,0,0,0,0,2021
LOM,LC,M 70,Attività di direzione aziendale e di consulenza gestional...,0,0,0,0,0,2021
LOM,LC,M 71,Attività degli studi di architettura e d'ingegneria; coll...,0,0,0,0,0,2021
LOM,LC,M 72,Ricerca scientifica e sviluppo                              ,0,0,0,0,0,2021
LOM,LC,M 73,Pubblicità e ricerche di mercato                            ,0,0,0,0,0,2021
LOM,LC,M 74,"Altre attività professionali, scientifiche e tecniche       ",0,0,0,0,0,2021
LOM,LC,M 75,Servizi veterinari                                          ,0,0,0,0,0,2021
LOM,LC,N   ,"Noleggio, agenzie di viaggio, servizi di supporto alle im...",1,0,0,0,1,2021
LOM,LC,N 77,Attività di noleggio e leasing operativo                    ,0,0,0,0,0,2021
LOM,LC,N 78,"Attività di ricerca, selezione, fornitura di personale      ",0,0,0,0,0,2021
LOM,LC,N 79,"Attività dei servizi delle agenzie di viaggio, dei tour o...",0,0,0,0,0,2021
LOM,LC,N 80,Servizi di vigilanza e investigazione                       ,0,0,0,0,0,2021
LOM,LC,N 81,Attività di servizi per edifici e paesaggio                 ,0,0,0,0,0,2021
LOM,LC,N 82,Attività di supporto per le funzioni d'ufficio e altri se...,1,0,0,0,1,2021
LOM,LC,O   ,Amministrazione pubblica e difesa; assicurazione sociale ...,0,0,0,0,0,2021
LOM,LC,O 84,Amministrazione pubblica e difesa; assicurazione sociale ...,0,0,0,0,0,2021
LOM,LC,P   ,Istruzione                                                  ,0,0,0,0,0,2021
LOM,LC,P 85,Istruzione                                                  ,0,0,0,0,0,2021
LOM,LC,Q   ,Sanita' e assistenza sociale                                ,0,0,0,1,1,2021
LOM,LC,Q 86,Assistenza sanitaria                                        ,0,0,0,0,0,2021
LOM,LC,Q 87,Servizi di assistenza sociale residenziale                  ,0,0,0,0,0,2021
LOM,LC,Q 88,Assistenza sociale non residenziale                         ,0,0,0,1,1,2021
LOM,LC,R   ,"Attività artistiche, sportive, di intrattenimento e diver...",0,0,0,0,0,2021
LOM,LC,R 90,"Attività creative, artistiche e di intrattenimento          ",0,0,0,0,0,2021
LOM,LC,R 91,"Attività di biblioteche, archivi, musei ed altre attività...",0,0,0,0,0,2021
LOM,LC,R 92,"Attività riguardanti le lotterie, le scommesse, le case d...",0,0,0,0,0,2021
LOM,LC,R 93,"Attività sportive, di intrattenimento e di divertimento     ",0,0,0,0,0,2021
LOM,LC,S   ,Altre attività di servizi                                   ,0,0,0,0,0,2021
LOM,LC,S 94,Attività di organizzazioni associative                      ,0,0,0,0,0,2021
LOM,LC,S 95,Riparazione di computer e di beni per uso personale e per...,0,0,0,0,0,2021
LOM,LC,S 96,Altre attività di servizi per la persona                    ,0,0,0,0,0,2021
LOM,LC,T   ,Attività di famiglie e convivenze come datori di lavoro p...,0,0,0,0,0,2021
LOM,LC,T 97,Attività di famiglie e convivenze come datori di lavoro p...,0,0,0,0,0,2021
LOM,LC,T 98,Produzione di beni e servizi indifferenziati per uso prop...,0,0,0,0,0,2021
LOM,LC,U   ,Organizzazioni ed organismi extraterritoriali               ,0,0,0,0,0,2021
LOM,LC,U 99,Organizzazioni ed organismi extraterritoriali               ,0,0,0,0,0,2021
LOM,LC,XX  ,Imprese non classificate                                    ,5,0,0,1,6,2021
LOM,LC,TOT ,TOTALE                                                      ,25,0,0,3,28,2021
LOM,LO,A   ,"Agricoltura, silvicoltura pesca                             ",0,0,13,0,13,2021
LOM,LO,A 01,"Coltivazioni agricole e produzione di prodotti animali, c...",0,0,13,0,13,2021
LOM,LO,A 02,Silvicoltura ed utilizzo di aree forestali                  ,0,0,0,0,0,2021
LOM,LO,A 03,Pesca e acquacoltura                                        ,0,0,0,0,0,2021
LOM,LO,B   ,Estrazione di minerali da cave e miniere                    ,0,0,0,0,0,2021
LOM,LO,B 05,Estrazione di carbone (esclusa torba)                       ,0,0,0,0,0,2021
LOM,LO,B 06,Estraz.di petrolio greggio e di gas naturale                ,0,0,0,0,0,2021
LOM,LO,B 07,Estrazione di minerali metalliferi                          ,0,0,0,0,0,2021
LOM,LO,B 08,Altre attività di estrazione di minerali da cave e miniere  ,0,0,0,0,0,2021
LOM,LO,B 09,Attività dei servizi di supporto all'estrazione             ,0,0,0,0,0,2021
LOM,LO,C   ,Attività manifatturiere                                     ,0,1,33,0,34,2021
LOM,LO,C 10,Industrie alimentari                                        ,0,0,2,0,2,2021
LOM,LO,C 11,Industria delle bevande                                     ,0,0,0,0,0,2021
LOM,LO,C 12,Industria del tabacco                                       ,0,0,0,0,0,2021
LOM,LO,C 13,Industrie tessili                                           ,0,0,1,0,1,2021
LOM,LO,C 14,Confezione di articoli di abbigliamento; confezione di ar...,0,0,2,0,2,2021
LOM,LO,C 15,Fabbricazione di articoli in pelle e simili                 ,0,0,0,0,0,2021
LOM,LO,C 16,Industria del legno e dei prodotti in legno e sughero (es...,0,0,3,0,3,2021
LOM,LO,C 17,Fabbricazione di carta e di prodotti di carta               ,0,0,0,0,0,2021
LOM,LO,C 18,Stampa e riproduzione di supporti registrati                ,0,0,1,0,1,2021
LOM,LO,C 19,Fabbricazione di coke e prodotti derivanti dalla raffinaz...,0,0,0,0,0,2021
LOM,LO,C 20,Fabbricazione di prodotti chimici                           ,0,0,0,0,0,2021
LOM,LO,C 21,Fabbricazione di prodotti farmaceutici di base e di prepa...,0,0,0,0,0,2021
LOM,LO,C 22,Fabbricazione di articoli in gomma e materie plastiche      ,0,0,0,0,0,2021
LOM,LO,C 23,Fabbricazione di altri prodotti della lavorazione di miner..,0,0,0,0,0,2021
LOM,LO,C 24,Metallurgia                                                 ,0,0,1,0,1,2021
LOM,LO,C 25,Fabbricazione di prodotti in metallo (esclusi macchinari ...,0,1,15,0,16,2021
LOM,LO,C 26,Fabbricazione di computer e prodotti di elettronica e ott...,0,0,2,0,2,2021
LOM,LO,C 27,Fabbricazione di apparecchiature elettriche ed apparecchi...,0,0,0,0,0,2021
LOM,LO,C 28,Fabbricazione di macchinari ed apparecchiature nca          ,0,0,1,0,1,2021
LOM,LO,C 29,"Fabbricazione di autoveicoli, rimorchi e semirimorchi       ",0,0,0,0,0,2021
LOM,LO,C 30,Fabbricazione di altri mezzi di trasporto                   ,0,0,0,0,0,2021
LOM,LO,C 31,Fabbricazione di mobili                                     ,0,0,0,0,0,2021
LOM,LO,C 32,Altre industrie manifatturiere                              ,0,0,3,0,3,2021
LOM,LO,C 33,"Riparazione, manutenzione ed installazione di macchine ed...",0,0,2,0,2,2021
LOM,LO,D   ,"Fornitura di energia elettrica, gas, vapore e aria condiz...",0,0,0,0,0,2021
LOM,LO,D 35,"Fornitura di energia elettrica, gas, vapore e aria condiz...",0,0,0,0,0,2021
LOM,LO,E   ,"Fornitura di acqua; reti fognarie, attività di gestione d...",0,0,1,0,1,2021
LOM,LO,E 36,"Raccolta, trattamento e fornitura di acqua                  ",0,0,0,0,0,2021
LOM,LO,E 37,Gestione delle reti fognarie                                ,0,0,0,0,0,2021
LOM,LO,E 38,"Attività di raccolta, trattamento e smaltimento dei rifiu...",0,0,1,0,1,2021
LOM,LO,E 39,Attività di risanamento e altri servizi di gestione dei r...,0,0,0,0,0,2021
LOM,LO,F   ,Costruzioni                                                 ,1,3,295,2,301,2021
LOM,LO,F 41,Costruzione di edifici                                      ,1,1,85,1,88,2021
LOM,LO,F 42,Ingegneria civile                                           ,0,0,1,0,1,2021
LOM,LO,F 43,Lavori di costruzione specializzati                         ,0,2,209,1,212,2021
LOM,LO,G   ,Commercio all'ingrosso e al dettaglio; riparazione di aut...,2,0,62,0,64,2021
LOM,LO,G 45,Commercio all'ingrosso e al dettaglio e riparazione di au...,1,0,7,0,8,2021
LOM,LO,G 46,Commercio all'ingrosso (escluso quello di autoveicoli e d...,0,0,15,0,15,2021
LOM,LO,G 47,Commercio al dettaglio (escluso quello di autoveicoli e d...,1,0,40,0,41,2021
LOM,LO,H   ,Trasporto e magazzinaggio                                   ,0,0,28,1,29,2021
LOM,LO,H 49,Trasporto terrestre e mediante condotte                     ,0,0,26,1,27,2021
LOM,LO,H 50,Trasporto marittimo e per vie d'acqua                       ,0,0,0,0,0,2021
LOM,LO,H 51,Trasporto aereo                                             ,0,0,0,0,0,2021
LOM,LO,H 52,Magazzinaggio e attività di supporto ai trasporti           ,0,0,1,0,1,2021
LOM,LO,H 53,Servizi postali e attività di corriere                      ,0,0,1,0,1,2021
LOM,LO,I   ,Attività dei servizi alloggio e ristorazione                ,1,0,20,0,21,2021
LOM,LO,I 55,Alloggio                                                    ,0,0,0,0,0,2021
LOM,LO,I 56,Attività dei servizi di ristorazione                        ,1,0,20,0,21,2021
LOM,LO,J   ,Servizi di informazione e comunicazione                     ,0,0,4,0,4,2021
LOM,LO,J 58,Attività editoriali                                         ,0,0,0,0,0,2021
LOM,LO,J 59,"Attività di produzione cinematografica, di video e di pro...",0,0,0,0,0,2021
LOM,LO,J 60,Attività di programmazione e trasmissione                   ,0,0,0,0,0,2021
LOM,LO,J 61,Telecomunicazioni                                           ,0,0,2,0,2,2021
LOM,LO,J 62,"Produzione di software, consulenza informatica e attività...",0,0,2,0,2,2021
LOM,LO,J 63,Attività dei servizi d'informazione e altri servizi infor...,0,0,0,0,0,2021
LOM,LO,K   ,Attività finanziarie e assicurative                         ,0,0,2,0,2,2021
LOM,LO,K 64,Attività di servizi finanziari (escluse le assicurazioni ...,0,0,0,0,0,2021
LOM,LO,K 65,"Assicurazioni, riassicurazioni e fondi pensione (escluse ...",0,0,0,0,0,2021
LOM,LO,K 66,Attività ausiliarie dei servizi finanziari e delle attivi...,0,0,2,0,2,2021
LOM,LO,L   ,Attivita' immobiliari                                       ,0,0,0,0,0,2021
LOM,LO,L 68,Attivita' immobiliari                                       ,0,0,0,0,0,2021
LOM,LO,M   ,"Attività professionali, scientifiche e tecniche             ",0,0,6,0,6,2021
LOM,LO,M 69,Attività legali e contabilità                               ,0,0,0,0,0,2021
LOM,LO,M 70,Attività di direzione aziendale e di consulenza gestional...,0,0,2,0,2,2021
LOM,LO,M 71,Attività degli studi di architettura e d'ingegneria; coll...,0,0,1,0,1,2021
LOM,LO,M 72,Ricerca scientifica e sviluppo                              ,0,0,0,0,0,2021
LOM,LO,M 73,Pubblicità e ricerche di mercato                            ,0,0,1,0,1,2021
LOM,LO,M 74,"Altre attività professionali, scientifiche e tecniche       ",0,0,2,0,2,2021
LOM,LO,M 75,Servizi veterinari                                          ,0,0,0,0,0,2021
LOM,LO,N   ,"Noleggio, agenzie di viaggio, servizi di supporto alle im...",0,0,12,1,13,2021
LOM,LO,N 77,Attività di noleggio e leasing operativo                    ,0,0,0,0,0,2021
LOM,LO,N 78,"Attività di ricerca, selezione, fornitura di personale      ",0,0,0,0,0,2021
LOM,LO,N 79,"Attività dei servizi delle agenzie di viaggio, dei tour o...",0,0,0,0,0,2021
LOM,LO,N 80,Servizi di vigilanza e investigazione                       ,0,0,0,0,0,2021
LOM,LO,N 81,Attività di servizi per edifici e paesaggio                 ,0,0,4,1,5,2021
LOM,LO,N 82,Attività di supporto per le funzioni d'ufficio e altri se...,0,0,8,0,8,2021
LOM,LO,O   ,Amministrazione pubblica e difesa; assicurazione sociale ...,0,0,0,0,0,2021
LOM,LO,O 84,Amministrazione pubblica e difesa; assicurazione sociale ...,0,0,0,0,0,2021
LOM,LO,P   ,Istruzione                                                  ,0,0,1,0,1,2021
LOM,LO,P 85,Istruzione                                                  ,0,0,1,0,1,2021
LOM,LO,Q   ,Sanita' e assistenza sociale                                ,0,0,0,0,0,2021
LOM,LO,Q 86,Assistenza sanitaria                                        ,0,0,0,0,0,2021
LOM,LO,Q 87,Servizi di assistenza sociale residenziale                  ,0,0,0,0,0,2021
LOM,LO,Q 88,Assistenza sociale non residenziale                         ,0,0,0,0,0,2021
LOM,LO,R   ,"Attività artistiche, sportive, di intrattenimento e diver...",0,0,5,0,5,2021
LOM,LO,R 90,"Attività creative, artistiche e di intrattenimento          ",0,0,1,0,1,2021
LOM,LO,R 91,"Attività di biblioteche, archivi, musei ed altre attività...",0,0,0,0,0,2021
LOM,LO,R 92,"Attività riguardanti le lotterie, le scommesse, le case d...",0,0,0,0,0,2021
LOM,LO,R 93,"Attività sportive, di intrattenimento e di divertimento     ",0,0,4,0,4,2021
LOM,LO,S   ,Altre attività di servizi                                   ,0,0,14,0,14,2021
LOM,LO,S 94,Attività di organizzazioni associative                      ,0,0,0,0,0,2021
LOM,LO,S 95,Riparazione di computer e di beni per uso personale e per...,0,0,3,0,3,2021
LOM,LO,S 96,Altre attività di servizi per la persona                    ,0,0,11,0,11,2021
LOM,LO,T   ,Attività di famiglie e convivenze come datori di lavoro p...,0,0,0,0,0,2021
LOM,LO,T 97,Attività di famiglie e convivenze come datori di lavoro p...,0,0,0,0,0,2021
LOM,LO,T 98,Produzione di beni e servizi indifferenziati per uso prop...,0,0,0,0,0,2021
LOM,LO,U   ,Organizzazioni ed organismi extraterritoriali               ,0,0,0,0,0,2021
LOM,LO,U 99,Organizzazioni ed organismi extraterritoriali               ,0,0,0,0,0,2021
LOM,LO,XX  ,Imprese non classificate                                    ,0,0,0,3,3,2021
LOM,LO,TOT ,TOTALE                                                      ,4,4,496,7,511,2021
LOM,MB,A   ,"Agricoltura, silvicoltura pesca                             ",0,0,11,0,11,2021
LOM,MB,A 01,"Coltivazioni agricole e produzione di prodotti animali, c...",0,0,11,0,11,2021
LOM,MB,A 02,Silvicoltura ed utilizzo di aree forestali                  ,0,0,0,0,0,2021
LOM,MB,A 03,Pesca e acquacoltura                                        ,0,0,0,0,0,2021
LOM,MB,B   ,Estrazione di minerali da cave e miniere                    ,0,0,0,0,0,2021
LOM,MB,B 05,Estrazione di carbone (esclusa torba)                       ,0,0,0,0,0,2021
LOM,MB,B 06,Estraz.di petrolio greggio e di gas naturale                ,0,0,0,0,0,2021
LOM,MB,B 07,Estrazione di minerali metalliferi                          ,0,0,0,0,0,2021
LOM,MB,B 08,Altre attività di estrazione di minerali da cave e miniere  ,0,0,0,0,0,2021
LOM,MB,B 09,Attività dei servizi di supporto all'estrazione             ,0,0,0,0,0,2021
LOM,MB,C   ,Attività manifatturiere                                     ,1,0,178,1,180,2021
LOM,MB,C 10,Industrie alimentari                                        ,0,0,13,0,13,2021
LOM,MB,C 11,Industria delle bevande                                     ,0,0,0,0,0,2021
LOM,MB,C 12,Industria del tabacco                                       ,0,0,0,0,0,2021
LOM,MB,C 13,Industrie tessili                                           ,0,0,6,0,6,2021
LOM,MB,C 14,Confezione di articoli di abbigliamento; confezione di ar...,1,0,14,0,15,2021
LOM,MB,C 15,Fabbricazione di articoli in pelle e simili                 ,0,0,0,0,0,2021
LOM,MB,C 16,Industria del legno e dei prodotti in legno e sughero (es...,0,0,11,0,11,2021
LOM,MB,C 17,Fabbricazione di carta e di prodotti di carta               ,0,0,1,0,1,2021
LOM,MB,C 18,Stampa e riproduzione di supporti registrati                ,0,0,4,0,4,2021
LOM,MB,C 19,Fabbricazione di coke e prodotti derivanti dalla raffinaz...,0,0,0,0,0,2021
LOM,MB,C 20,Fabbricazione di prodotti chimici                           ,0,0,0,0,0,2021
LOM,MB,C 21,Fabbricazione di prodotti farmaceutici di base e di prepa...,0,0,0,0,0,2021
LOM,MB,C 22,Fabbricazione di articoli in gomma e materie plastiche      ,0,0,3,0,3,2021
LOM,MB,C 23,Fabbricazione di altri prodotti della lavorazione di miner..,0,0,2,0,2,2021
LOM,MB,C 24,Metallurgia                                                 ,0,0,2,0,2,2021
LOM,MB,C 25,Fabbricazione di prodotti in metallo (esclusi macchinari ...,0,0,56,0,56,2021
LOM,MB,C 26,Fabbricazione di computer e prodotti di elettronica e ott...,0,0,6,0,6,2021
LOM,MB,C 27,Fabbricazione di apparecchiature elettriche ed apparecchi...,0,0,3,0,3,2021
LOM,MB,C 28,Fabbricazione di macchinari ed apparecchiature nca          ,0,0,11,0,11,2021
LOM,MB,C 29,"Fabbricazione di autoveicoli, rimorchi e semirimorchi       ",0,0,0,0,0,2021
LOM,MB,C 30,Fabbricazione di altri mezzi di trasporto                   ,0,0,2,0,2,2021
LOM,MB,C 31,Fabbricazione di mobili                                     ,0,0,25,0,25,2021
LOM,MB,C 32,Altre industrie manifatturiere                              ,0,0,8,0,8,2021
LOM,MB,C 33,"Riparazione, manutenzione ed installazione di macchine ed...",0,0,11,1,12,2021
LOM,MB,D   ,"Fornitura di energia elettrica, gas, vapore e aria condiz...",0,0,0,0,0,2021
LOM,MB,D 35,"Fornitura di energia elettrica, gas, vapore e aria condiz...",0,0,0,0,0,2021
LOM,MB,E   ,"Fornitura di acqua; reti fognarie, attività di gestione d...",0,0,0,0,0,2021
LOM,MB,E 36,"Raccolta, trattamento e fornitura di acqua                  ",0,0,0,0,0,2021
LOM,MB,E 37,Gestione delle reti fognarie                                ,0,0,0,0,0,2021
LOM,MB,E 38,"Attività di raccolta, trattamento e smaltimento dei rifiu...",0,0,0,0,0,2021
LOM,MB,E 39,Attività di risanamento e altri servizi di gestione dei r...,0,0,0,0,0,2021
LOM,MB,F   ,Costruzioni                                                 ,0,0,875,1,876,2021
LOM,MB,F 41,Costruzione di edifici                                      ,0,0,153,1,154,2021
LOM,MB,F 42,Ingegneria civile                                           ,0,0,5,0,5,2021
LOM,MB,F 43,Lavori di costruzione specializzati                         ,0,0,717,0,717,2021
LOM,MB,G   ,Commercio all'ingrosso e al dettaglio; riparazione di aut...,0,0,295,0,295,2021
LOM,MB,G 45,Commercio all'ingrosso e al dettaglio e riparazione di au...,0,0,38,0,38,2021
LOM,MB,G 46,Commercio all'ingrosso (escluso quello di autoveicoli e d...,0,0,86,0,86,2021
LOM,MB,G 47,Commercio al dettaglio (escluso quello di autoveicoli e d...,0,0,171,0,171,2021
LOM,MB,H   ,Trasporto e magazzinaggio                                   ,0,0,80,0,80,2021
LOM,MB,H 49,Trasporto terrestre e mediante condotte                     ,0,0,66,0,66,2021
LOM,MB,H 50,Trasporto marittimo e per vie d'acqua                       ,0,0,0,0,0,2021
LOM,MB,H 51,Trasporto aereo                                             ,0,0,0,0,0,2021
LOM,MB,H 52,Magazzinaggio e attività di supporto ai trasporti           ,0,0,5,0,5,2021
LOM,MB,H 53,Servizi postali e attività di corriere                      ,0,0,9,0,9,2021
LOM,MB,I   ,Attività dei servizi alloggio e ristorazione                ,0,0,98,0,98,2021
LOM,MB,I 55,Alloggio                                                    ,0,0,1,0,1,2021
LOM,MB,I 56,Attività dei servizi di ristorazione                        ,0,0,97,0,97,2021
LOM,MB,J   ,Servizi di informazione e comunicazione                     ,0,0,22,0,22,2021
LOM,MB,J 58,Attività editoriali                                         ,0,0,0,0,0,2021
LOM,MB,J 59,"Attività di produzione cinematografica, di video e di pro...",0,0,2,0,2,2021
LOM,MB,J 60,Attività di programmazione e trasmissione                   ,0,0,0,0,0,2021
LOM,MB,J 61,Telecomunicazioni                                           ,0,0,9,0,9,2021
LOM,MB,J 62,"Produzione di software, consulenza informatica e attività...",0,0,7,0,7,2021
LOM,MB,J 63,Attività dei servizi d'informazione e altri servizi infor...,0,0,4,0,4,2021
LOM,MB,K   ,Attività finanziarie e assicurative                         ,0,0,15,0,15,2021
LOM,MB,K 64,Attività di servizi finanziari (escluse le assicurazioni ...,0,0,0,0,0,2021
LOM,MB,K 65,"Assicurazioni, riassicurazioni e fondi pensione (escluse ...",0,0,0,0,0,2021
LOM,MB,K 66,Attività ausiliarie dei servizi finanziari e delle attivi...,0,0,15,0,15,2021
LOM,MB,L   ,Attivita' immobiliari                                       ,0,0,9,0,9,2021
LOM,MB,L 68,Attivita' immobiliari                                       ,0,0,9,0,9,2021
LOM,MB,M   ,"Attività professionali, scientifiche e tecniche             ",0,0,32,0,32,2021
LOM,MB,M 69,Attività legali e contabilità                               ,0,0,1,0,1,2021
LOM,MB,M 70,Attività di direzione aziendale e di consulenza gestional...,0,0,5,0,5,2021
LOM,MB,M 71,Attività degli studi di architettura e d'ingegneria; coll...,0,0,2,0,2,2021
LOM,MB,M 72,Ricerca scientifica e sviluppo                              ,0,0,0,0,0,2021
LOM,MB,M 73,Pubblicità e ricerche di mercato                            ,0,0,8,0,8,2021
LOM,MB,M 74,"Altre attività professionali, scientifiche e tecniche       ",0,0,16,0,16,2021
LOM,MB,M 75,Servizi veterinari                                          ,0,0,0,0,0,2021
LOM,MB,N   ,"Noleggio, agenzie di viaggio, servizi di supporto alle im...",0,0,64,0,64,2021
LOM,MB,N 77,Attività di noleggio e leasing operativo                    ,0,0,2,0,2,2021
LOM,MB,N 78,"Attività di ricerca, selezione, fornitura di personale      ",0,0,0,0,0,2021
LOM,MB,N 79,"Attività dei servizi delle agenzie di viaggio, dei tour o...",0,0,2,0,2,2021
LOM,MB,N 80,Servizi di vigilanza e investigazione                       ,0,0,0,0,0,2021
LOM,MB,N 81,Attività di servizi per edifici e paesaggio                 ,0,0,36,0,36,2021
LOM,MB,N 82,Attività di supporto per le funzioni d'ufficio e altri se...,0,0,24,0,24,2021
LOM,MB,O   ,Amministrazione pubblica e difesa; assicurazione sociale ...,0,0,0,0,0,2021
LOM,MB,O 84,Amministrazione pubblica e difesa; assicurazione sociale ...,0,0,0,0,0,2021
LOM,MB,P   ,Istruzione                                                  ,0,0,1,0,1,2021
LOM,MB,P 85,Istruzione                                                  ,0,0,1,0,1,2021
LOM,MB,Q   ,Sanita' e assistenza sociale                                ,0,0,0,1,1,2021
LOM,MB,Q 86,Assistenza sanitaria                                        ,0,0,0,0,0,2021
LOM,MB,Q 87,Servizi di assistenza sociale residenziale                  ,0,0,0,0,0,2021
LOM,MB,Q 88,Assistenza sociale non residenziale                         ,0,0,0,1,1,2021
LOM,MB,R   ,"Attività artistiche, sportive, di intrattenimento e diver...",0,0,8,0,8,2021
LOM,MB,R 90,"Attività creative, artistiche e di intrattenimento          ",0,0,2,0,2,2021
LOM,MB,R 91,"Attività di biblioteche, archivi, musei ed altre attività...",0,0,0,0,0,2021
LOM,MB,R 92,"Attività riguardanti le lotterie, le scommesse, le case d...",0,0,1,0,1,2021
LOM,MB,R 93,"Attività sportive, di intrattenimento e di divertimento     ",0,0,5,0,5,2021
LOM,MB,S   ,Altre attività di servizi                                   ,0,0,53,0,53,2021
LOM,MB,S 94,Attività di organizzazioni associative                      ,0,0,0,0,0,2021
LOM,MB,S 95,Riparazione di computer e di beni per uso personale e per...,0,0,12,0,12,2021
LOM,MB,S 96,Altre attività di servizi per la persona                    ,0,0,41,0,41,2021
LOM,MB,T   ,Attività di famiglie e convivenze come datori di lavoro p...,0,0,0,0,0,2021
LOM,MB,T 97,Attività di famiglie e convivenze come datori di lavoro p...,0,0,0,0,0,2021
LOM,MB,T 98,Produzione di beni e servizi indifferenziati per uso prop...,0,0,0,0,0,2021
LOM,MB,U   ,Organizzazioni ed organismi extraterritoriali               ,0,0,0,0,0,2021
LOM,MB,U 99,Organizzazioni ed organismi extraterritoriali               ,0,0,0,0,0,2021
LOM,MB,XX  ,Imprese non classificate                                    ,0,0,2,1,3,2021
LOM,MB,TOT ,TOTALE                                                      ,1,0,1743,4,1748,2021
TAA,  ,A   ,"Agricoltura, silvicoltura pesca                             ",0,1,53,0,54,2021
TAA,  ,A 01,"Coltivazioni agricole e produzione di prodotti animali, c...",0,1,51,0,52,2021
TAA,  ,A 02,Silvicoltura ed utilizzo di aree forestali                  ,0,0,2,0,2,2021
TAA,  ,A 03,Pesca e acquacoltura                                        ,0,0,0,0,0,2021
TAA,  ,B   ,Estrazione di minerali da cave e miniere                    ,0,0,0,0,0,2021
TAA,  ,B 05,Estrazione di carbone (esclusa torba)                       ,0,0,0,0,0,2021
TAA,  ,B 06,Estraz.di petrolio greggio e di gas naturale                ,0,0,0,0,0,2021
TAA,  ,B 07,Estrazione di minerali metalliferi                          ,0,0,0,0,0,2021
TAA,  ,B 08,Altre attività di estrazione di minerali da cave e miniere  ,0,0,0,0,0,2021
TAA,  ,B 09,Attività dei servizi di supporto all'estrazione             ,0,0,0,0,0,2021
TAA,  ,C   ,Attività manifatturiere                                     ,16,2,6,0,24,2021
TAA,  ,C 10,Industrie alimentari                                        ,1,0,0,0,1,2021
TAA,  ,C 11,Industria delle bevande                                     ,0,0,0,0,0,2021
TAA,  ,C 12,Industria del tabacco                                       ,0,0,0,0,0,2021
TAA,  ,C 13,Industrie tessili                                           ,1,0,0,0,1,2021
TAA,  ,C 14,Confezione di articoli di abbigliamento; confezione di ar...,0,0,1,0,1,2021
TAA,  ,C 15,Fabbricazione di articoli in pelle e simili                 ,0,0,0,0,0,2021
TAA,  ,C 16,Industria del legno e dei prodotti in legno e sughero (es...,1,0,0,0,1,2021
TAA,  ,C 17,Fabbricazione di carta e di prodotti di carta               ,0,0,0,0,0,2021
TAA,  ,C 18,Stampa e riproduzione di supporti registrati                ,0,0,0,0,0,2021
TAA,  ,C 19,Fabbricazione di coke e prodotti derivanti dalla raffinaz...,0,0,0,0,0,2021
TAA,  ,C 20,Fabbricazione di prodotti chimici                           ,1,0,0,0,1,2021
TAA,  ,C 21,Fabbricazione di prodotti farmaceutici di base e di prepa...,0,0,0,0,0,2021
TAA,  ,C 22,Fabbricazione di articoli in gomma e materie plastiche      ,1,0,0,0,1,2021
TAA,  ,C 23,Fabbricazione di altri prodotti della lavorazione di miner..,1,0,0,0,1,2021
TAA,  ,C 24,Metallurgia                                                 ,0,0,0,0,0,2021
TAA,  ,C 25,Fabbricazione di prodotti in metallo (esclusi macchinari ...,4,2,2,0,8,2021
TAA,  ,C 26,Fabbricazione di computer e prodotti di elettronica e ott...,0,0,0,0,0,2021
TAA,  ,C 27,Fabbricazione di apparecchiature elettriche ed apparecchi...,2,0,0,0,2,2021
TAA,  ,C 28,Fabbricazione di macchinari ed apparecchiature nca          ,4,0,1,0,5,2021
TAA,  ,C 29,"Fabbricazione di autoveicoli, rimorchi e semirimorchi       ",0,0,0,0,0,2021
TAA,  ,C 30,Fabbricazione di altri mezzi di trasporto                   ,0,0,0,0,0,2021
TAA,  ,C 31,Fabbricazione di mobili                                     ,0,0,0,0,0,2021
TAA,  ,C 32,Altre industrie manifatturiere                              ,0,0,0,0,0,2021
TAA,  ,C 33,"Riparazione, manutenzione ed installazione di macchine ed...",0,0,2,0,2,2021
TAA,  ,D   ,"Fornitura di energia elettrica, gas, vapore e aria condiz...",0,0,0,0,0,2021
TAA,  ,D 35,"Fornitura di energia elettrica, gas, vapore e aria condiz...",0,0,0,0,0,2021
TAA,  ,E   ,"Fornitura di acqua; reti fognarie, attività di gestione d...",0,0,0,0,0,2021
TAA,  ,E 36,"Raccolta, trattamento e fornitura di acqua                  ",0,0,0,0,0,2021
TAA,  ,E 37,Gestione delle reti fognarie                                ,0,0,0,0,0,2021
TAA,  ,E 38,"Attività di raccolta, trattamento e smaltimento dei rifiu...",0,0,0,0,0,2021
TAA,  ,E 39,Attività di risanamento e altri servizi di gestione dei r...,0,0,0,0,0,2021
TAA,  ,F   ,Costruzioni                                                 ,18,7,45,3,73,2021
TAA,  ,F 41,Costruzione di edifici                                      ,11,0,10,2,23,2021
TAA,  ,F 42,Ingegneria civile                                           ,4,1,0,1,6,2021
TAA,  ,F 43,Lavori di costruzione specializzati                         ,3,6,35,0,44,2021
TAA,  ,G   ,Commercio all'ingrosso e al dettaglio; riparazione di aut...,18,10,92,2,122,2021
TAA,  ,G 45,Commercio all'ingrosso e al dettaglio e riparazione di au...,1,1,10,0,12,2021
TAA,  ,G 46,Commercio all'ingrosso (escluso quello di autoveicoli e d...,9,5,32,1,47,2021
TAA,  ,G 47,Commercio al dettaglio (escluso quello di autoveicoli e d...,8,4,50,1,63,2021
TAA,  ,H   ,Trasporto e magazzinaggio                                   ,3,4,5,1,13,2021
TAA,  ,H 49,Trasporto terrestre e mediante condotte                     ,3,3,5,0,11,2021
TAA,  ,H 50,Trasporto marittimo e per vie d'acqua                       ,0,0,0,0,0,2021
TAA,  ,H 51,Trasporto aereo                                             ,0,0,0,0,0,2021
TAA,  ,H 52,Magazzinaggio e attività di supporto ai trasporti           ,0,1,0,1,2,2021
TAA,  ,H 53,Servizi postali e attività di corriere                      ,0,0,0,0,0,2021
TAA,  ,I   ,Attività dei servizi alloggio e ristorazione                ,7,25,28,1,61,2021
TAA,  ,I 55,Alloggio                                                    ,1,3,8,0,12,2021
TAA,  ,I 56,Attività dei servizi di ristorazione                        ,6,22,20,1,49,2021
TAA,  ,J   ,Servizi di informazione e comunicazione                     ,5,1,4,2,12,2021
TAA,  ,J 58,Attività editoriali                                         ,0,0,0,1,1,2021
TAA,  ,J 59,"Attività di produzione cinematografica, di video e di pro...",0,0,0,0,0,2021
TAA,  ,J 60,Attività di programmazione e trasmissione                   ,1,0,0,0,1,2021
TAA,  ,J 61,Telecomunicazioni                                           ,0,1,0,0,1,2021
TAA,  ,J 62,"Produzione di software, consulenza informatica e attività...",3,0,4,0,7,2021
TAA,  ,J 63,Attività dei servizi d'informazione e altri servizi infor...,1,0,0,1,2,2021
TAA,  ,K   ,Attività finanziarie e assicurative                         ,1,0,1,0,2,2021
TAA,  ,K 64,Attività di servizi finanziari (escluse le assicurazioni ...,0,0,0,0,0,2021
TAA,  ,K 65,"Assicurazioni, riassicurazioni e fondi pensione (escluse ...",0,0,0,0,0,2021
TAA,  ,K 66,Attività ausiliarie dei servizi finanziari e delle attivi...,1,0,1,0,2,2021
TAA,  ,L   ,Attivita' immobiliari                                       ,7,3,5,0,15,2021
TAA,  ,L 68,Attivita' immobiliari                                       ,7,3,5,0,15,2021
TAA,  ,M   ,"Attività professionali, scientifiche e tecniche             ",4,1,9,2,16,2021
TAA,  ,M 69,Attività legali e contabilità                               ,0,0,1,0,1,2021
TAA,  ,M 70,Attività di direzione aziendale e di consulenza gestional...,3,0,4,0,7,2021
TAA,  ,M 71,Attività degli studi di architettura e d'ingegneria; coll...,0,0,0,0,0,2021
TAA,  ,M 72,Ricerca scientifica e sviluppo                              ,0,0,0,0,0,2021
TAA,  ,M 73,Pubblicità e ricerche di mercato                            ,1,1,0,1,3,2021
TAA,  ,M 74,"Altre attività professionali, scientifiche e tecniche       ",0,0,4,1,5,2021
TAA,  ,M 75,Servizi veterinari                                          ,0,0,0,0,0,2021
TAA,  ,N   ,"Noleggio, agenzie di viaggio, servizi di supporto alle im...",2,2,3,4,11,2021
TAA,  ,N 77,Attività di noleggio e leasing operativo                    ,1,0,0,0,1,2021
TAA,  ,N 78,"Attività di ricerca, selezione, fornitura di personale      ",0,0,0,0,0,2021
TAA,  ,N 79,"Attività dei servizi delle agenzie di viaggio, dei tour o...",0,2,1,0,3,2021
TAA,  ,N 80,Servizi di vigilanza e investigazione                       ,0,0,0,0,0,2021
TAA,  ,N 81,Attività di servizi per edifici e paesaggio                 ,1,0,2,4,7,2021
TAA,  ,N 82,Attività di supporto per le funzioni d'ufficio e altri se...,0,0,0,0,0,2021
TAA,  ,O   ,Amministrazione pubblica e difesa; assicurazione sociale ...,0,0,0,0,0,2021
TAA,  ,O 84,Amministrazione pubblica e difesa; assicurazione sociale ...,0,0,0,0,0,2021
TAA,  ,P   ,Istruzione                                                  ,0,0,1,0,1,2021
TAA,  ,P 85,Istruzione                                                  ,0,0,1,0,1,2021
TAA,  ,Q   ,Sanita' e assistenza sociale                                ,0,0,0,2,2,2021
TAA,  ,Q 86,Assistenza sanitaria                                        ,0,0,0,0,0,2021
TAA,  ,Q 87,Servizi di assistenza sociale residenziale                  ,0,0,0,0,0,2021
TAA,  ,Q 88,Assistenza sociale non residenziale                         ,0,0,0,2,2,2021
TAA,  ,R   ,"Attività artistiche, sportive, di intrattenimento e diver...",0,0,0,1,1,2021
TAA,  ,R 90,"Attività creative, artistiche e di intrattenimento          ",0,0,0,0,0,2021
TAA,  ,R 91,"Attività di biblioteche, archivi, musei ed altre attività...",0,0,0,0,0,2021
TAA,  ,R 92,"Attività riguardanti le lotterie, le scommesse, le case d...",0,0,0,0,0,2021
TAA,  ,R 93,"Attività sportive, di intrattenimento e di divertimento     ",0,0,0,1,1,2021
TAA,  ,S   ,Altre attività di servizi                                   ,1,0,5,0,6,2021
TAA,  ,S 94,Attività di organizzazioni associative                      ,0,0,0,0,0,2021
TAA,  ,S 95,Riparazione di computer e di beni per uso personale e per...,0,0,4,0,4,2021
TAA,  ,S 96,Altre attività di servizi per la persona                    ,1,0,1,0,2,2021
TAA,  ,T   ,Attività di famiglie e convivenze come datori di lavoro p...,0,0,0,0,0,2021
TAA,  ,T 97,Attività di famiglie e convivenze come datori di lavoro p...,0,0,0,0,0,2021
TAA,  ,T 98,Produzione di beni e servizi indifferenziati per uso prop...,0,0,0,0,0,2021
TAA,  ,U   ,Organizzazioni ed organismi extraterritoriali               ,0,0,0,0,0,2021
TAA,  ,U 99,Organizzazioni ed organismi extraterritoriali               ,0,0,0,0,0,2021
TAA,  ,XX  ,Imprese non classificate                                    ,15,11,2,2,30,2021
TAA,  ,TOT ,TOTALE                                                      ,97,67,259,20,443,2021
TAA,BZ,A   ,"Agricoltura, silvicoltura pesca                             ",0,1,42,0,43,2021
TAA,BZ,A 01,"Coltivazioni agricole e produzione di prodotti animali, c...",0,1,40,0,41,2021
TAA,BZ,A 02,Silvicoltura ed utilizzo di aree forestali                  ,0,0,2,0,2,2021
TAA,BZ,A 03,Pesca e acquacoltura                                        ,0,0,0,0,0,2021
TAA,BZ,B   ,Estrazione di minerali da cave e miniere                    ,0,0,0,0,0,2021
TAA,BZ,B 05,Estrazione di carbone (esclusa torba)                       ,0,0,0,0,0,2021
TAA,BZ,B 06,Estraz.di petrolio greggio e di gas naturale                ,0,0,0,0,0,2021
TAA,BZ,B 07,Estrazione di minerali metalliferi                          ,0,0,0,0,0,2021
TAA,BZ,B 08,Altre attività di estrazione di minerali da cave e miniere  ,0,0,0,0,0,2021
TAA,BZ,B 09,Attività dei servizi di supporto all'estrazione             ,0,0,0,0,0,2021
TAA,BZ,C   ,Attività manifatturiere                                     ,0,2,5,0,7,2021
TAA,BZ,C 10,Industrie alimentari                                        ,0,0,0,0,0,2021
TAA,BZ,C 11,Industria delle bevande                                     ,0,0,0,0,0,2021
TAA,BZ,C 12,Industria del tabacco                                       ,0,0,0,0,0,2021
TAA,BZ,C 13,Industrie tessili                                           ,0,0,0,0,0,2021
TAA,BZ,C 14,Confezione di articoli di abbigliamento; confezione di ar...,0,0,0,0,0,2021
TAA,BZ,C 15,Fabbricazione di articoli in pelle e simili                 ,0,0,0,0,0,2021
TAA,BZ,C 16,Industria del legno e dei prodotti in legno e sughero (es...,0,0,0,0,0,2021
TAA,BZ,C 17,Fabbricazione di carta e di prodotti di carta               ,0,0,0,0,0,2021
TAA,BZ,C 18,Stampa e riproduzione di supporti registrati                ,0,0,0,0,0,2021
TAA,BZ,C 19,Fabbricazione di coke e prodotti derivanti dalla raffinaz...,0,0,0,0,0,2021
TAA,BZ,C 20,Fabbricazione di prodotti chimici                           ,0,0,0,0,0,2021
TAA,BZ,C 21,Fabbricazione di prodotti farmaceutici di base e di prepa...,0,0,0,0,0,2021
TAA,BZ,C 22,Fabbricazione di articoli in gomma e materie plastiche      ,0,0,0,0,0,2021
TAA,BZ,C 23,Fabbricazione di altri prodotti della lavorazione di miner..,0,0,0,0,0,2021
TAA,BZ,C 24,Metallurgia                                                 ,0,0,0,0,0,2021
TAA,BZ,C 25,Fabbricazione di prodotti in metallo (esclusi macchinari ...,0,2,2,0,4,2021
TAA,BZ,C 26,Fabbricazione di computer e prodotti di elettronica e ott...,0,0,0,0,0,2021
TAA,BZ,C 27,Fabbricazione di apparecchiature elettriche ed apparecchi...,0,0,0,0,0,2021
TAA,BZ,C 28,Fabbricazione di macchinari ed apparecchiature nca          ,0,0,1,0,1,2021
TAA,BZ,C 29,"Fabbricazione di autoveicoli, rimorchi e semirimorchi       ",0,0,0,0,0,2021
TAA,BZ,C 30,Fabbricazione di altri mezzi di trasporto                   ,0,0,0,0,0,2021
TAA,BZ,C 31,Fabbricazione di mobili                                     ,0,0,0,0,0,2021
TAA,BZ,C 32,Altre industrie manifatturiere                              ,0,0,0,0,0,2021
TAA,BZ,C 33,"Riparazione, manutenzione ed installazione di macchine ed...",0,0,2,0,2,2021
TAA,BZ,D   ,"Fornitura di energia elettrica, gas, vapore e aria condiz...",0,0,0,0,0,2021
TAA,BZ,D 35,"Fornitura di energia elettrica, gas, vapore e aria condiz...",0,0,0,0,0,2021
TAA,BZ,E   ,"Fornitura di acqua; reti fognarie, attività di gestione d...",0,0,0,0,0,2021
TAA,BZ,E 36,"Raccolta, trattamento e fornitura di acqua                  ",0,0,0,0,0,2021
TAA,BZ,E 37,Gestione delle reti fognarie                                ,0,0,0,0,0,2021
TAA,BZ,E 38,"Attività di raccolta, trattamento e smaltimento dei rifiu...",0,0,0,0,0,2021
TAA,BZ,E 39,Attività di risanamento e altri servizi di gestione dei r...,0,0,0,0,0,2021
TAA,BZ,F   ,Costruzioni                                                 ,0,7,45,3,55,2021
TAA,BZ,F 41,Costruzione di edifici                                      ,0,0,10,2,12,2021
TAA,BZ,F 42,Ingegneria civile                                           ,0,1,0,1,2,2021
TAA,BZ,F 43,Lavori di costruzione specializzati                         ,0,6,35,0,41,2021
TAA,BZ,G   ,Commercio all'ingrosso e al dettaglio; riparazione di aut...,0,10,90,2,102,2021
TAA,BZ,G 45,Commercio all'ingrosso e al dettaglio e riparazione di au...,0,1,9,0,10,2021
TAA,BZ,G 46,Commercio all'ingrosso (escluso quello di autoveicoli e d...,0,5,31,1,37,2021
TAA,BZ,G 47,Commercio al dettaglio (escluso quello di autoveicoli e d...,0,4,50,1,55,2021
TAA,BZ,H   ,Trasporto e magazzinaggio                                   ,0,4,5,1,10,2021
TAA,BZ,H 49,Trasporto terrestre e mediante condotte                     ,0,3,5,0,8,2021
TAA,BZ,H 50,Trasporto marittimo e per vie d'acqua                       ,0,0,0,0,0,2021
TAA,BZ,H 51,Trasporto aereo                                             ,0,0,0,0,0,2021
TAA,BZ,H 52,Magazzinaggio e attività di supporto ai trasporti           ,0,1,0,1,2,2021
TAA,BZ,H 53,Servizi postali e attività di corriere                      ,0,0,0,0,0,2021
TAA,BZ,I   ,Attività dei servizi alloggio e ristorazione                ,0,25,28,1,54,2021
TAA,BZ,I 55,Alloggio                                                    ,0,3,8,0,11,2021
TAA,BZ,I 56,Attività dei servizi di ristorazione                        ,0,22,20,1,43,2021
TAA,BZ,J   ,Servizi di informazione e comunicazione                     ,0,1,4,2,7,2021
TAA,BZ,J 58,Attività editoriali                                         ,0,0,0,1,1,2021
TAA,BZ,J 59,"Attività di produzione cinematografica, di video e di pro...",0,0,0,0,0,2021
TAA,BZ,J 60,Attività di programmazione e trasmissione                   ,0,0,0,0,0,2021
TAA,BZ,J 61,Telecomunicazioni                                           ,0,1,0,0,1,2021
TAA,BZ,J 62,"Produzione di software, consulenza informatica e attività...",0,0,4,0,4,2021
TAA,BZ,J 63,Attività dei servizi d'informazione e altri servizi infor...,0,0,0,1,1,2021
TAA,BZ,K   ,Attività finanziarie e assicurative                         ,0,0,1,0,1,2021
TAA,BZ,K 64,Attività di servizi finanziari (escluse le assicurazioni ...,0,0,0,0,0,2021
TAA,BZ,K 65,"Assicurazioni, riassicurazioni e fondi pensione (escluse ...",0,0,0,0,0,2021
TAA,BZ,K 66,Attività ausiliarie dei servizi finanziari e delle attivi...,0,0,1,0,1,2021
TAA,BZ,L   ,Attivita' immobiliari                                       ,0,3,5,0,8,2021
TAA,BZ,L 68,Attivita' immobiliari                                       ,0,3,5,0,8,2021
TAA,BZ,M   ,"Attività professionali, scientifiche e tecniche             ",0,1,9,2,12,2021
TAA,BZ,M 69,Attività legali e contabilità                               ,0,0,1,0,1,2021
TAA,BZ,M 70,Attività di direzione aziendale e di consulenza gestional...,0,0,4,0,4,2021
TAA,BZ,M 71,Attività degli studi di architettura e d'ingegneria; coll...,0,0,0,0,0,2021
TAA,BZ,M 72,Ricerca scientifica e sviluppo                              ,0,0,0,0,0,2021
TAA,BZ,M 73,Pubblicità e ricerche di mercato                            ,0,1,0,1,2,2021
TAA,BZ,M 74,"Altre attività professionali, scientifiche e tecniche       ",0,0,4,1,5,2021
TAA,BZ,M 75,Servizi veterinari                                          ,0,0,0,0,0,2021
TAA,BZ,N   ,"Noleggio, agenzie di viaggio, servizi di supporto alle im...",0,2,3,4,9,2021
TAA,BZ,N 77,Attività di noleggio e leasing operativo                    ,0,0,0,0,0,2021
TAA,BZ,N 78,"Attività di ricerca, selezione, fornitura di personale      ",0,0,0,0,0,2021
TAA,BZ,N 79,"Attività dei servizi delle agenzie di viaggio, dei tour o...",0,2,1,0,3,2021
TAA,BZ,N 80,Servizi di vigilanza e investigazione                       ,0,0,0,0,0,2021
TAA,BZ,N 81,Attività di servizi per edifici e paesaggio                 ,0,0,2,4,6,2021
TAA,BZ,N 82,Attività di supporto per le funzioni d'ufficio e altri se...,0,0,0,0,0,2021
TAA,BZ,O   ,Amministrazione pubblica e difesa; assicurazione sociale ...,0,0,0,0,0,2021
TAA,BZ,O 84,Amministrazione pubblica e difesa; assicurazione sociale ...,0,0,0,0,0,2021
TAA,BZ,P   ,Istruzione                                                  ,0,0,1,0,1,2021
TAA,BZ,P 85,Istruzione                                                  ,0,0,1,0,1,2021
TAA,BZ,Q   ,Sanita' e assistenza sociale                                ,0,0,0,2,2,2021
TAA,BZ,Q 86,Assistenza sanitaria                                        ,0,0,0,0,0,2021
TAA,BZ,Q 87,Servizi di assistenza sociale residenziale                  ,0,0,0,0,0,2021
TAA,BZ,Q 88,Assistenza sociale non residenziale                         ,0,0,0,2,2,2021
TAA,BZ,R   ,"Attività artistiche, sportive, di intrattenimento e diver...",0,0,0,1,1,2021
TAA,BZ,R 90,"Attività creative, artistiche e di intrattenimento          ",0,0,0,0,0,2021
TAA,BZ,R 91,"Attività di biblioteche, archivi, musei ed altre attività...",0,0,0,0,0,2021
TAA,BZ,R 92,"Attività riguardanti le lotterie, le scommesse, le case d...",0,0,0,0,0,2021
TAA,BZ,R 93,"Attività sportive, di intrattenimento e di divertimento     ",0,0,0,1,1,2021
TAA,BZ,S   ,Altre attività di servizi                                   ,0,0,5,0,5,2021
TAA,BZ,S 94,Attività di organizzazioni associative                      ,0,0,0,0,0,2021
TAA,BZ,S 95,Riparazione di computer e di beni per uso personale e per...,0,0,4,0,4,2021
TAA,BZ,S 96,Altre attività di servizi per la persona                    ,0,0,1,0,1,2021
TAA,BZ,T   ,Attività di famiglie e convivenze come datori di lavoro p...,0,0,0,0,0,2021
TAA,BZ,T 97,Attività di famiglie e convivenze come datori di lavoro p...,0,0,0,0,0,2021
TAA,BZ,T 98,Produzione di beni e servizi indifferenziati per uso prop...,0,0,0,0,0,2021
TAA,BZ,U   ,Organizzazioni ed organismi extraterritoriali               ,0,0,0,0,0,2021
TAA,BZ,U 99,Organizzazioni ed organismi extraterritoriali               ,0,0,0,0,0,2021
TAA,BZ,XX  ,Imprese non classificate                                    ,0,11,2,2,15,2021
TAA,BZ,TOT ,TOTALE                                                      ,0,67,245,20,332,2021
TAA,TN,A   ,"Agricoltura, silvicoltura pesca                             ",0,0,11,0,11,2021
TAA,TN,A 01,"Coltivazioni agricole e produzione di prodotti animali, c...",0,0,11,0,11,2021
TAA,TN,A 02,Silvicoltura ed utilizzo di aree forestali                  ,0,0,0,0,0,2021
TAA,TN,A 03,Pesca e acquacoltura                                        ,0,0,0,0,0,2021
TAA,TN,B   ,Estrazione di minerali da cave e miniere                    ,0,0,0,0,0,2021
TAA,TN,B 05,Estrazione di carbone (esclusa torba)                       ,0,0,0,0,0,2021
TAA,TN,B 06,Estraz.di petrolio greggio e di gas naturale                ,0,0,0,0,0,2021
TAA,TN,B 07,Estrazione di minerali metalliferi                          ,0,0,0,0,0,2021
TAA,TN,B 08,Altre attività di estrazione di minerali da cave e miniere  ,0,0,0,0,0,2021
TAA,TN,B 09,Attività dei servizi di supporto all'estrazione             ,0,0,0,0,0,2021
TAA,TN,C   ,Attività manifatturiere                                     ,16,0,1,0,17,2021
TAA,TN,C 10,Industrie alimentari                                        ,1,0,0,0,1,2021
TAA,TN,C 11,Industria delle bevande                                     ,0,0,0,0,0,2021
TAA,TN,C 12,Industria del tabacco                                       ,0,0,0,0,0,2021
TAA,TN,C 13,Industrie tessili                                           ,1,0,0,0,1,2021
TAA,TN,C 14,Confezione di articoli di abbigliamento; confezione di ar...,0,0,1,0,1,2021
TAA,TN,C 15,Fabbricazione di articoli in pelle e simili                 ,0,0,0,0,0,2021
TAA,TN,C 16,Industria del legno e dei prodotti in legno e sughero (es...,1,0,0,0,1,2021
TAA,TN,C 17,Fabbricazione di carta e di prodotti di carta               ,0,0,0,0,0,2021
TAA,TN,C 18,Stampa e riproduzione di supporti registrati                ,0,0,0,0,0,2021
TAA,TN,C 19,Fabbricazione di coke e prodotti derivanti dalla raffinaz...,0,0,0,0,0,2021
TAA,TN,C 20,Fabbricazione di prodotti chimici                           ,1,0,0,0,1,2021
TAA,TN,C 21,Fabbricazione di prodotti farmaceutici di base e di prepa...,0,0,0,0,0,2021
TAA,TN,C 22,Fabbricazione di articoli in gomma e materie plastiche      ,1,0,0,0,1,2021
TAA,TN,C 23,Fabbricazione di altri prodotti della lavorazione di miner..,1,0,0,0,1,2021
TAA,TN,C 24,Metallurgia                                                 ,0,0,0,0,0,2021
TAA,TN,C 25,Fabbricazione di prodotti in metallo (esclusi macchinari ...,4,0,0,0,4,2021
TAA,TN,C 26,Fabbricazione di computer e prodotti di elettronica e ott...,0,0,0,0,0,2021
TAA,TN,C 27,Fabbricazione di apparecchiature elettriche ed apparecchi...,2,0,0,0,2,2021
TAA,TN,C 28,Fabbricazione di macchinari ed apparecchiature nca          ,4,0,0,0,4,2021
TAA,TN,C 29,"Fabbricazione di autoveicoli, rimorchi e semirimorchi       ",0,0,0,0,0,2021
TAA,TN,C 30,Fabbricazione di altri mezzi di trasporto                   ,0,0,0,0,0,2021
TAA,TN,C 31,Fabbricazione di mobili                                     ,0,0,0,0,0,2021
TAA,TN,C 32,Altre industrie manifatturiere                              ,0,0,0,0,0,2021
TAA,TN,C 33,"Riparazione, manutenzione ed installazione di macchine ed...",0,0,0,0,0,2021
TAA,TN,D   ,"Fornitura di energia elettrica, gas, vapore e aria condiz...",0,0,0,0,0,2021
TAA,TN,D 35,"Fornitura di energia elettrica, gas, vapore e aria condiz...",0,0,0,0,0,2021
TAA,TN,E   ,"Fornitura di acqua; reti fognarie, attività di gestione d...",0,0,0,0,0,2021
TAA,TN,E 36,"Raccolta, trattamento e fornitura di acqua                  ",0,0,0,0,0,2021
TAA,TN,E 37,Gestione delle reti fognarie                                ,0,0,0,0,0,2021
TAA,TN,E 38,"Attività di raccolta, trattamento e smaltimento dei rifiu...",0,0,0,0,0,2021
TAA,TN,E 39,Attività di risanamento e altri servizi di gestione dei r...,0,0,0,0,0,2021
TAA,TN,F   ,Costruzioni                                                 ,18,0,0,0,18,2021
TAA,TN,F 41,Costruzione di edifici                                      ,11,0,0,0,11,2021
TAA,TN,F 42,Ingegneria civile                                           ,4,0,0,0,4,2021
TAA,TN,F 43,Lavori di costruzione specializzati                         ,3,0,0,0,3,2021
TAA,TN,G   ,Commercio all'ingrosso e al dettaglio; riparazione di aut...,18,0,2,0,20,2021
TAA,TN,G 45,Commercio all'ingrosso e al dettaglio e riparazione di au...,1,0,1,0,2,2021
TAA,TN,G 46,Commercio all'ingrosso (escluso quello di autoveicoli e d...,9,0,1,0,10,2021
TAA,TN,G 47,Commercio al dettaglio (escluso quello di autoveicoli e d...,8,0,0,0,8,2021
TAA,TN,H   ,Trasporto e magazzinaggio                                   ,3,0,0,0,3,2021
TAA,TN,H 49,Trasporto terrestre e mediante condotte                     ,3,0,0,0,3,2021
TAA,TN,H 50,Trasporto marittimo e per vie d'acqua                       ,0,0,0,0,0,2021
TAA,TN,H 51,Trasporto aereo                                             ,0,0,0,0,0,2021
TAA,TN,H 52,Magazzinaggio e attività di supporto ai trasporti           ,0,0,0,0,0,2021
TAA,TN,H 53,Servizi postali e attività di corriere                      ,0,0,0,0,0,2021
TAA,TN,I   ,Attività dei servizi alloggio e ristorazione                ,7,0,0,0,7,2021
TAA,TN,I 55,Alloggio                                                    ,1,0,0,0,1,2021
TAA,TN,I 56,Attività dei servizi di ristorazione                        ,6,0,0,0,6,2021
TAA,TN,J   ,Servizi di informazione e comunicazione                     ,5,0,0,0,5,2021
TAA,TN,J 58,Attività editoriali                                         ,0,0,0,0,0,2021
TAA,TN,J 59,"Attività di produzione cinematografica, di video e di pro...",0,0,0,0,0,2021
TAA,TN,J 60,Attività di programmazione e trasmissione                   ,1,0,0,0,1,2021
TAA,TN,J 61,Telecomunicazioni                                           ,0,0,0,0,0,2021
TAA,TN,J 62,"Produzione di software, consulenza informatica e attività...",3,0,0,0,3,2021
TAA,TN,J 63,Attività dei servizi d'informazione e altri servizi infor...,1,0,0,0,1,2021
TAA,TN,K   ,Attività finanziarie e assicurative                         ,1,0,0,0,1,2021
TAA,TN,K 64,Attività di servizi finanziari (escluse le assicurazioni ...,0,0,0,0,0,2021
TAA,TN,K 65,"Assicurazioni, riassicurazioni e fondi pensione (escluse ...",0,0,0,0,0,2021
TAA,TN,K 66,Attività ausiliarie dei servizi finanziari e delle attivi...,1,0,0,0,1,2021
TAA,TN,L   ,Attivita' immobiliari                                       ,7,0,0,0,7,2021
TAA,TN,L 68,Attivita' immobiliari                                       ,7,0,0,0,7,2021
TAA,TN,M   ,"Attività professionali, scientifiche e tecniche             ",4,0,0,0,4,2021
TAA,TN,M 69,Attività legali e contabilità                               ,0,0,0,0,0,2021
TAA,TN,M 70,Attività di direzione aziendale e di consulenza gestional...,3,0,0,0,3,2021
TAA,TN,M 71,Attività degli studi di architettura e d'ingegneria; coll...,0,0,0,0,0,2021
TAA,TN,M 72,Ricerca scientifica e sviluppo                              ,0,0,0,0,0,2021
TAA,TN,M 73,Pubblicità e ricerche di mercato                            ,1,0,0,0,1,2021
TAA,TN,M 74,"Altre attività professionali, scientifiche e tecniche       ",0,0,0,0,0,2021
TAA,TN,M 75,Servizi veterinari                                          ,0,0,0,0,0,2021
TAA,TN,N   ,"Noleggio, agenzie di viaggio, servizi di supporto alle im...",2,0,0,0,2,2021
TAA,TN,N 77,Attività di noleggio e leasing operativo                    ,1,0,0,0,1,2021
TAA,TN,N 78,"Attività di ricerca, selezione, fornitura di personale      ",0,0,0,0,0,2021
TAA,TN,N 79,"Attività dei servizi delle agenzie di viaggio, dei tour o...",0,0,0,0,0,2021
TAA,TN,N 80,Servizi di vigilanza e investigazione                       ,0,0,0,0,0,2021
TAA,TN,N 81,Attività di servizi per edifici e paesaggio                 ,1,0,0,0,1,2021
TAA,TN,N 82,Attività di supporto per le funzioni d'ufficio e altri se...,0,0,0,0,0,2021
TAA,TN,O   ,Amministrazione pubblica e difesa; assicurazione sociale ...,0,0,0,0,0,2021
TAA,TN,O 84,Amministrazione pubblica e difesa; assicurazione sociale ...,0,0,0,0,0,2021
TAA,TN,P   ,Istruzione                                                  ,0,0,0,0,0,2021
TAA,TN,P 85,Istruzione                                                  ,0,0,0,0,0,2021
TAA,TN,Q   ,Sanita' e assistenza sociale                                ,0,0,0,0,0,2021
TAA,TN,Q 86,Assistenza sanitaria                                        ,0,0,0,0,0,2021
TAA,TN,Q 87,Servizi di assistenza sociale residenziale                  ,0,0,0,0,0,2021
TAA,TN,Q 88,Assistenza sociale non residenziale                         ,0,0,0,0,0,2021
TAA,TN,R   ,"Attività artistiche, sportive, di intrattenimento e diver...",0,0,0,0,0,2021
TAA,TN,R 90,"Attività creative, artistiche e di intrattenimento          ",0,0,0,0,0,2021
TAA,TN,R 91,"Attività di biblioteche, archivi, musei ed altre attività...",0,0,0,0,0,2021
TAA,TN,R 92,"Attività riguardanti le lotterie, le scommesse, le case d...",0,0,0,0,0,2021
TAA,TN,R 93,"Attività sportive, di intrattenimento e di divertimento     ",0,0,0,0,0,2021
TAA,TN,S   ,Altre attività di servizi                                   ,1,0,0,0,1,2021
TAA,TN,S 94,Attività di organizzazioni associative                      ,0,0,0,0,0,2021
TAA,TN,S 95,Riparazione di computer e di beni per uso personale e per...,0,0,0,0,0,2021
TAA,TN,S 96,Altre attività di servizi per la persona                    ,1,0,0,0,1,2021
TAA,TN,T   ,Attività di famiglie e convivenze come datori di lavoro p...,0,0,0,0,0,2021
TAA,TN,T 97,Attività di famiglie e convivenze come datori di lavoro p...,0,0,0,0,0,2021
TAA,TN,T 98,Produzione di beni e servizi indifferenziati per uso prop...,0,0,0,0,0,2021
TAA,TN,U   ,Organizzazioni ed organismi extraterritoriali               ,0,0,0,0,0,2021
TAA,TN,U 99,Organizzazioni ed organismi extraterritoriali               ,0,0,0,0,0,2021
TAA,TN,XX  ,Imprese non classificate                                    ,15,0,0,0,15,2021
TAA,TN,TOT ,TOTALE                                                      ,97,0,14,0,111,2021
VEN,  ,A   ,"Agricoltura, silvicoltura pesca                             ",10,38,55,13,116,2021
VEN,  ,A 01,"Coltivazioni agricole e produzione di prodotti animali, c...",10,37,51,12,110,2021
VEN,  ,A 02,Silvicoltura ed utilizzo di aree forestali                  ,0,1,0,0,1,2021
VEN,  ,A 03,Pesca e acquacoltura                                        ,0,0,4,1,5,2021
VEN,  ,B   ,Estrazione di minerali da cave e miniere                    ,3,0,0,0,3,2021
VEN,  ,B 05,Estrazione di carbone (esclusa torba)                       ,0,0,0,0,0,2021
VEN,  ,B 06,Estraz.di petrolio greggio e di gas naturale                ,0,0,0,0,0,2021
VEN,  ,B 07,Estrazione di minerali metalliferi                          ,0,0,0,0,0,2021
VEN,  ,B 08,Altre attività di estrazione di minerali da cave e miniere  ,3,0,0,0,3,2021
VEN,  ,B 09,Attività dei servizi di supporto all'estrazione             ,0,0,0,0,0,2021
VEN,  ,C   ,Attività manifatturiere                                     ,356,135,173,7,671,2021
VEN,  ,C 10,Industrie alimentari                                        ,14,3,8,2,27,2021
VEN,  ,C 11,Industria delle bevande                                     ,1,0,0,0,1,2021
VEN,  ,C 12,Industria del tabacco                                       ,0,0,0,0,0,2021
VEN,  ,C 13,Industrie tessili                                           ,11,12,6,1,30,2021
VEN,  ,C 14,Confezione di articoli di abbigliamento; confezione di ar...,55,25,80,0,160,2021
VEN,  ,C 15,Fabbricazione di articoli in pelle e simili                 ,37,18,12,1,68,2021
VEN,  ,C 16,Industria del legno e dei prodotti in legno e sughero (es...,10,3,9,0,22,2021
VEN,  ,C 17,Fabbricazione di carta e di prodotti di carta               ,6,0,0,0,6,2021
VEN,  ,C 18,Stampa e riproduzione di supporti registrati                ,9,5,0,1,15,2021
VEN,  ,C 19,Fabbricazione di coke e prodotti derivanti dalla raffinaz...,0,0,0,0,0,2021
VEN,  ,C 20,Fabbricazione di prodotti chimici                           ,8,1,1,0,10,2021
VEN,  ,C 21,Fabbricazione di prodotti farmaceutici di base e di prepa...,0,0,0,0,0,2021
VEN,  ,C 22,Fabbricazione di articoli in gomma e materie plastiche      ,12,4,0,0,16,2021
VEN,  ,C 23,Fabbricazione di altri prodotti della lavorazione di miner..,15,6,5,1,27,2021
VEN,  ,C 24,Metallurgia                                                 ,12,0,0,0,12,2021
VEN,  ,C 25,Fabbricazione di prodotti in metallo (esclusi macchinari ...,42,31,30,0,103,2021
VEN,  ,C 26,Fabbricazione di computer e prodotti di elettronica e ott...,2,1,2,0,5,2021
VEN,  ,C 27,Fabbricazione di apparecchiature elettriche ed apparecchi...,13,1,0,0,14,2021
VEN,  ,C 28,Fabbricazione di macchinari ed apparecchiature nca          ,29,10,2,0,41,2021
VEN,  ,C 29,"Fabbricazione di autoveicoli, rimorchi e semirimorchi       ",2,0,1,0,3,2021
VEN,  ,C 30,Fabbricazione di altri mezzi di trasporto                   ,4,0,4,0,8,2021
VEN,  ,C 31,Fabbricazione di mobili                                     ,45,7,2,0,54,2021
VEN,  ,C 32,Altre industrie manifatturiere                              ,26,8,7,0,41,2021
VEN,  ,C 33,"Riparazione, manutenzione ed installazione di macchine ed...",3,0,4,1,8,2021
VEN,  ,D   ,"Fornitura di energia elettrica, gas, vapore e aria condiz...",1,0,0,1,2,2021
VEN,  ,D 35,"Fornitura di energia elettrica, gas, vapore e aria condiz...",1,0,0,1,2,2021
VEN,  ,E   ,"Fornitura di acqua; reti fognarie, attività di gestione d...",4,0,1,0,5,2021
VEN,  ,E 36,"Raccolta, trattamento e fornitura di acqua                  ",0,0,0,0,0,2021
VEN,  ,E 37,Gestione delle reti fognarie                                ,1,0,0,0,1,2021
VEN,  ,E 38,"Attività di raccolta, trattamento e smaltimento dei rifiu...",3,0,1,0,4,2021
VEN,  ,E 39,Attività di risanamento e altri servizi di gestione dei r...,0,0,0,0,0,2021
VEN,  ,F   ,Costruzioni                                                 ,140,74,451,12,677,2021
VEN,  ,F 41,Costruzione di edifici                                      ,85,40,108,10,243,2021
VEN,  ,F 42,Ingegneria civile                                           ,3,2,2,1,8,2021
VEN,  ,F 43,Lavori di costruzione specializzati                         ,52,32,341,1,426,2021
VEN,  ,G   ,Commercio all'ingrosso e al dettaglio; riparazione di aut...,304,188,420,6,918,2021
VEN,  ,G 45,Commercio all'ingrosso e al dettaglio e riparazione di au...,26,19,57,0,102,2021
VEN,  ,G 46,Commercio all'ingrosso (escluso quello di autoveicoli e d...,196,78,99,1,374,2021
VEN,  ,G 47,Commercio al dettaglio (escluso quello di autoveicoli e d...,82,91,264,5,442,2021
VEN,  ,H   ,Trasporto e magazzinaggio                                   ,39,11,33,12,95,2021
VEN,  ,H 49,Trasporto terrestre e mediante condotte                     ,28,10,29,0,67,2021
VEN,  ,H 50,Trasporto marittimo e per vie d'acqua                       ,0,0,1,0,1,2021
VEN,  ,H 51,Trasporto aereo                                             ,0,0,1,0,1,2021
VEN,  ,H 52,Magazzinaggio e attività di supporto ai trasporti           ,10,1,1,12,24,2021
VEN,  ,H 53,Servizi postali e attività di corriere                      ,1,0,1,0,2,2021
VEN,  ,I   ,Attività dei servizi alloggio e ristorazione                ,42,161,63,3,269,2021
VEN,  ,I 55,Alloggio                                                    ,4,8,6,0,18,2021
VEN,  ,I 56,Attività dei servizi di ristorazione                        ,38,153,57,3,251,2021
VEN,  ,J   ,Servizi di informazione e comunicazione                     ,33,17,18,3,71,2021
VEN,  ,J 58,Attività editoriali                                         ,6,5,2,2,15,2021
VEN,  ,J 59,"Attività di produzione cinematografica, di video e di pro...",1,2,0,0,3,2021
VEN,  ,J 60,Attività di programmazione e trasmissione                   ,2,0,0,0,2,2021
VEN,  ,J 61,Telecomunicazioni                                           ,2,3,12,0,17,2021
VEN,  ,J 62,"Produzione di software, consulenza informatica e attività...",14,3,3,1,21,2021
VEN,  ,J 63,Attività dei servizi d'informazione e altri servizi infor...,8,4,1,0,13,2021
VEN,  ,K   ,Attività finanziarie e assicurative                         ,16,9,8,0,33,2021
VEN,  ,K 64,Attività di servizi finanziari (escluse le assicurazioni ...,8,2,0,0,10,2021
VEN,  ,K 65,"Assicurazioni, riassicurazioni e fondi pensione (escluse ...",1,0,0,0,1,2021
VEN,  ,K 66,Attività ausiliarie dei servizi finanziari e delle attivi...,7,7,8,0,22,2021
VEN,  ,L   ,Attivita' immobiliari                                       ,91,51,2,2,146,2021
VEN,  ,L 68,Attivita' immobiliari                                       ,91,51,2,2,146,2021
VEN,  ,M   ,"Attività professionali, scientifiche e tecniche             ",72,25,31,5,133,2021
VEN,  ,M 69,Attività legali e contabilità                               ,2,3,1,0,6,2021
VEN,  ,M 70,Attività di direzione aziendale e di consulenza gestional...,24,8,6,1,39,2021
VEN,  ,M 71,Attività degli studi di architettura e d'ingegneria; coll...,12,1,4,0,17,2021
VEN,  ,M 72,Ricerca scientifica e sviluppo                              ,0,0,0,1,1,2021
VEN,  ,M 73,Pubblicità e ricerche di mercato                            ,13,7,8,0,28,2021
VEN,  ,M 74,"Altre attività professionali, scientifiche e tecniche       ",21,6,12,3,42,2021
VEN,  ,M 75,Servizi veterinari                                          ,0,0,0,0,0,2021
VEN,  ,N   ,"Noleggio, agenzie di viaggio, servizi di supporto alle im...",30,16,28,6,80,2021
VEN,  ,N 77,Attività di noleggio e leasing operativo                    ,9,0,4,0,13,2021
VEN,  ,N 78,"Attività di ricerca, selezione, fornitura di personale      ",0,0,0,0,0,2021
VEN,  ,N 79,"Attività dei servizi delle agenzie di viaggio, dei tour o...",9,1,0,0,10,2021
VEN,  ,N 80,Servizi di vigilanza e investigazione                       ,0,0,1,0,1,2021
VEN,  ,N 81,Attività di servizi per edifici e paesaggio                 ,3,7,6,5,21,2021
VEN,  ,N 82,Attività di supporto per le funzioni d'ufficio e altri se...,9,8,17,1,35,2021
VEN,  ,O   ,Amministrazione pubblica e difesa; assicurazione sociale ...,0,0,0,0,0,2021
VEN,  ,O 84,Amministrazione pubblica e difesa; assicurazione sociale ...,0,0,0,0,0,2021
VEN,  ,P   ,Istruzione                                                  ,2,1,1,1,5,2021
VEN,  ,P 85,Istruzione                                                  ,2,1,1,1,5,2021
VEN,  ,Q   ,Sanita' e assistenza sociale                                ,3,3,2,5,13,2021
VEN,  ,Q 86,Assistenza sanitaria                                        ,2,2,0,2,6,2021
VEN,  ,Q 87,Servizi di assistenza sociale residenziale                  ,0,0,0,0,0,2021
VEN,  ,Q 88,Assistenza sociale non residenziale                         ,1,1,2,3,7,2021
VEN,  ,R   ,"Attività artistiche, sportive, di intrattenimento e diver...",28,8,8,0,44,2021
VEN,  ,R 90,"Attività creative, artistiche e di intrattenimento          ",7,1,0,0,8,2021
VEN,  ,R 91,"Attività di biblioteche, archivi, musei ed altre attività...",0,0,0,0,0,2021
VEN,  ,R 92,"Attività riguardanti le lotterie, le scommesse, le case d...",3,1,0,0,4,2021
VEN,  ,R 93,"Attività sportive, di intrattenimento e di divertimento     ",18,6,8,0,32,2021
VEN,  ,S   ,Altre attività di servizi                                   ,11,27,21,0,59,2021
VEN,  ,S 94,Attività di organizzazioni associative                      ,0,0,0,0,0,2021
VEN,  ,S 95,Riparazione di computer e di beni per uso personale e per...,2,9,11,0,22,2021
VEN,  ,S 96,Altre attività di servizi per la persona                    ,9,18,10,0,37,2021
VEN,  ,T   ,Attività di famiglie e convivenze come datori di lavoro p...,0,0,0,0,0,2021
VEN,  ,T 97,Attività di famiglie e convivenze come datori di lavoro p...,0,0,0,0,0,2021
VEN,  ,T 98,Produzione di beni e servizi indifferenziati per uso prop...,0,0,0,0,0,2021
VEN,  ,U   ,Organizzazioni ed organismi extraterritoriali               ,0,0,0,0,0,2021
VEN,  ,U 99,Organizzazioni ed organismi extraterritoriali               ,0,0,0,0,0,2021
VEN,  ,XX  ,Imprese non classificate                                    ,627,223,35,23,908,2021
VEN,  ,TOT ,TOTALE                                                      ,1812,987,1350,99,4248,2021
VEN,VR,A   ,"Agricoltura, silvicoltura pesca                             ",1,5,8,1,15,2021
VEN,VR,A 01,"Coltivazioni agricole e produzione di prodotti animali, c...",1,4,8,1,14,2021
VEN,VR,A 02,Silvicoltura ed utilizzo di aree forestali                  ,0,1,0,0,1,2021
VEN,VR,A 03,Pesca e acquacoltura                                        ,0,0,0,0,0,2021
VEN,VR,B   ,Estrazione di minerali da cave e miniere                    ,0,0,0,0,0,2021
VEN,VR,B 05,Estrazione di carbone (esclusa torba)                       ,0,0,0,0,0,2021
VEN,VR,B 06,Estraz.di petrolio greggio e di gas naturale                ,0,0,0,0,0,2021
VEN,VR,B 07,Estrazione di minerali metalliferi                          ,0,0,0,0,0,2021
VEN,VR,B 08,Altre attività di estrazione di minerali da cave e miniere  ,0,0,0,0,0,2021
VEN,VR,B 09,Attività dei servizi di supporto all'estrazione             ,0,0,0,0,0,2021
VEN,VR,C   ,Attività manifatturiere                                     ,28,2,12,1,43,2021
VEN,VR,C 10,Industrie alimentari                                        ,2,0,0,0,2,2021
VEN,VR,C 11,Industria delle bevande                                     ,1,0,0,0,1,2021
VEN,VR,C 12,Industria del tabacco                                       ,0,0,0,0,0,2021
VEN,VR,C 13,Industrie tessili                                           ,0,0,1,0,1,2021
VEN,VR,C 14,Confezione di articoli di abbigliamento; confezione di ar...,4,0,5,0,9,2021
VEN,VR,C 15,Fabbricazione di articoli in pelle e simili                 ,1,0,0,1,2,2021
VEN,VR,C 16,Industria del legno e dei prodotti in legno e sughero (es...,1,0,0,0,1,2021
VEN,VR,C 17,Fabbricazione di carta e di prodotti di carta               ,1,0,0,0,1,2021
VEN,VR,C 18,Stampa e riproduzione di supporti registrati                ,2,0,0,0,2,2021
VEN,VR,C 19,Fabbricazione di coke e prodotti derivanti dalla raffinaz...,0,0,0,0,0,2021
VEN,VR,C 20,Fabbricazione di prodotti chimici                           ,0,0,0,0,0,2021
VEN,VR,C 21,Fabbricazione di prodotti farmaceutici di base e di prepa...,0,0,0,0,0,2021
VEN,VR,C 22,Fabbricazione di articoli in gomma e materie plastiche      ,0,0,0,0,0,2021
VEN,VR,C 23,Fabbricazione di altri prodotti della lavorazione di miner..,2,0,2,0,4,2021
VEN,VR,C 24,Metallurgia                                                 ,0,0,0,0,0,2021
VEN,VR,C 25,Fabbricazione di prodotti in metallo (esclusi macchinari ...,4,2,3,0,9,2021
VEN,VR,C 26,Fabbricazione di computer e prodotti di elettronica e ott...,0,0,0,0,0,2021
VEN,VR,C 27,Fabbricazione di apparecchiature elettriche ed apparecchi...,2,0,0,0,2,2021
VEN,VR,C 28,Fabbricazione di macchinari ed apparecchiature nca          ,2,0,0,0,2,2021
VEN,VR,C 29,"Fabbricazione di autoveicoli, rimorchi e semirimorchi       ",0,0,0,0,0,2021
VEN,VR,C 30,Fabbricazione di altri mezzi di trasporto                   ,0,0,0,0,0,2021
VEN,VR,C 31,Fabbricazione di mobili                                     ,4,0,0,0,4,2021
VEN,VR,C 32,Altre industrie manifatturiere                              ,1,0,0,0,1,2021
VEN,VR,C 33,"Riparazione, manutenzione ed installazione di macchine ed...",1,0,1,0,2,2021
VEN,VR,D   ,"Fornitura di energia elettrica, gas, vapore e aria condiz...",0,0,0,0,0,2021
VEN,VR,D 35,"Fornitura di energia elettrica, gas, vapore e aria condiz...",0,0,0,0,0,2021
VEN,VR,E   ,"Fornitura di acqua; reti fognarie, attività di gestione d...",1,0,0,0,1,2021
VEN,VR,E 36,"Raccolta, trattamento e fornitura di acqua                  ",0,0,0,0,0,2021
VEN,VR,E 37,Gestione delle reti fognarie                                ,1,0,0,0,1,2021
VEN,VR,E 38,"Attività di raccolta, trattamento e smaltimento dei rifiu...",0,0,0,0,0,2021
VEN,VR,E 39,Attività di risanamento e altri servizi di gestione dei r...,0,0,0,0,0,2021
VEN,VR,F   ,Costruzioni                                                 ,23,8,53,1,85,2021
VEN,VR,F 41,Costruzione di edifici                                      ,13,3,12,1,29,2021
VEN,VR,F 42,Ingegneria civile                                           ,1,0,0,0,1,2021
VEN,VR,F 43,Lavori di costruzione specializzati                         ,9,5,41,0,55,2021
VEN,VR,G   ,Commercio all'ingrosso e al dettaglio; riparazione di aut...,39,12,35,1,87,2021
VEN,VR,G 45,Commercio all'ingrosso e al dettaglio e riparazione di au...,2,1,0,0,3,2021
VEN,VR,G 46,Commercio all'ingrosso (escluso quello di autoveicoli e d...,26,1,12,0,39,2021
VEN,VR,G 47,Commercio al dettaglio (escluso quello di autoveicoli e d...,11,10,23,1,45,2021
VEN,VR,H   ,Trasporto e magazzinaggio                                   ,5,1,2,2,10,2021
VEN,VR,H 49,Trasporto terrestre e mediante condotte                     ,3,1,1,0,5,2021
VEN,VR,H 50,Trasporto marittimo e per vie d'acqua                       ,0,0,0,0,0,2021
VEN,VR,H 51,Trasporto aereo                                             ,0,0,0,0,0,2021
VEN,VR,H 52,Magazzinaggio e attività di supporto ai trasporti           ,2,0,0,2,4,2021
VEN,VR,H 53,Servizi postali e attività di corriere                      ,0,0,1,0,1,2021
VEN,VR,I   ,Attività dei servizi alloggio e ristorazione                ,5,41,9,0,55,2021
VEN,VR,I 55,Alloggio                                                    ,1,0,1,0,2,2021
VEN,VR,I 56,Attività dei servizi di ristorazione                        ,4,41,8,0,53,2021
VEN,VR,J   ,Servizi di informazione e comunicazione                     ,6,4,1,0,11,2021
VEN,VR,J 58,Attività editoriali                                         ,0,1,0,0,1,2021
VEN,VR,J 59,"Attività di produzione cinematografica, di video e di pro...",0,1,0,0,1,2021
VEN,VR,J 60,Attività di programmazione e trasmissione                   ,0,0,0,0,0,2021
VEN,VR,J 61,Telecomunicazioni                                           ,2,2,1,0,5,2021
VEN,VR,J 62,"Produzione di software, consulenza informatica e attività...",4,0,0,0,4,2021
VEN,VR,J 63,Attività dei servizi d'informazione e altri servizi infor...,0,0,0,0,0,2021
VEN,VR,K   ,Attività finanziarie e assicurative                         ,1,1,2,0,4,2021
VEN,VR,K 64,Attività di servizi finanziari (escluse le assicurazioni ...,0,0,0,0,0,2021
VEN,VR,K 65,"Assicurazioni, riassicurazioni e fondi pensione (escluse ...",0,0,0,0,0,2021
VEN,VR,K 66,Attività ausiliarie dei servizi finanziari e delle attivi...,1,1,2,0,4,2021
VEN,VR,L   ,Attivita' immobiliari                                       ,17,1,0,0,18,2021
VEN,VR,L 68,Attivita' immobiliari                                       ,17,1,0,0,18,2021
VEN,VR,M   ,"Attività professionali, scientifiche e tecniche             ",7,0,3,0,10,2021
VEN,VR,M 69,Attività legali e contabilità                               ,0,0,0,0,0,2021
VEN,VR,M 70,Attività di direzione aziendale e di consulenza gestional...,3,0,1,0,4,2021
VEN,VR,M 71,Attività degli studi di architettura e d'ingegneria; coll...,0,0,1,0,1,2021
VEN,VR,M 72,Ricerca scientifica e sviluppo                              ,0,0,0,0,0,2021
VEN,VR,M 73,Pubblicità e ricerche di mercato                            ,2,0,0,0,2,2021
VEN,VR,M 74,"Altre attività professionali, scientifiche e tecniche       ",2,0,1,0,3,2021
VEN,VR,M 75,Servizi veterinari                                          ,0,0,0,0,0,2021
VEN,VR,N   ,"Noleggio, agenzie di viaggio, servizi di supporto alle im...",7,1,3,1,12,2021
VEN,VR,N 77,Attività di noleggio e leasing operativo                    ,1,0,0,0,1,2021
VEN,VR,N 78,"Attività di ricerca, selezione, fornitura di personale      ",0,0,0,0,0,2021
VEN,VR,N 79,"Attività dei servizi delle agenzie di viaggio, dei tour o...",3,0,0,0,3,2021
VEN,VR,N 80,Servizi di vigilanza e investigazione                       ,0,0,0,0,0,2021
VEN,VR,N 81,Attività di servizi per edifici e paesaggio                 ,1,0,1,1,3,2021
VEN,VR,N 82,Attività di supporto per le funzioni d'ufficio e altri se...,2,1,2,0,5,2021
VEN,VR,O   ,Amministrazione pubblica e difesa; assicurazione sociale ...,0,0,0,0,0,2021
VEN,VR,O 84,Amministrazione pubblica e difesa; assicurazione sociale ...,0,0,0,0,0,2021
VEN,VR,P   ,Istruzione                                                  ,0,0,0,0,0,2021
VEN,VR,P 85,Istruzione                                                  ,0,0,0,0,0,2021
VEN,VR,Q   ,Sanita' e assistenza sociale                                ,0,0,0,0,0,2021
VEN,VR,Q 86,Assistenza sanitaria                                        ,0,0,0,0,0,2021
VEN,VR,Q 87,Servizi di assistenza sociale residenziale                  ,0,0,0,0,0,2021
VEN,VR,Q 88,Assistenza sociale non residenziale                         ,0,0,0,0,0,2021
VEN,VR,R   ,"Attività artistiche, sportive, di intrattenimento e diver...",6,2,0,0,8,2021
VEN,VR,R 90,"Attività creative, artistiche e di intrattenimento          ",1,0,0,0,1,2021
VEN,VR,R 91,"Attività di biblioteche, archivi, musei ed altre attività...",0,0,0,0,0,2021
VEN,VR,R 92,"Attività riguardanti le lotterie, le scommesse, le case d...",1,0,0,0,1,2021
VEN,VR,R 93,"Attività sportive, di intrattenimento e di divertimento     ",4,2,0,0,6,2021
VEN,VR,S   ,Altre attività di servizi                                   ,2,0,3,0,5,2021
VEN,VR,S 94,Attività di organizzazioni associative                      ,0,0,0,0,0,2021
VEN,VR,S 95,Riparazione di computer e di beni per uso personale e per...,0,0,2,0,2,2021
VEN,VR,S 96,Altre attività di servizi per la persona                    ,2,0,1,0,3,2021
VEN,VR,T   ,Attività di famiglie e convivenze come datori di lavoro p...,0,0,0,0,0,2021
VEN,VR,T 97,Attività di famiglie e convivenze come datori di lavoro p...,0,0,0,0,0,2021
VEN,VR,T 98,Produzione di beni e servizi indifferenziati per uso prop...,0,0,0,0,0,2021
VEN,VR,U   ,Organizzazioni ed organismi extraterritoriali               ,0,0,0,0,0,2021
VEN,VR,U 99,Organizzazioni ed organismi extraterritoriali               ,0,0,0,0,0,2021
VEN,VR,XX  ,Imprese non classificate                                    ,68,22,8,2,100,2021
VEN,VR,TOT ,TOTALE                                                      ,216,100,139,9,464,2021
VEN,VI,A   ,"Agricoltura, silvicoltura pesca                             ",3,1,0,2,6,2021
VEN,VI,A 01,"Coltivazioni agricole e produzione di prodotti animali, c...",3,1,0,2,6,2021
VEN,VI,A 02,Silvicoltura ed utilizzo di aree forestali                  ,0,0,0,0,0,2021
VEN,VI,A 03,Pesca e acquacoltura                                        ,0,0,0,0,0,2021
VEN,VI,B   ,Estrazione di minerali da cave e miniere                    ,3,0,0,0,3,2021
VEN,VI,B 05,Estrazione di carbone (esclusa torba)                       ,0,0,0,0,0,2021
VEN,VI,B 06,Estraz.di petrolio greggio e di gas naturale                ,0,0,0,0,0,2021
VEN,VI,B 07,Estrazione di minerali metalliferi                          ,0,0,0,0,0,2021
VEN,VI,B 08,Altre attività di estrazione di minerali da cave e miniere  ,3,0,0,0,3,2021
VEN,VI,B 09,Attività dei servizi di supporto all'estrazione             ,0,0,0,0,0,2021
VEN,VI,C   ,Attività manifatturiere                                     ,162,75,40,3,280,2021
VEN,VI,C 10,Industrie alimentari                                        ,8,3,3,2,16,2021
VEN,VI,C 11,Industria delle bevande                                     ,0,0,0,0,0,2021
VEN,VI,C 12,Industria del tabacco                                       ,0,0,0,0,0,2021
VEN,VI,C 13,Industrie tessili                                           ,5,5,1,0,11,2021
VEN,VI,C 14,Confezione di articoli di abbigliamento; confezione di ar...,33,16,18,0,67,2021
VEN,VI,C 15,Fabbricazione di articoli in pelle e simili                 ,27,13,5,0,45,2021
VEN,VI,C 16,Industria del legno e dei prodotti in legno e sughero (es...,3,0,0,0,3,2021
VEN,VI,C 17,Fabbricazione di carta e di prodotti di carta               ,4,0,0,0,4,2021
VEN,VI,C 18,Stampa e riproduzione di supporti registrati                ,1,1,0,0,2,2021
VEN,VI,C 19,Fabbricazione di coke e prodotti derivanti dalla raffinaz...,0,0,0,0,0,2021
VEN,VI,C 20,Fabbricazione di prodotti chimici                           ,6,1,1,0,8,2021
VEN,VI,C 21,Fabbricazione di prodotti farmaceutici di base e di prepa...,0,0,0,0,0,2021
VEN,VI,C 22,Fabbricazione di articoli in gomma e materie plastiche      ,3,1,0,0,4,2021
VEN,VI,C 23,Fabbricazione di altri prodotti della lavorazione di miner..,6,3,2,1,12,2021
VEN,VI,C 24,Metallurgia                                                 ,6,0,0,0,6,2021
VEN,VI,C 25,Fabbricazione di prodotti in metallo (esclusi macchinari ...,12,19,5,0,36,2021
VEN,VI,C 26,Fabbricazione di computer e prodotti di elettronica e ott...,0,0,0,0,0,2021
VEN,VI,C 27,Fabbricazione di apparecchiature elettriche ed apparecchi...,3,0,0,0,3,2021
VEN,VI,C 28,Fabbricazione di macchinari ed apparecchiature nca          ,18,9,0,0,27,2021
VEN,VI,C 29,"Fabbricazione di autoveicoli, rimorchi e semirimorchi       ",0,0,0,0,0,2021
VEN,VI,C 30,Fabbricazione di altri mezzi di trasporto                   ,2,0,1,0,3,2021
VEN,VI,C 31,Fabbricazione di mobili                                     ,13,1,1,0,15,2021
VEN,VI,C 32,Altre industrie manifatturiere                              ,12,3,3,0,18,2021
VEN,VI,C 33,"Riparazione, manutenzione ed installazione di macchine ed...",0,0,0,0,0,2021
VEN,VI,D   ,"Fornitura di energia elettrica, gas, vapore e aria condiz...",0,0,0,0,0,2021
VEN,VI,D 35,"Fornitura di energia elettrica, gas, vapore e aria condiz...",0,0,0,0,0,2021
VEN,VI,E   ,"Fornitura di acqua; reti fognarie, attività di gestione d...",1,0,0,0,1,2021
VEN,VI,E 36,"Raccolta, trattamento e fornitura di acqua                  ",0,0,0,0,0,2021
VEN,VI,E 37,Gestione delle reti fognarie                                ,0,0,0,0,0,2021
VEN,VI,E 38,"Attività di raccolta, trattamento e smaltimento dei rifiu...",1,0,0,0,1,2021
VEN,VI,E 39,Attività di risanamento e altri servizi di gestione dei r...,0,0,0,0,0,2021
VEN,VI,F   ,Costruzioni                                                 ,13,11,26,4,54,2021
VEN,VI,F 41,Costruzione di edifici                                      ,11,8,8,4,31,2021
VEN,VI,F 42,Ingegneria civile                                           ,1,0,0,0,1,2021
VEN,VI,F 43,Lavori di costruzione specializzati                         ,1,3,18,0,22,2021
VEN,VI,G   ,Commercio all'ingrosso e al dettaglio; riparazione di aut...,91,46,89,3,229,2021
VEN,VI,G 45,Commercio all'ingrosso e al dettaglio e riparazione di au...,4,5,12,0,21,2021
VEN,VI,G 46,Commercio all'ingrosso (escluso quello di autoveicoli e d...,66,29,19,1,115,2021
VEN,VI,G 47,Commercio al dettaglio (escluso quello di autoveicoli e d...,21,12,58,2,93,2021
VEN,VI,H   ,Trasporto e magazzinaggio                                   ,9,1,2,1,13,2021
VEN,VI,H 49,Trasporto terrestre e mediante condotte                     ,7,0,2,0,9,2021
VEN,VI,H 50,Trasporto marittimo e per vie d'acqua                       ,0,0,0,0,0,2021
VEN,VI,H 51,Trasporto aereo                                             ,0,0,0,0,0,2021
VEN,VI,H 52,Magazzinaggio e attività di supporto ai trasporti           ,2,1,0,1,4,2021
VEN,VI,H 53,Servizi postali e attività di corriere                      ,0,0,0,0,0,2021
VEN,VI,I   ,Attività dei servizi alloggio e ristorazione                ,10,7,15,0,32,2021
VEN,VI,I 55,Alloggio                                                    ,1,2,1,0,4,2021
VEN,VI,I 56,Attività dei servizi di ristorazione                        ,9,5,14,0,28,2021
VEN,VI,J   ,Servizi di informazione e comunicazione                     ,6,0,5,1,12,2021
VEN,VI,J 58,Attività editoriali                                         ,2,0,1,1,4,2021
VEN,VI,J 59,"Attività di produzione cinematografica, di video e di pro...",0,0,0,0,0,2021
VEN,VI,J 60,Attività di programmazione e trasmissione                   ,1,0,0,0,1,2021
VEN,VI,J 61,Telecomunicazioni                                           ,0,0,2,0,2,2021
VEN,VI,J 62,"Produzione di software, consulenza informatica e attività...",0,0,2,0,2,2021
VEN,VI,J 63,Attività dei servizi d'informazione e altri servizi infor...,3,0,0,0,3,2021
VEN,VI,K   ,Attività finanziarie e assicurative                         ,8,0,1,0,9,2021
VEN,VI,K 64,Attività di servizi finanziari (escluse le assicurazioni ...,5,0,0,0,5,2021
VEN,VI,K 65,"Assicurazioni, riassicurazioni e fondi pensione (escluse ...",1,0,0,0,1,2021
VEN,VI,K 66,Attività ausiliarie dei servizi finanziari e delle attivi...,2,0,1,0,3,2021
VEN,VI,L   ,Attivita' immobiliari                                       ,14,5,0,2,21,2021
VEN,VI,L 68,Attivita' immobiliari                                       ,14,5,0,2,21,2021
VEN,VI,M   ,"Attività professionali, scientifiche e tecniche             ",14,2,10,0,26,2021
VEN,VI,M 69,Attività legali e contabilità                               ,0,0,1,0,1,2021
VEN,VI,M 70,Attività di direzione aziendale e di consulenza gestional...,1,0,1,0,2,2021
VEN,VI,M 71,Attività degli studi di architettura e d'ingegneria; coll...,3,1,1,0,5,2021
VEN,VI,M 72,Ricerca scientifica e sviluppo                              ,0,0,0,0,0,2021
VEN,VI,M 73,Pubblicità e ricerche di mercato                            ,2,0,4,0,6,2021
VEN,VI,M 74,"Altre attività professionali, scientifiche e tecniche       ",8,1,3,0,12,2021
VEN,VI,M 75,Servizi veterinari                                          ,0,0,0,0,0,2021
VEN,VI,N   ,"Noleggio, agenzie di viaggio, servizi di supporto alle im...",3,0,6,1,10,2021
VEN,VI,N 77,Attività di noleggio e leasing operativo                    ,2,0,0,0,2,2021
VEN,VI,N 78,"Attività di ricerca, selezione, fornitura di personale      ",0,0,0,0,0,2021
VEN,VI,N 79,"Attività dei servizi delle agenzie di viaggio, dei tour o...",1,0,0,0,1,2021
VEN,VI,N 80,Servizi di vigilanza e investigazione                       ,0,0,0,0,0,2021
VEN,VI,N 81,Attività di servizi per edifici e paesaggio                 ,0,0,0,1,1,2021
VEN,VI,N 82,Attività di supporto per le funzioni d'ufficio e altri se...,0,0,6,0,6,2021
VEN,VI,O   ,Amministrazione pubblica e difesa; assicurazione sociale ...,0,0,0,0,0,2021
VEN,VI,O 84,Amministrazione pubblica e difesa; assicurazione sociale ...,0,0,0,0,0,2021
VEN,VI,P   ,Istruzione                                                  ,1,0,0,0,1,2021
VEN,VI,P 85,Istruzione                                                  ,1,0,0,0,1,2021
VEN,VI,Q   ,Sanita' e assistenza sociale                                ,1,1,2,2,6,2021
VEN,VI,Q 86,Assistenza sanitaria                                        ,0,0,0,1,1,2021
VEN,VI,Q 87,Servizi di assistenza sociale residenziale                  ,0,0,0,0,0,2021
VEN,VI,Q 88,Assistenza sociale non residenziale                         ,1,1,2,1,5,2021
VEN,VI,R   ,"Attività artistiche, sportive, di intrattenimento e diver...",3,0,2,0,5,2021
VEN,VI,R 90,"Attività creative, artistiche e di intrattenimento          ",0,0,0,0,0,2021
VEN,VI,R 91,"Attività di biblioteche, archivi, musei ed altre attività...",0,0,0,0,0,2021
VEN,VI,R 92,"Attività riguardanti le lotterie, le scommesse, le case d...",0,0,0,0,0,2021
VEN,VI,R 93,"Attività sportive, di intrattenimento e di divertimento     ",3,0,2,0,5,2021
VEN,VI,S   ,Altre attività di servizi                                   ,2,0,3,0,5,2021
VEN,VI,S 94,Attività di organizzazioni associative                      ,0,0,0,0,0,2021
VEN,VI,S 95,Riparazione di computer e di beni per uso personale e per...,2,0,2,0,4,2021
VEN,VI,S 96,Altre attività di servizi per la persona                    ,0,0,1,0,1,2021
VEN,VI,T   ,Attività di famiglie e convivenze come datori di lavoro p...,0,0,0,0,0,2021
VEN,VI,T 97,Attività di famiglie e convivenze come datori di lavoro p...,0,0,0,0,0,2021
VEN,VI,T 98,Produzione di beni e servizi indifferenziati per uso prop...,0,0,0,0,0,2021
VEN,VI,U   ,Organizzazioni ed organismi extraterritoriali               ,0,0,0,0,0,2021
VEN,VI,U 99,Organizzazioni ed organismi extraterritoriali               ,0,0,0,0,0,2021
VEN,VI,XX  ,Imprese non classificate                                    ,518,181,4,8,711,2021
VEN,VI,TOT ,TOTALE                                                      ,862,330,205,27,1424,2021
VEN,BL,A   ,"Agricoltura, silvicoltura pesca                             ",1,0,0,1,2,2021
VEN,BL,A 01,"Coltivazioni agricole e produzione di prodotti animali, c...",1,0,0,1,2,2021
VEN,BL,A 02,Silvicoltura ed utilizzo di aree forestali                  ,0,0,0,0,0,2021
VEN,BL,A 03,Pesca e acquacoltura                                        ,0,0,0,0,0,2021
VEN,BL,B   ,Estrazione di minerali da cave e miniere                    ,0,0,0,0,0,2021
VEN,BL,B 05,Estrazione di carbone (esclusa torba)                       ,0,0,0,0,0,2021
VEN,BL,B 06,Estraz.di petrolio greggio e di gas naturale                ,0,0,0,0,0,2021
VEN,BL,B 07,Estrazione di minerali metalliferi                          ,0,0,0,0,0,2021
VEN,BL,B 08,Altre attività di estrazione di minerali da cave e miniere  ,0,0,0,0,0,2021
VEN,BL,B 09,Attività dei servizi di supporto all'estrazione             ,0,0,0,0,0,2021
VEN,BL,C   ,Attività manifatturiere                                     ,16,0,0,0,16,2021
VEN,BL,C 10,Industrie alimentari                                        ,0,0,0,0,0,2021
VEN,BL,C 11,Industria delle bevande                                     ,0,0,0,0,0,2021
VEN,BL,C 12,Industria del tabacco                                       ,0,0,0,0,0,2021
VEN,BL,C 13,Industrie tessili                                           ,0,0,0,0,0,2021
VEN,BL,C 14,Confezione di articoli di abbigliamento; confezione di ar...,2,0,0,0,2,2021
VEN,BL,C 15,Fabbricazione di articoli in pelle e simili                 ,1,0,0,0,1,2021
VEN,BL,C 16,Industria del legno e dei prodotti in legno e sughero (es...,1,0,0,0,1,2021
VEN,BL,C 17,Fabbricazione di carta e di prodotti di carta               ,0,0,0,0,0,2021
VEN,BL,C 18,Stampa e riproduzione di supporti registrati                ,1,0,0,0,1,2021
VEN,BL,C 19,Fabbricazione di coke e prodotti derivanti dalla raffinaz...,0,0,0,0,0,2021
VEN,BL,C 20,Fabbricazione di prodotti chimici                           ,1,0,0,0,1,2021
VEN,BL,C 21,Fabbricazione di prodotti farmaceutici di base e di prepa...,0,0,0,0,0,2021
VEN,BL,C 22,Fabbricazione di articoli in gomma e materie plastiche      ,0,0,0,0,0,2021
VEN,BL,C 23,Fabbricazione di altri prodotti della lavorazione di miner..,2,0,0,0,2,2021
VEN,BL,C 24,Metallurgia                                                 ,0,0,0,0,0,2021
VEN,BL,C 25,Fabbricazione di prodotti in metallo (esclusi macchinari ...,2,0,0,0,2,2021
VEN,BL,C 26,Fabbricazione di computer e prodotti di elettronica e ott...,0,0,0,0,0,2021
VEN,BL,C 27,Fabbricazione di apparecchiature elettriche ed apparecchi...,0,0,0,0,0,2021
VEN,BL,C 28,Fabbricazione di macchinari ed apparecchiature nca          ,0,0,0,0,0,2021
VEN,BL,C 29,"Fabbricazione di autoveicoli, rimorchi e semirimorchi       ",0,0,0,0,0,2021
VEN,BL,C 30,Fabbricazione di altri mezzi di trasporto                   ,0,0,0,0,0,2021
VEN,BL,C 31,Fabbricazione di mobili                                     ,0,0,0,0,0,2021
VEN,BL,C 32,Altre industrie manifatturiere                              ,6,0,0,0,6,2021
VEN,BL,C 33,"Riparazione, manutenzione ed installazione di macchine ed...",0,0,0,0,0,2021
VEN,BL,D   ,"Fornitura di energia elettrica, gas, vapore e aria condiz...",0,0,0,1,1,2021
VEN,BL,D 35,"Fornitura di energia elettrica, gas, vapore e aria condiz...",0,0,0,1,1,2021
VEN,BL,E   ,"Fornitura di acqua; reti fognarie, attività di gestione d...",0,0,0,0,0,2021
VEN,BL,E 36,"Raccolta, trattamento e fornitura di acqua                  ",0,0,0,0,0,2021
VEN,BL,E 37,Gestione delle reti fognarie                                ,0,0,0,0,0,2021
VEN,BL,E 38,"Attività di raccolta, trattamento e smaltimento dei rifiu...",0,0,0,0,0,2021
VEN,BL,E 39,Attività di risanamento e altri servizi di gestione dei r...,0,0,0,0,0,2021
VEN,BL,F   ,Costruzioni                                                 ,9,0,14,0,23,2021
VEN,BL,F 41,Costruzione di edifici                                      ,7,0,0,0,7,2021
VEN,BL,F 42,Ingegneria civile                                           ,0,0,0,0,0,2021
VEN,BL,F 43,Lavori di costruzione specializzati                         ,2,0,14,0,16,2021
VEN,BL,G   ,Commercio all'ingrosso e al dettaglio; riparazione di aut...,12,0,11,0,23,2021
VEN,BL,G 45,Commercio all'ingrosso e al dettaglio e riparazione di au...,0,0,1,0,1,2021
VEN,BL,G 46,Commercio all'ingrosso (escluso quello di autoveicoli e d...,3,0,2,0,5,2021
VEN,BL,G 47,Commercio al dettaglio (escluso quello di autoveicoli e d...,9,0,8,0,17,2021
VEN,BL,H   ,Trasporto e magazzinaggio                                   ,0,0,0,0,0,2021
VEN,BL,H 49,Trasporto terrestre e mediante condotte                     ,0,0,0,0,0,2021
VEN,BL,H 50,Trasporto marittimo e per vie d'acqua                       ,0,0,0,0,0,2021
VEN,BL,H 51,Trasporto aereo                                             ,0,0,0,0,0,2021
VEN,BL,H 52,Magazzinaggio e attività di supporto ai trasporti           ,0,0,0,0,0,2021
VEN,BL,H 53,Servizi postali e attività di corriere                      ,0,0,0,0,0,2021
VEN,BL,I   ,Attività dei servizi alloggio e ristorazione                ,3,0,1,0,4,2021
VEN,BL,I 55,Alloggio                                                    ,0,0,0,0,0,2021
VEN,BL,I 56,Attività dei servizi di ristorazione                        ,3,0,1,0,4,2021
VEN,BL,J   ,Servizi di informazione e comunicazione                     ,1,0,0,1,2,2021
VEN,BL,J 58,Attività editoriali                                         ,0,0,0,1,1,2021
VEN,BL,J 59,"Attività di produzione cinematografica, di video e di pro...",0,0,0,0,0,2021
VEN,BL,J 60,Attività di programmazione e trasmissione                   ,0,0,0,0,0,2021
VEN,BL,J 61,Telecomunicazioni                                           ,0,0,0,0,0,2021
VEN,BL,J 62,"Produzione di software, consulenza informatica e attività...",1,0,0,0,1,2021
VEN,BL,J 63,Attività dei servizi d'informazione e altri servizi infor...,0,0,0,0,0,2021
VEN,BL,K   ,Attività finanziarie e assicurative                         ,0,0,0,0,0,2021
VEN,BL,K 64,Attività di servizi finanziari (escluse le assicurazioni ...,0,0,0,0,0,2021
VEN,BL,K 65,"Assicurazioni, riassicurazioni e fondi pensione (escluse ...",0,0,0,0,0,2021
VEN,BL,K 66,Attività ausiliarie dei servizi finanziari e delle attivi...,0,0,0,0,0,2021
VEN,BL,L   ,Attivita' immobiliari                                       ,5,0,0,0,5,2021
VEN,BL,L 68,Attivita' immobiliari                                       ,5,0,0,0,5,2021
VEN,BL,M   ,"Attività professionali, scientifiche e tecniche             ",3,0,0,0,3,2021
VEN,BL,M 69,Attività legali e contabilità                               ,0,0,0,0,0,2021
VEN,BL,M 70,Attività di direzione aziendale e di consulenza gestional...,1,0,0,0,1,2021
VEN,BL,M 71,Attività degli studi di architettura e d'ingegneria; coll...,2,0,0,0,2,2021
VEN,BL,M 72,Ricerca scientifica e sviluppo                              ,0,0,0,0,0,2021
VEN,BL,M 73,Pubblicità e ricerche di mercato                            ,0,0,0,0,0,2021
VEN,BL,M 74,"Altre attività professionali, scientifiche e tecniche       ",0,0,0,0,0,2021
VEN,BL,M 75,Servizi veterinari                                          ,0,0,0,0,0,2021
VEN,BL,N   ,"Noleggio, agenzie di viaggio, servizi di supporto alle im...",2,0,1,0,3,2021
VEN,BL,N 77,Attività di noleggio e leasing operativo                    ,1,0,0,0,1,2021
VEN,BL,N 78,"Attività di ricerca, selezione, fornitura di personale      ",0,0,0,0,0,2021
VEN,BL,N 79,"Attività dei servizi delle agenzie di viaggio, dei tour o...",0,0,0,0,0,2021
VEN,BL,N 80,Servizi di vigilanza e investigazione                       ,0,0,0,0,0,2021
VEN,BL,N 81,Attività di servizi per edifici e paesaggio                 ,1,0,1,0,2,2021
VEN,BL,N 82,Attività di supporto per le funzioni d'ufficio e altri se...,0,0,0,0,0,2021
VEN,BL,O   ,Amministrazione pubblica e difesa; assicurazione sociale ...,0,0,0,0,0,2021
VEN,BL,O 84,Amministrazione pubblica e difesa; assicurazione sociale ...,0,0,0,0,0,2021
VEN,BL,P   ,Istruzione                                                  ,0,0,0,0,0,2021
VEN,BL,P 85,Istruzione                                                  ,0,0,0,0,0,2021
VEN,BL,Q   ,Sanita' e assistenza sociale                                ,0,0,0,0,0,2021
VEN,BL,Q 86,Assistenza sanitaria                                        ,0,0,0,0,0,2021
VEN,BL,Q 87,Servizi di assistenza sociale residenziale                  ,0,0,0,0,0,2021
VEN,BL,Q 88,Assistenza sociale non residenziale                         ,0,0,0,0,0,2021
VEN,BL,R   ,"Attività artistiche, sportive, di intrattenimento e diver...",1,0,0,0,1,2021
VEN,BL,R 90,"Attività creative, artistiche e di intrattenimento          ",0,0,0,0,0,2021
VEN,BL,R 91,"Attività di biblioteche, archivi, musei ed altre attività...",0,0,0,0,0,2021
VEN,BL,R 92,"Attività riguardanti le lotterie, le scommesse, le case d...",1,0,0,0,1,2021
VEN,BL,R 93,"Attività sportive, di intrattenimento e di divertimento     ",0,0,0,0,0,2021
VEN,BL,S   ,Altre attività di servizi                                   ,0,0,0,0,0,2021
VEN,BL,S 94,Attività di organizzazioni associative                      ,0,0,0,0,0,2021
VEN,BL,S 95,Riparazione di computer e di beni per uso personale e per...,0,0,0,0,0,2021
VEN,BL,S 96,Altre attività di servizi per la persona                    ,0,0,0,0,0,2021
VEN,BL,T   ,Attività di famiglie e convivenze come datori di lavoro p...,0,0,0,0,0,2021
VEN,BL,T 97,Attività di famiglie e convivenze come datori di lavoro p...,0,0,0,0,0,2021
VEN,BL,T 98,Produzione di beni e servizi indifferenziati per uso prop...,0,0,0,0,0,2021
VEN,BL,U   ,Organizzazioni ed organismi extraterritoriali               ,0,0,0,0,0,2021
VEN,BL,U 99,Organizzazioni ed organismi extraterritoriali               ,0,0,0,0,0,2021
VEN,BL,XX  ,Imprese non classificate                                    ,0,0,0,1,1,2021
VEN,BL,TOT ,TOTALE                                                      ,53,0,27,4,84,2021
VEN,TV,A   ,"Agricoltura, silvicoltura pesca                             ",4,0,0,0,4,2021
VEN,TV,A 01,"Coltivazioni agricole e produzione di prodotti animali, c...",4,0,0,0,4,2021
VEN,TV,A 02,Silvicoltura ed utilizzo di aree forestali                  ,0,0,0,0,0,2021
VEN,TV,A 03,Pesca e acquacoltura                                        ,0,0,0,0,0,2021
VEN,TV,B   ,Estrazione di minerali da cave e miniere                    ,0,0,0,0,0,2021
VEN,TV,B 05,Estrazione di carbone (esclusa torba)                       ,0,0,0,0,0,2021
VEN,TV,B 06,Estraz.di petrolio greggio e di gas naturale                ,0,0,0,0,0,2021
VEN,TV,B 07,Estrazione di minerali metalliferi                          ,0,0,0,0,0,2021
VEN,TV,B 08,Altre attività di estrazione di minerali da cave e miniere  ,0,0,0,0,0,2021
VEN,TV,B 09,Attività dei servizi di supporto all'estrazione             ,0,0,0,0,0,2021
VEN,TV,C   ,Attività manifatturiere                                     ,146,0,2,2,150,2021
VEN,TV,C 10,Industrie alimentari                                        ,4,0,2,0,6,2021
VEN,TV,C 11,Industria delle bevande                                     ,0,0,0,0,0,2021
VEN,TV,C 12,Industria del tabacco                                       ,0,0,0,0,0,2021
VEN,TV,C 13,Industrie tessili                                           ,6,0,0,1,7,2021
VEN,TV,C 14,Confezione di articoli di abbigliamento; confezione di ar...,14,0,0,0,14,2021
VEN,TV,C 15,Fabbricazione di articoli in pelle e simili                 ,7,0,0,0,7,2021
VEN,TV,C 16,Industria del legno e dei prodotti in legno e sughero (es...,4,0,0,0,4,2021
VEN,TV,C 17,Fabbricazione di carta e di prodotti di carta               ,1,0,0,0,1,2021
VEN,TV,C 18,Stampa e riproduzione di supporti registrati                ,5,0,0,0,5,2021
VEN,TV,C 19,Fabbricazione di coke e prodotti derivanti dalla raffinaz...,0,0,0,0,0,2021
VEN,TV,C 20,Fabbricazione di prodotti chimici                           ,1,0,0,0,1,2021
VEN,TV,C 21,Fabbricazione di prodotti farmaceutici di base e di prepa...,0,0,0,0,0,2021
VEN,TV,C 22,Fabbricazione di articoli in gomma e materie plastiche      ,9,0,0,0,9,2021
VEN,TV,C 23,Fabbricazione di altri prodotti della lavorazione di miner..,5,0,0,0,5,2021
VEN,TV,C 24,Metallurgia                                                 ,6,0,0,0,6,2021
VEN,TV,C 25,Fabbricazione di prodotti in metallo (esclusi macchinari ...,24,0,0,0,24,2021
VEN,TV,C 26,Fabbricazione di computer e prodotti di elettronica e ott...,2,0,0,0,2,2021
VEN,TV,C 27,Fabbricazione di apparecchiature elettriche ed apparecchi...,8,0,0,0,8,2021
VEN,TV,C 28,Fabbricazione di macchinari ed apparecchiature nca          ,9,0,0,0,9,2021
VEN,TV,C 29,"Fabbricazione di autoveicoli, rimorchi e semirimorchi       ",2,0,0,0,2,2021
VEN,TV,C 30,Fabbricazione di altri mezzi di trasporto                   ,2,0,0,0,2,2021
VEN,TV,C 31,Fabbricazione di mobili                                     ,28,0,0,0,28,2021
VEN,TV,C 32,Altre industrie manifatturiere                              ,7,0,0,0,7,2021
VEN,TV,C 33,"Riparazione, manutenzione ed installazione di macchine ed...",2,0,0,1,3,2021
VEN,TV,D   ,"Fornitura di energia elettrica, gas, vapore e aria condiz...",1,0,0,0,1,2021
VEN,TV,D 35,"Fornitura di energia elettrica, gas, vapore e aria condiz...",1,0,0,0,1,2021
VEN,TV,E   ,"Fornitura di acqua; reti fognarie, attività di gestione d...",2,0,0,0,2,2021
VEN,TV,E 36,"Raccolta, trattamento e fornitura di acqua                  ",0,0,0,0,0,2021
VEN,TV,E 37,Gestione delle reti fognarie                                ,0,0,0,0,0,2021
VEN,TV,E 38,"Attività di raccolta, trattamento e smaltimento dei rifiu...",2,0,0,0,2,2021
VEN,TV,E 39,Attività di risanamento e altri servizi di gestione dei r...,0,0,0,0,0,2021
VEN,TV,F   ,Costruzioni                                                 ,88,0,4,2,94,2021
VEN,TV,F 41,Costruzione di edifici                                      ,49,0,3,1,53,2021
VEN,TV,F 42,Ingegneria civile                                           ,1,0,0,1,2,2021
VEN,TV,F 43,Lavori di costruzione specializzati                         ,38,0,1,0,39,2021
VEN,TV,G   ,Commercio all'ingrosso e al dettaglio; riparazione di aut...,151,2,62,0,215,2021
VEN,TV,G 45,Commercio all'ingrosso e al dettaglio e riparazione di au...,19,2,27,0,48,2021
VEN,TV,G 46,Commercio all'ingrosso (escluso quello di autoveicoli e d...,97,0,26,0,123,2021
VEN,TV,G 47,Commercio al dettaglio (escluso quello di autoveicoli e d...,35,0,9,0,44,2021
VEN,TV,H   ,Trasporto e magazzinaggio                                   ,22,0,0,3,25,2021
VEN,TV,H 49,Trasporto terrestre e mediante condotte                     ,15,0,0,0,15,2021
VEN,TV,H 50,Trasporto marittimo e per vie d'acqua                       ,0,0,0,0,0,2021
VEN,TV,H 51,Trasporto aereo                                             ,0,0,0,0,0,2021
VEN,TV,H 52,Magazzinaggio e attività di supporto ai trasporti           ,6,0,0,3,9,2021
VEN,TV,H 53,Servizi postali e attività di corriere                      ,1,0,0,0,1,2021
VEN,TV,I   ,Attività dei servizi alloggio e ristorazione                ,22,1,1,0,24,2021
VEN,TV,I 55,Alloggio                                                    ,1,0,0,0,1,2021
VEN,TV,I 56,Attività dei servizi di ristorazione                        ,21,1,1,0,23,2021
VEN,TV,J   ,Servizi di informazione e comunicazione                     ,20,0,0,0,20,2021
VEN,TV,J 58,Attività editoriali                                         ,4,0,0,0,4,2021
VEN,TV,J 59,"Attività di produzione cinematografica, di video e di pro...",1,0,0,0,1,2021
VEN,TV,J 60,Attività di programmazione e trasmissione                   ,1,0,0,0,1,2021
VEN,TV,J 61,Telecomunicazioni                                           ,0,0,0,0,0,2021
VEN,TV,J 62,"Produzione di software, consulenza informatica e attività...",9,0,0,0,9,2021
VEN,TV,J 63,Attività dei servizi d'informazione e altri servizi infor...,5,0,0,0,5,2021
VEN,TV,K   ,Attività finanziarie e assicurative                         ,7,0,1,0,8,2021
VEN,TV,K 64,Attività di servizi finanziari (escluse le assicurazioni ...,3,0,0,0,3,2021
VEN,TV,K 65,"Assicurazioni, riassicurazioni e fondi pensione (escluse ...",0,0,0,0,0,2021
VEN,TV,K 66,Attività ausiliarie dei servizi finanziari e delle attivi...,4,0,1,0,5,2021
VEN,TV,L   ,Attivita' immobiliari                                       ,51,1,2,0,54,2021
VEN,TV,L 68,Attivita' immobiliari                                       ,51,1,2,0,54,2021
VEN,TV,M   ,"Attività professionali, scientifiche e tecniche             ",46,0,1,4,51,2021
VEN,TV,M 69,Attività legali e contabilità                               ,2,0,0,0,2,2021
VEN,TV,M 70,Attività di direzione aziendale e di consulenza gestional...,18,0,0,1,19,2021
VEN,TV,M 71,Attività degli studi di architettura e d'ingegneria; coll...,7,0,0,0,7,2021
VEN,TV,M 72,Ricerca scientifica e sviluppo                              ,0,0,0,0,0,2021
VEN,TV,M 73,Pubblicità e ricerche di mercato                            ,8,0,1,0,9,2021
VEN,TV,M 74,"Altre attività professionali, scientifiche e tecniche       ",11,0,0,3,14,2021
VEN,TV,M 75,Servizi veterinari                                          ,0,0,0,0,0,2021
VEN,TV,N   ,"Noleggio, agenzie di viaggio, servizi di supporto alle im...",18,0,1,2,21,2021
VEN,TV,N 77,Attività di noleggio e leasing operativo                    ,5,0,0,0,5,2021
VEN,TV,N 78,"Attività di ricerca, selezione, fornitura di personale      ",0,0,0,0,0,2021
VEN,TV,N 79,"Attività dei servizi delle agenzie di viaggio, dei tour o...",5,0,0,0,5,2021
VEN,TV,N 80,Servizi di vigilanza e investigazione                       ,0,0,0,0,0,2021
VEN,TV,N 81,Attività di servizi per edifici e paesaggio                 ,1,0,0,2,3,2021
VEN,TV,N 82,Attività di supporto per le funzioni d'ufficio e altri se...,7,0,1,0,8,2021
VEN,TV,O   ,Amministrazione pubblica e difesa; assicurazione sociale ...,0,0,0,0,0,2021
VEN,TV,O 84,Amministrazione pubblica e difesa; assicurazione sociale ...,0,0,0,0,0,2021
VEN,TV,P   ,Istruzione                                                  ,1,0,0,0,1,2021
VEN,TV,P 85,Istruzione                                                  ,1,0,0,0,1,2021
VEN,TV,Q   ,Sanita' e assistenza sociale                                ,2,0,0,3,5,2021
VEN,TV,Q 86,Assistenza sanitaria                                        ,2,0,0,1,3,2021
VEN,TV,Q 87,Servizi di assistenza sociale residenziale                  ,0,0,0,0,0,2021
VEN,TV,Q 88,Assistenza sociale non residenziale                         ,0,0,0,2,2,2021
VEN,TV,R   ,"Attività artistiche, sportive, di intrattenimento e diver...",17,0,0,0,17,2021
VEN,TV,R 90,"Attività creative, artistiche e di intrattenimento          ",6,0,0,0,6,2021
VEN,TV,R 91,"Attività di biblioteche, archivi, musei ed altre attività...",0,0,0,0,0,2021
VEN,TV,R 92,"Attività riguardanti le lotterie, le scommesse, le case d...",1,0,0,0,1,2021
VEN,TV,R 93,"Attività sportive, di intrattenimento e di divertimento     ",10,0,0,0,10,2021
VEN,TV,S   ,Altre attività di servizi                                   ,7,0,1,0,8,2021
VEN,TV,S 94,Attività di organizzazioni associative                      ,0,0,0,0,0,2021
VEN,TV,S 95,Riparazione di computer e di beni per uso personale e per...,0,0,1,0,1,2021
VEN,TV,S 96,Altre attività di servizi per la persona                    ,7,0,0,0,7,2021
VEN,TV,T   ,Attività di famiglie e convivenze come datori di lavoro p...,0,0,0,0,0,2021
VEN,TV,T 97,Attività di famiglie e convivenze come datori di lavoro p...,0,0,0,0,0,2021
VEN,TV,T 98,Produzione di beni e servizi indifferenziati per uso prop...,0,0,0,0,0,2021
VEN,TV,U   ,Organizzazioni ed organismi extraterritoriali               ,0,0,0,0,0,2021
VEN,TV,U 99,Organizzazioni ed organismi extraterritoriali               ,0,0,0,0,0,2021
VEN,TV,XX  ,Imprese non classificate                                    ,33,0,0,7,40,2021
VEN,TV,TOT ,TOTALE                                                      ,638,4,75,23,740,2021
VEN,VE,A   ,"Agricoltura, silvicoltura pesca                             ",1,1,25,0,27,2021
VEN,VE,A 01,"Coltivazioni agricole e produzione di prodotti animali, c...",1,1,23,0,25,2021
VEN,VE,A 02,Silvicoltura ed utilizzo di aree forestali                  ,0,0,0,0,0,2021
VEN,VE,A 03,Pesca e acquacoltura                                        ,0,0,2,0,2,2021
VEN,VE,B   ,Estrazione di minerali da cave e miniere                    ,0,0,0,0,0,2021
VEN,VE,B 05,Estrazione di carbone (esclusa torba)                       ,0,0,0,0,0,2021
VEN,VE,B 06,Estraz.di petrolio greggio e di gas naturale                ,0,0,0,0,0,2021
VEN,VE,B 07,Estrazione di minerali metalliferi                          ,0,0,0,0,0,2021
VEN,VE,B 08,Altre attività di estrazione di minerali da cave e miniere  ,0,0,0,0,0,2021
VEN,VE,B 09,Attività dei servizi di supporto all'estrazione             ,0,0,0,0,0,2021
VEN,VE,C   ,Attività manifatturiere                                     ,2,19,61,0,82,2021
VEN,VE,C 10,Industrie alimentari                                        ,0,0,1,0,1,2021
VEN,VE,C 11,Industria delle bevande                                     ,0,0,0,0,0,2021
VEN,VE,C 12,Industria del tabacco                                       ,0,0,0,0,0,2021
VEN,VE,C 13,Industrie tessili                                           ,0,1,4,0,5,2021
VEN,VE,C 14,Confezione di articoli di abbigliamento; confezione di ar...,1,5,22,0,28,2021
VEN,VE,C 15,Fabbricazione di articoli in pelle e simili                 ,0,3,4,0,7,2021
VEN,VE,C 16,Industria del legno e dei prodotti in legno e sughero (es...,1,0,8,0,9,2021
VEN,VE,C 17,Fabbricazione di carta e di prodotti di carta               ,0,0,0,0,0,2021
VEN,VE,C 18,Stampa e riproduzione di supporti registrati                ,0,0,0,0,0,2021
VEN,VE,C 19,Fabbricazione di coke e prodotti derivanti dalla raffinaz...,0,0,0,0,0,2021
VEN,VE,C 20,Fabbricazione di prodotti chimici                           ,0,0,0,0,0,2021
VEN,VE,C 21,Fabbricazione di prodotti farmaceutici di base e di prepa...,0,0,0,0,0,2021
VEN,VE,C 22,Fabbricazione di articoli in gomma e materie plastiche      ,0,2,0,0,2,2021
VEN,VE,C 23,Fabbricazione di altri prodotti della lavorazione di miner..,0,2,1,0,3,2021
VEN,VE,C 24,Metallurgia                                                 ,0,0,0,0,0,2021
VEN,VE,C 25,Fabbricazione di prodotti in metallo (esclusi macchinari ...,0,3,10,0,13,2021
VEN,VE,C 26,Fabbricazione di computer e prodotti di elettronica e ott...,0,0,2,0,2,2021
VEN,VE,C 27,Fabbricazione di apparecchiature elettriche ed apparecchi...,0,0,0,0,0,2021
VEN,VE,C 28,Fabbricazione di macchinari ed apparecchiature nca          ,0,0,1,0,1,2021
VEN,VE,C 29,"Fabbricazione di autoveicoli, rimorchi e semirimorchi       ",0,0,0,0,0,2021
VEN,VE,C 30,Fabbricazione di altri mezzi di trasporto                   ,0,0,2,0,2,2021
VEN,VE,C 31,Fabbricazione di mobili                                     ,0,2,1,0,3,2021
VEN,VE,C 32,Altre industrie manifatturiere                              ,0,1,4,0,5,2021
VEN,VE,C 33,"Riparazione, manutenzione ed installazione di macchine ed...",0,0,1,0,1,2021
VEN,VE,D   ,"Fornitura di energia elettrica, gas, vapore e aria condiz...",0,0,0,0,0,2021
VEN,VE,D 35,"Fornitura di energia elettrica, gas, vapore e aria condiz...",0,0,0,0,0,2021
VEN,VE,E   ,"Fornitura di acqua; reti fognarie, attività di gestione d...",0,0,1,0,1,2021
VEN,VE,E 36,"Raccolta, trattamento e fornitura di acqua                  ",0,0,0,0,0,2021
VEN,VE,E 37,Gestione delle reti fognarie                                ,0,0,0,0,0,2021
VEN,VE,E 38,"Attività di raccolta, trattamento e smaltimento dei rifiu...",0,0,1,0,1,2021
VEN,VE,E 39,Attività di risanamento e altri servizi di gestione dei r...,0,0,0,0,0,2021
VEN,VE,F   ,Costruzioni                                                 ,3,7,248,2,260,2021
VEN,VE,F 41,Costruzione di edifici                                      ,2,4,62,2,70,2021
VEN,VE,F 42,Ingegneria civile                                           ,0,0,2,0,2,2021
VEN,VE,F 43,Lavori di costruzione specializzati                         ,1,3,184,0,188,2021
VEN,VE,G   ,Commercio all'ingrosso e al dettaglio; riparazione di aut...,10,27,144,1,182,2021
VEN,VE,G 45,Commercio all'ingrosso e al dettaglio e riparazione di au...,0,0,9,0,9,2021
VEN,VE,G 46,Commercio all'ingrosso (escluso quello di autoveicoli e d...,4,12,25,0,41,2021
VEN,VE,G 47,Commercio al dettaglio (escluso quello di autoveicoli e d...,6,15,110,1,132,2021
VEN,VE,H   ,Trasporto e magazzinaggio                                   ,3,3,21,4,31,2021
VEN,VE,H 49,Trasporto terrestre e mediante condotte                     ,3,3,20,0,26,2021
VEN,VE,H 50,Trasporto marittimo e per vie d'acqua                       ,0,0,0,0,0,2021
VEN,VE,H 51,Trasporto aereo                                             ,0,0,1,0,1,2021
VEN,VE,H 52,Magazzinaggio e attività di supporto ai trasporti           ,0,0,0,4,4,2021
VEN,VE,H 53,Servizi postali e attività di corriere                      ,0,0,0,0,0,2021
VEN,VE,I   ,Attività dei servizi alloggio e ristorazione                ,2,37,23,2,64,2021
VEN,VE,I 55,Alloggio                                                    ,1,3,4,0,8,2021
VEN,VE,I 56,Attività dei servizi di ristorazione                        ,1,34,19,2,56,2021
VEN,VE,J   ,Servizi di informazione e comunicazione                     ,0,2,8,0,10,2021
VEN,VE,J 58,Attività editoriali                                         ,0,1,1,0,2,2021
VEN,VE,J 59,"Attività di produzione cinematografica, di video e di pro...",0,0,0,0,0,2021
VEN,VE,J 60,Attività di programmazione e trasmissione                   ,0,0,0,0,0,2021
VEN,VE,J 61,Telecomunicazioni                                           ,0,0,7,0,7,2021
VEN,VE,J 62,"Produzione di software, consulenza informatica e attività...",0,1,0,0,1,2021
VEN,VE,J 63,Attività dei servizi d'informazione e altri servizi infor...,0,0,0,0,0,2021
VEN,VE,K   ,Attività finanziarie e assicurative                         ,0,2,3,0,5,2021
VEN,VE,K 64,Attività di servizi finanziari (escluse le assicurazioni ...,0,1,0,0,1,2021
VEN,VE,K 65,"Assicurazioni, riassicurazioni e fondi pensione (escluse ...",0,0,0,0,0,2021
VEN,VE,K 66,Attività ausiliarie dei servizi finanziari e delle attivi...,0,1,3,0,4,2021
VEN,VE,L   ,Attivita' immobiliari                                       ,3,3,0,0,6,2021
VEN,VE,L 68,Attivita' immobiliari                                       ,3,3,0,0,6,2021
VEN,VE,M   ,"Attività professionali, scientifiche e tecniche             ",2,3,10,0,15,2021
VEN,VE,M 69,Attività legali e contabilità                               ,0,1,0,0,1,2021
VEN,VE,M 70,Attività di direzione aziendale e di consulenza gestional...,1,0,2,0,3,2021
VEN,VE,M 71,Attività degli studi di architettura e d'ingegneria; coll...,0,0,2,0,2,2021
VEN,VE,M 72,Ricerca scientifica e sviluppo                              ,0,0,0,0,0,2021
VEN,VE,M 73,Pubblicità e ricerche di mercato                            ,1,1,2,0,4,2021
VEN,VE,M 74,"Altre attività professionali, scientifiche e tecniche       ",0,1,4,0,5,2021
VEN,VE,M 75,Servizi veterinari                                          ,0,0,0,0,0,2021
VEN,VE,N   ,"Noleggio, agenzie di viaggio, servizi di supporto alle im...",0,4,14,0,18,2021
VEN,VE,N 77,Attività di noleggio e leasing operativo                    ,0,0,3,0,3,2021
VEN,VE,N 78,"Attività di ricerca, selezione, fornitura di personale      ",0,0,0,0,0,2021
VEN,VE,N 79,"Attività dei servizi delle agenzie di viaggio, dei tour o...",0,0,0,0,0,2021
VEN,VE,N 80,Servizi di vigilanza e investigazione                       ,0,0,1,0,1,2021
VEN,VE,N 81,Attività di servizi per edifici e paesaggio                 ,0,3,2,0,5,2021
VEN,VE,N 82,Attività di supporto per le funzioni d'ufficio e altri se...,0,1,8,0,9,2021
VEN,VE,O   ,Amministrazione pubblica e difesa; assicurazione sociale ...,0,0,0,0,0,2021
VEN,VE,O 84,Amministrazione pubblica e difesa; assicurazione sociale ...,0,0,0,0,0,2021
VEN,VE,P   ,Istruzione                                                  ,0,1,0,1,2,2021
VEN,VE,P 85,Istruzione                                                  ,0,1,0,1,2,2021
VEN,VE,Q   ,Sanita' e assistenza sociale                                ,0,0,0,0,0,2021
VEN,VE,Q 86,Assistenza sanitaria                                        ,0,0,0,0,0,2021
VEN,VE,Q 87,Servizi di assistenza sociale residenziale                  ,0,0,0,0,0,2021
VEN,VE,Q 88,Assistenza sociale non residenziale                         ,0,0,0,0,0,2021
VEN,VE,R   ,"Attività artistiche, sportive, di intrattenimento e diver...",1,2,1,0,4,2021
VEN,VE,R 90,"Attività creative, artistiche e di intrattenimento          ",0,1,0,0,1,2021
VEN,VE,R 91,"Attività di biblioteche, archivi, musei ed altre attività...",0,0,0,0,0,2021
VEN,VE,R 92,"Attività riguardanti le lotterie, le scommesse, le case d...",0,0,0,0,0,2021
VEN,VE,R 93,"Attività sportive, di intrattenimento e di divertimento     ",1,1,1,0,3,2021
VEN,VE,S   ,Altre attività di servizi                                   ,0,0,12,0,12,2021
VEN,VE,S 94,Attività di organizzazioni associative                      ,0,0,0,0,0,2021
VEN,VE,S 95,Riparazione di computer e di beni per uso personale e per...,0,0,6,0,6,2021
VEN,VE,S 96,Altre attività di servizi per la persona                    ,0,0,6,0,6,2021
VEN,VE,T   ,Attività di famiglie e convivenze come datori di lavoro p...,0,0,0,0,0,2021
VEN,VE,T 97,Attività di famiglie e convivenze come datori di lavoro p...,0,0,0,0,0,2021
VEN,VE,T 98,Produzione di beni e servizi indifferenziati per uso prop...,0,0,0,0,0,2021
VEN,VE,U   ,Organizzazioni ed organismi extraterritoriali               ,0,0,0,0,0,2021
VEN,VE,U 99,Organizzazioni ed organismi extraterritoriali               ,0,0,0,0,0,2021
VEN,VE,XX  ,Imprese non classificate                                    ,5,2,15,1,23,2021
VEN,VE,TOT ,TOTALE                                                      ,32,113,586,11,742,2021
VEN,PD,A   ,"Agricoltura, silvicoltura pesca                             ",0,31,0,0,31,2021
VEN,PD,A 01,"Coltivazioni agricole e produzione di prodotti animali, c...",0,31,0,0,31,2021
VEN,PD,A 02,Silvicoltura ed utilizzo di aree forestali                  ,0,0,0,0,0,2021
VEN,PD,A 03,Pesca e acquacoltura                                        ,0,0,0,0,0,2021
VEN,PD,B   ,Estrazione di minerali da cave e miniere                    ,0,0,0,0,0,2021
VEN,PD,B 05,Estrazione di carbone (esclusa torba)                       ,0,0,0,0,0,2021
VEN,PD,B 06,Estraz.di petrolio greggio e di gas naturale                ,0,0,0,0,0,2021
VEN,PD,B 07,Estrazione di minerali metalliferi                          ,0,0,0,0,0,2021
VEN,PD,B 08,Altre attività di estrazione di minerali da cave e miniere  ,0,0,0,0,0,2021
VEN,PD,B 09,Attività dei servizi di supporto all'estrazione             ,0,0,0,0,0,2021
VEN,PD,C   ,Attività manifatturiere                                     ,2,38,1,0,41,2021
VEN,PD,C 10,Industrie alimentari                                        ,0,0,0,0,0,2021
VEN,PD,C 11,Industria delle bevande                                     ,0,0,0,0,0,2021
VEN,PD,C 12,Industria del tabacco                                       ,0,0,0,0,0,2021
VEN,PD,C 13,Industrie tessili                                           ,0,6,0,0,6,2021
VEN,PD,C 14,Confezione di articoli di abbigliamento; confezione di ar...,1,4,0,0,5,2021
VEN,PD,C 15,Fabbricazione di articoli in pelle e simili                 ,1,2,1,0,4,2021
VEN,PD,C 16,Industria del legno e dei prodotti in legno e sughero (es...,0,3,0,0,3,2021
VEN,PD,C 17,Fabbricazione di carta e di prodotti di carta               ,0,0,0,0,0,2021
VEN,PD,C 18,Stampa e riproduzione di supporti registrati                ,0,3,0,0,3,2021
VEN,PD,C 19,Fabbricazione di coke e prodotti derivanti dalla raffinaz...,0,0,0,0,0,2021
VEN,PD,C 20,Fabbricazione di prodotti chimici                           ,0,0,0,0,0,2021
VEN,PD,C 21,Fabbricazione di prodotti farmaceutici di base e di prepa...,0,0,0,0,0,2021
VEN,PD,C 22,Fabbricazione di articoli in gomma e materie plastiche      ,0,1,0,0,1,2021
VEN,PD,C 23,Fabbricazione di altri prodotti della lavorazione di miner..,0,1,0,0,1,2021
VEN,PD,C 24,Metallurgia                                                 ,0,0,0,0,0,2021
VEN,PD,C 25,Fabbricazione di prodotti in metallo (esclusi macchinari ...,0,7,0,0,7,2021
VEN,PD,C 26,Fabbricazione di computer e prodotti di elettronica e ott...,0,1,0,0,1,2021
VEN,PD,C 27,Fabbricazione di apparecchiature elettriche ed apparecchi...,0,1,0,0,1,2021
VEN,PD,C 28,Fabbricazione di macchinari ed apparecchiature nca          ,0,1,0,0,1,2021
VEN,PD,C 29,"Fabbricazione di autoveicoli, rimorchi e semirimorchi       ",0,0,0,0,0,2021
VEN,PD,C 30,Fabbricazione di altri mezzi di trasporto                   ,0,0,0,0,0,2021
VEN,PD,C 31,Fabbricazione di mobili                                     ,0,4,0,0,4,2021
VEN,PD,C 32,Altre industrie manifatturiere                              ,0,4,0,0,4,2021
VEN,PD,C 33,"Riparazione, manutenzione ed installazione di macchine ed...",0,0,0,0,0,2021
VEN,PD,D   ,"Fornitura di energia elettrica, gas, vapore e aria condiz...",0,0,0,0,0,2021
VEN,PD,D 35,"Fornitura di energia elettrica, gas, vapore e aria condiz...",0,0,0,0,0,2021
VEN,PD,E   ,"Fornitura di acqua; reti fognarie, attività di gestione d...",0,0,0,0,0,2021
VEN,PD,E 36,"Raccolta, trattamento e fornitura di acqua                  ",0,0,0,0,0,2021
VEN,PD,E 37,Gestione delle reti fognarie                                ,0,0,0,0,0,2021
VEN,PD,E 38,"Attività di raccolta, trattamento e smaltimento dei rifiu...",0,0,0,0,0,2021
VEN,PD,E 39,Attività di risanamento e altri servizi di gestione dei r...,0,0,0,0,0,2021
VEN,PD,F   ,Costruzioni                                                 ,1,48,0,1,50,2021
VEN,PD,F 41,Costruzione di edifici                                      ,1,25,0,1,27,2021
VEN,PD,F 42,Ingegneria civile                                           ,0,2,0,0,2,2021
VEN,PD,F 43,Lavori di costruzione specializzati                         ,0,21,0,0,21,2021
VEN,PD,G   ,Commercio all'ingrosso e al dettaglio; riparazione di aut...,0,101,2,1,104,2021
VEN,PD,G 45,Commercio all'ingrosso e al dettaglio e riparazione di au...,0,11,1,0,12,2021
VEN,PD,G 46,Commercio all'ingrosso (escluso quello di autoveicoli e d...,0,36,0,0,36,2021
VEN,PD,G 47,Commercio al dettaglio (escluso quello di autoveicoli e d...,0,54,1,1,56,2021
VEN,PD,H   ,Trasporto e magazzinaggio                                   ,0,6,0,0,6,2021
VEN,PD,H 49,Trasporto terrestre e mediante condotte                     ,0,6,0,0,6,2021
VEN,PD,H 50,Trasporto marittimo e per vie d'acqua                       ,0,0,0,0,0,2021
VEN,PD,H 51,Trasporto aereo                                             ,0,0,0,0,0,2021
VEN,PD,H 52,Magazzinaggio e attività di supporto ai trasporti           ,0,0,0,0,0,2021
VEN,PD,H 53,Servizi postali e attività di corriere                      ,0,0,0,0,0,2021
VEN,PD,I   ,Attività dei servizi alloggio e ristorazione                ,0,74,0,1,75,2021
VEN,PD,I 55,Alloggio                                                    ,0,3,0,0,3,2021
VEN,PD,I 56,Attività dei servizi di ristorazione                        ,0,71,0,1,72,2021
VEN,PD,J   ,Servizi di informazione e comunicazione                     ,0,11,0,0,11,2021
VEN,PD,J 58,Attività editoriali                                         ,0,3,0,0,3,2021
VEN,PD,J 59,"Attività di produzione cinematografica, di video e di pro...",0,1,0,0,1,2021
VEN,PD,J 60,Attività di programmazione e trasmissione                   ,0,0,0,0,0,2021
VEN,PD,J 61,Telecomunicazioni                                           ,0,1,0,0,1,2021
VEN,PD,J 62,"Produzione di software, consulenza informatica e attività...",0,2,0,0,2,2021
VEN,PD,J 63,Attività dei servizi d'informazione e altri servizi infor...,0,4,0,0,4,2021
VEN,PD,K   ,Attività finanziarie e assicurative                         ,0,6,0,0,6,2021
VEN,PD,K 64,Attività di servizi finanziari (escluse le assicurazioni ...,0,1,0,0,1,2021
VEN,PD,K 65,"Assicurazioni, riassicurazioni e fondi pensione (escluse ...",0,0,0,0,0,2021
VEN,PD,K 66,Attività ausiliarie dei servizi finanziari e delle attivi...,0,5,0,0,5,2021
VEN,PD,L   ,Attivita' immobiliari                                       ,0,41,0,0,41,2021
VEN,PD,L 68,Attivita' immobiliari                                       ,0,41,0,0,41,2021
VEN,PD,M   ,"Attività professionali, scientifiche e tecniche             ",0,20,1,1,22,2021
VEN,PD,M 69,Attività legali e contabilità                               ,0,2,0,0,2,2021
VEN,PD,M 70,Attività di direzione aziendale e di consulenza gestional...,0,8,0,0,8,2021
VEN,PD,M 71,Attività degli studi di architettura e d'ingegneria; coll...,0,0,0,0,0,2021
VEN,PD,M 72,Ricerca scientifica e sviluppo                              ,0,0,0,1,1,2021
VEN,PD,M 73,Pubblicità e ricerche di mercato                            ,0,6,0,0,6,2021
VEN,PD,M 74,"Altre attività professionali, scientifiche e tecniche       ",0,4,1,0,5,2021
VEN,PD,M 75,Servizi veterinari                                          ,0,0,0,0,0,2021
VEN,PD,N   ,"Noleggio, agenzie di viaggio, servizi di supporto alle im...",0,11,0,0,11,2021
VEN,PD,N 77,Attività di noleggio e leasing operativo                    ,0,0,0,0,0,2021
VEN,PD,N 78,"Attività di ricerca, selezione, fornitura di personale      ",0,0,0,0,0,2021
VEN,PD,N 79,"Attività dei servizi delle agenzie di viaggio, dei tour o...",0,1,0,0,1,2021
VEN,PD,N 80,Servizi di vigilanza e investigazione                       ,0,0,0,0,0,2021
VEN,PD,N 81,Attività di servizi per edifici e paesaggio                 ,0,4,0,0,4,2021
VEN,PD,N 82,Attività di supporto per le funzioni d'ufficio e altri se...,0,6,0,0,6,2021
VEN,PD,O   ,Amministrazione pubblica e difesa; assicurazione sociale ...,0,0,0,0,0,2021
VEN,PD,O 84,Amministrazione pubblica e difesa; assicurazione sociale ...,0,0,0,0,0,2021
VEN,PD,P   ,Istruzione                                                  ,0,0,0,0,0,2021
VEN,PD,P 85,Istruzione                                                  ,0,0,0,0,0,2021
VEN,PD,Q   ,Sanita' e assistenza sociale                                ,0,2,0,0,2,2021
VEN,PD,Q 86,Assistenza sanitaria                                        ,0,2,0,0,2,2021
VEN,PD,Q 87,Servizi di assistenza sociale residenziale                  ,0,0,0,0,0,2021
VEN,PD,Q 88,Assistenza sociale non residenziale                         ,0,0,0,0,0,2021
VEN,PD,R   ,"Attività artistiche, sportive, di intrattenimento e diver...",0,4,0,0,4,2021
VEN,PD,R 90,"Attività creative, artistiche e di intrattenimento          ",0,0,0,0,0,2021
VEN,PD,R 91,"Attività di biblioteche, archivi, musei ed altre attività...",0,0,0,0,0,2021
VEN,PD,R 92,"Attività riguardanti le lotterie, le scommesse, le case d...",0,1,0,0,1,2021
VEN,PD,R 93,"Attività sportive, di intrattenimento e di divertimento     ",0,3,0,0,3,2021
VEN,PD,S   ,Altre attività di servizi                                   ,0,27,1,0,28,2021
VEN,PD,S 94,Attività di organizzazioni associative                      ,0,0,0,0,0,2021
VEN,PD,S 95,Riparazione di computer e di beni per uso personale e per...,0,9,0,0,9,2021
VEN,PD,S 96,Altre attività di servizi per la persona                    ,0,18,1,0,19,2021
VEN,PD,T   ,Attività di famiglie e convivenze come datori di lavoro p...,0,0,0,0,0,2021
VEN,PD,T 97,Attività di famiglie e convivenze come datori di lavoro p...,0,0,0,0,0,2021
VEN,PD,T 98,Produzione di beni e servizi indifferenziati per uso prop...,0,0,0,0,0,2021
VEN,PD,U   ,Organizzazioni ed organismi extraterritoriali               ,0,0,0,0,0,2021
VEN,PD,U 99,Organizzazioni ed organismi extraterritoriali               ,0,0,0,0,0,2021
VEN,PD,XX  ,Imprese non classificate                                    ,0,18,0,0,18,2021
VEN,PD,TOT ,TOTALE                                                      ,3,438,5,4,450,2021
VEN,RO,A   ,"Agricoltura, silvicoltura pesca                             ",0,0,22,9,31,2021
VEN,RO,A 01,"Coltivazioni agricole e produzione di prodotti animali, c...",0,0,20,8,28,2021
VEN,RO,A 02,Silvicoltura ed utilizzo di aree forestali                  ,0,0,0,0,0,2021
VEN,RO,A 03,Pesca e acquacoltura                                        ,0,0,2,1,3,2021
VEN,RO,B   ,Estrazione di minerali da cave e miniere                    ,0,0,0,0,0,2021
VEN,RO,B 05,Estrazione di carbone (esclusa torba)                       ,0,0,0,0,0,2021
VEN,RO,B 06,Estraz.di petrolio greggio e di gas naturale                ,0,0,0,0,0,2021
VEN,RO,B 07,Estrazione di minerali metalliferi                          ,0,0,0,0,0,2021
VEN,RO,B 08,Altre attività di estrazione di minerali da cave e miniere  ,0,0,0,0,0,2021
VEN,RO,B 09,Attività dei servizi di supporto all'estrazione             ,0,0,0,0,0,2021
VEN,RO,C   ,Attività manifatturiere                                     ,0,1,57,1,59,2021
VEN,RO,C 10,Industrie alimentari                                        ,0,0,2,0,2,2021
VEN,RO,C 11,Industria delle bevande                                     ,0,0,0,0,0,2021
VEN,RO,C 12,Industria del tabacco                                       ,0,0,0,0,0,2021
VEN,RO,C 13,Industrie tessili                                           ,0,0,0,0,0,2021
VEN,RO,C 14,Confezione di articoli di abbigliamento; confezione di ar...,0,0,35,0,35,2021
VEN,RO,C 15,Fabbricazione di articoli in pelle e simili                 ,0,0,2,0,2,2021
VEN,RO,C 16,Industria del legno e dei prodotti in legno e sughero (es...,0,0,1,0,1,2021
VEN,RO,C 17,Fabbricazione di carta e di prodotti di carta               ,0,0,0,0,0,2021
VEN,RO,C 18,Stampa e riproduzione di supporti registrati                ,0,1,0,1,2,2021
VEN,RO,C 19,Fabbricazione di coke e prodotti derivanti dalla raffinaz...,0,0,0,0,0,2021
VEN,RO,C 20,Fabbricazione di prodotti chimici                           ,0,0,0,0,0,2021
VEN,RO,C 21,Fabbricazione di prodotti farmaceutici di base e di prepa...,0,0,0,0,0,2021
VEN,RO,C 22,Fabbricazione di articoli in gomma e materie plastiche      ,0,0,0,0,0,2021
VEN,RO,C 23,Fabbricazione di altri prodotti della lavorazione di miner..,0,0,0,0,0,2021
VEN,RO,C 24,Metallurgia                                                 ,0,0,0,0,0,2021
VEN,RO,C 25,Fabbricazione di prodotti in metallo (esclusi macchinari ...,0,0,12,0,12,2021
VEN,RO,C 26,Fabbricazione di computer e prodotti di elettronica e ott...,0,0,0,0,0,2021
VEN,RO,C 27,Fabbricazione di apparecchiature elettriche ed apparecchi...,0,0,0,0,0,2021
VEN,RO,C 28,Fabbricazione di macchinari ed apparecchiature nca          ,0,0,1,0,1,2021
VEN,RO,C 29,"Fabbricazione di autoveicoli, rimorchi e semirimorchi       ",0,0,1,0,1,2021
VEN,RO,C 30,Fabbricazione di altri mezzi di trasporto                   ,0,0,1,0,1,2021
VEN,RO,C 31,Fabbricazione di mobili                                     ,0,0,0,0,0,2021
VEN,RO,C 32,Altre industrie manifatturiere                              ,0,0,0,0,0,2021
VEN,RO,C 33,"Riparazione, manutenzione ed installazione di macchine ed...",0,0,2,0,2,2021
VEN,RO,D   ,"Fornitura di energia elettrica, gas, vapore e aria condiz...",0,0,0,0,0,2021
VEN,RO,D 35,"Fornitura di energia elettrica, gas, vapore e aria condiz...",0,0,0,0,0,2021
VEN,RO,E   ,"Fornitura di acqua; reti fognarie, attività di gestione d...",0,0,0,0,0,2021
VEN,RO,E 36,"Raccolta, trattamento e fornitura di acqua                  ",0,0,0,0,0,2021
VEN,RO,E 37,Gestione delle reti fognarie                                ,0,0,0,0,0,2021
VEN,RO,E 38,"Attività di raccolta, trattamento e smaltimento dei rifiu...",0,0,0,0,0,2021
VEN,RO,E 39,Attività di risanamento e altri servizi di gestione dei r...,0,0,0,0,0,2021
VEN,RO,F   ,Costruzioni                                                 ,3,0,106,2,111,2021
VEN,RO,F 41,Costruzione di edifici                                      ,2,0,23,1,26,2021
VEN,RO,F 42,Ingegneria civile                                           ,0,0,0,0,0,2021
VEN,RO,F 43,Lavori di costruzione specializzati                         ,1,0,83,1,85,2021
VEN,RO,G   ,Commercio all'ingrosso e al dettaglio; riparazione di aut...,1,0,77,0,78,2021
VEN,RO,G 45,Commercio all'ingrosso e al dettaglio e riparazione di au...,1,0,7,0,8,2021
VEN,RO,G 46,Commercio all'ingrosso (escluso quello di autoveicoli e d...,0,0,15,0,15,2021
VEN,RO,G 47,Commercio al dettaglio (escluso quello di autoveicoli e d...,0,0,55,0,55,2021
VEN,RO,H   ,Trasporto e magazzinaggio                                   ,0,0,8,2,10,2021
VEN,RO,H 49,Trasporto terrestre e mediante condotte                     ,0,0,6,0,6,2021
VEN,RO,H 50,Trasporto marittimo e per vie d'acqua                       ,0,0,1,0,1,2021
VEN,RO,H 51,Trasporto aereo                                             ,0,0,0,0,0,2021
VEN,RO,H 52,Magazzinaggio e attività di supporto ai trasporti           ,0,0,1,2,3,2021
VEN,RO,H 53,Servizi postali e attività di corriere                      ,0,0,0,0,0,2021
VEN,RO,I   ,Attività dei servizi alloggio e ristorazione                ,0,1,14,0,15,2021
VEN,RO,I 55,Alloggio                                                    ,0,0,0,0,0,2021
VEN,RO,I 56,Attività dei servizi di ristorazione                        ,0,1,14,0,15,2021
VEN,RO,J   ,Servizi di informazione e comunicazione                     ,0,0,4,1,5,2021
VEN,RO,J 58,Attività editoriali                                         ,0,0,0,0,0,2021
VEN,RO,J 59,"Attività di produzione cinematografica, di video e di pro...",0,0,0,0,0,2021
VEN,RO,J 60,Attività di programmazione e trasmissione                   ,0,0,0,0,0,2021
VEN,RO,J 61,Telecomunicazioni                                           ,0,0,2,0,2,2021
VEN,RO,J 62,"Produzione di software, consulenza informatica e attività...",0,0,1,1,2,2021
VEN,RO,J 63,Attività dei servizi d'informazione e altri servizi infor...,0,0,1,0,1,2021
VEN,RO,K   ,Attività finanziarie e assicurative                         ,0,0,1,0,1,2021
VEN,RO,K 64,Attività di servizi finanziari (escluse le assicurazioni ...,0,0,0,0,0,2021
VEN,RO,K 65,"Assicurazioni, riassicurazioni e fondi pensione (escluse ...",0,0,0,0,0,2021
VEN,RO,K 66,Attività ausiliarie dei servizi finanziari e delle attivi...,0,0,1,0,1,2021
VEN,RO,L   ,Attivita' immobiliari                                       ,1,0,0,0,1,2021
VEN,RO,L 68,Attivita' immobiliari                                       ,1,0,0,0,1,2021
VEN,RO,M   ,"Attività professionali, scientifiche e tecniche             ",0,0,6,0,6,2021
VEN,RO,M 69,Attività legali e contabilità                               ,0,0,0,0,0,2021
VEN,RO,M 70,Attività di direzione aziendale e di consulenza gestional...,0,0,2,0,2,2021
VEN,RO,M 71,Attività degli studi di architettura e d'ingegneria; coll...,0,0,0,0,0,2021
VEN,RO,M 72,Ricerca scientifica e sviluppo                              ,0,0,0,0,0,2021
VEN,RO,M 73,Pubblicità e ricerche di mercato                            ,0,0,1,0,1,2021
VEN,RO,M 74,"Altre attività professionali, scientifiche e tecniche       ",0,0,3,0,3,2021
VEN,RO,M 75,Servizi veterinari                                          ,0,0,0,0,0,2021
VEN,RO,N   ,"Noleggio, agenzie di viaggio, servizi di supporto alle im...",0,0,3,2,5,2021
VEN,RO,N 77,Attività di noleggio e leasing operativo                    ,0,0,1,0,1,2021
VEN,RO,N 78,"Attività di ricerca, selezione, fornitura di personale      ",0,0,0,0,0,2021
VEN,RO,N 79,"Attività dei servizi delle agenzie di viaggio, dei tour o...",0,0,0,0,0,2021
VEN,RO,N 80,Servizi di vigilanza e investigazione                       ,0,0,0,0,0,2021
VEN,RO,N 81,Attività di servizi per edifici e paesaggio                 ,0,0,2,1,3,2021
VEN,RO,N 82,Attività di supporto per le funzioni d'ufficio e altri se...,0,0,0,1,1,2021
VEN,RO,O   ,Amministrazione pubblica e difesa; assicurazione sociale ...,0,0,0,0,0,2021
VEN,RO,O 84,Amministrazione pubblica e difesa; assicurazione sociale ...,0,0,0,0,0,2021
VEN,RO,P   ,Istruzione                                                  ,0,0,1,0,1,2021
VEN,RO,P 85,Istruzione                                                  ,0,0,1,0,1,2021
VEN,RO,Q   ,Sanita' e assistenza sociale                                ,0,0,0,0,0,2021
VEN,RO,Q 86,Assistenza sanitaria                                        ,0,0,0,0,0,2021
VEN,RO,Q 87,Servizi di assistenza sociale residenziale                  ,0,0,0,0,0,2021
VEN,RO,Q 88,Assistenza sociale non residenziale                         ,0,0,0,0,0,2021
VEN,RO,R   ,"Attività artistiche, sportive, di intrattenimento e diver...",0,0,5,0,5,2021
VEN,RO,R 90,"Attività creative, artistiche e di intrattenimento          ",0,0,0,0,0,2021
VEN,RO,R 91,"Attività di biblioteche, archivi, musei ed altre attività...",0,0,0,0,0,2021
VEN,RO,R 92,"Attività riguardanti le lotterie, le scommesse, le case d...",0,0,0,0,0,2021
VEN,RO,R 93,"Attività sportive, di intrattenimento e di divertimento     ",0,0,5,0,5,2021
VEN,RO,S   ,Altre attività di servizi                                   ,0,0,1,0,1,2021
VEN,RO,S 94,Attività di organizzazioni associative                      ,0,0,0,0,0,2021
VEN,RO,S 95,Riparazione di computer e di beni per uso personale e per...,0,0,0,0,0,2021
VEN,RO,S 96,Altre attività di servizi per la persona                    ,0,0,1,0,1,2021
VEN,RO,T   ,Attività di famiglie e convivenze come datori di lavoro p...,0,0,0,0,0,2021
VEN,RO,T 97,Attività di famiglie e convivenze come datori di lavoro p...,0,0,0,0,0,2021
VEN,RO,T 98,Produzione di beni e servizi indifferenziati per uso prop...,0,0,0,0,0,2021
VEN,RO,U   ,Organizzazioni ed organismi extraterritoriali               ,0,0,0,0,0,2021
VEN,RO,U 99,Organizzazioni ed organismi extraterritoriali               ,0,0,0,0,0,2021
VEN,RO,XX  ,Imprese non classificate                                    ,3,0,8,4,15,2021
VEN,RO,TOT ,TOTALE                                                      ,8,2,313,21,344,2021
FVG,  ,A   ,"Agricoltura, silvicoltura pesca                             ",4,0,19,1,24,2021
FVG,  ,A 01,"Coltivazioni agricole e produzione di prodotti animali, c...",4,0,17,1,22,2021
FVG,  ,A 02,Silvicoltura ed utilizzo di aree forestali                  ,0,0,0,0,0,2021
FVG,  ,A 03,Pesca e acquacoltura                                        ,0,0,2,0,2,2021
FVG,  ,B   ,Estrazione di minerali da cave e miniere                    ,2,0,0,0,2,2021
FVG,  ,B 05,Estrazione di carbone (esclusa torba)                       ,0,0,0,0,0,2021
FVG,  ,B 06,Estraz.di petrolio greggio e di gas naturale                ,0,0,0,0,0,2021
FVG,  ,B 07,Estrazione di minerali metalliferi                          ,0,0,0,0,0,2021
FVG,  ,B 08,Altre attività di estrazione di minerali da cave e miniere  ,2,0,0,0,2,2021
FVG,  ,B 09,Attività dei servizi di supporto all'estrazione             ,0,0,0,0,0,2021
FVG,  ,C   ,Attività manifatturiere                                     ,135,5,21,0,161,2021
FVG,  ,C 10,Industrie alimentari                                        ,4,0,1,0,5,2021
FVG,  ,C 11,Industria delle bevande                                     ,1,0,0,0,1,2021
FVG,  ,C 12,Industria del tabacco                                       ,0,0,0,0,0,2021
FVG,  ,C 13,Industrie tessili                                           ,3,1,3,0,7,2021
FVG,  ,C 14,Confezione di articoli di abbigliamento; confezione di ar...,2,0,1,0,3,2021
FVG,  ,C 15,Fabbricazione di articoli in pelle e simili                 ,0,0,0,0,0,2021
FVG,  ,C 16,Industria del legno e dei prodotti in legno e sughero (es...,8,0,2,0,10,2021
FVG,  ,C 17,Fabbricazione di carta e di prodotti di carta               ,0,0,0,0,0,2021
FVG,  ,C 18,Stampa e riproduzione di supporti registrati                ,6,0,0,0,6,2021
FVG,  ,C 19,Fabbricazione di coke e prodotti derivanti dalla raffinaz...,0,0,0,0,0,2021
FVG,  ,C 20,Fabbricazione di prodotti chimici                           ,3,0,0,0,3,2021
FVG,  ,C 21,Fabbricazione di prodotti farmaceutici di base e di prepa...,0,0,0,0,0,2021
FVG,  ,C 22,Fabbricazione di articoli in gomma e materie plastiche      ,4,1,0,0,5,2021
FVG,  ,C 23,Fabbricazione di altri prodotti della lavorazione di miner..,4,0,0,0,4,2021
FVG,  ,C 24,Metallurgia                                                 ,1,1,0,0,2,2021
FVG,  ,C 25,Fabbricazione di prodotti in metallo (esclusi macchinari ...,27,1,10,0,38,2021
FVG,  ,C 26,Fabbricazione di computer e prodotti di elettronica e ott...,8,0,0,0,8,2021
FVG,  ,C 27,Fabbricazione di apparecchiature elettriche ed apparecchi...,2,0,0,0,2,2021
FVG,  ,C 28,Fabbricazione di macchinari ed apparecchiature nca          ,11,0,0,0,11,2021
FVG,  ,C 29,"Fabbricazione di autoveicoli, rimorchi e semirimorchi       ",1,0,0,0,1,2021
FVG,  ,C 30,Fabbricazione di altri mezzi di trasporto                   ,14,0,1,0,15,2021
FVG,  ,C 31,Fabbricazione di mobili                                     ,22,0,1,0,23,2021
FVG,  ,C 32,Altre industrie manifatturiere                              ,2,1,1,0,4,2021
FVG,  ,C 33,"Riparazione, manutenzione ed installazione di macchine ed...",12,0,1,0,13,2021
FVG,  ,D   ,"Fornitura di energia elettrica, gas, vapore e aria condiz...",1,0,0,0,1,2021
FVG,  ,D 35,"Fornitura di energia elettrica, gas, vapore e aria condiz...",1,0,0,0,1,2021
FVG,  ,E   ,"Fornitura di acqua; reti fognarie, attività di gestione d...",2,0,1,0,3,2021
FVG,  ,E 36,"Raccolta, trattamento e fornitura di acqua                  ",0,0,0,0,0,2021
FVG,  ,E 37,Gestione delle reti fognarie                                ,1,0,0,0,1,2021
FVG,  ,E 38,"Attività di raccolta, trattamento e smaltimento dei rifiu...",1,0,0,0,1,2021
FVG,  ,E 39,Attività di risanamento e altri servizi di gestione dei r...,0,0,1,0,1,2021
FVG,  ,F   ,Costruzioni                                                 ,127,8,220,0,355,2021
FVG,  ,F 41,Costruzione di edifici                                      ,84,6,25,0,115,2021
FVG,  ,F 42,Ingegneria civile                                           ,4,0,3,0,7,2021
FVG,  ,F 43,Lavori di costruzione specializzati                         ,39,2,192,0,233,2021
FVG,  ,G   ,Commercio all'ingrosso e al dettaglio; riparazione di aut...,178,11,148,0,337,2021
FVG,  ,G 45,Commercio all'ingrosso e al dettaglio e riparazione di au...,11,0,6,0,17,2021
FVG,  ,G 46,Commercio all'ingrosso (escluso quello di autoveicoli e d...,121,2,35,0,158,2021
FVG,  ,G 47,Commercio al dettaglio (escluso quello di autoveicoli e d...,46,9,107,0,162,2021
FVG,  ,H   ,Trasporto e magazzinaggio                                   ,21,1,27,1,50,2021
FVG,  ,H 49,Trasporto terrestre e mediante condotte                     ,9,1,22,0,32,2021
FVG,  ,H 50,Trasporto marittimo e per vie d'acqua                       ,0,0,1,0,1,2021
FVG,  ,H 51,Trasporto aereo                                             ,0,0,0,0,0,2021
FVG,  ,H 52,Magazzinaggio e attività di supporto ai trasporti           ,12,0,4,1,17,2021
FVG,  ,H 53,Servizi postali e attività di corriere                      ,0,0,0,0,0,2021
FVG,  ,I   ,Attività dei servizi alloggio e ristorazione                ,49,10,40,0,99,2021
FVG,  ,I 55,Alloggio                                                    ,4,1,1,0,6,2021
FVG,  ,I 56,Attività dei servizi di ristorazione                        ,45,9,39,0,93,2021
FVG,  ,J   ,Servizi di informazione e comunicazione                     ,33,0,14,0,47,2021
FVG,  ,J 58,Attività editoriali                                         ,3,0,5,0,8,2021
FVG,  ,J 59,"Attività di produzione cinematografica, di video e di pro...",0,0,0,0,0,2021
FVG,  ,J 60,Attività di programmazione e trasmissione                   ,2,0,0,0,2,2021
FVG,  ,J 61,Telecomunicazioni                                           ,3,0,4,0,7,2021
FVG,  ,J 62,"Produzione di software, consulenza informatica e attività...",16,0,4,0,20,2021
FVG,  ,J 63,Attività dei servizi d'informazione e altri servizi infor...,9,0,1,0,10,2021
FVG,  ,K   ,Attività finanziarie e assicurative                         ,14,0,5,0,19,2021
FVG,  ,K 64,Attività di servizi finanziari (escluse le assicurazioni ...,5,0,0,0,5,2021
FVG,  ,K 65,"Assicurazioni, riassicurazioni e fondi pensione (escluse ...",0,0,0,0,0,2021
FVG,  ,K 66,Attività ausiliarie dei servizi finanziari e delle attivi...,9,0,5,0,14,2021
FVG,  ,L   ,Attivita' immobiliari                                       ,71,1,1,0,73,2021
FVG,  ,L 68,Attivita' immobiliari                                       ,71,1,1,0,73,2021
FVG,  ,M   ,"Attività professionali, scientifiche e tecniche             ",52,0,15,1,68,2021
FVG,  ,M 69,Attività legali e contabilità                               ,1,0,0,0,1,2021
FVG,  ,M 70,Attività di direzione aziendale e di consulenza gestional...,17,0,3,1,21,2021
FVG,  ,M 71,Attività degli studi di architettura e d'ingegneria; coll...,7,0,3,0,10,2021
FVG,  ,M 72,Ricerca scientifica e sviluppo                              ,4,0,0,0,4,2021
FVG,  ,M 73,Pubblicità e ricerche di mercato                            ,14,0,4,0,18,2021
FVG,  ,M 74,"Altre attività professionali, scientifiche e tecniche       ",9,0,5,0,14,2021
FVG,  ,M 75,Servizi veterinari                                          ,0,0,0,0,0,2021
FVG,  ,N   ,"Noleggio, agenzie di viaggio, servizi di supporto alle im...",24,2,16,3,45,2021
FVG,  ,N 77,Attività di noleggio e leasing operativo                    ,8,1,3,0,12,2021
FVG,  ,N 78,"Attività di ricerca, selezione, fornitura di personale      ",0,0,0,0,0,2021
FVG,  ,N 79,"Attività dei servizi delle agenzie di viaggio, dei tour o...",3,0,0,1,4,2021
FVG,  ,N 80,Servizi di vigilanza e investigazione                       ,1,0,0,0,1,2021
FVG,  ,N 81,Attività di servizi per edifici e paesaggio                 ,4,0,6,0,10,2021
FVG,  ,N 82,Attività di supporto per le funzioni d'ufficio e altri se...,8,1,7,2,18,2021
FVG,  ,O   ,Amministrazione pubblica e difesa; assicurazione sociale ...,0,0,0,0,0,2021
FVG,  ,O 84,Amministrazione pubblica e difesa; assicurazione sociale ...,0,0,0,0,0,2021
FVG,  ,P   ,Istruzione                                                  ,6,0,1,1,8,2021
FVG,  ,P 85,Istruzione                                                  ,6,0,1,1,8,2021
FVG,  ,Q   ,Sanita' e assistenza sociale                                ,5,0,2,1,8,2021
FVG,  ,Q 86,Assistenza sanitaria                                        ,3,0,0,0,3,2021
FVG,  ,Q 87,Servizi di assistenza sociale residenziale                  ,1,0,2,0,3,2021
FVG,  ,Q 88,Assistenza sociale non residenziale                         ,1,0,0,1,2,2021
FVG,  ,R   ,"Attività artistiche, sportive, di intrattenimento e diver...",35,0,6,0,41,2021
FVG,  ,R 90,"Attività creative, artistiche e di intrattenimento          ",9,0,2,0,11,2021
FVG,  ,R 91,"Attività di biblioteche, archivi, musei ed altre attività...",0,0,0,0,0,2021
FVG,  ,R 92,"Attività riguardanti le lotterie, le scommesse, le case d...",4,0,1,0,5,2021
FVG,  ,R 93,"Attività sportive, di intrattenimento e di divertimento     ",22,0,3,0,25,2021
FVG,  ,S   ,Altre attività di servizi                                   ,21,2,21,0,44,2021
FVG,  ,S 94,Attività di organizzazioni associative                      ,0,0,0,0,0,2021
FVG,  ,S 95,Riparazione di computer e di beni per uso personale e per...,4,2,7,0,13,2021
FVG,  ,S 96,Altre attività di servizi per la persona                    ,17,0,14,0,31,2021
FVG,  ,T   ,Attività di famiglie e convivenze come datori di lavoro p...,0,0,0,0,0,2021
FVG,  ,T 97,Attività di famiglie e convivenze come datori di lavoro p...,0,0,0,0,0,2021
FVG,  ,T 98,Produzione di beni e servizi indifferenziati per uso prop...,0,0,0,0,0,2021
FVG,  ,U   ,Organizzazioni ed organismi extraterritoriali               ,0,0,0,0,0,2021
FVG,  ,U 99,Organizzazioni ed organismi extraterritoriali               ,0,0,0,0,0,2021
FVG,  ,XX  ,Imprese non classificate                                    ,71,0,0,3,74,2021
FVG,  ,TOT ,TOTALE                                                      ,851,40,557,11,1459,2021
FVG,UD,A   ,"Agricoltura, silvicoltura pesca                             ",2,0,0,0,2,2021
FVG,UD,A 01,"Coltivazioni agricole e produzione di prodotti animali, c...",2,0,0,0,2,2021
FVG,UD,A 02,Silvicoltura ed utilizzo di aree forestali                  ,0,0,0,0,0,2021
FVG,UD,A 03,Pesca e acquacoltura                                        ,0,0,0,0,0,2021
FVG,UD,B   ,Estrazione di minerali da cave e miniere                    ,2,0,0,0,2,2021
FVG,UD,B 05,Estrazione di carbone (esclusa torba)                       ,0,0,0,0,0,2021
FVG,UD,B 06,Estraz.di petrolio greggio e di gas naturale                ,0,0,0,0,0,2021
FVG,UD,B 07,Estrazione di minerali metalliferi                          ,0,0,0,0,0,2021
FVG,UD,B 08,Altre attività di estrazione di minerali da cave e miniere  ,2,0,0,0,2,2021
FVG,UD,B 09,Attività dei servizi di supporto all'estrazione             ,0,0,0,0,0,2021
FVG,UD,C   ,Attività manifatturiere                                     ,62,0,0,0,62,2021
FVG,UD,C 10,Industrie alimentari                                        ,1,0,0,0,1,2021
FVG,UD,C 11,Industria delle bevande                                     ,0,0,0,0,0,2021
FVG,UD,C 12,Industria del tabacco                                       ,0,0,0,0,0,2021
FVG,UD,C 13,Industrie tessili                                           ,0,0,0,0,0,2021
FVG,UD,C 14,Confezione di articoli di abbigliamento; confezione di ar...,2,0,0,0,2,2021
FVG,UD,C 15,Fabbricazione di articoli in pelle e simili                 ,0,0,0,0,0,2021
FVG,UD,C 16,Industria del legno e dei prodotti in legno e sughero (es...,5,0,0,0,5,2021
FVG,UD,C 17,Fabbricazione di carta e di prodotti di carta               ,0,0,0,0,0,2021
FVG,UD,C 18,Stampa e riproduzione di supporti registrati                ,4,0,0,0,4,2021
FVG,UD,C 19,Fabbricazione di coke e prodotti derivanti dalla raffinaz...,0,0,0,0,0,2021
FVG,UD,C 20,Fabbricazione di prodotti chimici                           ,0,0,0,0,0,2021
FVG,UD,C 21,Fabbricazione di prodotti farmaceutici di base e di prepa...,0,0,0,0,0,2021
FVG,UD,C 22,Fabbricazione di articoli in gomma e materie plastiche      ,1,0,0,0,1,2021
FVG,UD,C 23,Fabbricazione di altri prodotti della lavorazione di miner..,3,0,0,0,3,2021
FVG,UD,C 24,Metallurgia                                                 ,0,0,0,0,0,2021
FVG,UD,C 25,Fabbricazione di prodotti in metallo (esclusi macchinari ...,16,0,0,0,16,2021
FVG,UD,C 26,Fabbricazione di computer e prodotti di elettronica e ott...,3,0,0,0,3,2021
FVG,UD,C 27,Fabbricazione di apparecchiature elettriche ed apparecchi...,1,0,0,0,1,2021
FVG,UD,C 28,Fabbricazione di macchinari ed apparecchiature nca          ,4,0,0,0,4,2021
FVG,UD,C 29,"Fabbricazione di autoveicoli, rimorchi e semirimorchi       ",1,0,0,0,1,2021
FVG,UD,C 30,Fabbricazione di altri mezzi di trasporto                   ,3,0,0,0,3,2021
FVG,UD,C 31,Fabbricazione di mobili                                     ,14,0,0,0,14,2021
FVG,UD,C 32,Altre industrie manifatturiere                              ,1,0,0,0,1,2021
FVG,UD,C 33,"Riparazione, manutenzione ed installazione di macchine ed...",3,0,0,0,3,2021
FVG,UD,D   ,"Fornitura di energia elettrica, gas, vapore e aria condiz...",0,0,0,0,0,2021
FVG,UD,D 35,"Fornitura di energia elettrica, gas, vapore e aria condiz...",0,0,0,0,0,2021
FVG,UD,E   ,"Fornitura di acqua; reti fognarie, attività di gestione d...",0,0,0,0,0,2021
FVG,UD,E 36,"Raccolta, trattamento e fornitura di acqua                  ",0,0,0,0,0,2021
FVG,UD,E 37,Gestione delle reti fognarie                                ,0,0,0,0,0,2021
FVG,UD,E 38,"Attività di raccolta, trattamento e smaltimento dei rifiu...",0,0,0,0,0,2021
FVG,UD,E 39,Attività di risanamento e altri servizi di gestione dei r...,0,0,0,0,0,2021
FVG,UD,F   ,Costruzioni                                                 ,62,0,1,0,63,2021
FVG,UD,F 41,Costruzione di edifici                                      ,47,0,0,0,47,2021
FVG,UD,F 42,Ingegneria civile                                           ,2,0,0,0,2,2021
FVG,UD,F 43,Lavori di costruzione specializzati                         ,13,0,1,0,14,2021
FVG,UD,G   ,Commercio all'ingrosso e al dettaglio; riparazione di aut...,92,0,0,0,92,2021
FVG,UD,G 45,Commercio all'ingrosso e al dettaglio e riparazione di au...,6,0,0,0,6,2021
FVG,UD,G 46,Commercio all'ingrosso (escluso quello di autoveicoli e d...,63,0,0,0,63,2021
FVG,UD,G 47,Commercio al dettaglio (escluso quello di autoveicoli e d...,23,0,0,0,23,2021
FVG,UD,H   ,Trasporto e magazzinaggio                                   ,7,0,0,0,7,2021
FVG,UD,H 49,Trasporto terrestre e mediante condotte                     ,3,0,0,0,3,2021
FVG,UD,H 50,Trasporto marittimo e per vie d'acqua                       ,0,0,0,0,0,2021
FVG,UD,H 51,Trasporto aereo                                             ,0,0,0,0,0,2021
FVG,UD,H 52,Magazzinaggio e attività di supporto ai trasporti           ,4,0,0,0,4,2021
FVG,UD,H 53,Servizi postali e attività di corriere                      ,0,0,0,0,0,2021
FVG,UD,I   ,Attività dei servizi alloggio e ristorazione                ,27,1,0,0,28,2021
FVG,UD,I 55,Alloggio                                                    ,2,0,0,0,2,2021
FVG,UD,I 56,Attività dei servizi di ristorazione                        ,25,1,0,0,26,2021
FVG,UD,J   ,Servizi di informazione e comunicazione                     ,18,0,0,0,18,2021
FVG,UD,J 58,Attività editoriali                                         ,2,0,0,0,2,2021
FVG,UD,J 59,"Attività di produzione cinematografica, di video e di pro...",0,0,0,0,0,2021
FVG,UD,J 60,Attività di programmazione e trasmissione                   ,0,0,0,0,0,2021
FVG,UD,J 61,Telecomunicazioni                                           ,3,0,0,0,3,2021
FVG,UD,J 62,"Produzione di software, consulenza informatica e attività...",8,0,0,0,8,2021
FVG,UD,J 63,Attività dei servizi d'informazione e altri servizi infor...,5,0,0,0,5,2021
FVG,UD,K   ,Attività finanziarie e assicurative                         ,5,0,0,0,5,2021
FVG,UD,K 64,Attività di servizi finanziari (escluse le assicurazioni ...,0,0,0,0,0,2021
FVG,UD,K 65,"Assicurazioni, riassicurazioni e fondi pensione (escluse ...",0,0,0,0,0,2021
FVG,UD,K 66,Attività ausiliarie dei servizi finanziari e delle attivi...,5,0,0,0,5,2021
FVG,UD,L   ,Attivita' immobiliari                                       ,42,0,0,0,42,2021
FVG,UD,L 68,Attivita' immobiliari                                       ,42,0,0,0,42,2021
FVG,UD,M   ,"Attività professionali, scientifiche e tecniche             ",29,0,0,0,29,2021
FVG,UD,M 69,Attività legali e contabilità                               ,1,0,0,0,1,2021
FVG,UD,M 70,Attività di direzione aziendale e di consulenza gestional...,8,0,0,0,8,2021
FVG,UD,M 71,Attività degli studi di architettura e d'ingegneria; coll...,2,0,0,0,2,2021
FVG,UD,M 72,Ricerca scientifica e sviluppo                              ,0,0,0,0,0,2021
FVG,UD,M 73,Pubblicità e ricerche di mercato                            ,11,0,0,0,11,2021
FVG,UD,M 74,"Altre attività professionali, scientifiche e tecniche       ",7,0,0,0,7,2021
FVG,UD,M 75,Servizi veterinari                                          ,0,0,0,0,0,2021
FVG,UD,N   ,"Noleggio, agenzie di viaggio, servizi di supporto alle im...",13,0,0,1,14,2021
FVG,UD,N 77,Attività di noleggio e leasing operativo                    ,3,0,0,0,3,2021
FVG,UD,N 78,"Attività di ricerca, selezione, fornitura di personale      ",0,0,0,0,0,2021
FVG,UD,N 79,"Attività dei servizi delle agenzie di viaggio, dei tour o...",2,0,0,1,3,2021
FVG,UD,N 80,Servizi di vigilanza e investigazione                       ,1,0,0,0,1,2021
FVG,UD,N 81,Attività di servizi per edifici e paesaggio                 ,4,0,0,0,4,2021
FVG,UD,N 82,Attività di supporto per le funzioni d'ufficio e altri se...,3,0,0,0,3,2021
FVG,UD,O   ,Amministrazione pubblica e difesa; assicurazione sociale ...,0,0,0,0,0,2021
FVG,UD,O 84,Amministrazione pubblica e difesa; assicurazione sociale ...,0,0,0,0,0,2021
FVG,UD,P   ,Istruzione                                                  ,2,0,0,1,3,2021
FVG,UD,P 85,Istruzione                                                  ,2,0,0,1,3,2021
FVG,UD,Q   ,Sanita' e assistenza sociale                                ,1,0,0,1,2,2021
FVG,UD,Q 86,Assistenza sanitaria                                        ,1,0,0,0,1,2021
FVG,UD,Q 87,Servizi di assistenza sociale residenziale                  ,0,0,0,0,0,2021
FVG,UD,Q 88,Assistenza sociale non residenziale                         ,0,0,0,1,1,2021
FVG,UD,R   ,"Attività artistiche, sportive, di intrattenimento e diver...",20,0,0,0,20,2021
FVG,UD,R 90,"Attività creative, artistiche e di intrattenimento          ",7,0,0,0,7,2021
FVG,UD,R 91,"Attività di biblioteche, archivi, musei ed altre attività...",0,0,0,0,0,2021
FVG,UD,R 92,"Attività riguardanti le lotterie, le scommesse, le case d...",3,0,0,0,3,2021
FVG,UD,R 93,"Attività sportive, di intrattenimento e di divertimento     ",10,0,0,0,10,2021
FVG,UD,S   ,Altre attività di servizi                                   ,10,0,1,0,11,2021
FVG,UD,S 94,Attività di organizzazioni associative                      ,0,0,0,0,0,2021
FVG,UD,S 95,Riparazione di computer e di beni per uso personale e per...,3,0,0,0,3,2021
FVG,UD,S 96,Altre attività di servizi per la persona                    ,7,0,1,0,8,2021
FVG,UD,T   ,Attività di famiglie e convivenze come datori di lavoro p...,0,0,0,0,0,2021
FVG,UD,T 97,Attività di famiglie e convivenze come datori di lavoro p...,0,0,0,0,0,2021
FVG,UD,T 98,Produzione di beni e servizi indifferenziati per uso prop...,0,0,0,0,0,2021
FVG,UD,U   ,Organizzazioni ed organismi extraterritoriali               ,0,0,0,0,0,2021
FVG,UD,U 99,Organizzazioni ed organismi extraterritoriali               ,0,0,0,0,0,2021
FVG,UD,XX  ,Imprese non classificate                                    ,34,0,0,1,35,2021
FVG,UD,TOT ,TOTALE                                                      ,428,1,2,4,435,2021
FVG,GO,A   ,"Agricoltura, silvicoltura pesca                             ",2,0,13,0,15,2021
FVG,GO,A 01,"Coltivazioni agricole e produzione di prodotti animali, c...",2,0,12,0,14,2021
FVG,GO,A 02,Silvicoltura ed utilizzo di aree forestali                  ,0,0,0,0,0,2021
FVG,GO,A 03,Pesca e acquacoltura                                        ,0,0,1,0,1,2021
FVG,GO,B   ,Estrazione di minerali da cave e miniere                    ,0,0,0,0,0,2021
FVG,GO,B 05,Estrazione di carbone (esclusa torba)                       ,0,0,0,0,0,2021
FVG,GO,B 06,Estraz.di petrolio greggio e di gas naturale                ,0,0,0,0,0,2021
FVG,GO,B 07,Estrazione di minerali metalliferi                          ,0,0,0,0,0,2021
FVG,GO,B 08,Altre attività di estrazione di minerali da cave e miniere  ,0,0,0,0,0,2021
FVG,GO,B 09,Attività dei servizi di supporto all'estrazione             ,0,0,0,0,0,2021
FVG,GO,C   ,Attività manifatturiere                                     ,51,3,3,0,57,2021
FVG,GO,C 10,Industrie alimentari                                        ,3,0,0,0,3,2021
FVG,GO,C 11,Industria delle bevande                                     ,1,0,0,0,1,2021
FVG,GO,C 12,Industria del tabacco                                       ,0,0,0,0,0,2021
FVG,GO,C 13,Industrie tessili                                           ,3,1,0,0,4,2021
FVG,GO,C 14,Confezione di articoli di abbigliamento; confezione di ar...,0,0,1,0,1,2021
FVG,GO,C 15,Fabbricazione di articoli in pelle e simili                 ,0,0,0,0,0,2021
FVG,GO,C 16,Industria del legno e dei prodotti in legno e sughero (es...,2,0,0,0,2,2021
FVG,GO,C 17,Fabbricazione di carta e di prodotti di carta               ,0,0,0,0,0,2021
FVG,GO,C 18,Stampa e riproduzione di supporti registrati                ,0,0,0,0,0,2021
FVG,GO,C 19,Fabbricazione di coke e prodotti derivanti dalla raffinaz...,0,0,0,0,0,2021
FVG,GO,C 20,Fabbricazione di prodotti chimici                           ,2,0,0,0,2,2021
FVG,GO,C 21,Fabbricazione di prodotti farmaceutici di base e di prepa...,0,0,0,0,0,2021
FVG,GO,C 22,Fabbricazione di articoli in gomma e materie plastiche      ,3,1,0,0,4,2021
FVG,GO,C 23,Fabbricazione di altri prodotti della lavorazione di miner..,1,0,0,0,1,2021
FVG,GO,C 24,Metallurgia                                                 ,1,0,0,0,1,2021
FVG,GO,C 25,Fabbricazione di prodotti in metallo (esclusi macchinari ...,7,0,2,0,9,2021
FVG,GO,C 26,Fabbricazione di computer e prodotti di elettronica e ott...,3,0,0,0,3,2021
FVG,GO,C 27,Fabbricazione di apparecchiature elettriche ed apparecchi...,1,0,0,0,1,2021
FVG,GO,C 28,Fabbricazione di macchinari ed apparecchiature nca          ,4,0,0,0,4,2021
FVG,GO,C 29,"Fabbricazione di autoveicoli, rimorchi e semirimorchi       ",0,0,0,0,0,2021
FVG,GO,C 30,Fabbricazione di altri mezzi di trasporto                   ,9,0,0,0,9,2021
FVG,GO,C 31,Fabbricazione di mobili                                     ,5,0,0,0,5,2021
FVG,GO,C 32,Altre industrie manifatturiere                              ,1,1,0,0,2,2021
FVG,GO,C 33,"Riparazione, manutenzione ed installazione di macchine ed...",5,0,0,0,5,2021
FVG,GO,D   ,"Fornitura di energia elettrica, gas, vapore e aria condiz...",0,0,0,0,0,2021
FVG,GO,D 35,"Fornitura di energia elettrica, gas, vapore e aria condiz...",0,0,0,0,0,2021
FVG,GO,E   ,"Fornitura di acqua; reti fognarie, attività di gestione d...",1,0,0,0,1,2021
FVG,GO,E 36,"Raccolta, trattamento e fornitura di acqua                  ",0,0,0,0,0,2021
FVG,GO,E 37,Gestione delle reti fognarie                                ,0,0,0,0,0,2021
FVG,GO,E 38,"Attività di raccolta, trattamento e smaltimento dei rifiu...",1,0,0,0,1,2021
FVG,GO,E 39,Attività di risanamento e altri servizi di gestione dei r...,0,0,0,0,0,2021
FVG,GO,F   ,Costruzioni                                                 ,33,5,20,0,58,2021
FVG,GO,F 41,Costruzione di edifici                                      ,20,5,2,0,27,2021
FVG,GO,F 42,Ingegneria civile                                           ,0,0,0,0,0,2021
FVG,GO,F 43,Lavori di costruzione specializzati                         ,13,0,18,0,31,2021
FVG,GO,G   ,Commercio all'ingrosso e al dettaglio; riparazione di aut...,44,1,34,0,79,2021
FVG,GO,G 45,Commercio all'ingrosso e al dettaglio e riparazione di au...,3,0,1,0,4,2021
FVG,GO,G 46,Commercio all'ingrosso (escluso quello di autoveicoli e d...,30,0,7,0,37,2021
FVG,GO,G 47,Commercio al dettaglio (escluso quello di autoveicoli e d...,11,1,26,0,38,2021
FVG,GO,H   ,Trasporto e magazzinaggio                                   ,6,0,3,0,9,2021
FVG,GO,H 49,Trasporto terrestre e mediante condotte                     ,3,0,2,0,5,2021
FVG,GO,H 50,Trasporto marittimo e per vie d'acqua                       ,0,0,0,0,0,2021
FVG,GO,H 51,Trasporto aereo                                             ,0,0,0,0,0,2021
FVG,GO,H 52,Magazzinaggio e attività di supporto ai trasporti           ,3,0,1,0,4,2021
FVG,GO,H 53,Servizi postali e attività di corriere                      ,0,0,0,0,0,2021
FVG,GO,I   ,Attività dei servizi alloggio e ristorazione                ,9,1,14,0,24,2021
FVG,GO,I 55,Alloggio                                                    ,1,0,1,0,2,2021
FVG,GO,I 56,Attività dei servizi di ristorazione                        ,8,1,13,0,22,2021
FVG,GO,J   ,Servizi di informazione e comunicazione                     ,1,0,2,0,3,2021
FVG,GO,J 58,Attività editoriali                                         ,1,0,0,0,1,2021
FVG,GO,J 59,"Attività di produzione cinematografica, di video e di pro...",0,0,0,0,0,2021
FVG,GO,J 60,Attività di programmazione e trasmissione                   ,0,0,0,0,0,2021
FVG,GO,J 61,Telecomunicazioni                                           ,0,0,2,0,2,2021
FVG,GO,J 62,"Produzione di software, consulenza informatica e attività...",0,0,0,0,0,2021
FVG,GO,J 63,Attività dei servizi d'informazione e altri servizi infor...,0,0,0,0,0,2021
FVG,GO,K   ,Attività finanziarie e assicurative                         ,4,0,1,0,5,2021
FVG,GO,K 64,Attività di servizi finanziari (escluse le assicurazioni ...,2,0,0,0,2,2021
FVG,GO,K 65,"Assicurazioni, riassicurazioni e fondi pensione (escluse ...",0,0,0,0,0,2021
FVG,GO,K 66,Attività ausiliarie dei servizi finanziari e delle attivi...,2,0,1,0,3,2021
FVG,GO,L   ,Attivita' immobiliari                                       ,7,0,0,0,7,2021
FVG,GO,L 68,Attivita' immobiliari                                       ,7,0,0,0,7,2021
FVG,GO,M   ,"Attività professionali, scientifiche e tecniche             ",5,0,3,0,8,2021
FVG,GO,M 69,Attività legali e contabilità                               ,0,0,0,0,0,2021
FVG,GO,M 70,Attività di direzione aziendale e di consulenza gestional...,2,0,1,0,3,2021
FVG,GO,M 71,Attività degli studi di architettura e d'ingegneria; coll...,1,0,1,0,2,2021
FVG,GO,M 72,Ricerca scientifica e sviluppo                              ,1,0,0,0,1,2021
FVG,GO,M 73,Pubblicità e ricerche di mercato                            ,0,0,0,0,0,2021
FVG,GO,M 74,"Altre attività professionali, scientifiche e tecniche       ",1,0,1,0,2,2021
FVG,GO,M 75,Servizi veterinari                                          ,0,0,0,0,0,2021
FVG,GO,N   ,"Noleggio, agenzie di viaggio, servizi di supporto alle im...",3,0,4,0,7,2021
FVG,GO,N 77,Attività di noleggio e leasing operativo                    ,1,0,0,0,1,2021
FVG,GO,N 78,"Attività di ricerca, selezione, fornitura di personale      ",0,0,0,0,0,2021
FVG,GO,N 79,"Attività dei servizi delle agenzie di viaggio, dei tour o...",0,0,0,0,0,2021
FVG,GO,N 80,Servizi di vigilanza e investigazione                       ,0,0,0,0,0,2021
FVG,GO,N 81,Attività di servizi per edifici e paesaggio                 ,0,0,2,0,2,2021
FVG,GO,N 82,Attività di supporto per le funzioni d'ufficio e altri se...,2,0,2,0,4,2021
FVG,GO,O   ,Amministrazione pubblica e difesa; assicurazione sociale ...,0,0,0,0,0,2021
FVG,GO,O 84,Amministrazione pubblica e difesa; assicurazione sociale ...,0,0,0,0,0,2021
FVG,GO,P   ,Istruzione                                                  ,1,0,0,0,1,2021
FVG,GO,P 85,Istruzione                                                  ,1,0,0,0,1,2021
FVG,GO,Q   ,Sanita' e assistenza sociale                                ,2,0,0,0,2,2021
FVG,GO,Q 86,Assistenza sanitaria                                        ,1,0,0,0,1,2021
FVG,GO,Q 87,Servizi di assistenza sociale residenziale                  ,0,0,0,0,0,2021
FVG,GO,Q 88,Assistenza sociale non residenziale                         ,1,0,0,0,1,2021
FVG,GO,R   ,"Attività artistiche, sportive, di intrattenimento e diver...",4,0,3,0,7,2021
FVG,GO,R 90,"Attività creative, artistiche e di intrattenimento          ",2,0,0,0,2,2021
FVG,GO,R 91,"Attività di biblioteche, archivi, musei ed altre attività...",0,0,0,0,0,2021
FVG,GO,R 92,"Attività riguardanti le lotterie, le scommesse, le case d...",0,0,1,0,1,2021
FVG,GO,R 93,"Attività sportive, di intrattenimento e di divertimento     ",2,0,2,0,4,2021
FVG,GO,S   ,Altre attività di servizi                                   ,7,1,7,0,15,2021
FVG,GO,S 94,Attività di organizzazioni associative                      ,0,0,0,0,0,2021
FVG,GO,S 95,Riparazione di computer e di beni per uso personale e per...,1,1,1,0,3,2021
FVG,GO,S 96,Altre attività di servizi per la persona                    ,6,0,6,0,12,2021
FVG,GO,T   ,Attività di famiglie e convivenze come datori di lavoro p...,0,0,0,0,0,2021
FVG,GO,T 97,Attività di famiglie e convivenze come datori di lavoro p...,0,0,0,0,0,2021
FVG,GO,T 98,Produzione di beni e servizi indifferenziati per uso prop...,0,0,0,0,0,2021
FVG,GO,U   ,Organizzazioni ed organismi extraterritoriali               ,0,0,0,0,0,2021
FVG,GO,U 99,Organizzazioni ed organismi extraterritoriali               ,0,0,0,0,0,2021
FVG,GO,XX  ,Imprese non classificate                                    ,19,0,0,1,20,2021
FVG,GO,TOT ,TOTALE                                                      ,199,11,107,1,318,2021
FVG,TS,A   ,"Agricoltura, silvicoltura pesca                             ",0,0,6,0,6,2021
FVG,TS,A 01,"Coltivazioni agricole e produzione di prodotti animali, c...",0,0,5,0,5,2021
FVG,TS,A 02,Silvicoltura ed utilizzo di aree forestali                  ,0,0,0,0,0,2021
FVG,TS,A 03,Pesca e acquacoltura                                        ,0,0,1,0,1,2021
FVG,TS,B   ,Estrazione di minerali da cave e miniere                    ,0,0,0,0,0,2021
FVG,TS,B 05,Estrazione di carbone (esclusa torba)                       ,0,0,0,0,0,2021
FVG,TS,B 06,Estraz.di petrolio greggio e di gas naturale                ,0,0,0,0,0,2021
FVG,TS,B 07,Estrazione di minerali metalliferi                          ,0,0,0,0,0,2021
FVG,TS,B 08,Altre attività di estrazione di minerali da cave e miniere  ,0,0,0,0,0,2021
FVG,TS,B 09,Attività dei servizi di supporto all'estrazione             ,0,0,0,0,0,2021
FVG,TS,C   ,Attività manifatturiere                                     ,11,1,16,0,28,2021
FVG,TS,C 10,Industrie alimentari                                        ,0,0,1,0,1,2021
FVG,TS,C 11,Industria delle bevande                                     ,0,0,0,0,0,2021
FVG,TS,C 12,Industria del tabacco                                       ,0,0,0,0,0,2021
FVG,TS,C 13,Industrie tessili                                           ,0,0,3,0,3,2021
FVG,TS,C 14,Confezione di articoli di abbigliamento; confezione di ar...,0,0,0,0,0,2021
FVG,TS,C 15,Fabbricazione di articoli in pelle e simili                 ,0,0,0,0,0,2021
FVG,TS,C 16,Industria del legno e dei prodotti in legno e sughero (es...,1,0,2,0,3,2021
FVG,TS,C 17,Fabbricazione di carta e di prodotti di carta               ,0,0,0,0,0,2021
FVG,TS,C 18,Stampa e riproduzione di supporti registrati                ,1,0,0,0,1,2021
FVG,TS,C 19,Fabbricazione di coke e prodotti derivanti dalla raffinaz...,0,0,0,0,0,2021
FVG,TS,C 20,Fabbricazione di prodotti chimici                           ,0,0,0,0,0,2021
FVG,TS,C 21,Fabbricazione di prodotti farmaceutici di base e di prepa...,0,0,0,0,0,2021
FVG,TS,C 22,Fabbricazione di articoli in gomma e materie plastiche      ,0,0,0,0,0,2021
FVG,TS,C 23,Fabbricazione di altri prodotti della lavorazione di miner..,0,0,0,0,0,2021
FVG,TS,C 24,Metallurgia                                                 ,0,1,0,0,1,2021
FVG,TS,C 25,Fabbricazione di prodotti in metallo (esclusi macchinari ...,3,0,6,0,9,2021
FVG,TS,C 26,Fabbricazione di computer e prodotti di elettronica e ott...,1,0,0,0,1,2021
FVG,TS,C 27,Fabbricazione di apparecchiature elettriche ed apparecchi...,0,0,0,0,0,2021
FVG,TS,C 28,Fabbricazione di macchinari ed apparecchiature nca          ,1,0,0,0,1,2021
FVG,TS,C 29,"Fabbricazione di autoveicoli, rimorchi e semirimorchi       ",0,0,0,0,0,2021
FVG,TS,C 30,Fabbricazione di altri mezzi di trasporto                   ,2,0,1,0,3,2021
FVG,TS,C 31,Fabbricazione di mobili                                     ,0,0,1,0,1,2021
FVG,TS,C 32,Altre industrie manifatturiere                              ,0,0,1,0,1,2021
FVG,TS,C 33,"Riparazione, manutenzione ed installazione di macchine ed...",2,0,1,0,3,2021
FVG,TS,D   ,"Fornitura di energia elettrica, gas, vapore e aria condiz...",1,0,0,0,1,2021
FVG,TS,D 35,"Fornitura di energia elettrica, gas, vapore e aria condiz...",1,0,0,0,1,2021
FVG,TS,E   ,"Fornitura di acqua; reti fognarie, attività di gestione d...",1,0,1,0,2,2021
FVG,TS,E 36,"Raccolta, trattamento e fornitura di acqua                  ",0,0,0,0,0,2021
FVG,TS,E 37,Gestione delle reti fognarie                                ,1,0,0,0,1,2021
FVG,TS,E 38,"Attività di raccolta, trattamento e smaltimento dei rifiu...",0,0,0,0,0,2021
FVG,TS,E 39,Attività di risanamento e altri servizi di gestione dei r...,0,0,1,0,1,2021
FVG,TS,F   ,Costruzioni                                                 ,27,3,190,0,220,2021
FVG,TS,F 41,Costruzione di edifici                                      ,13,1,21,0,35,2021
FVG,TS,F 42,Ingegneria civile                                           ,2,0,2,0,4,2021
FVG,TS,F 43,Lavori di costruzione specializzati                         ,12,2,167,0,181,2021
FVG,TS,G   ,Commercio all'ingrosso e al dettaglio; riparazione di aut...,34,10,114,0,158,2021
FVG,TS,G 45,Commercio all'ingrosso e al dettaglio e riparazione di au...,2,0,5,0,7,2021
FVG,TS,G 46,Commercio all'ingrosso (escluso quello di autoveicoli e d...,24,2,28,0,54,2021
FVG,TS,G 47,Commercio al dettaglio (escluso quello di autoveicoli e d...,8,8,81,0,97,2021
FVG,TS,H   ,Trasporto e magazzinaggio                                   ,7,1,22,1,31,2021
FVG,TS,H 49,Trasporto terrestre e mediante condotte                     ,2,1,18,0,21,2021
FVG,TS,H 50,Trasporto marittimo e per vie d'acqua                       ,0,0,1,0,1,2021
FVG,TS,H 51,Trasporto aereo                                             ,0,0,0,0,0,2021
FVG,TS,H 52,Magazzinaggio e attività di supporto ai trasporti           ,5,0,3,1,9,2021
FVG,TS,H 53,Servizi postali e attività di corriere                      ,0,0,0,0,0,2021
FVG,TS,I   ,Attività dei servizi alloggio e ristorazione                ,10,8,26,0,44,2021
FVG,TS,I 55,Alloggio                                                    ,1,1,0,0,2,2021
FVG,TS,I 56,Attività dei servizi di ristorazione                        ,9,7,26,0,42,2021
FVG,TS,J   ,Servizi di informazione e comunicazione                     ,12,0,11,0,23,2021
FVG,TS,J 58,Attività editoriali                                         ,0,0,5,0,5,2021
FVG,TS,J 59,"Attività di produzione cinematografica, di video e di pro...",0,0,0,0,0,2021
FVG,TS,J 60,Attività di programmazione e trasmissione                   ,2,0,0,0,2,2021
FVG,TS,J 61,Telecomunicazioni                                           ,0,0,2,0,2,2021
FVG,TS,J 62,"Produzione di software, consulenza informatica e attività...",6,0,3,0,9,2021
FVG,TS,J 63,Attività dei servizi d'informazione e altri servizi infor...,4,0,1,0,5,2021
FVG,TS,K   ,Attività finanziarie e assicurative                         ,4,0,4,0,8,2021
FVG,TS,K 64,Attività di servizi finanziari (escluse le assicurazioni ...,2,0,0,0,2,2021
FVG,TS,K 65,"Assicurazioni, riassicurazioni e fondi pensione (escluse ...",0,0,0,0,0,2021
FVG,TS,K 66,Attività ausiliarie dei servizi finanziari e delle attivi...,2,0,4,0,6,2021
FVG,TS,L   ,Attivita' immobiliari                                       ,18,1,1,0,20,2021
FVG,TS,L 68,Attivita' immobiliari                                       ,18,1,1,0,20,2021
FVG,TS,M   ,"Attività professionali, scientifiche e tecniche             ",16,0,12,0,28,2021
FVG,TS,M 69,Attività legali e contabilità                               ,0,0,0,0,0,2021
FVG,TS,M 70,Attività di direzione aziendale e di consulenza gestional...,7,0,2,0,9,2021
FVG,TS,M 71,Attività degli studi di architettura e d'ingegneria; coll...,3,0,2,0,5,2021
FVG,TS,M 72,Ricerca scientifica e sviluppo                              ,3,0,0,0,3,2021
FVG,TS,M 73,Pubblicità e ricerche di mercato                            ,2,0,4,0,6,2021
FVG,TS,M 74,"Altre attività professionali, scientifiche e tecniche       ",1,0,4,0,5,2021
FVG,TS,M 75,Servizi veterinari                                          ,0,0,0,0,0,2021
FVG,TS,N   ,"Noleggio, agenzie di viaggio, servizi di supporto alle im...",7,2,12,1,22,2021
FVG,TS,N 77,Attività di noleggio e leasing operativo                    ,3,1,3,0,7,2021
FVG,TS,N 78,"Attività di ricerca, selezione, fornitura di personale      ",0,0,0,0,0,2021
FVG,TS,N 79,"Attività dei servizi delle agenzie di viaggio, dei tour o...",1,0,0,0,1,2021
FVG,TS,N 80,Servizi di vigilanza e investigazione                       ,0,0,0,0,0,2021
FVG,TS,N 81,Attività di servizi per edifici e paesaggio                 ,0,0,4,0,4,2021
FVG,TS,N 82,Attività di supporto per le funzioni d'ufficio e altri se...,3,1,5,1,10,2021
FVG,TS,O   ,Amministrazione pubblica e difesa; assicurazione sociale ...,0,0,0,0,0,2021
FVG,TS,O 84,Amministrazione pubblica e difesa; assicurazione sociale ...,0,0,0,0,0,2021
FVG,TS,P   ,Istruzione                                                  ,1,0,1,0,2,2021
FVG,TS,P 85,Istruzione                                                  ,1,0,1,0,2,2021
FVG,TS,Q   ,Sanita' e assistenza sociale                                ,1,0,2,0,3,2021
FVG,TS,Q 86,Assistenza sanitaria                                        ,0,0,0,0,0,2021
FVG,TS,Q 87,Servizi di assistenza sociale residenziale                  ,1,0,2,0,3,2021
FVG,TS,Q 88,Assistenza sociale non residenziale                         ,0,0,0,0,0,2021
FVG,TS,R   ,"Attività artistiche, sportive, di intrattenimento e diver...",8,0,3,0,11,2021
FVG,TS,R 90,"Attività creative, artistiche e di intrattenimento          ",0,0,2,0,2,2021
FVG,TS,R 91,"Attività di biblioteche, archivi, musei ed altre attività...",0,0,0,0,0,2021
FVG,TS,R 92,"Attività riguardanti le lotterie, le scommesse, le case d...",1,0,0,0,1,2021
FVG,TS,R 93,"Attività sportive, di intrattenimento e di divertimento     ",7,0,1,0,8,2021
FVG,TS,S   ,Altre attività di servizi                                   ,4,1,13,0,18,2021
FVG,TS,S 94,Attività di organizzazioni associative                      ,0,0,0,0,0,2021
FVG,TS,S 95,Riparazione di computer e di beni per uso personale e per...,0,1,6,0,7,2021
FVG,TS,S 96,Altre attività di servizi per la persona                    ,4,0,7,0,11,2021
FVG,TS,T   ,Attività di famiglie e convivenze come datori di lavoro p...,0,0,0,0,0,2021
FVG,TS,T 97,Attività di famiglie e convivenze come datori di lavoro p...,0,0,0,0,0,2021
FVG,TS,T 98,Produzione di beni e servizi indifferenziati per uso prop...,0,0,0,0,0,2021
FVG,TS,U   ,Organizzazioni ed organismi extraterritoriali               ,0,0,0,0,0,2021
FVG,TS,U 99,Organizzazioni ed organismi extraterritoriali               ,0,0,0,0,0,2021
FVG,TS,XX  ,Imprese non classificate                                    ,11,0,0,1,12,2021
FVG,TS,TOT ,TOTALE                                                      ,173,27,434,3,637,2021
FVG,PN,A   ,"Agricoltura, silvicoltura pesca                             ",0,0,0,1,1,2021
FVG,PN,A 01,"Coltivazioni agricole e produzione di prodotti animali, c...",0,0,0,1,1,2021
FVG,PN,A 02,Silvicoltura ed utilizzo di aree forestali                  ,0,0,0,0,0,2021
FVG,PN,A 03,Pesca e acquacoltura                                        ,0,0,0,0,0,2021
FVG,PN,B   ,Estrazione di minerali da cave e miniere                    ,0,0,0,0,0,2021
FVG,PN,B 05,Estrazione di carbone (esclusa torba)                       ,0,0,0,0,0,2021
FVG,PN,B 06,Estraz.di petrolio greggio e di gas naturale                ,0,0,0,0,0,2021
FVG,PN,B 07,Estrazione di minerali metalliferi                          ,0,0,0,0,0,2021
FVG,PN,B 08,Altre attività di estrazione di minerali da cave e miniere  ,0,0,0,0,0,2021
FVG,PN,B 09,Attività dei servizi di supporto all'estrazione             ,0,0,0,0,0,2021
FVG,PN,C   ,Attività manifatturiere                                     ,11,1,2,0,14,2021
FVG,PN,C 10,Industrie alimentari                                        ,0,0,0,0,0,2021
FVG,PN,C 11,Industria delle bevande                                     ,0,0,0,0,0,2021
FVG,PN,C 12,Industria del tabacco                                       ,0,0,0,0,0,2021
FVG,PN,C 13,Industrie tessili                                           ,0,0,0,0,0,2021
FVG,PN,C 14,Confezione di articoli di abbigliamento; confezione di ar...,0,0,0,0,0,2021
FVG,PN,C 15,Fabbricazione di articoli in pelle e simili                 ,0,0,0,0,0,2021
FVG,PN,C 16,Industria del legno e dei prodotti in legno e sughero (es...,0,0,0,0,0,2021
FVG,PN,C 17,Fabbricazione di carta e di prodotti di carta               ,0,0,0,0,0,2021
FVG,PN,C 18,Stampa e riproduzione di supporti registrati                ,1,0,0,0,1,2021
FVG,PN,C 19,Fabbricazione di coke e prodotti derivanti dalla raffinaz...,0,0,0,0,0,2021
FVG,PN,C 20,Fabbricazione di prodotti chimici                           ,1,0,0,0,1,2021
FVG,PN,C 21,Fabbricazione di prodotti farmaceutici di base e di prepa...,0,0,0,0,0,2021
FVG,PN,C 22,Fabbricazione di articoli in gomma e materie plastiche      ,0,0,0,0,0,2021
FVG,PN,C 23,Fabbricazione di altri prodotti della lavorazione di miner..,0,0,0,0,0,2021
FVG,PN,C 24,Metallurgia                                                 ,0,0,0,0,0,2021
FVG,PN,C 25,Fabbricazione di prodotti in metallo (esclusi macchinari ...,1,1,2,0,4,2021
FVG,PN,C 26,Fabbricazione di computer e prodotti di elettronica e ott...,1,0,0,0,1,2021
FVG,PN,C 27,Fabbricazione di apparecchiature elettriche ed apparecchi...,0,0,0,0,0,2021
FVG,PN,C 28,Fabbricazione di macchinari ed apparecchiature nca          ,2,0,0,0,2,2021
FVG,PN,C 29,"Fabbricazione di autoveicoli, rimorchi e semirimorchi       ",0,0,0,0,0,2021
FVG,PN,C 30,Fabbricazione di altri mezzi di trasporto                   ,0,0,0,0,0,2021
FVG,PN,C 31,Fabbricazione di mobili                                     ,3,0,0,0,3,2021
FVG,PN,C 32,Altre industrie manifatturiere                              ,0,0,0,0,0,2021
FVG,PN,C 33,"Riparazione, manutenzione ed installazione di macchine ed...",2,0,0,0,2,2021
FVG,PN,D   ,"Fornitura di energia elettrica, gas, vapore e aria condiz...",0,0,0,0,0,2021
FVG,PN,D 35,"Fornitura di energia elettrica, gas, vapore e aria condiz...",0,0,0,0,0,2021
FVG,PN,E   ,"Fornitura di acqua; reti fognarie, attività di gestione d...",0,0,0,0,0,2021
FVG,PN,E 36,"Raccolta, trattamento e fornitura di acqua                  ",0,0,0,0,0,2021
FVG,PN,E 37,Gestione delle reti fognarie                                ,0,0,0,0,0,2021
FVG,PN,E 38,"Attività di raccolta, trattamento e smaltimento dei rifiu...",0,0,0,0,0,2021
FVG,PN,E 39,Attività di risanamento e altri servizi di gestione dei r...,0,0,0,0,0,2021
FVG,PN,F   ,Costruzioni                                                 ,5,0,9,0,14,2021
FVG,PN,F 41,Costruzione di edifici                                      ,4,0,2,0,6,2021
FVG,PN,F 42,Ingegneria civile                                           ,0,0,1,0,1,2021
FVG,PN,F 43,Lavori di costruzione specializzati                         ,1,0,6,0,7,2021
FVG,PN,G   ,Commercio all'ingrosso e al dettaglio; riparazione di aut...,8,0,0,0,8,2021
FVG,PN,G 45,Commercio all'ingrosso e al dettaglio e riparazione di au...,0,0,0,0,0,2021
FVG,PN,G 46,Commercio all'ingrosso (escluso quello di autoveicoli e d...,4,0,0,0,4,2021
FVG,PN,G 47,Commercio al dettaglio (escluso quello di autoveicoli e d...,4,0,0,0,4,2021
FVG,PN,H   ,Trasporto e magazzinaggio                                   ,1,0,2,0,3,2021
FVG,PN,H 49,Trasporto terrestre e mediante condotte                     ,1,0,2,0,3,2021
FVG,PN,H 50,Trasporto marittimo e per vie d'acqua                       ,0,0,0,0,0,2021
FVG,PN,H 51,Trasporto aereo                                             ,0,0,0,0,0,2021
FVG,PN,H 52,Magazzinaggio e attività di supporto ai trasporti           ,0,0,0,0,0,2021
FVG,PN,H 53,Servizi postali e attività di corriere                      ,0,0,0,0,0,2021
FVG,PN,I   ,Attività dei servizi alloggio e ristorazione                ,3,0,0,0,3,2021
FVG,PN,I 55,Alloggio                                                    ,0,0,0,0,0,2021
FVG,PN,I 56,Attività dei servizi di ristorazione                        ,3,0,0,0,3,2021
FVG,PN,J   ,Servizi di informazione e comunicazione                     ,2,0,1,0,3,2021
FVG,PN,J 58,Attività editoriali                                         ,0,0,0,0,0,2021
FVG,PN,J 59,"Attività di produzione cinematografica, di video e di pro...",0,0,0,0,0,2021
FVG,PN,J 60,Attività di programmazione e trasmissione                   ,0,0,0,0,0,2021
FVG,PN,J 61,Telecomunicazioni                                           ,0,0,0,0,0,2021
FVG,PN,J 62,"Produzione di software, consulenza informatica e attività...",2,0,1,0,3,2021
FVG,PN,J 63,Attività dei servizi d'informazione e altri servizi infor...,0,0,0,0,0,2021
FVG,PN,K   ,Attività finanziarie e assicurative                         ,1,0,0,0,1,2021
FVG,PN,K 64,Attività di servizi finanziari (escluse le assicurazioni ...,1,0,0,0,1,2021
FVG,PN,K 65,"Assicurazioni, riassicurazioni e fondi pensione (escluse ...",0,0,0,0,0,2021
FVG,PN,K 66,Attività ausiliarie dei servizi finanziari e delle attivi...,0,0,0,0,0,2021
FVG,PN,L   ,Attivita' immobiliari                                       ,4,0,0,0,4,2021
FVG,PN,L 68,Attivita' immobiliari                                       ,4,0,0,0,4,2021
FVG,PN,M   ,"Attività professionali, scientifiche e tecniche             ",2,0,0,1,3,2021
FVG,PN,M 69,Attività legali e contabilità                               ,0,0,0,0,0,2021
FVG,PN,M 70,Attività di direzione aziendale e di consulenza gestional...,0,0,0,1,1,2021
FVG,PN,M 71,Attività degli studi di architettura e d'ingegneria; coll...,1,0,0,0,1,2021
FVG,PN,M 72,Ricerca scientifica e sviluppo                              ,0,0,0,0,0,2021
FVG,PN,M 73,Pubblicità e ricerche di mercato                            ,1,0,0,0,1,2021
FVG,PN,M 74,"Altre attività professionali, scientifiche e tecniche       ",0,0,0,0,0,2021
FVG,PN,M 75,Servizi veterinari                                          ,0,0,0,0,0,2021
FVG,PN,N   ,"Noleggio, agenzie di viaggio, servizi di supporto alle im...",1,0,0,1,2,2021
FVG,PN,N 77,Attività di noleggio e leasing operativo                    ,1,0,0,0,1,2021
FVG,PN,N 78,"Attività di ricerca, selezione, fornitura di personale      ",0,0,0,0,0,2021
FVG,PN,N 79,"Attività dei servizi delle agenzie di viaggio, dei tour o...",0,0,0,0,0,2021
FVG,PN,N 80,Servizi di vigilanza e investigazione                       ,0,0,0,0,0,2021
FVG,PN,N 81,Attività di servizi per edifici e paesaggio                 ,0,0,0,0,0,2021
FVG,PN,N 82,Attività di supporto per le funzioni d'ufficio e altri se...,0,0,0,1,1,2021
FVG,PN,O   ,Amministrazione pubblica e difesa; assicurazione sociale ...,0,0,0,0,0,2021
FVG,PN,O 84,Amministrazione pubblica e difesa; assicurazione sociale ...,0,0,0,0,0,2021
FVG,PN,P   ,Istruzione                                                  ,2,0,0,0,2,2021
FVG,PN,P 85,Istruzione                                                  ,2,0,0,0,2,2021
FVG,PN,Q   ,Sanita' e assistenza sociale                                ,1,0,0,0,1,2021
FVG,PN,Q 86,Assistenza sanitaria                                        ,1,0,0,0,1,2021
FVG,PN,Q 87,Servizi di assistenza sociale residenziale                  ,0,0,0,0,0,2021
FVG,PN,Q 88,Assistenza sociale non residenziale                         ,0,0,0,0,0,2021
FVG,PN,R   ,"Attività artistiche, sportive, di intrattenimento e diver...",3,0,0,0,3,2021
FVG,PN,R 90,"Attività creative, artistiche e di intrattenimento          ",0,0,0,0,0,2021
FVG,PN,R 91,"Attività di biblioteche, archivi, musei ed altre attività...",0,0,0,0,0,2021
FVG,PN,R 92,"Attività riguardanti le lotterie, le scommesse, le case d...",0,0,0,0,0,2021
FVG,PN,R 93,"Attività sportive, di intrattenimento e di divertimento     ",3,0,0,0,3,2021
FVG,PN,S   ,Altre attività di servizi                                   ,0,0,0,0,0,2021
FVG,PN,S 94,Attività di organizzazioni associative                      ,0,0,0,0,0,2021
FVG,PN,S 95,Riparazione di computer e di beni per uso personale e per...,0,0,0,0,0,2021
FVG,PN,S 96,Altre attività di servizi per la persona                    ,0,0,0,0,0,2021
FVG,PN,T   ,Attività di famiglie e convivenze come datori di lavoro p...,0,0,0,0,0,2021
FVG,PN,T 97,Attività di famiglie e convivenze come datori di lavoro p...,0,0,0,0,0,2021
FVG,PN,T 98,Produzione di beni e servizi indifferenziati per uso prop...,0,0,0,0,0,2021
FVG,PN,U   ,Organizzazioni ed organismi extraterritoriali               ,0,0,0,0,0,2021
FVG,PN,U 99,Organizzazioni ed organismi extraterritoriali               ,0,0,0,0,0,2021
FVG,PN,XX  ,Imprese non classificate                                    ,7,0,0,0,7,2021
FVG,PN,TOT ,TOTALE                                                      ,51,1,14,3,69,2021
LIG,  ,A   ,"Agricoltura, silvicoltura pesca                             ",0,0,10,1,11,2021
LIG,  ,A 01,"Coltivazioni agricole e produzione di prodotti animali, c...",0,0,8,0,8,2021
LIG,  ,A 02,Silvicoltura ed utilizzo di aree forestali                  ,0,0,1,1,2,2021
LIG,  ,A 03,Pesca e acquacoltura                                        ,0,0,1,0,1,2021
LIG,  ,B   ,Estrazione di minerali da cave e miniere                    ,0,0,0,0,0,2021
LIG,  ,B 05,Estrazione di carbone (esclusa torba)                       ,0,0,0,0,0,2021
LIG,  ,B 06,Estraz.di petrolio greggio e di gas naturale                ,0,0,0,0,0,2021
LIG,  ,B 07,Estrazione di minerali metalliferi                          ,0,0,0,0,0,2021
LIG,  ,B 08,Altre attività di estrazione di minerali da cave e miniere  ,0,0,0,0,0,2021
LIG,  ,B 09,Attività dei servizi di supporto all'estrazione             ,0,0,0,0,0,2021
LIG,  ,C   ,Attività manifatturiere                                     ,8,4,5,2,19,2021
LIG,  ,C 10,Industrie alimentari                                        ,0,1,1,0,2,2021
LIG,  ,C 11,Industria delle bevande                                     ,0,0,0,0,0,2021
LIG,  ,C 12,Industria del tabacco                                       ,0,0,0,0,0,2021
LIG,  ,C 13,Industrie tessili                                           ,0,0,1,0,1,2021
LIG,  ,C 14,Confezione di articoli di abbigliamento; confezione di ar...,0,0,0,0,0,2021
LIG,  ,C 15,Fabbricazione di articoli in pelle e simili                 ,0,0,0,0,0,2021
LIG,  ,C 16,Industria del legno e dei prodotti in legno e sughero (es...,1,0,0,0,1,2021
LIG,  ,C 17,Fabbricazione di carta e di prodotti di carta               ,0,0,0,0,0,2021
LIG,  ,C 18,Stampa e riproduzione di supporti registrati                ,1,1,0,0,2,2021
LIG,  ,C 19,Fabbricazione di coke e prodotti derivanti dalla raffinaz...,0,0,0,0,0,2021
LIG,  ,C 20,Fabbricazione di prodotti chimici                           ,0,0,0,0,0,2021
LIG,  ,C 21,Fabbricazione di prodotti farmaceutici di base e di prepa...,0,0,0,0,0,2021
LIG,  ,C 22,Fabbricazione di articoli in gomma e materie plastiche      ,0,0,0,0,0,2021
LIG,  ,C 23,Fabbricazione di altri prodotti della lavorazione di miner..,1,0,0,0,1,2021
LIG,  ,C 24,Metallurgia                                                 ,0,0,0,0,0,2021
LIG,  ,C 25,Fabbricazione di prodotti in metallo (esclusi macchinari ...,1,0,2,0,3,2021
LIG,  ,C 26,Fabbricazione di computer e prodotti di elettronica e ott...,0,0,0,0,0,2021
LIG,  ,C 27,Fabbricazione di apparecchiature elettriche ed apparecchi...,0,0,0,0,0,2021
LIG,  ,C 28,Fabbricazione di macchinari ed apparecchiature nca          ,0,0,0,0,0,2021
LIG,  ,C 29,"Fabbricazione di autoveicoli, rimorchi e semirimorchi       ",0,0,0,0,0,2021
LIG,  ,C 30,Fabbricazione di altri mezzi di trasporto                   ,0,1,0,2,3,2021
LIG,  ,C 31,Fabbricazione di mobili                                     ,1,0,0,0,1,2021
LIG,  ,C 32,Altre industrie manifatturiere                              ,1,1,0,0,2,2021
LIG,  ,C 33,"Riparazione, manutenzione ed installazione di macchine ed...",2,0,1,0,3,2021
LIG,  ,D   ,"Fornitura di energia elettrica, gas, vapore e aria condiz...",0,0,0,0,0,2021
LIG,  ,D 35,"Fornitura di energia elettrica, gas, vapore e aria condiz...",0,0,0,0,0,2021
LIG,  ,E   ,"Fornitura di acqua; reti fognarie, attività di gestione d...",0,0,0,1,1,2021
LIG,  ,E 36,"Raccolta, trattamento e fornitura di acqua                  ",0,0,0,0,0,2021
LIG,  ,E 37,Gestione delle reti fognarie                                ,0,0,0,1,1,2021
LIG,  ,E 38,"Attività di raccolta, trattamento e smaltimento dei rifiu...",0,0,0,0,0,2021
LIG,  ,E 39,Attività di risanamento e altri servizi di gestione dei r...,0,0,0,0,0,2021
LIG,  ,F   ,Costruzioni                                                 ,13,3,13,7,36,2021
LIG,  ,F 41,Costruzione di edifici                                      ,7,2,3,3,15,2021
LIG,  ,F 42,Ingegneria civile                                           ,0,0,0,1,1,2021
LIG,  ,F 43,Lavori di costruzione specializzati                         ,6,1,10,3,20,2021
LIG,  ,G   ,Commercio all'ingrosso e al dettaglio; riparazione di aut...,11,9,83,4,107,2021
LIG,  ,G 45,Commercio all'ingrosso e al dettaglio e riparazione di au...,1,1,8,1,11,2021
LIG,  ,G 46,Commercio all'ingrosso (escluso quello di autoveicoli e d...,5,2,24,1,32,2021
LIG,  ,G 47,Commercio al dettaglio (escluso quello di autoveicoli e d...,5,6,51,2,64,2021
LIG,  ,H   ,Trasporto e magazzinaggio                                   ,0,2,4,4,10,2021
LIG,  ,H 49,Trasporto terrestre e mediante condotte                     ,0,0,3,1,4,2021
LIG,  ,H 50,Trasporto marittimo e per vie d'acqua                       ,0,0,0,0,0,2021
LIG,  ,H 51,Trasporto aereo                                             ,0,0,0,0,0,2021
LIG,  ,H 52,Magazzinaggio e attività di supporto ai trasporti           ,0,2,1,3,6,2021
LIG,  ,H 53,Servizi postali e attività di corriere                      ,0,0,0,0,0,2021
LIG,  ,I   ,Attività dei servizi alloggio e ristorazione                ,13,11,12,1,37,2021
LIG,  ,I 55,Alloggio                                                    ,0,0,1,0,1,2021
LIG,  ,I 56,Attività dei servizi di ristorazione                        ,13,11,11,1,36,2021
LIG,  ,J   ,Servizi di informazione e comunicazione                     ,2,0,3,3,8,2021
LIG,  ,J 58,Attività editoriali                                         ,0,0,1,0,1,2021
LIG,  ,J 59,"Attività di produzione cinematografica, di video e di pro...",1,0,1,0,2,2021
LIG,  ,J 60,Attività di programmazione e trasmissione                   ,0,0,0,0,0,2021
LIG,  ,J 61,Telecomunicazioni                                           ,0,0,0,0,0,2021
LIG,  ,J 62,"Produzione di software, consulenza informatica e attività...",0,0,0,0,0,2021
LIG,  ,J 63,Attività dei servizi d'informazione e altri servizi infor...,1,0,1,3,5,2021
LIG,  ,K   ,Attività finanziarie e assicurative                         ,1,2,3,0,6,2021
LIG,  ,K 64,Attività di servizi finanziari (escluse le assicurazioni ...,1,0,0,0,1,2021
LIG,  ,K 65,"Assicurazioni, riassicurazioni e fondi pensione (escluse ...",0,0,0,0,0,2021
LIG,  ,K 66,Attività ausiliarie dei servizi finanziari e delle attivi...,0,2,3,0,5,2021
LIG,  ,L   ,Attivita' immobiliari                                       ,2,4,7,0,13,2021
LIG,  ,L 68,Attivita' immobiliari                                       ,2,4,7,0,13,2021
LIG,  ,M   ,"Attività professionali, scientifiche e tecniche             ",3,0,2,1,6,2021
LIG,  ,M 69,Attività legali e contabilità                               ,0,0,1,0,1,2021
LIG,  ,M 70,Attività di direzione aziendale e di consulenza gestional...,0,0,1,0,1,2021
LIG,  ,M 71,Attività degli studi di architettura e d'ingegneria; coll...,1,0,0,0,1,2021
LIG,  ,M 72,Ricerca scientifica e sviluppo                              ,0,0,0,0,0,2021
LIG,  ,M 73,Pubblicità e ricerche di mercato                            ,1,0,0,1,2,2021
LIG,  ,M 74,"Altre attività professionali, scientifiche e tecniche       ",1,0,0,0,1,2021
LIG,  ,M 75,Servizi veterinari                                          ,0,0,0,0,0,2021
LIG,  ,N   ,"Noleggio, agenzie di viaggio, servizi di supporto alle im...",1,0,5,1,7,2021
LIG,  ,N 77,Attività di noleggio e leasing operativo                    ,0,0,0,0,0,2021
LIG,  ,N 78,"Attività di ricerca, selezione, fornitura di personale      ",0,0,0,1,1,2021
LIG,  ,N 79,"Attività dei servizi delle agenzie di viaggio, dei tour o...",1,0,0,0,1,2021
LIG,  ,N 80,Servizi di vigilanza e investigazione                       ,0,0,0,0,0,2021
LIG,  ,N 81,Attività di servizi per edifici e paesaggio                 ,0,0,2,0,2,2021
LIG,  ,N 82,Attività di supporto per le funzioni d'ufficio e altri se...,0,0,3,0,3,2021
LIG,  ,O   ,Amministrazione pubblica e difesa; assicurazione sociale ...,0,0,0,0,0,2021
LIG,  ,O 84,Amministrazione pubblica e difesa; assicurazione sociale ...,0,0,0,0,0,2021
LIG,  ,P   ,Istruzione                                                  ,1,0,0,0,1,2021
LIG,  ,P 85,Istruzione                                                  ,1,0,0,0,1,2021
LIG,  ,Q   ,Sanita' e assistenza sociale                                ,1,1,0,0,2,2021
LIG,  ,Q 86,Assistenza sanitaria                                        ,1,0,0,0,1,2021
LIG,  ,Q 87,Servizi di assistenza sociale residenziale                  ,0,0,0,0,0,2021
LIG,  ,Q 88,Assistenza sociale non residenziale                         ,0,1,0,0,1,2021
LIG,  ,R   ,"Attività artistiche, sportive, di intrattenimento e diver...",5,1,0,0,6,2021
LIG,  ,R 90,"Attività creative, artistiche e di intrattenimento          ",0,0,0,0,0,2021
LIG,  ,R 91,"Attività di biblioteche, archivi, musei ed altre attività...",0,0,0,0,0,2021
LIG,  ,R 92,"Attività riguardanti le lotterie, le scommesse, le case d...",1,0,0,0,1,2021
LIG,  ,R 93,"Attività sportive, di intrattenimento e di divertimento     ",4,1,0,0,5,2021
LIG,  ,S   ,Altre attività di servizi                                   ,3,0,1,1,5,2021
LIG,  ,S 94,Attività di organizzazioni associative                      ,0,0,0,0,0,2021
LIG,  ,S 95,Riparazione di computer e di beni per uso personale e per...,1,0,1,0,2,2021
LIG,  ,S 96,Altre attività di servizi per la persona                    ,2,0,0,1,3,2021
LIG,  ,T   ,Attività di famiglie e convivenze come datori di lavoro p...,0,0,0,0,0,2021
LIG,  ,T 97,Attività di famiglie e convivenze come datori di lavoro p...,0,0,0,0,0,2021
LIG,  ,T 98,Produzione di beni e servizi indifferenziati per uso prop...,0,0,0,0,0,2021
LIG,  ,U   ,Organizzazioni ed organismi extraterritoriali               ,0,0,0,0,0,2021
LIG,  ,U 99,Organizzazioni ed organismi extraterritoriali               ,0,0,0,0,0,2021
LIG,  ,XX  ,Imprese non classificate                                    ,16,5,5,17,43,2021
LIG,  ,TOT ,TOTALE                                                      ,80,42,153,43,318,2021
LIG,IM,A   ,"Agricoltura, silvicoltura pesca                             ",0,0,0,1,1,2021
LIG,IM,A 01,"Coltivazioni agricole e produzione di prodotti animali, c...",0,0,0,0,0,2021
LIG,IM,A 02,Silvicoltura ed utilizzo di aree forestali                  ,0,0,0,1,1,2021
LIG,IM,A 03,Pesca e acquacoltura                                        ,0,0,0,0,0,2021
LIG,IM,B   ,Estrazione di minerali da cave e miniere                    ,0,0,0,0,0,2021
LIG,IM,B 05,Estrazione di carbone (esclusa torba)                       ,0,0,0,0,0,2021
LIG,IM,B 06,Estraz.di petrolio greggio e di gas naturale                ,0,0,0,0,0,2021
LIG,IM,B 07,Estrazione di minerali metalliferi                          ,0,0,0,0,0,2021
LIG,IM,B 08,Altre attività di estrazione di minerali da cave e miniere  ,0,0,0,0,0,2021
LIG,IM,B 09,Attività dei servizi di supporto all'estrazione             ,0,0,0,0,0,2021
LIG,IM,C   ,Attività manifatturiere                                     ,0,1,0,0,1,2021
LIG,IM,C 10,Industrie alimentari                                        ,0,0,0,0,0,2021
LIG,IM,C 11,Industria delle bevande                                     ,0,0,0,0,0,2021
LIG,IM,C 12,Industria del tabacco                                       ,0,0,0,0,0,2021
LIG,IM,C 13,Industrie tessili                                           ,0,0,0,0,0,2021
LIG,IM,C 14,Confezione di articoli di abbigliamento; confezione di ar...,0,0,0,0,0,2021
LIG,IM,C 15,Fabbricazione di articoli in pelle e simili                 ,0,0,0,0,0,2021
LIG,IM,C 16,Industria del legno e dei prodotti in legno e sughero (es...,0,0,0,0,0,2021
LIG,IM,C 17,Fabbricazione di carta e di prodotti di carta               ,0,0,0,0,0,2021
LIG,IM,C 18,Stampa e riproduzione di supporti registrati                ,0,0,0,0,0,2021
LIG,IM,C 19,Fabbricazione di coke e prodotti derivanti dalla raffinaz...,0,0,0,0,0,2021
LIG,IM,C 20,Fabbricazione di prodotti chimici                           ,0,0,0,0,0,2021
LIG,IM,C 21,Fabbricazione di prodotti farmaceutici di base e di prepa...,0,0,0,0,0,2021
LIG,IM,C 22,Fabbricazione di articoli in gomma e materie plastiche      ,0,0,0,0,0,2021
LIG,IM,C 23,Fabbricazione di altri prodotti della lavorazione di miner..,0,0,0,0,0,2021
LIG,IM,C 24,Metallurgia                                                 ,0,0,0,0,0,2021
LIG,IM,C 25,Fabbricazione di prodotti in metallo (esclusi macchinari ...,0,0,0,0,0,2021
LIG,IM,C 26,Fabbricazione di computer e prodotti di elettronica e ott...,0,0,0,0,0,2021
LIG,IM,C 27,Fabbricazione di apparecchiature elettriche ed apparecchi...,0,0,0,0,0,2021
LIG,IM,C 28,Fabbricazione di macchinari ed apparecchiature nca          ,0,0,0,0,0,2021
LIG,IM,C 29,"Fabbricazione di autoveicoli, rimorchi e semirimorchi       ",0,0,0,0,0,2021
LIG,IM,C 30,Fabbricazione di altri mezzi di trasporto                   ,0,0,0,0,0,2021
LIG,IM,C 31,Fabbricazione di mobili                                     ,0,0,0,0,0,2021
LIG,IM,C 32,Altre industrie manifatturiere                              ,0,1,0,0,1,2021
LIG,IM,C 33,"Riparazione, manutenzione ed installazione di macchine ed...",0,0,0,0,0,2021
LIG,IM,D   ,"Fornitura di energia elettrica, gas, vapore e aria condiz...",0,0,0,0,0,2021
LIG,IM,D 35,"Fornitura di energia elettrica, gas, vapore e aria condiz...",0,0,0,0,0,2021
LIG,IM,E   ,"Fornitura di acqua; reti fognarie, attività di gestione d...",0,0,0,0,0,2021
LIG,IM,E 36,"Raccolta, trattamento e fornitura di acqua                  ",0,0,0,0,0,2021
LIG,IM,E 37,Gestione delle reti fognarie                                ,0,0,0,0,0,2021
LIG,IM,E 38,"Attività di raccolta, trattamento e smaltimento dei rifiu...",0,0,0,0,0,2021
LIG,IM,E 39,Attività di risanamento e altri servizi di gestione dei r...,0,0,0,0,0,2021
LIG,IM,F   ,Costruzioni                                                 ,0,3,0,0,3,2021
LIG,IM,F 41,Costruzione di edifici                                      ,0,2,0,0,2,2021
LIG,IM,F 42,Ingegneria civile                                           ,0,0,0,0,0,2021
LIG,IM,F 43,Lavori di costruzione specializzati                         ,0,1,0,0,1,2021
LIG,IM,G   ,Commercio all'ingrosso e al dettaglio; riparazione di aut...,0,1,0,0,1,2021
LIG,IM,G 45,Commercio all'ingrosso e al dettaglio e riparazione di au...,0,0,0,0,0,2021
LIG,IM,G 46,Commercio all'ingrosso (escluso quello di autoveicoli e d...,0,1,0,0,1,2021
LIG,IM,G 47,Commercio al dettaglio (escluso quello di autoveicoli e d...,0,0,0,0,0,2021
LIG,IM,H   ,Trasporto e magazzinaggio                                   ,0,0,0,1,1,2021
LIG,IM,H 49,Trasporto terrestre e mediante condotte                     ,0,0,0,0,0,2021
LIG,IM,H 50,Trasporto marittimo e per vie d'acqua                       ,0,0,0,0,0,2021
LIG,IM,H 51,Trasporto aereo                                             ,0,0,0,0,0,2021
LIG,IM,H 52,Magazzinaggio e attività di supporto ai trasporti           ,0,0,0,1,1,2021
LIG,IM,H 53,Servizi postali e attività di corriere                      ,0,0,0,0,0,2021
LIG,IM,I   ,Attività dei servizi alloggio e ristorazione                ,0,2,0,0,2,2021
LIG,IM,I 55,Alloggio                                                    ,0,0,0,0,0,2021
LIG,IM,I 56,Attività dei servizi di ristorazione                        ,0,2,0,0,2,2021
LIG,IM,J   ,Servizi di informazione e comunicazione                     ,0,0,0,1,1,2021
LIG,IM,J 58,Attività editoriali                                         ,0,0,0,0,0,2021
LIG,IM,J 59,"Attività di produzione cinematografica, di video e di pro...",0,0,0,0,0,2021
LIG,IM,J 60,Attività di programmazione e trasmissione                   ,0,0,0,0,0,2021
LIG,IM,J 61,Telecomunicazioni                                           ,0,0,0,0,0,2021
LIG,IM,J 62,"Produzione di software, consulenza informatica e attività...",0,0,0,0,0,2021
LIG,IM,J 63,Attività dei servizi d'informazione e altri servizi infor...,0,0,0,1,1,2021
LIG,IM,K   ,Attività finanziarie e assicurative                         ,0,0,0,0,0,2021
LIG,IM,K 64,Attività di servizi finanziari (escluse le assicurazioni ...,0,0,0,0,0,2021
LIG,IM,K 65,"Assicurazioni, riassicurazioni e fondi pensione (escluse ...",0,0,0,0,0,2021
LIG,IM,K 66,Attività ausiliarie dei servizi finanziari e delle attivi...,0,0,0,0,0,2021
LIG,IM,L   ,Attivita' immobiliari                                       ,0,2,0,0,2,2021
LIG,IM,L 68,Attivita' immobiliari                                       ,0,2,0,0,2,2021
LIG,IM,M   ,"Attività professionali, scientifiche e tecniche             ",0,0,0,1,1,2021
LIG,IM,M 69,Attività legali e contabilità                               ,0,0,0,0,0,2021
LIG,IM,M 70,Attività di direzione aziendale e di consulenza gestional...,0,0,0,0,0,2021
LIG,IM,M 71,Attività degli studi di architettura e d'ingegneria; coll...,0,0,0,0,0,2021
LIG,IM,M 72,Ricerca scientifica e sviluppo                              ,0,0,0,0,0,2021
LIG,IM,M 73,Pubblicità e ricerche di mercato                            ,0,0,0,1,1,2021
LIG,IM,M 74,"Altre attività professionali, scientifiche e tecniche       ",0,0,0,0,0,2021
LIG,IM,M 75,Servizi veterinari                                          ,0,0,0,0,0,2021
LIG,IM,N   ,"Noleggio, agenzie di viaggio, servizi di supporto alle im...",0,0,0,0,0,2021
LIG,IM,N 77,Attività di noleggio e leasing operativo                    ,0,0,0,0,0,2021
LIG,IM,N 78,"Attività di ricerca, selezione, fornitura di personale      ",0,0,0,0,0,2021
LIG,IM,N 79,"Attività dei servizi delle agenzie di viaggio, dei tour o...",0,0,0,0,0,2021
LIG,IM,N 80,Servizi di vigilanza e investigazione                       ,0,0,0,0,0,2021
LIG,IM,N 81,Attività di servizi per edifici e paesaggio                 ,0,0,0,0,0,2021
LIG,IM,N 82,Attività di supporto per le funzioni d'ufficio e altri se...,0,0,0,0,0,2021
LIG,IM,O   ,Amministrazione pubblica e difesa; assicurazione sociale ...,0,0,0,0,0,2021
LIG,IM,O 84,Amministrazione pubblica e difesa; assicurazione sociale ...,0,0,0,0,0,2021
LIG,IM,P   ,Istruzione                                                  ,0,0,0,0,0,2021
LIG,IM,P 85,Istruzione                                                  ,0,0,0,0,0,2021
LIG,IM,Q   ,Sanita' e assistenza sociale                                ,0,0,0,0,0,2021
LIG,IM,Q 86,Assistenza sanitaria                                        ,0,0,0,0,0,2021
LIG,IM,Q 87,Servizi di assistenza sociale residenziale                  ,0,0,0,0,0,2021
LIG,IM,Q 88,Assistenza sociale non residenziale                         ,0,0,0,0,0,2021
LIG,IM,R   ,"Attività artistiche, sportive, di intrattenimento e diver...",0,0,0,0,0,2021
LIG,IM,R 90,"Attività creative, artistiche e di intrattenimento          ",0,0,0,0,0,2021
LIG,IM,R 91,"Attività di biblioteche, archivi, musei ed altre attività...",0,0,0,0,0,2021
LIG,IM,R 92,"Attività riguardanti le lotterie, le scommesse, le case d...",0,0,0,0,0,2021
LIG,IM,R 93,"Attività sportive, di intrattenimento e di divertimento     ",0,0,0,0,0,2021
LIG,IM,S   ,Altre attività di servizi                                   ,0,0,0,1,1,2021
LIG,IM,S 94,Attività di organizzazioni associative                      ,0,0,0,0,0,2021
LIG,IM,S 95,Riparazione di computer e di beni per uso personale e per...,0,0,0,0,0,2021
LIG,IM,S 96,Altre attività di servizi per la persona                    ,0,0,0,1,1,2021
LIG,IM,T   ,Attività di famiglie e convivenze come datori di lavoro p...,0,0,0,0,0,2021
LIG,IM,T 97,Attività di famiglie e convivenze come datori di lavoro p...,0,0,0,0,0,2021
LIG,IM,T 98,Produzione di beni e servizi indifferenziati per uso prop...,0,0,0,0,0,2021
LIG,IM,U   ,Organizzazioni ed organismi extraterritoriali               ,0,0,0,0,0,2021
LIG,IM,U 99,Organizzazioni ed organismi extraterritoriali               ,0,0,0,0,0,2021
LIG,IM,XX  ,Imprese non classificate                                    ,0,2,0,3,5,2021
LIG,IM,TOT ,TOTALE                                                      ,0,11,0,8,19,2021
LIG,SV,A   ,"Agricoltura, silvicoltura pesca                             ",0,0,0,0,0,2021
LIG,SV,A 01,"Coltivazioni agricole e produzione di prodotti animali, c...",0,0,0,0,0,2021
LIG,SV,A 02,Silvicoltura ed utilizzo di aree forestali                  ,0,0,0,0,0,2021
LIG,SV,A 03,Pesca e acquacoltura                                        ,0,0,0,0,0,2021
LIG,SV,B   ,Estrazione di minerali da cave e miniere                    ,0,0,0,0,0,2021
LIG,SV,B 05,Estrazione di carbone (esclusa torba)                       ,0,0,0,0,0,2021
LIG,SV,B 06,Estraz.di petrolio greggio e di gas naturale                ,0,0,0,0,0,2021
LIG,SV,B 07,Estrazione di minerali metalliferi                          ,0,0,0,0,0,2021
LIG,SV,B 08,Altre attività di estrazione di minerali da cave e miniere  ,0,0,0,0,0,2021
LIG,SV,B 09,Attività dei servizi di supporto all'estrazione             ,0,0,0,0,0,2021
LIG,SV,C   ,Attività manifatturiere                                     ,1,0,0,0,1,2021
LIG,SV,C 10,Industrie alimentari                                        ,0,0,0,0,0,2021
LIG,SV,C 11,Industria delle bevande                                     ,0,0,0,0,0,2021
LIG,SV,C 12,Industria del tabacco                                       ,0,0,0,0,0,2021
LIG,SV,C 13,Industrie tessili                                           ,0,0,0,0,0,2021
LIG,SV,C 14,Confezione di articoli di abbigliamento; confezione di ar...,0,0,0,0,0,2021
LIG,SV,C 15,Fabbricazione di articoli in pelle e simili                 ,0,0,0,0,0,2021
LIG,SV,C 16,Industria del legno e dei prodotti in legno e sughero (es...,0,0,0,0,0,2021
LIG,SV,C 17,Fabbricazione di carta e di prodotti di carta               ,0,0,0,0,0,2021
LIG,SV,C 18,Stampa e riproduzione di supporti registrati                ,1,0,0,0,1,2021
LIG,SV,C 19,Fabbricazione di coke e prodotti derivanti dalla raffinaz...,0,0,0,0,0,2021
LIG,SV,C 20,Fabbricazione di prodotti chimici                           ,0,0,0,0,0,2021
LIG,SV,C 21,Fabbricazione di prodotti farmaceutici di base e di prepa...,0,0,0,0,0,2021
LIG,SV,C 22,Fabbricazione di articoli in gomma e materie plastiche      ,0,0,0,0,0,2021
LIG,SV,C 23,Fabbricazione di altri prodotti della lavorazione di miner..,0,0,0,0,0,2021
LIG,SV,C 24,Metallurgia                                                 ,0,0,0,0,0,2021
LIG,SV,C 25,Fabbricazione di prodotti in metallo (esclusi macchinari ...,0,0,0,0,0,2021
LIG,SV,C 26,Fabbricazione di computer e prodotti di elettronica e ott...,0,0,0,0,0,2021
LIG,SV,C 27,Fabbricazione di apparecchiature elettriche ed apparecchi...,0,0,0,0,0,2021
LIG,SV,C 28,Fabbricazione di macchinari ed apparecchiature nca          ,0,0,0,0,0,2021
LIG,SV,C 29,"Fabbricazione di autoveicoli, rimorchi e semirimorchi       ",0,0,0,0,0,2021
LIG,SV,C 30,Fabbricazione di altri mezzi di trasporto                   ,0,0,0,0,0,2021
LIG,SV,C 31,Fabbricazione di mobili                                     ,0,0,0,0,0,2021
LIG,SV,C 32,Altre industrie manifatturiere                              ,0,0,0,0,0,2021
LIG,SV,C 33,"Riparazione, manutenzione ed installazione di macchine ed...",0,0,0,0,0,2021
LIG,SV,D   ,"Fornitura di energia elettrica, gas, vapore e aria condiz...",0,0,0,0,0,2021
LIG,SV,D 35,"Fornitura di energia elettrica, gas, vapore e aria condiz...",0,0,0,0,0,2021
LIG,SV,E   ,"Fornitura di acqua; reti fognarie, attività di gestione d...",0,0,0,1,1,2021
LIG,SV,E 36,"Raccolta, trattamento e fornitura di acqua                  ",0,0,0,0,0,2021
LIG,SV,E 37,Gestione delle reti fognarie                                ,0,0,0,1,1,2021
LIG,SV,E 38,"Attività di raccolta, trattamento e smaltimento dei rifiu...",0,0,0,0,0,2021
LIG,SV,E 39,Attività di risanamento e altri servizi di gestione dei r...,0,0,0,0,0,2021
LIG,SV,F   ,Costruzioni                                                 ,6,0,5,0,11,2021
LIG,SV,F 41,Costruzione di edifici                                      ,3,0,0,0,3,2021
LIG,SV,F 42,Ingegneria civile                                           ,0,0,0,0,0,2021
LIG,SV,F 43,Lavori di costruzione specializzati                         ,3,0,5,0,8,2021
LIG,SV,G   ,Commercio all'ingrosso e al dettaglio; riparazione di aut...,3,0,5,0,8,2021
LIG,SV,G 45,Commercio all'ingrosso e al dettaglio e riparazione di au...,0,0,0,0,0,2021
LIG,SV,G 46,Commercio all'ingrosso (escluso quello di autoveicoli e d...,2,0,1,0,3,2021
LIG,SV,G 47,Commercio al dettaglio (escluso quello di autoveicoli e d...,1,0,4,0,5,2021
LIG,SV,H   ,Trasporto e magazzinaggio                                   ,0,0,0,2,2,2021
LIG,SV,H 49,Trasporto terrestre e mediante condotte                     ,0,0,0,1,1,2021
LIG,SV,H 50,Trasporto marittimo e per vie d'acqua                       ,0,0,0,0,0,2021
LIG,SV,H 51,Trasporto aereo                                             ,0,0,0,0,0,2021
LIG,SV,H 52,Magazzinaggio e attività di supporto ai trasporti           ,0,0,0,1,1,2021
LIG,SV,H 53,Servizi postali e attività di corriere                      ,0,0,0,0,0,2021
LIG,SV,I   ,Attività dei servizi alloggio e ristorazione                ,7,2,1,0,10,2021
LIG,SV,I 55,Alloggio                                                    ,0,0,0,0,0,2021
LIG,SV,I 56,Attività dei servizi di ristorazione                        ,7,2,1,0,10,2021
LIG,SV,J   ,Servizi di informazione e comunicazione                     ,0,0,0,1,1,2021
LIG,SV,J 58,Attività editoriali                                         ,0,0,0,0,0,2021
LIG,SV,J 59,"Attività di produzione cinematografica, di video e di pro...",0,0,0,0,0,2021
LIG,SV,J 60,Attività di programmazione e trasmissione                   ,0,0,0,0,0,2021
LIG,SV,J 61,Telecomunicazioni                                           ,0,0,0,0,0,2021
LIG,SV,J 62,"Produzione di software, consulenza informatica e attività...",0,0,0,0,0,2021
LIG,SV,J 63,Attività dei servizi d'informazione e altri servizi infor...,0,0,0,1,1,2021
LIG,SV,K   ,Attività finanziarie e assicurative                         ,0,0,0,0,0,2021
LIG,SV,K 64,Attività di servizi finanziari (escluse le assicurazioni ...,0,0,0,0,0,2021
LIG,SV,K 65,"Assicurazioni, riassicurazioni e fondi pensione (escluse ...",0,0,0,0,0,2021
LIG,SV,K 66,Attività ausiliarie dei servizi finanziari e delle attivi...,0,0,0,0,0,2021
LIG,SV,L   ,Attivita' immobiliari                                       ,1,1,0,0,2,2021
LIG,SV,L 68,Attivita' immobiliari                                       ,1,1,0,0,2,2021
LIG,SV,M   ,"Attività professionali, scientifiche e tecniche             ",0,0,0,0,0,2021
LIG,SV,M 69,Attività legali e contabilità                               ,0,0,0,0,0,2021
LIG,SV,M 70,Attività di direzione aziendale e di consulenza gestional...,0,0,0,0,0,2021
LIG,SV,M 71,Attività degli studi di architettura e d'ingegneria; coll...,0,0,0,0,0,2021
LIG,SV,M 72,Ricerca scientifica e sviluppo                              ,0,0,0,0,0,2021
LIG,SV,M 73,Pubblicità e ricerche di mercato                            ,0,0,0,0,0,2021
LIG,SV,M 74,"Altre attività professionali, scientifiche e tecniche       ",0,0,0,0,0,2021
LIG,SV,M 75,Servizi veterinari                                          ,0,0,0,0,0,2021
LIG,SV,N   ,"Noleggio, agenzie di viaggio, servizi di supporto alle im...",0,0,1,0,1,2021
LIG,SV,N 77,Attività di noleggio e leasing operativo                    ,0,0,0,0,0,2021
LIG,SV,N 78,"Attività di ricerca, selezione, fornitura di personale      ",0,0,0,0,0,2021
LIG,SV,N 79,"Attività dei servizi delle agenzie di viaggio, dei tour o...",0,0,0,0,0,2021
LIG,SV,N 80,Servizi di vigilanza e investigazione                       ,0,0,0,0,0,2021
LIG,SV,N 81,Attività di servizi per edifici e paesaggio                 ,0,0,0,0,0,2021
LIG,SV,N 82,Attività di supporto per le funzioni d'ufficio e altri se...,0,0,1,0,1,2021
LIG,SV,O   ,Amministrazione pubblica e difesa; assicurazione sociale ...,0,0,0,0,0,2021
LIG,SV,O 84,Amministrazione pubblica e difesa; assicurazione sociale ...,0,0,0,0,0,2021
LIG,SV,P   ,Istruzione                                                  ,1,0,0,0,1,2021
LIG,SV,P 85,Istruzione                                                  ,1,0,0,0,1,2021
LIG,SV,Q   ,Sanita' e assistenza sociale                                ,0,0,0,0,0,2021
LIG,SV,Q 86,Assistenza sanitaria                                        ,0,0,0,0,0,2021
LIG,SV,Q 87,Servizi di assistenza sociale residenziale                  ,0,0,0,0,0,2021
LIG,SV,Q 88,Assistenza sociale non residenziale                         ,0,0,0,0,0,2021
LIG,SV,R   ,"Attività artistiche, sportive, di intrattenimento e diver...",0,1,0,0,1,2021
LIG,SV,R 90,"Attività creative, artistiche e di intrattenimento          ",0,0,0,0,0,2021
LIG,SV,R 91,"Attività di biblioteche, archivi, musei ed altre attività...",0,0,0,0,0,2021
LIG,SV,R 92,"Attività riguardanti le lotterie, le scommesse, le case d...",0,0,0,0,0,2021
LIG,SV,R 93,"Attività sportive, di intrattenimento e di divertimento     ",0,1,0,0,1,2021
LIG,SV,S   ,Altre attività di servizi                                   ,2,0,0,0,2,2021
LIG,SV,S 94,Attività di organizzazioni associative                      ,0,0,0,0,0,2021
LIG,SV,S 95,Riparazione di computer e di beni per uso personale e per...,0,0,0,0,0,2021
LIG,SV,S 96,Altre attività di servizi per la persona                    ,2,0,0,0,2,2021
LIG,SV,T   ,Attività di famiglie e convivenze come datori di lavoro p...,0,0,0,0,0,2021
LIG,SV,T 97,Attività di famiglie e convivenze come datori di lavoro p...,0,0,0,0,0,2021
LIG,SV,T 98,Produzione di beni e servizi indifferenziati per uso prop...,0,0,0,0,0,2021
LIG,SV,U   ,Organizzazioni ed organismi extraterritoriali               ,0,0,0,0,0,2021
LIG,SV,U 99,Organizzazioni ed organismi extraterritoriali               ,0,0,0,0,0,2021
LIG,SV,XX  ,Imprese non classificate                                    ,10,0,0,3,13,2021
LIG,SV,TOT ,TOTALE                                                      ,31,4,12,7,54,2021
LIG,GE,A   ,"Agricoltura, silvicoltura pesca                             ",0,0,10,0,10,2021
LIG,GE,A 01,"Coltivazioni agricole e produzione di prodotti animali, c...",0,0,8,0,8,2021
LIG,GE,A 02,Silvicoltura ed utilizzo di aree forestali                  ,0,0,1,0,1,2021
LIG,GE,A 03,Pesca e acquacoltura                                        ,0,0,1,0,1,2021
LIG,GE,B   ,Estrazione di minerali da cave e miniere                    ,0,0,0,0,0,2021
LIG,GE,B 05,Estrazione di carbone (esclusa torba)                       ,0,0,0,0,0,2021
LIG,GE,B 06,Estraz.di petrolio greggio e di gas naturale                ,0,0,0,0,0,2021
LIG,GE,B 07,Estrazione di minerali metalliferi                          ,0,0,0,0,0,2021
LIG,GE,B 08,Altre attività di estrazione di minerali da cave e miniere  ,0,0,0,0,0,2021
LIG,GE,B 09,Attività dei servizi di supporto all'estrazione             ,0,0,0,0,0,2021
LIG,GE,C   ,Attività manifatturiere                                     ,0,0,5,2,7,2021
LIG,GE,C 10,Industrie alimentari                                        ,0,0,1,0,1,2021
LIG,GE,C 11,Industria delle bevande                                     ,0,0,0,0,0,2021
LIG,GE,C 12,Industria del tabacco                                       ,0,0,0,0,0,2021
LIG,GE,C 13,Industrie tessili                                           ,0,0,1,0,1,2021
LIG,GE,C 14,Confezione di articoli di abbigliamento; confezione di ar...,0,0,0,0,0,2021
LIG,GE,C 15,Fabbricazione di articoli in pelle e simili                 ,0,0,0,0,0,2021
LIG,GE,C 16,Industria del legno e dei prodotti in legno e sughero (es...,0,0,0,0,0,2021
LIG,GE,C 17,Fabbricazione di carta e di prodotti di carta               ,0,0,0,0,0,2021
LIG,GE,C 18,Stampa e riproduzione di supporti registrati                ,0,0,0,0,0,2021
LIG,GE,C 19,Fabbricazione di coke e prodotti derivanti dalla raffinaz...,0,0,0,0,0,2021
LIG,GE,C 20,Fabbricazione di prodotti chimici                           ,0,0,0,0,0,2021
LIG,GE,C 21,Fabbricazione di prodotti farmaceutici di base e di prepa...,0,0,0,0,0,2021
LIG,GE,C 22,Fabbricazione di articoli in gomma e materie plastiche      ,0,0,0,0,0,2021
LIG,GE,C 23,Fabbricazione di altri prodotti della lavorazione di miner..,0,0,0,0,0,2021
LIG,GE,C 24,Metallurgia                                                 ,0,0,0,0,0,2021
LIG,GE,C 25,Fabbricazione di prodotti in metallo (esclusi macchinari ...,0,0,2,0,2,2021
LIG,GE,C 26,Fabbricazione di computer e prodotti di elettronica e ott...,0,0,0,0,0,2021
LIG,GE,C 27,Fabbricazione di apparecchiature elettriche ed apparecchi...,0,0,0,0,0,2021
LIG,GE,C 28,Fabbricazione di macchinari ed apparecchiature nca          ,0,0,0,0,0,2021
LIG,GE,C 29,"Fabbricazione di autoveicoli, rimorchi e semirimorchi       ",0,0,0,0,0,2021
LIG,GE,C 30,Fabbricazione di altri mezzi di trasporto                   ,0,0,0,2,2,2021
LIG,GE,C 31,Fabbricazione di mobili                                     ,0,0,0,0,0,2021
LIG,GE,C 32,Altre industrie manifatturiere                              ,0,0,0,0,0,2021
LIG,GE,C 33,"Riparazione, manutenzione ed installazione di macchine ed...",0,0,1,0,1,2021
LIG,GE,D   ,"Fornitura di energia elettrica, gas, vapore e aria condiz...",0,0,0,0,0,2021
LIG,GE,D 35,"Fornitura di energia elettrica, gas, vapore e aria condiz...",0,0,0,0,0,2021
LIG,GE,E   ,"Fornitura di acqua; reti fognarie, attività di gestione d...",0,0,0,0,0,2021
LIG,GE,E 36,"Raccolta, trattamento e fornitura di acqua                  ",0,0,0,0,0,2021
LIG,GE,E 37,Gestione delle reti fognarie                                ,0,0,0,0,0,2021
LIG,GE,E 38,"Attività di raccolta, trattamento e smaltimento dei rifiu...",0,0,0,0,0,2021
LIG,GE,E 39,Attività di risanamento e altri servizi di gestione dei r...,0,0,0,0,0,2021
LIG,GE,F   ,Costruzioni                                                 ,0,0,8,5,13,2021
LIG,GE,F 41,Costruzione di edifici                                      ,0,0,3,2,5,2021
LIG,GE,F 42,Ingegneria civile                                           ,0,0,0,0,0,2021
LIG,GE,F 43,Lavori di costruzione specializzati                         ,0,0,5,3,8,2021
LIG,GE,G   ,Commercio all'ingrosso e al dettaglio; riparazione di aut...,1,1,77,4,83,2021
LIG,GE,G 45,Commercio all'ingrosso e al dettaglio e riparazione di au...,0,0,7,1,8,2021
LIG,GE,G 46,Commercio all'ingrosso (escluso quello di autoveicoli e d...,1,0,23,1,25,2021
LIG,GE,G 47,Commercio al dettaglio (escluso quello di autoveicoli e d...,0,1,47,2,50,2021
LIG,GE,H   ,Trasporto e magazzinaggio                                   ,0,1,4,0,5,2021
LIG,GE,H 49,Trasporto terrestre e mediante condotte                     ,0,0,3,0,3,2021
LIG,GE,H 50,Trasporto marittimo e per vie d'acqua                       ,0,0,0,0,0,2021
LIG,GE,H 51,Trasporto aereo                                             ,0,0,0,0,0,2021
LIG,GE,H 52,Magazzinaggio e attività di supporto ai trasporti           ,0,1,1,0,2,2021
LIG,GE,H 53,Servizi postali e attività di corriere                      ,0,0,0,0,0,2021
LIG,GE,I   ,Attività dei servizi alloggio e ristorazione                ,0,0,11,1,12,2021
LIG,GE,I 55,Alloggio                                                    ,0,0,1,0,1,2021
LIG,GE,I 56,Attività dei servizi di ristorazione                        ,0,0,10,1,11,2021
LIG,GE,J   ,Servizi di informazione e comunicazione                     ,0,0,3,1,4,2021
LIG,GE,J 58,Attività editoriali                                         ,0,0,1,0,1,2021
LIG,GE,J 59,"Attività di produzione cinematografica, di video e di pro...",0,0,1,0,1,2021
LIG,GE,J 60,Attività di programmazione e trasmissione                   ,0,0,0,0,0,2021
LIG,GE,J 61,Telecomunicazioni                                           ,0,0,0,0,0,2021
LIG,GE,J 62,"Produzione di software, consulenza informatica e attività...",0,0,0,0,0,2021
LIG,GE,J 63,Attività dei servizi d'informazione e altri servizi infor...,0,0,1,1,2,2021
LIG,GE,K   ,Attività finanziarie e assicurative                         ,0,1,3,0,4,2021
LIG,GE,K 64,Attività di servizi finanziari (escluse le assicurazioni ...,0,0,0,0,0,2021
LIG,GE,K 65,"Assicurazioni, riassicurazioni e fondi pensione (escluse ...",0,0,0,0,0,2021
LIG,GE,K 66,Attività ausiliarie dei servizi finanziari e delle attivi...,0,1,3,0,4,2021
LIG,GE,L   ,Attivita' immobiliari                                       ,0,0,7,0,7,2021
LIG,GE,L 68,Attivita' immobiliari                                       ,0,0,7,0,7,2021
LIG,GE,M   ,"Attività professionali, scientifiche e tecniche             ",1,0,2,0,3,2021
LIG,GE,M 69,Attività legali e contabilità                               ,0,0,1,0,1,2021
LIG,GE,M 70,Attività di direzione aziendale e di consulenza gestional...,0,0,1,0,1,2021
LIG,GE,M 71,Attività degli studi di architettura e d'ingegneria; coll...,1,0,0,0,1,2021
LIG,GE,M 72,Ricerca scientifica e sviluppo                              ,0,0,0,0,0,2021
LIG,GE,M 73,Pubblicità e ricerche di mercato                            ,0,0,0,0,0,2021
LIG,GE,M 74,"Altre attività professionali, scientifiche e tecniche       ",0,0,0,0,0,2021
LIG,GE,M 75,Servizi veterinari                                          ,0,0,0,0,0,2021
LIG,GE,N   ,"Noleggio, agenzie di viaggio, servizi di supporto alle im...",0,0,4,1,5,2021
LIG,GE,N 77,Attività di noleggio e leasing operativo                    ,0,0,0,0,0,2021
LIG,GE,N 78,"Attività di ricerca, selezione, fornitura di personale      ",0,0,0,1,1,2021
LIG,GE,N 79,"Attività dei servizi delle agenzie di viaggio, dei tour o...",0,0,0,0,0,2021
LIG,GE,N 80,Servizi di vigilanza e investigazione                       ,0,0,0,0,0,2021
LIG,GE,N 81,Attività di servizi per edifici e paesaggio                 ,0,0,2,0,2,2021
LIG,GE,N 82,Attività di supporto per le funzioni d'ufficio e altri se...,0,0,2,0,2,2021
LIG,GE,O   ,Amministrazione pubblica e difesa; assicurazione sociale ...,0,0,0,0,0,2021
LIG,GE,O 84,Amministrazione pubblica e difesa; assicurazione sociale ...,0,0,0,0,0,2021
LIG,GE,P   ,Istruzione                                                  ,0,0,0,0,0,2021
LIG,GE,P 85,Istruzione                                                  ,0,0,0,0,0,2021
LIG,GE,Q   ,Sanita' e assistenza sociale                                ,0,0,0,0,0,2021
LIG,GE,Q 86,Assistenza sanitaria                                        ,0,0,0,0,0,2021
LIG,GE,Q 87,Servizi di assistenza sociale residenziale                  ,0,0,0,0,0,2021
LIG,GE,Q 88,Assistenza sociale non residenziale                         ,0,0,0,0,0,2021
LIG,GE,R   ,"Attività artistiche, sportive, di intrattenimento e diver...",0,0,0,0,0,2021
LIG,GE,R 90,"Attività creative, artistiche e di intrattenimento          ",0,0,0,0,0,2021
LIG,GE,R 91,"Attività di biblioteche, archivi, musei ed altre attività...",0,0,0,0,0,2021
LIG,GE,R 92,"Attività riguardanti le lotterie, le scommesse, le case d...",0,0,0,0,0,2021
LIG,GE,R 93,"Attività sportive, di intrattenimento e di divertimento     ",0,0,0,0,0,2021
LIG,GE,S   ,Altre attività di servizi                                   ,0,0,1,0,1,2021
LIG,GE,S 94,Attività di organizzazioni associative                      ,0,0,0,0,0,2021
LIG,GE,S 95,Riparazione di computer e di beni per uso personale e per...,0,0,1,0,1,2021
LIG,GE,S 96,Altre attività di servizi per la persona                    ,0,0,0,0,0,2021
LIG,GE,T   ,Attività di famiglie e convivenze come datori di lavoro p...,0,0,0,0,0,2021
LIG,GE,T 97,Attività di famiglie e convivenze come datori di lavoro p...,0,0,0,0,0,2021
LIG,GE,T 98,Produzione di beni e servizi indifferenziati per uso prop...,0,0,0,0,0,2021
LIG,GE,U   ,Organizzazioni ed organismi extraterritoriali               ,0,0,0,0,0,2021
LIG,GE,U 99,Organizzazioni ed organismi extraterritoriali               ,0,0,0,0,0,2021
LIG,GE,XX  ,Imprese non classificate                                    ,0,0,5,10,15,2021
LIG,GE,TOT ,TOTALE                                                      ,2,3,140,24,169,2021
LIG,SP,A   ,"Agricoltura, silvicoltura pesca                             ",0,0,0,0,0,2021
LIG,SP,A 01,"Coltivazioni agricole e produzione di prodotti animali, c...",0,0,0,0,0,2021
LIG,SP,A 02,Silvicoltura ed utilizzo di aree forestali                  ,0,0,0,0,0,2021
LIG,SP,A 03,Pesca e acquacoltura                                        ,0,0,0,0,0,2021
LIG,SP,B   ,Estrazione di minerali da cave e miniere                    ,0,0,0,0,0,2021
LIG,SP,B 05,Estrazione di carbone (esclusa torba)                       ,0,0,0,0,0,2021
LIG,SP,B 06,Estraz.di petrolio greggio e di gas naturale                ,0,0,0,0,0,2021
LIG,SP,B 07,Estrazione di minerali metalliferi                          ,0,0,0,0,0,2021
LIG,SP,B 08,Altre attività di estrazione di minerali da cave e miniere  ,0,0,0,0,0,2021
LIG,SP,B 09,Attività dei servizi di supporto all'estrazione             ,0,0,0,0,0,2021
LIG,SP,C   ,Attività manifatturiere                                     ,7,3,0,0,10,2021
LIG,SP,C 10,Industrie alimentari                                        ,0,1,0,0,1,2021
LIG,SP,C 11,Industria delle bevande                                     ,0,0,0,0,0,2021
LIG,SP,C 12,Industria del tabacco                                       ,0,0,0,0,0,2021
LIG,SP,C 13,Industrie tessili                                           ,0,0,0,0,0,2021
LIG,SP,C 14,Confezione di articoli di abbigliamento; confezione di ar...,0,0,0,0,0,2021
LIG,SP,C 15,Fabbricazione di articoli in pelle e simili                 ,0,0,0,0,0,2021
LIG,SP,C 16,Industria del legno e dei prodotti in legno e sughero (es...,1,0,0,0,1,2021
LIG,SP,C 17,Fabbricazione di carta e di prodotti di carta               ,0,0,0,0,0,2021
LIG,SP,C 18,Stampa e riproduzione di supporti registrati                ,0,1,0,0,1,2021
LIG,SP,C 19,Fabbricazione di coke e prodotti derivanti dalla raffinaz...,0,0,0,0,0,2021
LIG,SP,C 20,Fabbricazione di prodotti chimici                           ,0,0,0,0,0,2021
LIG,SP,C 21,Fabbricazione di prodotti farmaceutici di base e di prepa...,0,0,0,0,0,2021
LIG,SP,C 22,Fabbricazione di articoli in gomma e materie plastiche      ,0,0,0,0,0,2021
LIG,SP,C 23,Fabbricazione di altri prodotti della lavorazione di miner..,1,0,0,0,1,2021
LIG,SP,C 24,Metallurgia                                                 ,0,0,0,0,0,2021
LIG,SP,C 25,Fabbricazione di prodotti in metallo (esclusi macchinari ...,1,0,0,0,1,2021
LIG,SP,C 26,Fabbricazione di computer e prodotti di elettronica e ott...,0,0,0,0,0,2021
LIG,SP,C 27,Fabbricazione di apparecchiature elettriche ed apparecchi...,0,0,0,0,0,2021
LIG,SP,C 28,Fabbricazione di macchinari ed apparecchiature nca          ,0,0,0,0,0,2021
LIG,SP,C 29,"Fabbricazione di autoveicoli, rimorchi e semirimorchi       ",0,0,0,0,0,2021
LIG,SP,C 30,Fabbricazione di altri mezzi di trasporto                   ,0,1,0,0,1,2021
LIG,SP,C 31,Fabbricazione di mobili                                     ,1,0,0,0,1,2021
LIG,SP,C 32,Altre industrie manifatturiere                              ,1,0,0,0,1,2021
LIG,SP,C 33,"Riparazione, manutenzione ed installazione di macchine ed...",2,0,0,0,2,2021
LIG,SP,D   ,"Fornitura di energia elettrica, gas, vapore e aria condiz...",0,0,0,0,0,2021
LIG,SP,D 35,"Fornitura di energia elettrica, gas, vapore e aria condiz...",0,0,0,0,0,2021
LIG,SP,E   ,"Fornitura di acqua; reti fognarie, attività di gestione d...",0,0,0,0,0,2021
LIG,SP,E 36,"Raccolta, trattamento e fornitura di acqua                  ",0,0,0,0,0,2021
LIG,SP,E 37,Gestione delle reti fognarie                                ,0,0,0,0,0,2021
LIG,SP,E 38,"Attività di raccolta, trattamento e smaltimento dei rifiu...",0,0,0,0,0,2021
LIG,SP,E 39,Attività di risanamento e altri servizi di gestione dei r...,0,0,0,0,0,2021
LIG,SP,F   ,Costruzioni                                                 ,7,0,0,2,9,2021
LIG,SP,F 41,Costruzione di edifici                                      ,4,0,0,1,5,2021
LIG,SP,F 42,Ingegneria civile                                           ,0,0,0,1,1,2021
LIG,SP,F 43,Lavori di costruzione specializzati                         ,3,0,0,0,3,2021
LIG,SP,G   ,Commercio all'ingrosso e al dettaglio; riparazione di aut...,7,7,1,0,15,2021
LIG,SP,G 45,Commercio all'ingrosso e al dettaglio e riparazione di au...,1,1,1,0,3,2021
LIG,SP,G 46,Commercio all'ingrosso (escluso quello di autoveicoli e d...,2,1,0,0,3,2021
LIG,SP,G 47,Commercio al dettaglio (escluso quello di autoveicoli e d...,4,5,0,0,9,2021
LIG,SP,H   ,Trasporto e magazzinaggio                                   ,0,1,0,1,2,2021
LIG,SP,H 49,Trasporto terrestre e mediante condotte                     ,0,0,0,0,0,2021
LIG,SP,H 50,Trasporto marittimo e per vie d'acqua                       ,0,0,0,0,0,2021
LIG,SP,H 51,Trasporto aereo                                             ,0,0,0,0,0,2021
LIG,SP,H 52,Magazzinaggio e attività di supporto ai trasporti           ,0,1,0,1,2,2021
LIG,SP,H 53,Servizi postali e attività di corriere                      ,0,0,0,0,0,2021
LIG,SP,I   ,Attività dei servizi alloggio e ristorazione                ,6,7,0,0,13,2021
LIG,SP,I 55,Alloggio                                                    ,0,0,0,0,0,2021
LIG,SP,I 56,Attività dei servizi di ristorazione                        ,6,7,0,0,13,2021
LIG,SP,J   ,Servizi di informazione e comunicazione                     ,2,0,0,0,2,2021
LIG,SP,J 58,Attività editoriali                                         ,0,0,0,0,0,2021
LIG,SP,J 59,"Attività di produzione cinematografica, di video e di pro...",1,0,0,0,1,2021
LIG,SP,J 60,Attività di programmazione e trasmissione                   ,0,0,0,0,0,2021
LIG,SP,J 61,Telecomunicazioni                                           ,0,0,0,0,0,2021
LIG,SP,J 62,"Produzione di software, consulenza informatica e attività...",0,0,0,0,0,2021
LIG,SP,J 63,Attività dei servizi d'informazione e altri servizi infor...,1,0,0,0,1,2021
LIG,SP,K   ,Attività finanziarie e assicurative                         ,1,1,0,0,2,2021
LIG,SP,K 64,Attività di servizi finanziari (escluse le assicurazioni ...,1,0,0,0,1,2021
LIG,SP,K 65,"Assicurazioni, riassicurazioni e fondi pensione (escluse ...",0,0,0,0,0,2021
LIG,SP,K 66,Attività ausiliarie dei servizi finanziari e delle attivi...,0,1,0,0,1,2021
LIG,SP,L   ,Attivita' immobiliari                                       ,1,1,0,0,2,2021
LIG,SP,L 68,Attivita' immobiliari                                       ,1,1,0,0,2,2021
LIG,SP,M   ,"Attività professionali, scientifiche e tecniche             ",2,0,0,0,2,2021
LIG,SP,M 69,Attività legali e contabilità                               ,0,0,0,0,0,2021
LIG,SP,M 70,Attività di direzione aziendale e di consulenza gestional...,0,0,0,0,0,2021
LIG,SP,M 71,Attività degli studi di architettura e d'ingegneria; coll...,0,0,0,0,0,2021
LIG,SP,M 72,Ricerca scientifica e sviluppo                              ,0,0,0,0,0,2021
LIG,SP,M 73,Pubblicità e ricerche di mercato                            ,1,0,0,0,1,2021
LIG,SP,M 74,"Altre attività professionali, scientifiche e tecniche       ",1,0,0,0,1,2021
LIG,SP,M 75,Servizi veterinari                                          ,0,0,0,0,0,2021
LIG,SP,N   ,"Noleggio, agenzie di viaggio, servizi di supporto alle im...",1,0,0,0,1,2021
LIG,SP,N 77,Attività di noleggio e leasing operativo                    ,0,0,0,0,0,2021
LIG,SP,N 78,"Attività di ricerca, selezione, fornitura di personale      ",0,0,0,0,0,2021
LIG,SP,N 79,"Attività dei servizi delle agenzie di viaggio, dei tour o...",1,0,0,0,1,2021
LIG,SP,N 80,Servizi di vigilanza e investigazione                       ,0,0,0,0,0,2021
LIG,SP,N 81,Attività di servizi per edifici e paesaggio                 ,0,0,0,0,0,2021
LIG,SP,N 82,Attività di supporto per le funzioni d'ufficio e altri se...,0,0,0,0,0,2021
LIG,SP,O   ,Amministrazione pubblica e difesa; assicurazione sociale ...,0,0,0,0,0,2021
LIG,SP,O 84,Amministrazione pubblica e difesa; assicurazione sociale ...,0,0,0,0,0,2021
LIG,SP,P   ,Istruzione                                                  ,0,0,0,0,0,2021
LIG,SP,P 85,Istruzione                                                  ,0,0,0,0,0,2021
LIG,SP,Q   ,Sanita' e assistenza sociale                                ,1,1,0,0,2,2021
LIG,SP,Q 86,Assistenza sanitaria                                        ,1,0,0,0,1,2021
LIG,SP,Q 87,Servizi di assistenza sociale residenziale                  ,0,0,0,0,0,2021
LIG,SP,Q 88,Assistenza sociale non residenziale                         ,0,1,0,0,1,2021
LIG,SP,R   ,"Attività artistiche, sportive, di intrattenimento e diver...",5,0,0,0,5,2021
LIG,SP,R 90,"Attività creative, artistiche e di intrattenimento          ",0,0,0,0,0,2021
LIG,SP,R 91,"Attività di biblioteche, archivi, musei ed altre attività...",0,0,0,0,0,2021
LIG,SP,R 92,"Attività riguardanti le lotterie, le scommesse, le case d...",1,0,0,0,1,2021
LIG,SP,R 93,"Attività sportive, di intrattenimento e di divertimento     ",4,0,0,0,4,2021
LIG,SP,S   ,Altre attività di servizi                                   ,1,0,0,0,1,2021
LIG,SP,S 94,Attività di organizzazioni associative                      ,0,0,0,0,0,2021
LIG,SP,S 95,Riparazione di computer e di beni per uso personale e per...,1,0,0,0,1,2021
LIG,SP,S 96,Altre attività di servizi per la persona                    ,0,0,0,0,0,2021
LIG,SP,T   ,Attività di famiglie e convivenze come datori di lavoro p...,0,0,0,0,0,2021
LIG,SP,T 97,Attività di famiglie e convivenze come datori di lavoro p...,0,0,0,0,0,2021
LIG,SP,T 98,Produzione di beni e servizi indifferenziati per uso prop...,0,0,0,0,0,2021
LIG,SP,U   ,Organizzazioni ed organismi extraterritoriali               ,0,0,0,0,0,2021
LIG,SP,U 99,Organizzazioni ed organismi extraterritoriali               ,0,0,0,0,0,2021
LIG,SP,XX  ,Imprese non classificate                                    ,6,3,0,1,10,2021
LIG,SP,TOT ,TOTALE                                                      ,47,24,1,4,76,2021
EMI,  ,A   ,"Agricoltura, silvicoltura pesca                             ",4,4,26,5,39,2021
EMI,  ,A 01,"Coltivazioni agricole e produzione di prodotti animali, c...",4,4,26,4,38,2021
EMI,  ,A 02,Silvicoltura ed utilizzo di aree forestali                  ,0,0,0,0,0,2021
EMI,  ,A 03,Pesca e acquacoltura                                        ,0,0,0,1,1,2021
EMI,  ,B   ,Estrazione di minerali da cave e miniere                    ,0,0,1,0,1,2021
EMI,  ,B 05,Estrazione di carbone (esclusa torba)                       ,0,0,0,0,0,2021
EMI,  ,B 06,Estraz.di petrolio greggio e di gas naturale                ,0,0,0,0,0,2021
EMI,  ,B 07,Estrazione di minerali metalliferi                          ,0,0,0,0,0,2021
EMI,  ,B 08,Altre attività di estrazione di minerali da cave e miniere  ,0,0,1,0,1,2021
EMI,  ,B 09,Attività dei servizi di supporto all'estrazione             ,0,0,0,0,0,2021
EMI,  ,C   ,Attività manifatturiere                                     ,137,62,89,10,298,2021
EMI,  ,C 10,Industrie alimentari                                        ,14,4,3,1,22,2021
EMI,  ,C 11,Industria delle bevande                                     ,0,2,0,0,2,2021
EMI,  ,C 12,Industria del tabacco                                       ,0,0,0,0,0,2021
EMI,  ,C 13,Industrie tessili                                           ,7,0,7,0,14,2021
EMI,  ,C 14,Confezione di articoli di abbigliamento; confezione di ar...,27,13,18,1,59,2021
EMI,  ,C 15,Fabbricazione di articoli in pelle e simili                 ,1,2,0,0,3,2021
EMI,  ,C 16,Industria del legno e dei prodotti in legno e sughero (es...,2,2,3,0,7,2021
EMI,  ,C 17,Fabbricazione di carta e di prodotti di carta               ,0,0,1,0,1,2021
EMI,  ,C 18,Stampa e riproduzione di supporti registrati                ,8,2,1,0,11,2021
EMI,  ,C 19,Fabbricazione di coke e prodotti derivanti dalla raffinaz...,0,0,0,0,0,2021
EMI,  ,C 20,Fabbricazione di prodotti chimici                           ,0,0,0,0,0,2021
EMI,  ,C 21,Fabbricazione di prodotti farmaceutici di base e di prepa...,0,1,0,0,1,2021
EMI,  ,C 22,Fabbricazione di articoli in gomma e materie plastiche      ,5,0,2,0,7,2021
EMI,  ,C 23,Fabbricazione di altri prodotti della lavorazione di miner..,10,6,4,0,20,2021
EMI,  ,C 24,Metallurgia                                                 ,3,0,0,0,3,2021
EMI,  ,C 25,Fabbricazione di prodotti in metallo (esclusi macchinari ...,20,19,33,4,76,2021
EMI,  ,C 26,Fabbricazione di computer e prodotti di elettronica e ott...,4,0,0,0,4,2021
EMI,  ,C 27,Fabbricazione di apparecchiature elettriche ed apparecchi...,6,2,0,0,8,2021
EMI,  ,C 28,Fabbricazione di macchinari ed apparecchiature nca          ,15,5,5,1,26,2021
EMI,  ,C 29,"Fabbricazione di autoveicoli, rimorchi e semirimorchi       ",0,2,0,0,2,2021
EMI,  ,C 30,Fabbricazione di altri mezzi di trasporto                   ,2,0,0,0,2,2021
EMI,  ,C 31,Fabbricazione di mobili                                     ,4,1,5,3,13,2021
EMI,  ,C 32,Altre industrie manifatturiere                              ,5,1,4,0,10,2021
EMI,  ,C 33,"Riparazione, manutenzione ed installazione di macchine ed...",4,0,3,0,7,2021
EMI,  ,D   ,"Fornitura di energia elettrica, gas, vapore e aria condiz...",1,0,0,0,1,2021
EMI,  ,D 35,"Fornitura di energia elettrica, gas, vapore e aria condiz...",1,0,0,0,1,2021
EMI,  ,E   ,"Fornitura di acqua; reti fognarie, attività di gestione d...",1,0,0,0,1,2021
EMI,  ,E 36,"Raccolta, trattamento e fornitura di acqua                  ",0,0,0,0,0,2021
EMI,  ,E 37,Gestione delle reti fognarie                                ,1,0,0,0,1,2021
EMI,  ,E 38,"Attività di raccolta, trattamento e smaltimento dei rifiu...",0,0,0,0,0,2021
EMI,  ,E 39,Attività di risanamento e altri servizi di gestione dei r...,0,0,0,0,0,2021
EMI,  ,F   ,Costruzioni                                                 ,104,23,223,25,375,2021
EMI,  ,F 41,Costruzione di edifici                                      ,70,14,47,18,149,2021
EMI,  ,F 42,Ingegneria civile                                           ,0,0,0,1,1,2021
EMI,  ,F 43,Lavori di costruzione specializzati                         ,34,9,176,6,225,2021
EMI,  ,G   ,Commercio all'ingrosso e al dettaglio; riparazione di aut...,108,74,135,3,320,2021
EMI,  ,G 45,Commercio all'ingrosso e al dettaglio e riparazione di au...,14,12,19,2,47,2021
EMI,  ,G 46,Commercio all'ingrosso (escluso quello di autoveicoli e d...,56,34,35,1,126,2021
EMI,  ,G 47,Commercio al dettaglio (escluso quello di autoveicoli e d...,38,28,81,0,147,2021
EMI,  ,H   ,Trasporto e magazzinaggio                                   ,17,6,44,16,83,2021
EMI,  ,H 49,Trasporto terrestre e mediante condotte                     ,8,5,44,2,59,2021
EMI,  ,H 50,Trasporto marittimo e per vie d'acqua                       ,0,0,0,0,0,2021
EMI,  ,H 51,Trasporto aereo                                             ,0,0,0,0,0,2021
EMI,  ,H 52,Magazzinaggio e attività di supporto ai trasporti           ,7,1,0,14,22,2021
EMI,  ,H 53,Servizi postali e attività di corriere                      ,2,0,0,0,2,2021
EMI,  ,I   ,Attività dei servizi alloggio e ristorazione                ,53,53,28,3,137,2021
EMI,  ,I 55,Alloggio                                                    ,1,3,0,0,4,2021
EMI,  ,I 56,Attività dei servizi di ristorazione                        ,52,50,28,3,133,2021
EMI,  ,J   ,Servizi di informazione e comunicazione                     ,19,4,5,3,31,2021
EMI,  ,J 58,Attività editoriali                                         ,3,0,1,0,4,2021
EMI,  ,J 59,"Attività di produzione cinematografica, di video e di pro...",0,1,0,2,3,2021
EMI,  ,J 60,Attività di programmazione e trasmissione                   ,0,0,0,0,0,2021
EMI,  ,J 61,Telecomunicazioni                                           ,1,1,0,0,2,2021
EMI,  ,J 62,"Produzione di software, consulenza informatica e attività...",9,0,1,0,10,2021
EMI,  ,J 63,Attività dei servizi d'informazione e altri servizi infor...,6,2,3,1,12,2021
EMI,  ,K   ,Attività finanziarie e assicurative                         ,8,1,3,0,12,2021
EMI,  ,K 64,Attività di servizi finanziari (escluse le assicurazioni ...,2,1,0,0,3,2021
EMI,  ,K 65,"Assicurazioni, riassicurazioni e fondi pensione (escluse ...",0,0,0,0,0,2021
EMI,  ,K 66,Attività ausiliarie dei servizi finanziari e delle attivi...,6,0,3,0,9,2021
EMI,  ,L   ,Attivita' immobiliari                                       ,53,7,0,0,60,2021
EMI,  ,L 68,Attivita' immobiliari                                       ,53,7,0,0,60,2021
EMI,  ,M   ,"Attività professionali, scientifiche e tecniche             ",41,4,16,1,62,2021
EMI,  ,M 69,Attività legali e contabilità                               ,0,0,0,0,0,2021
EMI,  ,M 70,Attività di direzione aziendale e di consulenza gestional...,17,1,1,1,20,2021
EMI,  ,M 71,Attività degli studi di architettura e d'ingegneria; coll...,4,0,1,0,5,2021
EMI,  ,M 72,Ricerca scientifica e sviluppo                              ,2,0,0,0,2,2021
EMI,  ,M 73,Pubblicità e ricerche di mercato                            ,5,0,6,0,11,2021
EMI,  ,M 74,"Altre attività professionali, scientifiche e tecniche       ",13,3,8,0,24,2021
EMI,  ,M 75,Servizi veterinari                                          ,0,0,0,0,0,2021
EMI,  ,N   ,"Noleggio, agenzie di viaggio, servizi di supporto alle im...",14,2,8,13,37,2021
EMI,  ,N 77,Attività di noleggio e leasing operativo                    ,2,0,1,0,3,2021
EMI,  ,N 78,"Attività di ricerca, selezione, fornitura di personale      ",0,0,0,0,0,2021
EMI,  ,N 79,"Attività dei servizi delle agenzie di viaggio, dei tour o...",1,0,1,0,2,2021
EMI,  ,N 80,Servizi di vigilanza e investigazione                       ,0,0,0,0,0,2021
EMI,  ,N 81,Attività di servizi per edifici e paesaggio                 ,6,1,3,7,17,2021
EMI,  ,N 82,Attività di supporto per le funzioni d'ufficio e altri se...,5,1,3,6,15,2021
EMI,  ,O   ,Amministrazione pubblica e difesa; assicurazione sociale ...,0,0,0,0,0,2021
EMI,  ,O 84,Amministrazione pubblica e difesa; assicurazione sociale ...,0,0,0,0,0,2021
EMI,  ,P   ,Istruzione                                                  ,0,0,1,1,2,2021
EMI,  ,P 85,Istruzione                                                  ,0,0,1,1,2,2021
EMI,  ,Q   ,Sanita' e assistenza sociale                                ,6,0,0,2,8,2021
EMI,  ,Q 86,Assistenza sanitaria                                        ,6,0,0,0,6,2021
EMI,  ,Q 87,Servizi di assistenza sociale residenziale                  ,0,0,0,1,1,2021
EMI,  ,Q 88,Assistenza sociale non residenziale                         ,0,0,0,1,1,2021
EMI,  ,R   ,"Attività artistiche, sportive, di intrattenimento e diver...",24,4,3,3,34,2021
EMI,  ,R 90,"Attività creative, artistiche e di intrattenimento          ",6,0,0,0,6,2021
EMI,  ,R 91,"Attività di biblioteche, archivi, musei ed altre attività...",0,0,0,0,0,2021
EMI,  ,R 92,"Attività riguardanti le lotterie, le scommesse, le case d...",4,0,0,0,4,2021
EMI,  ,R 93,"Attività sportive, di intrattenimento e di divertimento     ",14,4,3,3,24,2021
EMI,  ,S   ,Altre attività di servizi                                   ,11,3,9,3,26,2021
EMI,  ,S 94,Attività di organizzazioni associative                      ,0,0,0,0,0,2021
EMI,  ,S 95,Riparazione di computer e di beni per uso personale e per...,3,1,4,0,8,2021
EMI,  ,S 96,Altre attività di servizi per la persona                    ,8,2,5,3,18,2021
EMI,  ,T   ,Attività di famiglie e convivenze come datori di lavoro p...,0,0,0,0,0,2021
EMI,  ,T 97,Attività di famiglie e convivenze come datori di lavoro p...,0,0,0,0,0,2021
EMI,  ,T 98,Produzione di beni e servizi indifferenziati per uso prop...,0,0,0,0,0,2021
EMI,  ,U   ,Organizzazioni ed organismi extraterritoriali               ,0,0,0,0,0,2021
EMI,  ,U 99,Organizzazioni ed organismi extraterritoriali               ,0,0,0,0,0,2021
EMI,  ,XX  ,Imprese non classificate                                    ,75,24,12,37,148,2021
EMI,  ,TOT ,TOTALE                                                      ,676,271,603,125,1675,2021
EMI,PC,A   ,"Agricoltura, silvicoltura pesca                             ",0,0,0,0,0,2021
EMI,PC,A 01,"Coltivazioni agricole e produzione di prodotti animali, c...",0,0,0,0,0,2021
EMI,PC,A 02,Silvicoltura ed utilizzo di aree forestali                  ,0,0,0,0,0,2021
EMI,PC,A 03,Pesca e acquacoltura                                        ,0,0,0,0,0,2021
EMI,PC,B   ,Estrazione di minerali da cave e miniere                    ,0,0,1,0,1,2021
EMI,PC,B 05,Estrazione di carbone (esclusa torba)                       ,0,0,0,0,0,2021
EMI,PC,B 06,Estraz.di petrolio greggio e di gas naturale                ,0,0,0,0,0,2021
EMI,PC,B 07,Estrazione di minerali metalliferi                          ,0,0,0,0,0,2021
EMI,PC,B 08,Altre attività di estrazione di minerali da cave e miniere  ,0,0,1,0,1,2021
EMI,PC,B 09,Attività dei servizi di supporto all'estrazione             ,0,0,0,0,0,2021
EMI,PC,C   ,Attività manifatturiere                                     ,3,0,1,0,4,2021
EMI,PC,C 10,Industrie alimentari                                        ,0,0,0,0,0,2021
EMI,PC,C 11,Industria delle bevande                                     ,0,0,0,0,0,2021
EMI,PC,C 12,Industria del tabacco                                       ,0,0,0,0,0,2021
EMI,PC,C 13,Industrie tessili                                           ,0,0,0,0,0,2021
EMI,PC,C 14,Confezione di articoli di abbigliamento; confezione di ar...,0,0,0,0,0,2021
EMI,PC,C 15,Fabbricazione di articoli in pelle e simili                 ,0,0,0,0,0,2021
EMI,PC,C 16,Industria del legno e dei prodotti in legno e sughero (es...,0,0,0,0,0,2021
EMI,PC,C 17,Fabbricazione di carta e di prodotti di carta               ,0,0,0,0,0,2021
EMI,PC,C 18,Stampa e riproduzione di supporti registrati                ,0,0,0,0,0,2021
EMI,PC,C 19,Fabbricazione di coke e prodotti derivanti dalla raffinaz...,0,0,0,0,0,2021
EMI,PC,C 20,Fabbricazione di prodotti chimici                           ,0,0,0,0,0,2021
EMI,PC,C 21,Fabbricazione di prodotti farmaceutici di base e di prepa...,0,0,0,0,0,2021
EMI,PC,C 22,Fabbricazione di articoli in gomma e materie plastiche      ,0,0,0,0,0,2021
EMI,PC,C 23,Fabbricazione di altri prodotti della lavorazione di miner..,0,0,0,0,0,2021
EMI,PC,C 24,Metallurgia                                                 ,0,0,0,0,0,2021
EMI,PC,C 25,Fabbricazione di prodotti in metallo (esclusi macchinari ...,1,0,1,0,2,2021
EMI,PC,C 26,Fabbricazione di computer e prodotti di elettronica e ott...,0,0,0,0,0,2021
EMI,PC,C 27,Fabbricazione di apparecchiature elettriche ed apparecchi...,0,0,0,0,0,2021
EMI,PC,C 28,Fabbricazione di macchinari ed apparecchiature nca          ,0,0,0,0,0,2021
EMI,PC,C 29,"Fabbricazione di autoveicoli, rimorchi e semirimorchi       ",0,0,0,0,0,2021
EMI,PC,C 30,Fabbricazione di altri mezzi di trasporto                   ,0,0,0,0,0,2021
EMI,PC,C 31,Fabbricazione di mobili                                     ,1,0,0,0,1,2021
EMI,PC,C 32,Altre industrie manifatturiere                              ,0,0,0,0,0,2021
EMI,PC,C 33,"Riparazione, manutenzione ed installazione di macchine ed...",1,0,0,0,1,2021
EMI,PC,D   ,"Fornitura di energia elettrica, gas, vapore e aria condiz...",0,0,0,0,0,2021
EMI,PC,D 35,"Fornitura di energia elettrica, gas, vapore e aria condiz...",0,0,0,0,0,2021
EMI,PC,E   ,"Fornitura di acqua; reti fognarie, attività di gestione d...",0,0,0,0,0,2021
EMI,PC,E 36,"Raccolta, trattamento e fornitura di acqua                  ",0,0,0,0,0,2021
EMI,PC,E 37,Gestione delle reti fognarie                                ,0,0,0,0,0,2021
EMI,PC,E 38,"Attività di raccolta, trattamento e smaltimento dei rifiu...",0,0,0,0,0,2021
EMI,PC,E 39,Attività di risanamento e altri servizi di gestione dei r...,0,0,0,0,0,2021
EMI,PC,F   ,Costruzioni                                                 ,6,0,5,3,14,2021
EMI,PC,F 41,Costruzione di edifici                                      ,4,0,1,3,8,2021
EMI,PC,F 42,Ingegneria civile                                           ,0,0,0,0,0,2021
EMI,PC,F 43,Lavori di costruzione specializzati                         ,2,0,4,0,6,2021
EMI,PC,G   ,Commercio all'ingrosso e al dettaglio; riparazione di aut...,6,0,13,0,19,2021
EMI,PC,G 45,Commercio all'ingrosso e al dettaglio e riparazione di au...,0,0,1,0,1,2021
EMI,PC,G 46,Commercio all'ingrosso (escluso quello di autoveicoli e d...,4,0,4,0,8,2021
EMI,PC,G 47,Commercio al dettaglio (escluso quello di autoveicoli e d...,2,0,8,0,10,2021
EMI,PC,H   ,Trasporto e magazzinaggio                                   ,1,0,2,1,4,2021
EMI,PC,H 49,Trasporto terrestre e mediante condotte                     ,0,0,2,0,2,2021
EMI,PC,H 50,Trasporto marittimo e per vie d'acqua                       ,0,0,0,0,0,2021
EMI,PC,H 51,Trasporto aereo                                             ,0,0,0,0,0,2021
EMI,PC,H 52,Magazzinaggio e attività di supporto ai trasporti           ,1,0,0,1,2,2021
EMI,PC,H 53,Servizi postali e attività di corriere                      ,0,0,0,0,0,2021
EMI,PC,I   ,Attività dei servizi alloggio e ristorazione                ,4,0,4,0,8,2021
EMI,PC,I 55,Alloggio                                                    ,0,0,0,0,0,2021
EMI,PC,I 56,Attività dei servizi di ristorazione                        ,4,0,4,0,8,2021
EMI,PC,J   ,Servizi di informazione e comunicazione                     ,1,0,0,0,1,2021
EMI,PC,J 58,Attività editoriali                                         ,0,0,0,0,0,2021
EMI,PC,J 59,"Attività di produzione cinematografica, di video e di pro...",0,0,0,0,0,2021
EMI,PC,J 60,Attività di programmazione e trasmissione                   ,0,0,0,0,0,2021
EMI,PC,J 61,Telecomunicazioni                                           ,0,0,0,0,0,2021
EMI,PC,J 62,"Produzione di software, consulenza informatica e attività...",0,0,0,0,0,2021
EMI,PC,J 63,Attività dei servizi d'informazione e altri servizi infor...,1,0,0,0,1,2021
EMI,PC,K   ,Attività finanziarie e assicurative                         ,2,0,0,0,2,2021
EMI,PC,K 64,Attività di servizi finanziari (escluse le assicurazioni ...,1,0,0,0,1,2021
EMI,PC,K 65,"Assicurazioni, riassicurazioni e fondi pensione (escluse ...",0,0,0,0,0,2021
EMI,PC,K 66,Attività ausiliarie dei servizi finanziari e delle attivi...,1,0,0,0,1,2021
EMI,PC,L   ,Attivita' immobiliari                                       ,1,0,0,0,1,2021
EMI,PC,L 68,Attivita' immobiliari                                       ,1,0,0,0,1,2021
EMI,PC,M   ,"Attività professionali, scientifiche e tecniche             ",1,0,1,0,2,2021
EMI,PC,M 69,Attività legali e contabilità                               ,0,0,0,0,0,2021
EMI,PC,M 70,Attività di direzione aziendale e di consulenza gestional...,1,0,0,0,1,2021
EMI,PC,M 71,Attività degli studi di architettura e d'ingegneria; coll...,0,0,0,0,0,2021
EMI,PC,M 72,Ricerca scientifica e sviluppo                              ,0,0,0,0,0,2021
EMI,PC,M 73,Pubblicità e ricerche di mercato                            ,0,0,1,0,1,2021
EMI,PC,M 74,"Altre attività professionali, scientifiche e tecniche       ",0,0,0,0,0,2021
EMI,PC,M 75,Servizi veterinari                                          ,0,0,0,0,0,2021
EMI,PC,N   ,"Noleggio, agenzie di viaggio, servizi di supporto alle im...",1,0,1,1,3,2021
EMI,PC,N 77,Attività di noleggio e leasing operativo                    ,0,0,0,0,0,2021
EMI,PC,N 78,"Attività di ricerca, selezione, fornitura di personale      ",0,0,0,0,0,2021
EMI,PC,N 79,"Attività dei servizi delle agenzie di viaggio, dei tour o...",0,0,1,0,1,2021
EMI,PC,N 80,Servizi di vigilanza e investigazione                       ,0,0,0,0,0,2021
EMI,PC,N 81,Attività di servizi per edifici e paesaggio                 ,0,0,0,1,1,2021
EMI,PC,N 82,Attività di supporto per le funzioni d'ufficio e altri se...,1,0,0,0,1,2021
EMI,PC,O   ,Amministrazione pubblica e difesa; assicurazione sociale ...,0,0,0,0,0,2021
EMI,PC,O 84,Amministrazione pubblica e difesa; assicurazione sociale ...,0,0,0,0,0,2021
EMI,PC,P   ,Istruzione                                                  ,0,0,0,0,0,2021
EMI,PC,P 85,Istruzione                                                  ,0,0,0,0,0,2021
EMI,PC,Q   ,Sanita' e assistenza sociale                                ,1,0,0,0,1,2021
EMI,PC,Q 86,Assistenza sanitaria                                        ,1,0,0,0,1,2021
EMI,PC,Q 87,Servizi di assistenza sociale residenziale                  ,0,0,0,0,0,2021
EMI,PC,Q 88,Assistenza sociale non residenziale                         ,0,0,0,0,0,2021
EMI,PC,R   ,"Attività artistiche, sportive, di intrattenimento e diver...",2,0,0,0,2,2021
EMI,PC,R 90,"Attività creative, artistiche e di intrattenimento          ",0,0,0,0,0,2021
EMI,PC,R 91,"Attività di biblioteche, archivi, musei ed altre attività...",0,0,0,0,0,2021
EMI,PC,R 92,"Attività riguardanti le lotterie, le scommesse, le case d...",0,0,0,0,0,2021
EMI,PC,R 93,"Attività sportive, di intrattenimento e di divertimento     ",2,0,0,0,2,2021
EMI,PC,S   ,Altre attività di servizi                                   ,0,0,0,1,1,2021
EMI,PC,S 94,Attività di organizzazioni associative                      ,0,0,0,0,0,2021
EMI,PC,S 95,Riparazione di computer e di beni per uso personale e per...,0,0,0,0,0,2021
EMI,PC,S 96,Altre attività di servizi per la persona                    ,0,0,0,1,1,2021
EMI,PC,T   ,Attività di famiglie e convivenze come datori di lavoro p...,0,0,0,0,0,2021
EMI,PC,T 97,Attività di famiglie e convivenze come datori di lavoro p...,0,0,0,0,0,2021
EMI,PC,T 98,Produzione di beni e servizi indifferenziati per uso prop...,0,0,0,0,0,2021
EMI,PC,U   ,Organizzazioni ed organismi extraterritoriali               ,0,0,0,0,0,2021
EMI,PC,U 99,Organizzazioni ed organismi extraterritoriali               ,0,0,0,0,0,2021
EMI,PC,XX  ,Imprese non classificate                                    ,3,0,8,2,13,2021
EMI,PC,TOT ,TOTALE                                                      ,32,0,36,8,76,2021
EMI,PR,A   ,"Agricoltura, silvicoltura pesca                             ",1,0,0,0,1,2021
EMI,PR,A 01,"Coltivazioni agricole e produzione di prodotti animali, c...",1,0,0,0,1,2021
EMI,PR,A 02,Silvicoltura ed utilizzo di aree forestali                  ,0,0,0,0,0,2021
EMI,PR,A 03,Pesca e acquacoltura                                        ,0,0,0,0,0,2021
EMI,PR,B   ,Estrazione di minerali da cave e miniere                    ,0,0,0,0,0,2021
EMI,PR,B 05,Estrazione di carbone (esclusa torba)                       ,0,0,0,0,0,2021
EMI,PR,B 06,Estraz.di petrolio greggio e di gas naturale                ,0,0,0,0,0,2021
EMI,PR,B 07,Estrazione di minerali metalliferi                          ,0,0,0,0,0,2021
EMI,PR,B 08,Altre attività di estrazione di minerali da cave e miniere  ,0,0,0,0,0,2021
EMI,PR,B 09,Attività dei servizi di supporto all'estrazione             ,0,0,0,0,0,2021
EMI,PR,C   ,Attività manifatturiere                                     ,23,0,1,1,25,2021
EMI,PR,C 10,Industrie alimentari                                        ,6,0,0,0,6,2021
EMI,PR,C 11,Industria delle bevande                                     ,0,0,0,0,0,2021
EMI,PR,C 12,Industria del tabacco                                       ,0,0,0,0,0,2021
EMI,PR,C 13,Industrie tessili                                           ,1,0,0,0,1,2021
EMI,PR,C 14,Confezione di articoli di abbigliamento; confezione di ar...,0,0,0,0,0,2021
EMI,PR,C 15,Fabbricazione di articoli in pelle e simili                 ,0,0,0,0,0,2021
EMI,PR,C 16,Industria del legno e dei prodotti in legno e sughero (es...,0,0,0,0,0,2021
EMI,PR,C 17,Fabbricazione di carta e di prodotti di carta               ,0,0,0,0,0,2021
EMI,PR,C 18,Stampa e riproduzione di supporti registrati                ,0,0,0,0,0,2021
EMI,PR,C 19,Fabbricazione di coke e prodotti derivanti dalla raffinaz...,0,0,0,0,0,2021
EMI,PR,C 20,Fabbricazione di prodotti chimici                           ,0,0,0,0,0,2021
EMI,PR,C 21,Fabbricazione di prodotti farmaceutici di base e di prepa...,0,0,0,0,0,2021
EMI,PR,C 22,Fabbricazione di articoli in gomma e materie plastiche      ,2,0,0,0,2,2021
EMI,PR,C 23,Fabbricazione di altri prodotti della lavorazione di miner..,1,0,0,0,1,2021
EMI,PR,C 24,Metallurgia                                                 ,1,0,0,0,1,2021
EMI,PR,C 25,Fabbricazione di prodotti in metallo (esclusi macchinari ...,7,0,1,1,9,2021
EMI,PR,C 26,Fabbricazione di computer e prodotti di elettronica e ott...,0,0,0,0,0,2021
EMI,PR,C 27,Fabbricazione di apparecchiature elettriche ed apparecchi...,0,0,0,0,0,2021
EMI,PR,C 28,Fabbricazione di macchinari ed apparecchiature nca          ,5,0,0,0,5,2021
EMI,PR,C 29,"Fabbricazione di autoveicoli, rimorchi e semirimorchi       ",0,0,0,0,0,2021
EMI,PR,C 30,Fabbricazione di altri mezzi di trasporto                   ,0,0,0,0,0,2021
EMI,PR,C 31,Fabbricazione di mobili                                     ,0,0,0,0,0,2021
EMI,PR,C 32,Altre industrie manifatturiere                              ,0,0,0,0,0,2021
EMI,PR,C 33,"Riparazione, manutenzione ed installazione di macchine ed...",0,0,0,0,0,2021
EMI,PR,D   ,"Fornitura di energia elettrica, gas, vapore e aria condiz...",0,0,0,0,0,2021
EMI,PR,D 35,"Fornitura di energia elettrica, gas, vapore e aria condiz...",0,0,0,0,0,2021
EMI,PR,E   ,"Fornitura di acqua; reti fognarie, attività di gestione d...",0,0,0,0,0,2021
EMI,PR,E 36,"Raccolta, trattamento e fornitura di acqua                  ",0,0,0,0,0,2021
EMI,PR,E 37,Gestione delle reti fognarie                                ,0,0,0,0,0,2021
EMI,PR,E 38,"Attività di raccolta, trattamento e smaltimento dei rifiu...",0,0,0,0,0,2021
EMI,PR,E 39,Attività di risanamento e altri servizi di gestione dei r...,0,0,0,0,0,2021
EMI,PR,F   ,Costruzioni                                                 ,24,2,4,2,32,2021
EMI,PR,F 41,Costruzione di edifici                                      ,13,1,0,2,16,2021
EMI,PR,F 42,Ingegneria civile                                           ,0,0,0,0,0,2021
EMI,PR,F 43,Lavori di costruzione specializzati                         ,11,1,4,0,16,2021
EMI,PR,G   ,Commercio all'ingrosso e al dettaglio; riparazione di aut...,16,2,1,0,19,2021
EMI,PR,G 45,Commercio all'ingrosso e al dettaglio e riparazione di au...,1,2,0,0,3,2021
EMI,PR,G 46,Commercio all'ingrosso (escluso quello di autoveicoli e d...,8,0,0,0,8,2021
EMI,PR,G 47,Commercio al dettaglio (escluso quello di autoveicoli e d...,7,0,1,0,8,2021
EMI,PR,H   ,Trasporto e magazzinaggio                                   ,1,0,0,1,2,2021
EMI,PR,H 49,Trasporto terrestre e mediante condotte                     ,0,0,0,0,0,2021
EMI,PR,H 50,Trasporto marittimo e per vie d'acqua                       ,0,0,0,0,0,2021
EMI,PR,H 51,Trasporto aereo                                             ,0,0,0,0,0,2021
EMI,PR,H 52,Magazzinaggio e attività di supporto ai trasporti           ,1,0,0,1,2,2021
EMI,PR,H 53,Servizi postali e attività di corriere                      ,0,0,0,0,0,2021
EMI,PR,I   ,Attività dei servizi alloggio e ristorazione                ,11,1,0,0,12,2021
EMI,PR,I 55,Alloggio                                                    ,1,0,0,0,1,2021
EMI,PR,I 56,Attività dei servizi di ristorazione                        ,10,1,0,0,11,2021
EMI,PR,J   ,Servizi di informazione e comunicazione                     ,4,0,0,0,4,2021
EMI,PR,J 58,Attività editoriali                                         ,0,0,0,0,0,2021
EMI,PR,J 59,"Attività di produzione cinematografica, di video e di pro...",0,0,0,0,0,2021
EMI,PR,J 60,Attività di programmazione e trasmissione                   ,0,0,0,0,0,2021
EMI,PR,J 61,Telecomunicazioni                                           ,0,0,0,0,0,2021
EMI,PR,J 62,"Produzione di software, consulenza informatica e attività...",2,0,0,0,2,2021
EMI,PR,J 63,Attività dei servizi d'informazione e altri servizi infor...,2,0,0,0,2,2021
EMI,PR,K   ,Attività finanziarie e assicurative                         ,1,0,0,0,1,2021
EMI,PR,K 64,Attività di servizi finanziari (escluse le assicurazioni ...,0,0,0,0,0,2021
EMI,PR,K 65,"Assicurazioni, riassicurazioni e fondi pensione (escluse ...",0,0,0,0,0,2021
EMI,PR,K 66,Attività ausiliarie dei servizi finanziari e delle attivi...,1,0,0,0,1,2021
EMI,PR,L   ,Attivita' immobiliari                                       ,15,0,0,0,15,2021
EMI,PR,L 68,Attivita' immobiliari                                       ,15,0,0,0,15,2021
EMI,PR,M   ,"Attività professionali, scientifiche e tecniche             ",5,0,1,0,6,2021
EMI,PR,M 69,Attività legali e contabilità                               ,0,0,0,0,0,2021
EMI,PR,M 70,Attività di direzione aziendale e di consulenza gestional...,3,0,0,0,3,2021
EMI,PR,M 71,Attività degli studi di architettura e d'ingegneria; coll...,2,0,0,0,2,2021
EMI,PR,M 72,Ricerca scientifica e sviluppo                              ,0,0,0,0,0,2021
EMI,PR,M 73,Pubblicità e ricerche di mercato                            ,0,0,1,0,1,2021
EMI,PR,M 74,"Altre attività professionali, scientifiche e tecniche       ",0,0,0,0,0,2021
EMI,PR,M 75,Servizi veterinari                                          ,0,0,0,0,0,2021
EMI,PR,N   ,"Noleggio, agenzie di viaggio, servizi di supporto alle im...",3,0,0,1,4,2021
EMI,PR,N 77,Attività di noleggio e leasing operativo                    ,0,0,0,0,0,2021
EMI,PR,N 78,"Attività di ricerca, selezione, fornitura di personale      ",0,0,0,0,0,2021
EMI,PR,N 79,"Attività dei servizi delle agenzie di viaggio, dei tour o...",1,0,0,0,1,2021
EMI,PR,N 80,Servizi di vigilanza e investigazione                       ,0,0,0,0,0,2021
EMI,PR,N 81,Attività di servizi per edifici e paesaggio                 ,1,0,0,0,1,2021
EMI,PR,N 82,Attività di supporto per le funzioni d'ufficio e altri se...,1,0,0,1,2,2021
EMI,PR,O   ,Amministrazione pubblica e difesa; assicurazione sociale ...,0,0,0,0,0,2021
EMI,PR,O 84,Amministrazione pubblica e difesa; assicurazione sociale ...,0,0,0,0,0,2021
EMI,PR,P   ,Istruzione                                                  ,0,0,0,0,0,2021
EMI,PR,P 85,Istruzione                                                  ,0,0,0,0,0,2021
EMI,PR,Q   ,Sanita' e assistenza sociale                                ,2,0,0,0,2,2021
EMI,PR,Q 86,Assistenza sanitaria                                        ,2,0,0,0,2,2021
EMI,PR,Q 87,Servizi di assistenza sociale residenziale                  ,0,0,0,0,0,2021
EMI,PR,Q 88,Assistenza sociale non residenziale                         ,0,0,0,0,0,2021
EMI,PR,R   ,"Attività artistiche, sportive, di intrattenimento e diver...",3,0,0,0,3,2021
EMI,PR,R 90,"Attività creative, artistiche e di intrattenimento          ",0,0,0,0,0,2021
EMI,PR,R 91,"Attività di biblioteche, archivi, musei ed altre attività...",0,0,0,0,0,2021
EMI,PR,R 92,"Attività riguardanti le lotterie, le scommesse, le case d...",0,0,0,0,0,2021
EMI,PR,R 93,"Attività sportive, di intrattenimento e di divertimento     ",3,0,0,0,3,2021
EMI,PR,S   ,Altre attività di servizi                                   ,1,1,0,0,2,2021
EMI,PR,S 94,Attività di organizzazioni associative                      ,0,0,0,0,0,2021
EMI,PR,S 95,Riparazione di computer e di beni per uso personale e per...,1,0,0,0,1,2021
EMI,PR,S 96,Altre attività di servizi per la persona                    ,0,1,0,0,1,2021
EMI,PR,T   ,Attività di famiglie e convivenze come datori di lavoro p...,0,0,0,0,0,2021
EMI,PR,T 97,Attività di famiglie e convivenze come datori di lavoro p...,0,0,0,0,0,2021
EMI,PR,T 98,Produzione di beni e servizi indifferenziati per uso prop...,0,0,0,0,0,2021
EMI,PR,U   ,Organizzazioni ed organismi extraterritoriali               ,0,0,0,0,0,2021
EMI,PR,U 99,Organizzazioni ed organismi extraterritoriali               ,0,0,0,0,0,2021
EMI,PR,XX  ,Imprese non classificate                                    ,18,2,0,2,22,2021
EMI,PR,TOT ,TOTALE                                                      ,128,8,7,7,150,2021
EMI,RE,A   ,"Agricoltura, silvicoltura pesca                             ",0,0,0,0,0,2021
EMI,RE,A 01,"Coltivazioni agricole e produzione di prodotti animali, c...",0,0,0,0,0,2021
EMI,RE,A 02,Silvicoltura ed utilizzo di aree forestali                  ,0,0,0,0,0,2021
EMI,RE,A 03,Pesca e acquacoltura                                        ,0,0,0,0,0,2021
EMI,RE,B   ,Estrazione di minerali da cave e miniere                    ,0,0,0,0,0,2021
EMI,RE,B 05,Estrazione di carbone (esclusa torba)                       ,0,0,0,0,0,2021
EMI,RE,B 06,Estraz.di petrolio greggio e di gas naturale                ,0,0,0,0,0,2021
EMI,RE,B 07,Estrazione di minerali metalliferi                          ,0,0,0,0,0,2021
EMI,RE,B 08,Altre attività di estrazione di minerali da cave e miniere  ,0,0,0,0,0,2021
EMI,RE,B 09,Attività dei servizi di supporto all'estrazione             ,0,0,0,0,0,2021
EMI,RE,C   ,Attività manifatturiere                                     ,0,0,0,0,0,2021
EMI,RE,C 10,Industrie alimentari                                        ,0,0,0,0,0,2021
EMI,RE,C 11,Industria delle bevande                                     ,0,0,0,0,0,2021
EMI,RE,C 12,Industria del tabacco                                       ,0,0,0,0,0,2021
EMI,RE,C 13,Industrie tessili                                           ,0,0,0,0,0,2021
EMI,RE,C 14,Confezione di articoli di abbigliamento; confezione di ar...,0,0,0,0,0,2021
EMI,RE,C 15,Fabbricazione di articoli in pelle e simili                 ,0,0,0,0,0,2021
EMI,RE,C 16,Industria del legno e dei prodotti in legno e sughero (es...,0,0,0,0,0,2021
EMI,RE,C 17,Fabbricazione di carta e di prodotti di carta               ,0,0,0,0,0,2021
EMI,RE,C 18,Stampa e riproduzione di supporti registrati                ,0,0,0,0,0,2021
EMI,RE,C 19,Fabbricazione di coke e prodotti derivanti dalla raffinaz...,0,0,0,0,0,2021
EMI,RE,C 20,Fabbricazione di prodotti chimici                           ,0,0,0,0,0,2021
EMI,RE,C 21,Fabbricazione di prodotti farmaceutici di base e di prepa...,0,0,0,0,0,2021
EMI,RE,C 22,Fabbricazione di articoli in gomma e materie plastiche      ,0,0,0,0,0,2021
EMI,RE,C 23,Fabbricazione di altri prodotti della lavorazione di miner..,0,0,0,0,0,2021
EMI,RE,C 24,Metallurgia                                                 ,0,0,0,0,0,2021
EMI,RE,C 25,Fabbricazione di prodotti in metallo (esclusi macchinari ...,0,0,0,0,0,2021
EMI,RE,C 26,Fabbricazione di computer e prodotti di elettronica e ott...,0,0,0,0,0,2021
EMI,RE,C 27,Fabbricazione di apparecchiature elettriche ed apparecchi...,0,0,0,0,0,2021
EMI,RE,C 28,Fabbricazione di macchinari ed apparecchiature nca          ,0,0,0,0,0,2021
EMI,RE,C 29,"Fabbricazione di autoveicoli, rimorchi e semirimorchi       ",0,0,0,0,0,2021
EMI,RE,C 30,Fabbricazione di altri mezzi di trasporto                   ,0,0,0,0,0,2021
EMI,RE,C 31,Fabbricazione di mobili                                     ,0,0,0,0,0,2021
EMI,RE,C 32,Altre industrie manifatturiere                              ,0,0,0,0,0,2021
EMI,RE,C 33,"Riparazione, manutenzione ed installazione di macchine ed...",0,0,0,0,0,2021
EMI,RE,D   ,"Fornitura di energia elettrica, gas, vapore e aria condiz...",0,0,0,0,0,2021
EMI,RE,D 35,"Fornitura di energia elettrica, gas, vapore e aria condiz...",0,0,0,0,0,2021
EMI,RE,E   ,"Fornitura di acqua; reti fognarie, attività di gestione d...",0,0,0,0,0,2021
EMI,RE,E 36,"Raccolta, trattamento e fornitura di acqua                  ",0,0,0,0,0,2021
EMI,RE,E 37,Gestione delle reti fognarie                                ,0,0,0,0,0,2021
EMI,RE,E 38,"Attività di raccolta, trattamento e smaltimento dei rifiu...",0,0,0,0,0,2021
EMI,RE,E 39,Attività di risanamento e altri servizi di gestione dei r...,0,0,0,0,0,2021
EMI,RE,F   ,Costruzioni                                                 ,0,1,1,1,3,2021
EMI,RE,F 41,Costruzione di edifici                                      ,0,0,1,1,2,2021
EMI,RE,F 42,Ingegneria civile                                           ,0,0,0,0,0,2021
EMI,RE,F 43,Lavori di costruzione specializzati                         ,0,1,0,0,1,2021
EMI,RE,G   ,Commercio all'ingrosso e al dettaglio; riparazione di aut...,0,0,0,0,0,2021
EMI,RE,G 45,Commercio all'ingrosso e al dettaglio e riparazione di au...,0,0,0,0,0,2021
EMI,RE,G 46,Commercio all'ingrosso (escluso quello di autoveicoli e d...,0,0,0,0,0,2021
EMI,RE,G 47,Commercio al dettaglio (escluso quello di autoveicoli e d...,0,0,0,0,0,2021
EMI,RE,H   ,Trasporto e magazzinaggio                                   ,0,0,0,0,0,2021
EMI,RE,H 49,Trasporto terrestre e mediante condotte                     ,0,0,0,0,0,2021
EMI,RE,H 50,Trasporto marittimo e per vie d'acqua                       ,0,0,0,0,0,2021
EMI,RE,H 51,Trasporto aereo                                             ,0,0,0,0,0,2021
EMI,RE,H 52,Magazzinaggio e attività di supporto ai trasporti           ,0,0,0,0,0,2021
EMI,RE,H 53,Servizi postali e attività di corriere                      ,0,0,0,0,0,2021
EMI,RE,I   ,Attività dei servizi alloggio e ristorazione                ,0,0,1,1,2,2021
EMI,RE,I 55,Alloggio                                                    ,0,0,0,0,0,2021
EMI,RE,I 56,Attività dei servizi di ristorazione                        ,0,0,1,1,2,2021
EMI,RE,J   ,Servizi di informazione e comunicazione                     ,0,0,0,0,0,2021
EMI,RE,J 58,Attività editoriali                                         ,0,0,0,0,0,2021
EMI,RE,J 59,"Attività di produzione cinematografica, di video e di pro...",0,0,0,0,0,2021
EMI,RE,J 60,Attività di programmazione e trasmissione                   ,0,0,0,0,0,2021
EMI,RE,J 61,Telecomunicazioni                                           ,0,0,0,0,0,2021
EMI,RE,J 62,"Produzione di software, consulenza informatica e attività...",0,0,0,0,0,2021
EMI,RE,J 63,Attività dei servizi d'informazione e altri servizi infor...,0,0,0,0,0,2021
EMI,RE,K   ,Attività finanziarie e assicurative                         ,0,0,0,0,0,2021
EMI,RE,K 64,Attività di servizi finanziari (escluse le assicurazioni ...,0,0,0,0,0,2021
EMI,RE,K 65,"Assicurazioni, riassicurazioni e fondi pensione (escluse ...",0,0,0,0,0,2021
EMI,RE,K 66,Attività ausiliarie dei servizi finanziari e delle attivi...,0,0,0,0,0,2021
EMI,RE,L   ,Attivita' immobiliari                                       ,0,0,0,0,0,2021
EMI,RE,L 68,Attivita' immobiliari                                       ,0,0,0,0,0,2021
EMI,RE,M   ,"Attività professionali, scientifiche e tecniche             ",0,0,0,1,1,2021
EMI,RE,M 69,Attività legali e contabilità                               ,0,0,0,0,0,2021
EMI,RE,M 70,Attività di direzione aziendale e di consulenza gestional...,0,0,0,1,1,2021
EMI,RE,M 71,Attività degli studi di architettura e d'ingegneria; coll...,0,0,0,0,0,2021
EMI,RE,M 72,Ricerca scientifica e sviluppo                              ,0,0,0,0,0,2021
EMI,RE,M 73,Pubblicità e ricerche di mercato                            ,0,0,0,0,0,2021
EMI,RE,M 74,"Altre attività professionali, scientifiche e tecniche       ",0,0,0,0,0,2021
EMI,RE,M 75,Servizi veterinari                                          ,0,0,0,0,0,2021
EMI,RE,N   ,"Noleggio, agenzie di viaggio, servizi di supporto alle im...",0,0,0,0,0,2021
EMI,RE,N 77,Attività di noleggio e leasing operativo                    ,0,0,0,0,0,2021
EMI,RE,N 78,"Attività di ricerca, selezione, fornitura di personale      ",0,0,0,0,0,2021
EMI,RE,N 79,"Attività dei servizi delle agenzie di viaggio, dei tour o...",0,0,0,0,0,2021
EMI,RE,N 80,Servizi di vigilanza e investigazione                       ,0,0,0,0,0,2021
EMI,RE,N 81,Attività di servizi per edifici e paesaggio                 ,0,0,0,0,0,2021
EMI,RE,N 82,Attività di supporto per le funzioni d'ufficio e altri se...,0,0,0,0,0,2021
EMI,RE,O   ,Amministrazione pubblica e difesa; assicurazione sociale ...,0,0,0,0,0,2021
EMI,RE,O 84,Amministrazione pubblica e difesa; assicurazione sociale ...,0,0,0,0,0,2021
EMI,RE,P   ,Istruzione                                                  ,0,0,0,0,0,2021
EMI,RE,P 85,Istruzione                                                  ,0,0,0,0,0,2021
EMI,RE,Q   ,Sanita' e assistenza sociale                                ,0,0,0,0,0,2021
EMI,RE,Q 86,Assistenza sanitaria                                        ,0,0,0,0,0,2021
EMI,RE,Q 87,Servizi di assistenza sociale residenziale                  ,0,0,0,0,0,2021
EMI,RE,Q 88,Assistenza sociale non residenziale                         ,0,0,0,0,0,2021
EMI,RE,R   ,"Attività artistiche, sportive, di intrattenimento e diver...",0,0,0,0,0,2021
EMI,RE,R 90,"Attività creative, artistiche e di intrattenimento          ",0,0,0,0,0,2021
EMI,RE,R 91,"Attività di biblioteche, archivi, musei ed altre attività...",0,0,0,0,0,2021
EMI,RE,R 92,"Attività riguardanti le lotterie, le scommesse, le case d...",0,0,0,0,0,2021
EMI,RE,R 93,"Attività sportive, di intrattenimento e di divertimento     ",0,0,0,0,0,2021
EMI,RE,S   ,Altre attività di servizi                                   ,0,0,0,0,0,2021
EMI,RE,S 94,Attività di organizzazioni associative                      ,0,0,0,0,0,2021
EMI,RE,S 95,Riparazione di computer e di beni per uso personale e per...,0,0,0,0,0,2021
EMI,RE,S 96,Altre attività di servizi per la persona                    ,0,0,0,0,0,2021
EMI,RE,T   ,Attività di famiglie e convivenze come datori di lavoro p...,0,0,0,0,0,2021
EMI,RE,T 97,Attività di famiglie e convivenze come datori di lavoro p...,0,0,0,0,0,2021
EMI,RE,T 98,Produzione di beni e servizi indifferenziati per uso prop...,0,0,0,0,0,2021
EMI,RE,U   ,Organizzazioni ed organismi extraterritoriali               ,0,0,0,0,0,2021
EMI,RE,U 99,Organizzazioni ed organismi extraterritoriali               ,0,0,0,0,0,2021
EMI,RE,XX  ,Imprese non classificate                                    ,0,0,0,0,0,2021
EMI,RE,TOT ,TOTALE                                                      ,0,1,2,3,6,2021
EMI,MO,A   ,"Agricoltura, silvicoltura pesca                             ",2,4,20,1,27,2021
EMI,MO,A 01,"Coltivazioni agricole e produzione di prodotti animali, c...",2,4,20,1,27,2021
EMI,MO,A 02,Silvicoltura ed utilizzo di aree forestali                  ,0,0,0,0,0,2021
EMI,MO,A 03,Pesca e acquacoltura                                        ,0,0,0,0,0,2021
EMI,MO,B   ,Estrazione di minerali da cave e miniere                    ,0,0,0,0,0,2021
EMI,MO,B 05,Estrazione di carbone (esclusa torba)                       ,0,0,0,0,0,2021
EMI,MO,B 06,Estraz.di petrolio greggio e di gas naturale                ,0,0,0,0,0,2021
EMI,MO,B 07,Estrazione di minerali metalliferi                          ,0,0,0,0,0,2021
EMI,MO,B 08,Altre attività di estrazione di minerali da cave e miniere  ,0,0,0,0,0,2021
EMI,MO,B 09,Attività dei servizi di supporto all'estrazione             ,0,0,0,0,0,2021
EMI,MO,C   ,Attività manifatturiere                                     ,82,61,80,4,227,2021
EMI,MO,C 10,Industrie alimentari                                        ,6,4,2,1,13,2021
EMI,MO,C 11,Industria delle bevande                                     ,0,2,0,0,2,2021
EMI,MO,C 12,Industria del tabacco                                       ,0,0,0,0,0,2021
EMI,MO,C 13,Industrie tessili                                           ,6,0,6,0,12,2021
EMI,MO,C 14,Confezione di articoli di abbigliamento; confezione di ar...,22,13,16,0,51,2021
EMI,MO,C 15,Fabbricazione di articoli in pelle e simili                 ,1,2,0,0,3,2021
EMI,MO,C 16,Industria del legno e dei prodotti in legno e sughero (es...,2,2,2,0,6,2021
EMI,MO,C 17,Fabbricazione di carta e di prodotti di carta               ,0,0,1,0,1,2021
EMI,MO,C 18,Stampa e riproduzione di supporti registrati                ,5,2,0,0,7,2021
EMI,MO,C 19,Fabbricazione di coke e prodotti derivanti dalla raffinaz...,0,0,0,0,0,2021
EMI,MO,C 20,Fabbricazione di prodotti chimici                           ,0,0,0,0,0,2021
EMI,MO,C 21,Fabbricazione di prodotti farmaceutici di base e di prepa...,0,1,0,0,1,2021
EMI,MO,C 22,Fabbricazione di articoli in gomma e materie plastiche      ,2,0,2,0,4,2021
EMI,MO,C 23,Fabbricazione di altri prodotti della lavorazione di miner..,8,6,4,0,18,2021
EMI,MO,C 24,Metallurgia                                                 ,1,0,0,0,1,2021
EMI,MO,C 25,Fabbricazione di prodotti in metallo (esclusi macchinari ...,8,18,30,2,58,2021
EMI,MO,C 26,Fabbricazione di computer e prodotti di elettronica e ott...,3,0,0,0,3,2021
EMI,MO,C 27,Fabbricazione di apparecchiature elettriche ed apparecchi...,3,2,0,0,5,2021
EMI,MO,C 28,Fabbricazione di macchinari ed apparecchiature nca          ,8,5,5,1,19,2021
EMI,MO,C 29,"Fabbricazione di autoveicoli, rimorchi e semirimorchi       ",0,2,0,0,2,2021
EMI,MO,C 30,Fabbricazione di altri mezzi di trasporto                   ,0,0,0,0,0,2021
EMI,MO,C 31,Fabbricazione di mobili                                     ,2,1,5,0,8,2021
EMI,MO,C 32,Altre industrie manifatturiere                              ,3,1,4,0,8,2021
EMI,MO,C 33,"Riparazione, manutenzione ed installazione di macchine ed...",2,0,3,0,5,2021
EMI,MO,D   ,"Fornitura di energia elettrica, gas, vapore e aria condiz...",1,0,0,0,1,2021
EMI,MO,D 35,"Fornitura di energia elettrica, gas, vapore e aria condiz...",1,0,0,0,1,2021
EMI,MO,E   ,"Fornitura di acqua; reti fognarie, attività di gestione d...",0,0,0,0,0,2021
EMI,MO,E 36,"Raccolta, trattamento e fornitura di acqua                  ",0,0,0,0,0,2021
EMI,MO,E 37,Gestione delle reti fognarie                                ,0,0,0,0,0,2021
EMI,MO,E 38,"Attività di raccolta, trattamento e smaltimento dei rifiu...",0,0,0,0,0,2021
EMI,MO,E 39,Attività di risanamento e altri servizi di gestione dei r...,0,0,0,0,0,2021
EMI,MO,F   ,Costruzioni                                                 ,49,18,193,2,262,2021
EMI,MO,F 41,Costruzione di edifici                                      ,34,11,44,1,90,2021
EMI,MO,F 42,Ingegneria civile                                           ,0,0,0,0,0,2021
EMI,MO,F 43,Lavori di costruzione specializzati                         ,15,7,149,1,172,2021
EMI,MO,G   ,Commercio all'ingrosso e al dettaglio; riparazione di aut...,53,70,67,0,190,2021
EMI,MO,G 45,Commercio all'ingrosso e al dettaglio e riparazione di au...,9,9,6,0,24,2021
EMI,MO,G 46,Commercio all'ingrosso (escluso quello di autoveicoli e d...,27,33,16,0,76,2021
EMI,MO,G 47,Commercio al dettaglio (escluso quello di autoveicoli e d...,17,28,45,0,90,2021
EMI,MO,H   ,Trasporto e magazzinaggio                                   ,6,6,30,7,49,2021
EMI,MO,H 49,Trasporto terrestre e mediante condotte                     ,4,5,30,2,41,2021
EMI,MO,H 50,Trasporto marittimo e per vie d'acqua                       ,0,0,0,0,0,2021
EMI,MO,H 51,Trasporto aereo                                             ,0,0,0,0,0,2021
EMI,MO,H 52,Magazzinaggio e attività di supporto ai trasporti           ,2,1,0,5,8,2021
EMI,MO,H 53,Servizi postali e attività di corriere                      ,0,0,0,0,0,2021
EMI,MO,I   ,Attività dei servizi alloggio e ristorazione                ,21,50,16,0,87,2021
EMI,MO,I 55,Alloggio                                                    ,0,3,0,0,3,2021
EMI,MO,I 56,Attività dei servizi di ristorazione                        ,21,47,16,0,84,2021
EMI,MO,J   ,Servizi di informazione e comunicazione                     ,6,3,3,0,12,2021
EMI,MO,J 58,Attività editoriali                                         ,0,0,0,0,0,2021
EMI,MO,J 59,"Attività di produzione cinematografica, di video e di pro...",0,0,0,0,0,2021
EMI,MO,J 60,Attività di programmazione e trasmissione                   ,0,0,0,0,0,2021
EMI,MO,J 61,Telecomunicazioni                                           ,1,1,0,0,2,2021
EMI,MO,J 62,"Produzione di software, consulenza informatica e attività...",2,0,1,0,3,2021
EMI,MO,J 63,Attività dei servizi d'informazione e altri servizi infor...,3,2,2,0,7,2021
EMI,MO,K   ,Attività finanziarie e assicurative                         ,2,1,2,0,5,2021
EMI,MO,K 64,Attività di servizi finanziari (escluse le assicurazioni ...,1,1,0,0,2,2021
EMI,MO,K 65,"Assicurazioni, riassicurazioni e fondi pensione (escluse ...",0,0,0,0,0,2021
EMI,MO,K 66,Attività ausiliarie dei servizi finanziari e delle attivi...,1,0,2,0,3,2021
EMI,MO,L   ,Attivita' immobiliari                                       ,27,5,0,0,32,2021
EMI,MO,L 68,Attivita' immobiliari                                       ,27,5,0,0,32,2021
EMI,MO,M   ,"Attività professionali, scientifiche e tecniche             ",19,4,12,0,35,2021
EMI,MO,M 69,Attività legali e contabilità                               ,0,0,0,0,0,2021
EMI,MO,M 70,Attività di direzione aziendale e di consulenza gestional...,6,1,1,0,8,2021
EMI,MO,M 71,Attività degli studi di architettura e d'ingegneria; coll...,1,0,1,0,2,2021
EMI,MO,M 72,Ricerca scientifica e sviluppo                              ,2,0,0,0,2,2021
EMI,MO,M 73,Pubblicità e ricerche di mercato                            ,3,0,3,0,6,2021
EMI,MO,M 74,"Altre attività professionali, scientifiche e tecniche       ",7,3,7,0,17,2021
EMI,MO,M 75,Servizi veterinari                                          ,0,0,0,0,0,2021
EMI,MO,N   ,"Noleggio, agenzie di viaggio, servizi di supporto alle im...",4,2,4,6,16,2021
EMI,MO,N 77,Attività di noleggio e leasing operativo                    ,1,0,1,0,2,2021
EMI,MO,N 78,"Attività di ricerca, selezione, fornitura di personale      ",0,0,0,0,0,2021
EMI,MO,N 79,"Attività dei servizi delle agenzie di viaggio, dei tour o...",0,0,0,0,0,2021
EMI,MO,N 80,Servizi di vigilanza e investigazione                       ,0,0,0,0,0,2021
EMI,MO,N 81,Attività di servizi per edifici e paesaggio                 ,2,1,2,2,7,2021
EMI,MO,N 82,Attività di supporto per le funzioni d'ufficio e altri se...,1,1,1,4,7,2021
EMI,MO,O   ,Amministrazione pubblica e difesa; assicurazione sociale ...,0,0,0,0,0,2021
EMI,MO,O 84,Amministrazione pubblica e difesa; assicurazione sociale ...,0,0,0,0,0,2021
EMI,MO,P   ,Istruzione                                                  ,0,0,1,0,1,2021
EMI,MO,P 85,Istruzione                                                  ,0,0,1,0,1,2021
EMI,MO,Q   ,Sanita' e assistenza sociale                                ,2,0,0,1,3,2021
EMI,MO,Q 86,Assistenza sanitaria                                        ,2,0,0,0,2,2021
EMI,MO,Q 87,Servizi di assistenza sociale residenziale                  ,0,0,0,0,0,2021
EMI,MO,Q 88,Assistenza sociale non residenziale                         ,0,0,0,1,1,2021
EMI,MO,R   ,"Attività artistiche, sportive, di intrattenimento e diver...",8,3,2,0,13,2021
EMI,MO,R 90,"Attività creative, artistiche e di intrattenimento          ",2,0,0,0,2,2021
EMI,MO,R 91,"Attività di biblioteche, archivi, musei ed altre attività...",0,0,0,0,0,2021
EMI,MO,R 92,"Attività riguardanti le lotterie, le scommesse, le case d...",3,0,0,0,3,2021
EMI,MO,R 93,"Attività sportive, di intrattenimento e di divertimento     ",3,3,2,0,8,2021
EMI,MO,S   ,Altre attività di servizi                                   ,3,2,5,1,11,2021
EMI,MO,S 94,Attività di organizzazioni associative                      ,0,0,0,0,0,2021
EMI,MO,S 95,Riparazione di computer e di beni per uso personale e per...,0,1,3,0,4,2021
EMI,MO,S 96,Altre attività di servizi per la persona                    ,3,1,2,1,7,2021
EMI,MO,T   ,Attività di famiglie e convivenze come datori di lavoro p...,0,0,0,0,0,2021
EMI,MO,T 97,Attività di famiglie e convivenze come datori di lavoro p...,0,0,0,0,0,2021
EMI,MO,T 98,Produzione di beni e servizi indifferenziati per uso prop...,0,0,0,0,0,2021
EMI,MO,U   ,Organizzazioni ed organismi extraterritoriali               ,0,0,0,0,0,2021
EMI,MO,U 99,Organizzazioni ed organismi extraterritoriali               ,0,0,0,0,0,2021
EMI,MO,XX  ,Imprese non classificate                                    ,38,22,0,4,64,2021
EMI,MO,TOT ,TOTALE                                                      ,323,251,435,26,1035,2021
EMI,BO,A   ,"Agricoltura, silvicoltura pesca                             ",1,0,6,1,8,2021
EMI,BO,A 01,"Coltivazioni agricole e produzione di prodotti animali, c...",1,0,6,1,8,2021
EMI,BO,A 02,Silvicoltura ed utilizzo di aree forestali                  ,0,0,0,0,0,2021
EMI,BO,A 03,Pesca e acquacoltura                                        ,0,0,0,0,0,2021
EMI,BO,B   ,Estrazione di minerali da cave e miniere                    ,0,0,0,0,0,2021
EMI,BO,B 05,Estrazione di carbone (esclusa torba)                       ,0,0,0,0,0,2021
EMI,BO,B 06,Estraz.di petrolio greggio e di gas naturale                ,0,0,0,0,0,2021
EMI,BO,B 07,Estrazione di minerali metalliferi                          ,0,0,0,0,0,2021
EMI,BO,B 08,Altre attività di estrazione di minerali da cave e miniere  ,0,0,0,0,0,2021
EMI,BO,B 09,Attività dei servizi di supporto all'estrazione             ,0,0,0,0,0,2021
EMI,BO,C   ,Attività manifatturiere                                     ,29,1,7,2,39,2021
EMI,BO,C 10,Industrie alimentari                                        ,2,0,1,0,3,2021
EMI,BO,C 11,Industria delle bevande                                     ,0,0,0,0,0,2021
EMI,BO,C 12,Industria del tabacco                                       ,0,0,0,0,0,2021
EMI,BO,C 13,Industrie tessili                                           ,0,0,1,0,1,2021
EMI,BO,C 14,Confezione di articoli di abbigliamento; confezione di ar...,5,0,2,1,8,2021
EMI,BO,C 15,Fabbricazione di articoli in pelle e simili                 ,0,0,0,0,0,2021
EMI,BO,C 16,Industria del legno e dei prodotti in legno e sughero (es...,0,0,1,0,1,2021
EMI,BO,C 17,Fabbricazione di carta e di prodotti di carta               ,0,0,0,0,0,2021
EMI,BO,C 18,Stampa e riproduzione di supporti registrati                ,3,0,1,0,4,2021
EMI,BO,C 19,Fabbricazione di coke e prodotti derivanti dalla raffinaz...,0,0,0,0,0,2021
EMI,BO,C 20,Fabbricazione di prodotti chimici                           ,0,0,0,0,0,2021
EMI,BO,C 21,Fabbricazione di prodotti farmaceutici di base e di prepa...,0,0,0,0,0,2021
EMI,BO,C 22,Fabbricazione di articoli in gomma e materie plastiche      ,1,0,0,0,1,2021
EMI,BO,C 23,Fabbricazione di altri prodotti della lavorazione di miner..,1,0,0,0,1,2021
EMI,BO,C 24,Metallurgia                                                 ,1,0,0,0,1,2021
EMI,BO,C 25,Fabbricazione di prodotti in metallo (esclusi macchinari ...,4,1,1,1,7,2021
EMI,BO,C 26,Fabbricazione di computer e prodotti di elettronica e ott...,1,0,0,0,1,2021
EMI,BO,C 27,Fabbricazione di apparecchiature elettriche ed apparecchi...,3,0,0,0,3,2021
EMI,BO,C 28,Fabbricazione di macchinari ed apparecchiature nca          ,2,0,0,0,2,2021
EMI,BO,C 29,"Fabbricazione di autoveicoli, rimorchi e semirimorchi       ",0,0,0,0,0,2021
EMI,BO,C 30,Fabbricazione di altri mezzi di trasporto                   ,2,0,0,0,2,2021
EMI,BO,C 31,Fabbricazione di mobili                                     ,1,0,0,0,1,2021
EMI,BO,C 32,Altre industrie manifatturiere                              ,2,0,0,0,2,2021
EMI,BO,C 33,"Riparazione, manutenzione ed installazione di macchine ed...",1,0,0,0,1,2021
EMI,BO,D   ,"Fornitura di energia elettrica, gas, vapore e aria condiz...",0,0,0,0,0,2021
EMI,BO,D 35,"Fornitura di energia elettrica, gas, vapore e aria condiz...",0,0,0,0,0,2021
EMI,BO,E   ,"Fornitura di acqua; reti fognarie, attività di gestione d...",1,0,0,0,1,2021
EMI,BO,E 36,"Raccolta, trattamento e fornitura di acqua                  ",0,0,0,0,0,2021
EMI,BO,E 37,Gestione delle reti fognarie                                ,1,0,0,0,1,2021
EMI,BO,E 38,"Attività di raccolta, trattamento e smaltimento dei rifiu...",0,0,0,0,0,2021
EMI,BO,E 39,Attività di risanamento e altri servizi di gestione dei r...,0,0,0,0,0,2021
EMI,BO,F   ,Costruzioni                                                 ,25,2,17,12,56,2021
EMI,BO,F 41,Costruzione di edifici                                      ,19,2,1,8,30,2021
EMI,BO,F 42,Ingegneria civile                                           ,0,0,0,0,0,2021
EMI,BO,F 43,Lavori di costruzione specializzati                         ,6,0,16,4,26,2021
EMI,BO,G   ,Commercio all'ingrosso e al dettaglio; riparazione di aut...,33,1,42,2,78,2021
EMI,BO,G 45,Commercio all'ingrosso e al dettaglio e riparazione di au...,4,1,3,1,9,2021
EMI,BO,G 46,Commercio all'ingrosso (escluso quello di autoveicoli e d...,17,0,12,1,30,2021
EMI,BO,G 47,Commercio al dettaglio (escluso quello di autoveicoli e d...,12,0,27,0,39,2021
EMI,BO,H   ,Trasporto e magazzinaggio                                   ,9,0,11,5,25,2021
EMI,BO,H 49,Trasporto terrestre e mediante condotte                     ,4,0,11,0,15,2021
EMI,BO,H 50,Trasporto marittimo e per vie d'acqua                       ,0,0,0,0,0,2021
EMI,BO,H 51,Trasporto aereo                                             ,0,0,0,0,0,2021
EMI,BO,H 52,Magazzinaggio e attività di supporto ai trasporti           ,3,0,0,5,8,2021
EMI,BO,H 53,Servizi postali e attività di corriere                      ,2,0,0,0,2,2021
EMI,BO,I   ,Attività dei servizi alloggio e ristorazione                ,17,2,6,0,25,2021
EMI,BO,I 55,Alloggio                                                    ,0,0,0,0,0,2021
EMI,BO,I 56,Attività dei servizi di ristorazione                        ,17,2,6,0,25,2021
EMI,BO,J   ,Servizi di informazione e comunicazione                     ,8,1,2,2,13,2021
EMI,BO,J 58,Attività editoriali                                         ,3,0,1,0,4,2021
EMI,BO,J 59,"Attività di produzione cinematografica, di video e di pro...",0,1,0,2,3,2021
EMI,BO,J 60,Attività di programmazione e trasmissione                   ,0,0,0,0,0,2021
EMI,BO,J 61,Telecomunicazioni                                           ,0,0,0,0,0,2021
EMI,BO,J 62,"Produzione di software, consulenza informatica e attività...",5,0,0,0,5,2021
EMI,BO,J 63,Attività dei servizi d'informazione e altri servizi infor...,0,0,1,0,1,2021
EMI,BO,K   ,Attività finanziarie e assicurative                         ,3,0,1,0,4,2021
EMI,BO,K 64,Attività di servizi finanziari (escluse le assicurazioni ...,0,0,0,0,0,2021
EMI,BO,K 65,"Assicurazioni, riassicurazioni e fondi pensione (escluse ...",0,0,0,0,0,2021
EMI,BO,K 66,Attività ausiliarie dei servizi finanziari e delle attivi...,3,0,1,0,4,2021
EMI,BO,L   ,Attivita' immobiliari                                       ,9,2,0,0,11,2021
EMI,BO,L 68,Attivita' immobiliari                                       ,9,2,0,0,11,2021
EMI,BO,M   ,"Attività professionali, scientifiche e tecniche             ",16,0,2,0,18,2021
EMI,BO,M 69,Attività legali e contabilità                               ,0,0,0,0,0,2021
EMI,BO,M 70,Attività di direzione aziendale e di consulenza gestional...,7,0,0,0,7,2021
EMI,BO,M 71,Attività degli studi di architettura e d'ingegneria; coll...,1,0,0,0,1,2021
EMI,BO,M 72,Ricerca scientifica e sviluppo                              ,0,0,0,0,0,2021
EMI,BO,M 73,Pubblicità e ricerche di mercato                            ,2,0,1,0,3,2021
EMI,BO,M 74,"Altre attività professionali, scientifiche e tecniche       ",6,0,1,0,7,2021
EMI,BO,M 75,Servizi veterinari                                          ,0,0,0,0,0,2021
EMI,BO,N   ,"Noleggio, agenzie di viaggio, servizi di supporto alle im...",6,0,3,3,12,2021
EMI,BO,N 77,Attività di noleggio e leasing operativo                    ,1,0,0,0,1,2021
EMI,BO,N 78,"Attività di ricerca, selezione, fornitura di personale      ",0,0,0,0,0,2021
EMI,BO,N 79,"Attività dei servizi delle agenzie di viaggio, dei tour o...",0,0,0,0,0,2021
EMI,BO,N 80,Servizi di vigilanza e investigazione                       ,0,0,0,0,0,2021
EMI,BO,N 81,Attività di servizi per edifici e paesaggio                 ,3,0,1,3,7,2021
EMI,BO,N 82,Attività di supporto per le funzioni d'ufficio e altri se...,2,0,2,0,4,2021
EMI,BO,O   ,Amministrazione pubblica e difesa; assicurazione sociale ...,0,0,0,0,0,2021
EMI,BO,O 84,Amministrazione pubblica e difesa; assicurazione sociale ...,0,0,0,0,0,2021
EMI,BO,P   ,Istruzione                                                  ,0,0,0,1,1,2021
EMI,BO,P 85,Istruzione                                                  ,0,0,0,1,1,2021
EMI,BO,Q   ,Sanita' e assistenza sociale                                ,1,0,0,0,1,2021
EMI,BO,Q 86,Assistenza sanitaria                                        ,1,0,0,0,1,2021
EMI,BO,Q 87,Servizi di assistenza sociale residenziale                  ,0,0,0,0,0,2021
EMI,BO,Q 88,Assistenza sociale non residenziale                         ,0,0,0,0,0,2021
EMI,BO,R   ,"Attività artistiche, sportive, di intrattenimento e diver...",11,0,1,0,12,2021
EMI,BO,R 90,"Attività creative, artistiche e di intrattenimento          ",4,0,0,0,4,2021
EMI,BO,R 91,"Attività di biblioteche, archivi, musei ed altre attività...",0,0,0,0,0,2021
EMI,BO,R 92,"Attività riguardanti le lotterie, le scommesse, le case d...",1,0,0,0,1,2021
EMI,BO,R 93,"Attività sportive, di intrattenimento e di divertimento     ",6,0,1,0,7,2021
EMI,BO,S   ,Altre attività di servizi                                   ,7,0,4,1,12,2021
EMI,BO,S 94,Attività di organizzazioni associative                      ,0,0,0,0,0,2021
EMI,BO,S 95,Riparazione di computer e di beni per uso personale e per...,2,0,1,0,3,2021
EMI,BO,S 96,Altre attività di servizi per la persona                    ,5,0,3,1,9,2021
EMI,BO,T   ,Attività di famiglie e convivenze come datori di lavoro p...,0,0,0,0,0,2021
EMI,BO,T 97,Attività di famiglie e convivenze come datori di lavoro p...,0,0,0,0,0,2021
EMI,BO,T 98,Produzione di beni e servizi indifferenziati per uso prop...,0,0,0,0,0,2021
EMI,BO,U   ,Organizzazioni ed organismi extraterritoriali               ,0,0,0,0,0,2021
EMI,BO,U 99,Organizzazioni ed organismi extraterritoriali               ,0,0,0,0,0,2021
EMI,BO,XX  ,Imprese non classificate                                    ,16,0,3,13,32,2021
EMI,BO,TOT ,TOTALE                                                      ,192,9,105,42,348,2021
EMI,FE,A   ,"Agricoltura, silvicoltura pesca                             ",0,0,0,1,1,2021
EMI,FE,A 01,"Coltivazioni agricole e produzione di prodotti animali, c...",0,0,0,0,0,2021
EMI,FE,A 02,Silvicoltura ed utilizzo di aree forestali                  ,0,0,0,0,0,2021
EMI,FE,A 03,Pesca e acquacoltura                                        ,0,0,0,1,1,2021
EMI,FE,B   ,Estrazione di minerali da cave e miniere                    ,0,0,0,0,0,2021
EMI,FE,B 05,Estrazione di carbone (esclusa torba)                       ,0,0,0,0,0,2021
EMI,FE,B 06,Estraz.di petrolio greggio e di gas naturale                ,0,0,0,0,0,2021
EMI,FE,B 07,Estrazione di minerali metalliferi                          ,0,0,0,0,0,2021
EMI,FE,B 08,Altre attività di estrazione di minerali da cave e miniere  ,0,0,0,0,0,2021
EMI,FE,B 09,Attività dei servizi di supporto all'estrazione             ,0,0,0,0,0,2021
EMI,FE,C   ,Attività manifatturiere                                     ,0,0,0,1,1,2021
EMI,FE,C 10,Industrie alimentari                                        ,0,0,0,0,0,2021
EMI,FE,C 11,Industria delle bevande                                     ,0,0,0,0,0,2021
EMI,FE,C 12,Industria del tabacco                                       ,0,0,0,0,0,2021
EMI,FE,C 13,Industrie tessili                                           ,0,0,0,0,0,2021
EMI,FE,C 14,Confezione di articoli di abbigliamento; confezione di ar...,0,0,0,0,0,2021
EMI,FE,C 15,Fabbricazione di articoli in pelle e simili                 ,0,0,0,0,0,2021
EMI,FE,C 16,Industria del legno e dei prodotti in legno e sughero (es...,0,0,0,0,0,2021
EMI,FE,C 17,Fabbricazione di carta e di prodotti di carta               ,0,0,0,0,0,2021
EMI,FE,C 18,Stampa e riproduzione di supporti registrati                ,0,0,0,0,0,2021
EMI,FE,C 19,Fabbricazione di coke e prodotti derivanti dalla raffinaz...,0,0,0,0,0,2021
EMI,FE,C 20,Fabbricazione di prodotti chimici                           ,0,0,0,0,0,2021
EMI,FE,C 21,Fabbricazione di prodotti farmaceutici di base e di prepa...,0,0,0,0,0,2021
EMI,FE,C 22,Fabbricazione di articoli in gomma e materie plastiche      ,0,0,0,0,0,2021
EMI,FE,C 23,Fabbricazione di altri prodotti della lavorazione di miner..,0,0,0,0,0,2021
EMI,FE,C 24,Metallurgia                                                 ,0,0,0,0,0,2021
EMI,FE,C 25,Fabbricazione di prodotti in metallo (esclusi macchinari ...,0,0,0,0,0,2021
EMI,FE,C 26,Fabbricazione di computer e prodotti di elettronica e ott...,0,0,0,0,0,2021
EMI,FE,C 27,Fabbricazione di apparecchiature elettriche ed apparecchi...,0,0,0,0,0,2021
EMI,FE,C 28,Fabbricazione di macchinari ed apparecchiature nca          ,0,0,0,0,0,2021
EMI,FE,C 29,"Fabbricazione di autoveicoli, rimorchi e semirimorchi       ",0,0,0,0,0,2021
EMI,FE,C 30,Fabbricazione di altri mezzi di trasporto                   ,0,0,0,0,0,2021
EMI,FE,C 31,Fabbricazione di mobili                                     ,0,0,0,1,1,2021
EMI,FE,C 32,Altre industrie manifatturiere                              ,0,0,0,0,0,2021
EMI,FE,C 33,"Riparazione, manutenzione ed installazione di macchine ed...",0,0,0,0,0,2021
EMI,FE,D   ,"Fornitura di energia elettrica, gas, vapore e aria condiz...",0,0,0,0,0,2021
EMI,FE,D 35,"Fornitura di energia elettrica, gas, vapore e aria condiz...",0,0,0,0,0,2021
EMI,FE,E   ,"Fornitura di acqua; reti fognarie, attività di gestione d...",0,0,0,0,0,2021
EMI,FE,E 36,"Raccolta, trattamento e fornitura di acqua                  ",0,0,0,0,0,2021
EMI,FE,E 37,Gestione delle reti fognarie                                ,0,0,0,0,0,2021
EMI,FE,E 38,"Attività di raccolta, trattamento e smaltimento dei rifiu...",0,0,0,0,0,2021
EMI,FE,E 39,Attività di risanamento e altri servizi di gestione dei r...,0,0,0,0,0,2021
EMI,FE,F   ,Costruzioni                                                 ,0,0,0,0,0,2021
EMI,FE,F 41,Costruzione di edifici                                      ,0,0,0,0,0,2021
EMI,FE,F 42,Ingegneria civile                                           ,0,0,0,0,0,2021
EMI,FE,F 43,Lavori di costruzione specializzati                         ,0,0,0,0,0,2021
EMI,FE,G   ,Commercio all'ingrosso e al dettaglio; riparazione di aut...,0,0,0,0,0,2021
EMI,FE,G 45,Commercio all'ingrosso e al dettaglio e riparazione di au...,0,0,0,0,0,2021
EMI,FE,G 46,Commercio all'ingrosso (escluso quello di autoveicoli e d...,0,0,0,0,0,2021
EMI,FE,G 47,Commercio al dettaglio (escluso quello di autoveicoli e d...,0,0,0,0,0,2021
EMI,FE,H   ,Trasporto e magazzinaggio                                   ,0,0,0,0,0,2021
EMI,FE,H 49,Trasporto terrestre e mediante condotte                     ,0,0,0,0,0,2021
EMI,FE,H 50,Trasporto marittimo e per vie d'acqua                       ,0,0,0,0,0,2021
EMI,FE,H 51,Trasporto aereo                                             ,0,0,0,0,0,2021
EMI,FE,H 52,Magazzinaggio e attività di supporto ai trasporti           ,0,0,0,0,0,2021
EMI,FE,H 53,Servizi postali e attività di corriere                      ,0,0,0,0,0,2021
EMI,FE,I   ,Attività dei servizi alloggio e ristorazione                ,0,0,0,0,0,2021
EMI,FE,I 55,Alloggio                                                    ,0,0,0,0,0,2021
EMI,FE,I 56,Attività dei servizi di ristorazione                        ,0,0,0,0,0,2021
EMI,FE,J   ,Servizi di informazione e comunicazione                     ,0,0,0,0,0,2021
EMI,FE,J 58,Attività editoriali                                         ,0,0,0,0,0,2021
EMI,FE,J 59,"Attività di produzione cinematografica, di video e di pro...",0,0,0,0,0,2021
EMI,FE,J 60,Attività di programmazione e trasmissione                   ,0,0,0,0,0,2021
EMI,FE,J 61,Telecomunicazioni                                           ,0,0,0,0,0,2021
EMI,FE,J 62,"Produzione di software, consulenza informatica e attività...",0,0,0,0,0,2021
EMI,FE,J 63,Attività dei servizi d'informazione e altri servizi infor...,0,0,0,0,0,2021
EMI,FE,K   ,Attività finanziarie e assicurative                         ,0,0,0,0,0,2021
EMI,FE,K 64,Attività di servizi finanziari (escluse le assicurazioni ...,0,0,0,0,0,2021
EMI,FE,K 65,"Assicurazioni, riassicurazioni e fondi pensione (escluse ...",0,0,0,0,0,2021
EMI,FE,K 66,Attività ausiliarie dei servizi finanziari e delle attivi...,0,0,0,0,0,2021
EMI,FE,L   ,Attivita' immobiliari                                       ,0,0,0,0,0,2021
EMI,FE,L 68,Attivita' immobiliari                                       ,0,0,0,0,0,2021
EMI,FE,M   ,"Attività professionali, scientifiche e tecniche             ",0,0,0,0,0,2021
EMI,FE,M 69,Attività legali e contabilità                               ,0,0,0,0,0,2021
EMI,FE,M 70,Attività di direzione aziendale e di consulenza gestional...,0,0,0,0,0,2021
EMI,FE,M 71,Attività degli studi di architettura e d'ingegneria; coll...,0,0,0,0,0,2021
EMI,FE,M 72,Ricerca scientifica e sviluppo                              ,0,0,0,0,0,2021
EMI,FE,M 73,Pubblicità e ricerche di mercato                            ,0,0,0,0,0,2021
EMI,FE,M 74,"Altre attività professionali, scientifiche e tecniche       ",0,0,0,0,0,2021
EMI,FE,M 75,Servizi veterinari                                          ,0,0,0,0,0,2021
EMI,FE,N   ,"Noleggio, agenzie di viaggio, servizi di supporto alle im...",0,0,0,0,0,2021
EMI,FE,N 77,Attività di noleggio e leasing operativo                    ,0,0,0,0,0,2021
EMI,FE,N 78,"Attività di ricerca, selezione, fornitura di personale      ",0,0,0,0,0,2021
EMI,FE,N 79,"Attività dei servizi delle agenzie di viaggio, dei tour o...",0,0,0,0,0,2021
EMI,FE,N 80,Servizi di vigilanza e investigazione                       ,0,0,0,0,0,2021
EMI,FE,N 81,Attività di servizi per edifici e paesaggio                 ,0,0,0,0,0,2021
EMI,FE,N 82,Attività di supporto per le funzioni d'ufficio e altri se...,0,0,0,0,0,2021
EMI,FE,O   ,Amministrazione pubblica e difesa; assicurazione sociale ...,0,0,0,0,0,2021
EMI,FE,O 84,Amministrazione pubblica e difesa; assicurazione sociale ...,0,0,0,0,0,2021
EMI,FE,P   ,Istruzione                                                  ,0,0,0,0,0,2021
EMI,FE,P 85,Istruzione                                                  ,0,0,0,0,0,2021
EMI,FE,Q   ,Sanita' e assistenza sociale                                ,0,0,0,0,0,2021
EMI,FE,Q 86,Assistenza sanitaria                                        ,0,0,0,0,0,2021
EMI,FE,Q 87,Servizi di assistenza sociale residenziale                  ,0,0,0,0,0,2021
EMI,FE,Q 88,Assistenza sociale non residenziale                         ,0,0,0,0,0,2021
EMI,FE,R   ,"Attività artistiche, sportive, di intrattenimento e diver...",0,0,0,2,2,2021
EMI,FE,R 90,"Attività creative, artistiche e di intrattenimento          ",0,0,0,0,0,2021
EMI,FE,R 91,"Attività di biblioteche, archivi, musei ed altre attività...",0,0,0,0,0,2021
EMI,FE,R 92,"Attività riguardanti le lotterie, le scommesse, le case d...",0,0,0,0,0,2021
EMI,FE,R 93,"Attività sportive, di intrattenimento e di divertimento     ",0,0,0,2,2,2021
EMI,FE,S   ,Altre attività di servizi                                   ,0,0,0,0,0,2021
EMI,FE,S 94,Attività di organizzazioni associative                      ,0,0,0,0,0,2021
EMI,FE,S 95,Riparazione di computer e di beni per uso personale e per...,0,0,0,0,0,2021
EMI,FE,S 96,Altre attività di servizi per la persona                    ,0,0,0,0,0,2021
EMI,FE,T   ,Attività di famiglie e convivenze come datori di lavoro p...,0,0,0,0,0,2021
EMI,FE,T 97,Attività di famiglie e convivenze come datori di lavoro p...,0,0,0,0,0,2021
EMI,FE,T 98,Produzione di beni e servizi indifferenziati per uso prop...,0,0,0,0,0,2021
EMI,FE,U   ,Organizzazioni ed organismi extraterritoriali               ,0,0,0,0,0,2021
EMI,FE,U 99,Organizzazioni ed organismi extraterritoriali               ,0,0,0,0,0,2021
EMI,FE,XX  ,Imprese non classificate                                    ,0,0,0,2,2,2021
EMI,FE,TOT ,TOTALE                                                      ,0,0,0,6,6,2021
EMI,RA,A   ,"Agricoltura, silvicoltura pesca                             ",0,0,0,0,0,2021
EMI,RA,A 01,"Coltivazioni agricole e produzione di prodotti animali, c...",0,0,0,0,0,2021
EMI,RA,A 02,Silvicoltura ed utilizzo di aree forestali                  ,0,0,0,0,0,2021
EMI,RA,A 03,Pesca e acquacoltura                                        ,0,0,0,0,0,2021
EMI,RA,B   ,Estrazione di minerali da cave e miniere                    ,0,0,0,0,0,2021
EMI,RA,B 05,Estrazione di carbone (esclusa torba)                       ,0,0,0,0,0,2021
EMI,RA,B 06,Estraz.di petrolio greggio e di gas naturale                ,0,0,0,0,0,2021
EMI,RA,B 07,Estrazione di minerali metalliferi                          ,0,0,0,0,0,2021
EMI,RA,B 08,Altre attività di estrazione di minerali da cave e miniere  ,0,0,0,0,0,2021
EMI,RA,B 09,Attività dei servizi di supporto all'estrazione             ,0,0,0,0,0,2021
EMI,RA,C   ,Attività manifatturiere                                     ,0,0,0,1,1,2021
EMI,RA,C 10,Industrie alimentari                                        ,0,0,0,0,0,2021
EMI,RA,C 11,Industria delle bevande                                     ,0,0,0,0,0,2021
EMI,RA,C 12,Industria del tabacco                                       ,0,0,0,0,0,2021
EMI,RA,C 13,Industrie tessili                                           ,0,0,0,0,0,2021
EMI,RA,C 14,Confezione di articoli di abbigliamento; confezione di ar...,0,0,0,0,0,2021
EMI,RA,C 15,Fabbricazione di articoli in pelle e simili                 ,0,0,0,0,0,2021
EMI,RA,C 16,Industria del legno e dei prodotti in legno e sughero (es...,0,0,0,0,0,2021
EMI,RA,C 17,Fabbricazione di carta e di prodotti di carta               ,0,0,0,0,0,2021
EMI,RA,C 18,Stampa e riproduzione di supporti registrati                ,0,0,0,0,0,2021
EMI,RA,C 19,Fabbricazione di coke e prodotti derivanti dalla raffinaz...,0,0,0,0,0,2021
EMI,RA,C 20,Fabbricazione di prodotti chimici                           ,0,0,0,0,0,2021
EMI,RA,C 21,Fabbricazione di prodotti farmaceutici di base e di prepa...,0,0,0,0,0,2021
EMI,RA,C 22,Fabbricazione di articoli in gomma e materie plastiche      ,0,0,0,0,0,2021
EMI,RA,C 23,Fabbricazione di altri prodotti della lavorazione di miner..,0,0,0,0,0,2021
EMI,RA,C 24,Metallurgia                                                 ,0,0,0,0,0,2021
EMI,RA,C 25,Fabbricazione di prodotti in metallo (esclusi macchinari ...,0,0,0,0,0,2021
EMI,RA,C 26,Fabbricazione di computer e prodotti di elettronica e ott...,0,0,0,0,0,2021
EMI,RA,C 27,Fabbricazione di apparecchiature elettriche ed apparecchi...,0,0,0,0,0,2021
EMI,RA,C 28,Fabbricazione di macchinari ed apparecchiature nca          ,0,0,0,0,0,2021
EMI,RA,C 29,"Fabbricazione di autoveicoli, rimorchi e semirimorchi       ",0,0,0,0,0,2021
EMI,RA,C 30,Fabbricazione di altri mezzi di trasporto                   ,0,0,0,0,0,2021
EMI,RA,C 31,Fabbricazione di mobili                                     ,0,0,0,1,1,2021
EMI,RA,C 32,Altre industrie manifatturiere                              ,0,0,0,0,0,2021
EMI,RA,C 33,"Riparazione, manutenzione ed installazione di macchine ed...",0,0,0,0,0,2021
EMI,RA,D   ,"Fornitura di energia elettrica, gas, vapore e aria condiz...",0,0,0,0,0,2021
EMI,RA,D 35,"Fornitura di energia elettrica, gas, vapore e aria condiz...",0,0,0,0,0,2021
EMI,RA,E   ,"Fornitura di acqua; reti fognarie, attività di gestione d...",0,0,0,0,0,2021
EMI,RA,E 36,"Raccolta, trattamento e fornitura di acqua                  ",0,0,0,0,0,2021
EMI,RA,E 37,Gestione delle reti fognarie                                ,0,0,0,0,0,2021
EMI,RA,E 38,"Attività di raccolta, trattamento e smaltimento dei rifiu...",0,0,0,0,0,2021
EMI,RA,E 39,Attività di risanamento e altri servizi di gestione dei r...,0,0,0,0,0,2021
EMI,RA,F   ,Costruzioni                                                 ,0,0,1,0,1,2021
EMI,RA,F 41,Costruzione di edifici                                      ,0,0,0,0,0,2021
EMI,RA,F 42,Ingegneria civile                                           ,0,0,0,0,0,2021
EMI,RA,F 43,Lavori di costruzione specializzati                         ,0,0,1,0,1,2021
EMI,RA,G   ,Commercio all'ingrosso e al dettaglio; riparazione di aut...,0,1,10,1,12,2021
EMI,RA,G 45,Commercio all'ingrosso e al dettaglio e riparazione di au...,0,0,7,1,8,2021
EMI,RA,G 46,Commercio all'ingrosso (escluso quello di autoveicoli e d...,0,1,3,0,4,2021
EMI,RA,G 47,Commercio al dettaglio (escluso quello di autoveicoli e d...,0,0,0,0,0,2021
EMI,RA,H   ,Trasporto e magazzinaggio                                   ,0,0,0,0,0,2021
EMI,RA,H 49,Trasporto terrestre e mediante condotte                     ,0,0,0,0,0,2021
EMI,RA,H 50,Trasporto marittimo e per vie d'acqua                       ,0,0,0,0,0,2021
EMI,RA,H 51,Trasporto aereo                                             ,0,0,0,0,0,2021
EMI,RA,H 52,Magazzinaggio e attività di supporto ai trasporti           ,0,0,0,0,0,2021
EMI,RA,H 53,Servizi postali e attività di corriere                      ,0,0,0,0,0,2021
EMI,RA,I   ,Attività dei servizi alloggio e ristorazione                ,0,0,1,2,3,2021
EMI,RA,I 55,Alloggio                                                    ,0,0,0,0,0,2021
EMI,RA,I 56,Attività dei servizi di ristorazione                        ,0,0,1,2,3,2021
EMI,RA,J   ,Servizi di informazione e comunicazione                     ,0,0,0,0,0,2021
EMI,RA,J 58,Attività editoriali                                         ,0,0,0,0,0,2021
EMI,RA,J 59,"Attività di produzione cinematografica, di video e di pro...",0,0,0,0,0,2021
EMI,RA,J 60,Attività di programmazione e trasmissione                   ,0,0,0,0,0,2021
EMI,RA,J 61,Telecomunicazioni                                           ,0,0,0,0,0,2021
EMI,RA,J 62,"Produzione di software, consulenza informatica e attività...",0,0,0,0,0,2021
EMI,RA,J 63,Attività dei servizi d'informazione e altri servizi infor...,0,0,0,0,0,2021
EMI,RA,K   ,Attività finanziarie e assicurative                         ,0,0,0,0,0,2021
EMI,RA,K 64,Attività di servizi finanziari (escluse le assicurazioni ...,0,0,0,0,0,2021
EMI,RA,K 65,"Assicurazioni, riassicurazioni e fondi pensione (escluse ...",0,0,0,0,0,2021
EMI,RA,K 66,Attività ausiliarie dei servizi finanziari e delle attivi...,0,0,0,0,0,2021
EMI,RA,L   ,Attivita' immobiliari                                       ,0,0,0,0,0,2021
EMI,RA,L 68,Attivita' immobiliari                                       ,0,0,0,0,0,2021
EMI,RA,M   ,"Attività professionali, scientifiche e tecniche             ",0,0,0,0,0,2021
EMI,RA,M 69,Attività legali e contabilità                               ,0,0,0,0,0,2021
EMI,RA,M 70,Attività di direzione aziendale e di consulenza gestional...,0,0,0,0,0,2021
EMI,RA,M 71,Attività degli studi di architettura e d'ingegneria; coll...,0,0,0,0,0,2021
EMI,RA,M 72,Ricerca scientifica e sviluppo                              ,0,0,0,0,0,2021
EMI,RA,M 73,Pubblicità e ricerche di mercato                            ,0,0,0,0,0,2021
EMI,RA,M 74,"Altre attività professionali, scientifiche e tecniche       ",0,0,0,0,0,2021
EMI,RA,M 75,Servizi veterinari                                          ,0,0,0,0,0,2021
EMI,RA,N   ,"Noleggio, agenzie di viaggio, servizi di supporto alle im...",0,0,0,0,0,2021
EMI,RA,N 77,Attività di noleggio e leasing operativo                    ,0,0,0,0,0,2021
EMI,RA,N 78,"Attività di ricerca, selezione, fornitura di personale      ",0,0,0,0,0,2021
EMI,RA,N 79,"Attività dei servizi delle agenzie di viaggio, dei tour o...",0,0,0,0,0,2021
EMI,RA,N 80,Servizi di vigilanza e investigazione                       ,0,0,0,0,0,2021
EMI,RA,N 81,Attività di servizi per edifici e paesaggio                 ,0,0,0,0,0,2021
EMI,RA,N 82,Attività di supporto per le funzioni d'ufficio e altri se...,0,0,0,0,0,2021
EMI,RA,O   ,Amministrazione pubblica e difesa; assicurazione sociale ...,0,0,0,0,0,2021
EMI,RA,O 84,Amministrazione pubblica e difesa; assicurazione sociale ...,0,0,0,0,0,2021
EMI,RA,P   ,Istruzione                                                  ,0,0,0,0,0,2021
EMI,RA,P 85,Istruzione                                                  ,0,0,0,0,0,2021
EMI,RA,Q   ,Sanita' e assistenza sociale                                ,0,0,0,1,1,2021
EMI,RA,Q 86,Assistenza sanitaria                                        ,0,0,0,0,0,2021
EMI,RA,Q 87,Servizi di assistenza sociale residenziale                  ,0,0,0,1,1,2021
EMI,RA,Q 88,Assistenza sociale non residenziale                         ,0,0,0,0,0,2021
EMI,RA,R   ,"Attività artistiche, sportive, di intrattenimento e diver...",0,1,0,0,1,2021
EMI,RA,R 90,"Attività creative, artistiche e di intrattenimento          ",0,0,0,0,0,2021
EMI,RA,R 91,"Attività di biblioteche, archivi, musei ed altre attività...",0,0,0,0,0,2021
EMI,RA,R 92,"Attività riguardanti le lotterie, le scommesse, le case d...",0,0,0,0,0,2021
EMI,RA,R 93,"Attività sportive, di intrattenimento e di divertimento     ",0,1,0,0,1,2021
EMI,RA,S   ,Altre attività di servizi                                   ,0,0,0,0,0,2021
EMI,RA,S 94,Attività di organizzazioni associative                      ,0,0,0,0,0,2021
EMI,RA,S 95,Riparazione di computer e di beni per uso personale e per...,0,0,0,0,0,2021
EMI,RA,S 96,Altre attività di servizi per la persona                    ,0,0,0,0,0,2021
EMI,RA,T   ,Attività di famiglie e convivenze come datori di lavoro p...,0,0,0,0,0,2021
EMI,RA,T 97,Attività di famiglie e convivenze come datori di lavoro p...,0,0,0,0,0,2021
EMI,RA,T 98,Produzione di beni e servizi indifferenziati per uso prop...,0,0,0,0,0,2021
EMI,RA,U   ,Organizzazioni ed organismi extraterritoriali               ,0,0,0,0,0,2021
EMI,RA,U 99,Organizzazioni ed organismi extraterritoriali               ,0,0,0,0,0,2021
EMI,RA,XX  ,Imprese non classificate                                    ,0,0,1,1,2,2021
EMI,RA,TOT ,TOTALE                                                      ,0,2,13,6,21,2021
EMI,FO,A   ,"Agricoltura, silvicoltura pesca                             ",0,0,0,1,1,2021
EMI,FO,A 01,"Coltivazioni agricole e produzione di prodotti animali, c...",0,0,0,1,1,2021
EMI,FO,A 02,Silvicoltura ed utilizzo di aree forestali                  ,0,0,0,0,0,2021
EMI,FO,A 03,Pesca e acquacoltura                                        ,0,0,0,0,0,2021
EMI,FO,B   ,Estrazione di minerali da cave e miniere                    ,0,0,0,0,0,2021
EMI,FO,B 05,Estrazione di carbone (esclusa torba)                       ,0,0,0,0,0,2021
EMI,FO,B 06,Estraz.di petrolio greggio e di gas naturale                ,0,0,0,0,0,2021
EMI,FO,B 07,Estrazione di minerali metalliferi                          ,0,0,0,0,0,2021
EMI,FO,B 08,Altre attività di estrazione di minerali da cave e miniere  ,0,0,0,0,0,2021
EMI,FO,B 09,Attività dei servizi di supporto all'estrazione             ,0,0,0,0,0,2021
EMI,FO,C   ,Attività manifatturiere                                     ,0,0,0,1,1,2021
EMI,FO,C 10,Industrie alimentari                                        ,0,0,0,0,0,2021
EMI,FO,C 11,Industria delle bevande                                     ,0,0,0,0,0,2021
EMI,FO,C 12,Industria del tabacco                                       ,0,0,0,0,0,2021
EMI,FO,C 13,Industrie tessili                                           ,0,0,0,0,0,2021
EMI,FO,C 14,Confezione di articoli di abbigliamento; confezione di ar...,0,0,0,0,0,2021
EMI,FO,C 15,Fabbricazione di articoli in pelle e simili                 ,0,0,0,0,0,2021
EMI,FO,C 16,Industria del legno e dei prodotti in legno e sughero (es...,0,0,0,0,0,2021
EMI,FO,C 17,Fabbricazione di carta e di prodotti di carta               ,0,0,0,0,0,2021
EMI,FO,C 18,Stampa e riproduzione di supporti registrati                ,0,0,0,0,0,2021
EMI,FO,C 19,Fabbricazione di coke e prodotti derivanti dalla raffinaz...,0,0,0,0,0,2021
EMI,FO,C 20,Fabbricazione di prodotti chimici                           ,0,0,0,0,0,2021
EMI,FO,C 21,Fabbricazione di prodotti farmaceutici di base e di prepa...,0,0,0,0,0,2021
EMI,FO,C 22,Fabbricazione di articoli in gomma e materie plastiche      ,0,0,0,0,0,2021
EMI,FO,C 23,Fabbricazione di altri prodotti della lavorazione di miner..,0,0,0,0,0,2021
EMI,FO,C 24,Metallurgia                                                 ,0,0,0,0,0,2021
EMI,FO,C 25,Fabbricazione di prodotti in metallo (esclusi macchinari ...,0,0,0,0,0,2021
EMI,FO,C 26,Fabbricazione di computer e prodotti di elettronica e ott...,0,0,0,0,0,2021
EMI,FO,C 27,Fabbricazione di apparecchiature elettriche ed apparecchi...,0,0,0,0,0,2021
EMI,FO,C 28,Fabbricazione di macchinari ed apparecchiature nca          ,0,0,0,0,0,2021
EMI,FO,C 29,"Fabbricazione di autoveicoli, rimorchi e semirimorchi       ",0,0,0,0,0,2021
EMI,FO,C 30,Fabbricazione di altri mezzi di trasporto                   ,0,0,0,0,0,2021
EMI,FO,C 31,Fabbricazione di mobili                                     ,0,0,0,1,1,2021
EMI,FO,C 32,Altre industrie manifatturiere                              ,0,0,0,0,0,2021
EMI,FO,C 33,"Riparazione, manutenzione ed installazione di macchine ed...",0,0,0,0,0,2021
EMI,FO,D   ,"Fornitura di energia elettrica, gas, vapore e aria condiz...",0,0,0,0,0,2021
EMI,FO,D 35,"Fornitura di energia elettrica, gas, vapore e aria condiz...",0,0,0,0,0,2021
EMI,FO,E   ,"Fornitura di acqua; reti fognarie, attività di gestione d...",0,0,0,0,0,2021
EMI,FO,E 36,"Raccolta, trattamento e fornitura di acqua                  ",0,0,0,0,0,2021
EMI,FO,E 37,Gestione delle reti fognarie                                ,0,0,0,0,0,2021
EMI,FO,E 38,"Attività di raccolta, trattamento e smaltimento dei rifiu...",0,0,0,0,0,2021
EMI,FO,E 39,Attività di risanamento e altri servizi di gestione dei r...,0,0,0,0,0,2021
EMI,FO,F   ,Costruzioni                                                 ,0,0,1,5,6,2021
EMI,FO,F 41,Costruzione di edifici                                      ,0,0,0,3,3,2021
EMI,FO,F 42,Ingegneria civile                                           ,0,0,0,1,1,2021
EMI,FO,F 43,Lavori di costruzione specializzati                         ,0,0,1,1,2,2021
EMI,FO,G   ,Commercio all'ingrosso e al dettaglio; riparazione di aut...,0,0,2,0,2,2021
EMI,FO,G 45,Commercio all'ingrosso e al dettaglio e riparazione di au...,0,0,2,0,2,2021
EMI,FO,G 46,Commercio all'ingrosso (escluso quello di autoveicoli e d...,0,0,0,0,0,2021
EMI,FO,G 47,Commercio al dettaglio (escluso quello di autoveicoli e d...,0,0,0,0,0,2021
EMI,FO,H   ,Trasporto e magazzinaggio                                   ,0,0,1,1,2,2021
EMI,FO,H 49,Trasporto terrestre e mediante condotte                     ,0,0,1,0,1,2021
EMI,FO,H 50,Trasporto marittimo e per vie d'acqua                       ,0,0,0,0,0,2021
EMI,FO,H 51,Trasporto aereo                                             ,0,0,0,0,0,2021
EMI,FO,H 52,Magazzinaggio e attività di supporto ai trasporti           ,0,0,0,1,1,2021
EMI,FO,H 53,Servizi postali e attività di corriere                      ,0,0,0,0,0,2021
EMI,FO,I   ,Attività dei servizi alloggio e ristorazione                ,0,0,0,0,0,2021
EMI,FO,I 55,Alloggio                                                    ,0,0,0,0,0,2021
EMI,FO,I 56,Attività dei servizi di ristorazione                        ,0,0,0,0,0,2021
EMI,FO,J   ,Servizi di informazione e comunicazione                     ,0,0,0,1,1,2021
EMI,FO,J 58,Attività editoriali                                         ,0,0,0,0,0,2021
EMI,FO,J 59,"Attività di produzione cinematografica, di video e di pro...",0,0,0,0,0,2021
EMI,FO,J 60,Attività di programmazione e trasmissione                   ,0,0,0,0,0,2021
EMI,FO,J 61,Telecomunicazioni                                           ,0,0,0,0,0,2021
EMI,FO,J 62,"Produzione di software, consulenza informatica e attività...",0,0,0,0,0,2021
EMI,FO,J 63,Attività dei servizi d'informazione e altri servizi infor...,0,0,0,1,1,2021
EMI,FO,K   ,Attività finanziarie e assicurative                         ,0,0,0,0,0,2021
EMI,FO,K 64,Attività di servizi finanziari (escluse le assicurazioni ...,0,0,0,0,0,2021
EMI,FO,K 65,"Assicurazioni, riassicurazioni e fondi pensione (escluse ...",0,0,0,0,0,2021
EMI,FO,K 66,Attività ausiliarie dei servizi finanziari e delle attivi...,0,0,0,0,0,2021
EMI,FO,L   ,Attivita' immobiliari                                       ,0,0,0,0,0,2021
EMI,FO,L 68,Attivita' immobiliari                                       ,0,0,0,0,0,2021
EMI,FO,M   ,"Attività professionali, scientifiche e tecniche             ",0,0,0,0,0,2021
EMI,FO,M 69,Attività legali e contabilità                               ,0,0,0,0,0,2021
EMI,FO,M 70,Attività di direzione aziendale e di consulenza gestional...,0,0,0,0,0,2021
EMI,FO,M 71,Attività degli studi di architettura e d'ingegneria; coll...,0,0,0,0,0,2021
EMI,FO,M 72,Ricerca scientifica e sviluppo                              ,0,0,0,0,0,2021
EMI,FO,M 73,Pubblicità e ricerche di mercato                            ,0,0,0,0,0,2021
EMI,FO,M 74,"Altre attività professionali, scientifiche e tecniche       ",0,0,0,0,0,2021
EMI,FO,M 75,Servizi veterinari                                          ,0,0,0,0,0,2021
EMI,FO,N   ,"Noleggio, agenzie di viaggio, servizi di supporto alle im...",0,0,0,0,0,2021
EMI,FO,N 77,Attività di noleggio e leasing operativo                    ,0,0,0,0,0,2021
EMI,FO,N 78,"Attività di ricerca, selezione, fornitura di personale      ",0,0,0,0,0,2021
EMI,FO,N 79,"Attività dei servizi delle agenzie di viaggio, dei tour o...",0,0,0,0,0,2021
EMI,FO,N 80,Servizi di vigilanza e investigazione                       ,0,0,0,0,0,2021
EMI,FO,N 81,Attività di servizi per edifici e paesaggio                 ,0,0,0,0,0,2021
EMI,FO,N 82,Attività di supporto per le funzioni d'ufficio e altri se...,0,0,0,0,0,2021
EMI,FO,O   ,Amministrazione pubblica e difesa; assicurazione sociale ...,0,0,0,0,0,2021
EMI,FO,O 84,Amministrazione pubblica e difesa; assicurazione sociale ...,0,0,0,0,0,2021
EMI,FO,P   ,Istruzione                                                  ,0,0,0,0,0,2021
EMI,FO,P 85,Istruzione                                                  ,0,0,0,0,0,2021
EMI,FO,Q   ,Sanita' e assistenza sociale                                ,0,0,0,0,0,2021
EMI,FO,Q 86,Assistenza sanitaria                                        ,0,0,0,0,0,2021
EMI,FO,Q 87,Servizi di assistenza sociale residenziale                  ,0,0,0,0,0,2021
EMI,FO,Q 88,Assistenza sociale non residenziale                         ,0,0,0,0,0,2021
EMI,FO,R   ,"Attività artistiche, sportive, di intrattenimento e diver...",0,0,0,1,1,2021
EMI,FO,R 90,"Attività creative, artistiche e di intrattenimento          ",0,0,0,0,0,2021
EMI,FO,R 91,"Attività di biblioteche, archivi, musei ed altre attività...",0,0,0,0,0,2021
EMI,FO,R 92,"Attività riguardanti le lotterie, le scommesse, le case d...",0,0,0,0,0,2021
EMI,FO,R 93,"Attività sportive, di intrattenimento e di divertimento     ",0,0,0,1,1,2021
EMI,FO,S   ,Altre attività di servizi                                   ,0,0,0,0,0,2021
EMI,FO,S 94,Attività di organizzazioni associative                      ,0,0,0,0,0,2021
EMI,FO,S 95,Riparazione di computer e di beni per uso personale e per...,0,0,0,0,0,2021
EMI,FO,S 96,Altre attività di servizi per la persona                    ,0,0,0,0,0,2021
EMI,FO,T   ,Attività di famiglie e convivenze come datori di lavoro p...,0,0,0,0,0,2021
EMI,FO,T 97,Attività di famiglie e convivenze come datori di lavoro p...,0,0,0,0,0,2021
EMI,FO,T 98,Produzione di beni e servizi indifferenziati per uso prop...,0,0,0,0,0,2021
EMI,FO,U   ,Organizzazioni ed organismi extraterritoriali               ,0,0,0,0,0,2021
EMI,FO,U 99,Organizzazioni ed organismi extraterritoriali               ,0,0,0,0,0,2021
EMI,FO,XX  ,Imprese non classificate                                    ,0,0,0,7,7,2021
EMI,FO,TOT ,TOTALE                                                      ,0,0,4,17,21,2021
EMI,RN,A   ,"Agricoltura, silvicoltura pesca                             ",0,0,0,1,1,2021
EMI,RN,A 01,"Coltivazioni agricole e produzione di prodotti animali, c...",0,0,0,1,1,2021
EMI,RN,A 02,Silvicoltura ed utilizzo di aree forestali                  ,0,0,0,0,0,2021
EMI,RN,A 03,Pesca e acquacoltura                                        ,0,0,0,0,0,2021
EMI,RN,B   ,Estrazione di minerali da cave e miniere                    ,0,0,0,0,0,2021
EMI,RN,B 05,Estrazione di carbone (esclusa torba)                       ,0,0,0,0,0,2021
EMI,RN,B 06,Estraz.di petrolio greggio e di gas naturale                ,0,0,0,0,0,2021
EMI,RN,B 07,Estrazione di minerali metalliferi                          ,0,0,0,0,0,2021
EMI,RN,B 08,Altre attività di estrazione di minerali da cave e miniere  ,0,0,0,0,0,2021
EMI,RN,B 09,Attività dei servizi di supporto all'estrazione             ,0,0,0,0,0,2021
EMI,RN,C   ,Attività manifatturiere                                     ,0,0,0,0,0,2021
EMI,RN,C 10,Industrie alimentari                                        ,0,0,0,0,0,2021
EMI,RN,C 11,Industria delle bevande                                     ,0,0,0,0,0,2021
EMI,RN,C 12,Industria del tabacco                                       ,0,0,0,0,0,2021
EMI,RN,C 13,Industrie tessili                                           ,0,0,0,0,0,2021
EMI,RN,C 14,Confezione di articoli di abbigliamento; confezione di ar...,0,0,0,0,0,2021
EMI,RN,C 15,Fabbricazione di articoli in pelle e simili                 ,0,0,0,0,0,2021
EMI,RN,C 16,Industria del legno e dei prodotti in legno e sughero (es...,0,0,0,0,0,2021
EMI,RN,C 17,Fabbricazione di carta e di prodotti di carta               ,0,0,0,0,0,2021
EMI,RN,C 18,Stampa e riproduzione di supporti registrati                ,0,0,0,0,0,2021
EMI,RN,C 19,Fabbricazione di coke e prodotti derivanti dalla raffinaz...,0,0,0,0,0,2021
EMI,RN,C 20,Fabbricazione di prodotti chimici                           ,0,0,0,0,0,2021
EMI,RN,C 21,Fabbricazione di prodotti farmaceutici di base e di prepa...,0,0,0,0,0,2021
EMI,RN,C 22,Fabbricazione di articoli in gomma e materie plastiche      ,0,0,0,0,0,2021
EMI,RN,C 23,Fabbricazione di altri prodotti della lavorazione di miner..,0,0,0,0,0,2021
EMI,RN,C 24,Metallurgia                                                 ,0,0,0,0,0,2021
EMI,RN,C 25,Fabbricazione di prodotti in metallo (esclusi macchinari ...,0,0,0,0,0,2021
EMI,RN,C 26,Fabbricazione di computer e prodotti di elettronica e ott...,0,0,0,0,0,2021
EMI,RN,C 27,Fabbricazione di apparecchiature elettriche ed apparecchi...,0,0,0,0,0,2021
EMI,RN,C 28,Fabbricazione di macchinari ed apparecchiature nca          ,0,0,0,0,0,2021
EMI,RN,C 29,"Fabbricazione di autoveicoli, rimorchi e semirimorchi       ",0,0,0,0,0,2021
EMI,RN,C 30,Fabbricazione di altri mezzi di trasporto                   ,0,0,0,0,0,2021
EMI,RN,C 31,Fabbricazione di mobili                                     ,0,0,0,0,0,2021
EMI,RN,C 32,Altre industrie manifatturiere                              ,0,0,0,0,0,2021
EMI,RN,C 33,"Riparazione, manutenzione ed installazione di macchine ed...",0,0,0,0,0,2021
EMI,RN,D   ,"Fornitura di energia elettrica, gas, vapore e aria condiz...",0,0,0,0,0,2021
EMI,RN,D 35,"Fornitura di energia elettrica, gas, vapore e aria condiz...",0,0,0,0,0,2021
EMI,RN,E   ,"Fornitura di acqua; reti fognarie, attività di gestione d...",0,0,0,0,0,2021
EMI,RN,E 36,"Raccolta, trattamento e fornitura di acqua                  ",0,0,0,0,0,2021
EMI,RN,E 37,Gestione delle reti fognarie                                ,0,0,0,0,0,2021
EMI,RN,E 38,"Attività di raccolta, trattamento e smaltimento dei rifiu...",0,0,0,0,0,2021
EMI,RN,E 39,Attività di risanamento e altri servizi di gestione dei r...,0,0,0,0,0,2021
EMI,RN,F   ,Costruzioni                                                 ,0,0,1,0,1,2021
EMI,RN,F 41,Costruzione di edifici                                      ,0,0,0,0,0,2021
EMI,RN,F 42,Ingegneria civile                                           ,0,0,0,0,0,2021
EMI,RN,F 43,Lavori di costruzione specializzati                         ,0,0,1,0,1,2021
EMI,RN,G   ,Commercio all'ingrosso e al dettaglio; riparazione di aut...,0,0,0,0,0,2021
EMI,RN,G 45,Commercio all'ingrosso e al dettaglio e riparazione di au...,0,0,0,0,0,2021
EMI,RN,G 46,Commercio all'ingrosso (escluso quello di autoveicoli e d...,0,0,0,0,0,2021
EMI,RN,G 47,Commercio al dettaglio (escluso quello di autoveicoli e d...,0,0,0,0,0,2021
EMI,RN,H   ,Trasporto e magazzinaggio                                   ,0,0,0,1,1,2021
EMI,RN,H 49,Trasporto terrestre e mediante condotte                     ,0,0,0,0,0,2021
EMI,RN,H 50,Trasporto marittimo e per vie d'acqua                       ,0,0,0,0,0,2021
EMI,RN,H 51,Trasporto aereo                                             ,0,0,0,0,0,2021
EMI,RN,H 52,Magazzinaggio e attività di supporto ai trasporti           ,0,0,0,1,1,2021
EMI,RN,H 53,Servizi postali e attività di corriere                      ,0,0,0,0,0,2021
EMI,RN,I   ,Attività dei servizi alloggio e ristorazione                ,0,0,0,0,0,2021
EMI,RN,I 55,Alloggio                                                    ,0,0,0,0,0,2021
EMI,RN,I 56,Attività dei servizi di ristorazione                        ,0,0,0,0,0,2021
EMI,RN,J   ,Servizi di informazione e comunicazione                     ,0,0,0,0,0,2021
EMI,RN,J 58,Attività editoriali                                         ,0,0,0,0,0,2021
EMI,RN,J 59,"Attività di produzione cinematografica, di video e di pro...",0,0,0,0,0,2021
EMI,RN,J 60,Attività di programmazione e trasmissione                   ,0,0,0,0,0,2021
EMI,RN,J 61,Telecomunicazioni                                           ,0,0,0,0,0,2021
EMI,RN,J 62,"Produzione di software, consulenza informatica e attività...",0,0,0,0,0,2021
EMI,RN,J 63,Attività dei servizi d'informazione e altri servizi infor...,0,0,0,0,0,2021
EMI,RN,K   ,Attività finanziarie e assicurative                         ,0,0,0,0,0,2021
EMI,RN,K 64,Attività di servizi finanziari (escluse le assicurazioni ...,0,0,0,0,0,2021
EMI,RN,K 65,"Assicurazioni, riassicurazioni e fondi pensione (escluse ...",0,0,0,0,0,2021
EMI,RN,K 66,Attività ausiliarie dei servizi finanziari e delle attivi...,0,0,0,0,0,2021
EMI,RN,L   ,Attivita' immobiliari                                       ,1,0,0,0,1,2021
EMI,RN,L 68,Attivita' immobiliari                                       ,1,0,0,0,1,2021
EMI,RN,M   ,"Attività professionali, scientifiche e tecniche             ",0,0,0,0,0,2021
EMI,RN,M 69,Attività legali e contabilità                               ,0,0,0,0,0,2021
EMI,RN,M 70,Attività di direzione aziendale e di consulenza gestional...,0,0,0,0,0,2021
EMI,RN,M 71,Attività degli studi di architettura e d'ingegneria; coll...,0,0,0,0,0,2021
EMI,RN,M 72,Ricerca scientifica e sviluppo                              ,0,0,0,0,0,2021
EMI,RN,M 73,Pubblicità e ricerche di mercato                            ,0,0,0,0,0,2021
EMI,RN,M 74,"Altre attività professionali, scientifiche e tecniche       ",0,0,0,0,0,2021
EMI,RN,M 75,Servizi veterinari                                          ,0,0,0,0,0,2021
EMI,RN,N   ,"Noleggio, agenzie di viaggio, servizi di supporto alle im...",0,0,0,2,2,2021
EMI,RN,N 77,Attività di noleggio e leasing operativo                    ,0,0,0,0,0,2021
EMI,RN,N 78,"Attività di ricerca, selezione, fornitura di personale      ",0,0,0,0,0,2021
EMI,RN,N 79,"Attività dei servizi delle agenzie di viaggio, dei tour o...",0,0,0,0,0,2021
EMI,RN,N 80,Servizi di vigilanza e investigazione                       ,0,0,0,0,0,2021
EMI,RN,N 81,Attività di servizi per edifici e paesaggio                 ,0,0,0,1,1,2021
EMI,RN,N 82,Attività di supporto per le funzioni d'ufficio e altri se...,0,0,0,1,1,2021
EMI,RN,O   ,Amministrazione pubblica e difesa; assicurazione sociale ...,0,0,0,0,0,2021
EMI,RN,O 84,Amministrazione pubblica e difesa; assicurazione sociale ...,0,0,0,0,0,2021
EMI,RN,P   ,Istruzione                                                  ,0,0,0,0,0,2021
EMI,RN,P 85,Istruzione                                                  ,0,0,0,0,0,2021
EMI,RN,Q   ,Sanita' e assistenza sociale                                ,0,0,0,0,0,2021
EMI,RN,Q 86,Assistenza sanitaria                                        ,0,0,0,0,0,2021
EMI,RN,Q 87,Servizi di assistenza sociale residenziale                  ,0,0,0,0,0,2021
EMI,RN,Q 88,Assistenza sociale non residenziale                         ,0,0,0,0,0,2021
EMI,RN,R   ,"Attività artistiche, sportive, di intrattenimento e diver...",0,0,0,0,0,2021
EMI,RN,R 90,"Attività creative, artistiche e di intrattenimento          ",0,0,0,0,0,2021
EMI,RN,R 91,"Attività di biblioteche, archivi, musei ed altre attività...",0,0,0,0,0,2021
EMI,RN,R 92,"Attività riguardanti le lotterie, le scommesse, le case d...",0,0,0,0,0,2021
EMI,RN,R 93,"Attività sportive, di intrattenimento e di divertimento     ",0,0,0,0,0,2021
EMI,RN,S   ,Altre attività di servizi                                   ,0,0,0,0,0,2021
EMI,RN,S 94,Attività di organizzazioni associative                      ,0,0,0,0,0,2021
EMI,RN,S 95,Riparazione di computer e di beni per uso personale e per...,0,0,0,0,0,2021
EMI,RN,S 96,Altre attività di servizi per la persona                    ,0,0,0,0,0,2021
EMI,RN,T   ,Attività di famiglie e convivenze come datori di lavoro p...,0,0,0,0,0,2021
EMI,RN,T 97,Attività di famiglie e convivenze come datori di lavoro p...,0,0,0,0,0,2021
EMI,RN,T 98,Produzione di beni e servizi indifferenziati per uso prop...,0,0,0,0,0,2021
EMI,RN,U   ,Organizzazioni ed organismi extraterritoriali               ,0,0,0,0,0,2021
EMI,RN,U 99,Organizzazioni ed organismi extraterritoriali               ,0,0,0,0,0,2021
EMI,RN,XX  ,Imprese non classificate                                    ,0,0,0,6,6,2021
EMI,RN,TOT ,TOTALE                                                      ,1,0,1,10,12,2021
TOS,  ,A   ,"Agricoltura, silvicoltura pesca                             ",8,32,143,1,184,2021
TOS,  ,A 01,"Coltivazioni agricole e produzione di prodotti animali, c...",7,29,137,1,174,2021
TOS,  ,A 02,Silvicoltura ed utilizzo di aree forestali                  ,1,2,6,0,9,2021
TOS,  ,A 03,Pesca e acquacoltura                                        ,0,1,0,0,1,2021
TOS,  ,B   ,Estrazione di minerali da cave e miniere                    ,0,0,0,0,0,2021
TOS,  ,B 05,Estrazione di carbone (esclusa torba)                       ,0,0,0,0,0,2021
TOS,  ,B 06,Estraz.di petrolio greggio e di gas naturale                ,0,0,0,0,0,2021
TOS,  ,B 07,Estrazione di minerali metalliferi                          ,0,0,0,0,0,2021
TOS,  ,B 08,Altre attività di estrazione di minerali da cave e miniere  ,0,0,0,0,0,2021
TOS,  ,B 09,Attività dei servizi di supporto all'estrazione             ,0,0,0,0,0,2021
TOS,  ,C   ,Attività manifatturiere                                     ,208,122,514,6,850,2021
TOS,  ,C 10,Industrie alimentari                                        ,6,17,13,1,37,2021
TOS,  ,C 11,Industria delle bevande                                     ,0,0,0,0,0,2021
TOS,  ,C 12,Industria del tabacco                                       ,0,0,0,0,0,2021
TOS,  ,C 13,Industrie tessili                                           ,24,2,19,0,45,2021
TOS,  ,C 14,Confezione di articoli di abbigliamento; confezione di ar...,15,17,178,1,211,2021
TOS,  ,C 15,Fabbricazione di articoli in pelle e simili                 ,15,34,128,1,178,2021
TOS,  ,C 16,Industria del legno e dei prodotti in legno e sughero (es...,7,6,27,0,40,2021
TOS,  ,C 17,Fabbricazione di carta e di prodotti di carta               ,3,0,1,0,4,2021
TOS,  ,C 18,Stampa e riproduzione di supporti registrati                ,4,8,6,1,19,2021
TOS,  ,C 19,Fabbricazione di coke e prodotti derivanti dalla raffinaz...,0,0,0,0,0,2021
TOS,  ,C 20,Fabbricazione di prodotti chimici                           ,3,1,0,0,4,2021
TOS,  ,C 21,Fabbricazione di prodotti farmaceutici di base e di prepa...,0,0,0,0,0,2021
TOS,  ,C 22,Fabbricazione di articoli in gomma e materie plastiche      ,3,1,5,0,9,2021
TOS,  ,C 23,Fabbricazione di altri prodotti della lavorazione di miner..,13,3,11,0,27,2021
TOS,  ,C 24,Metallurgia                                                 ,1,0,2,0,3,2021
TOS,  ,C 25,Fabbricazione di prodotti in metallo (esclusi macchinari ...,41,11,45,0,97,2021
TOS,  ,C 26,Fabbricazione di computer e prodotti di elettronica e ott...,2,1,3,0,6,2021
TOS,  ,C 27,Fabbricazione di apparecchiature elettriche ed apparecchi...,5,0,3,0,8,2021
TOS,  ,C 28,Fabbricazione di macchinari ed apparecchiature nca          ,6,1,9,0,16,2021
TOS,  ,C 29,"Fabbricazione di autoveicoli, rimorchi e semirimorchi       ",1,0,1,0,2,2021
TOS,  ,C 30,Fabbricazione di altri mezzi di trasporto                   ,7,1,9,0,17,2021
TOS,  ,C 31,Fabbricazione di mobili                                     ,15,10,12,0,37,2021
TOS,  ,C 32,Altre industrie manifatturiere                              ,30,9,27,0,66,2021
TOS,  ,C 33,"Riparazione, manutenzione ed installazione di macchine ed...",7,0,15,2,24,2021
TOS,  ,D   ,"Fornitura di energia elettrica, gas, vapore e aria condiz...",3,0,1,0,4,2021
TOS,  ,D 35,"Fornitura di energia elettrica, gas, vapore e aria condiz...",3,0,1,0,4,2021
TOS,  ,E   ,"Fornitura di acqua; reti fognarie, attività di gestione d...",7,1,3,0,11,2021
TOS,  ,E 36,"Raccolta, trattamento e fornitura di acqua                  ",0,0,0,0,0,2021
TOS,  ,E 37,Gestione delle reti fognarie                                ,1,0,0,0,1,2021
TOS,  ,E 38,"Attività di raccolta, trattamento e smaltimento dei rifiu...",6,1,3,0,10,2021
TOS,  ,E 39,Attività di risanamento e altri servizi di gestione dei r...,0,0,0,0,0,2021
TOS,  ,F   ,Costruzioni                                                 ,176,92,1595,12,1875,2021
TOS,  ,F 41,Costruzione di edifici                                      ,119,42,218,5,384,2021
TOS,  ,F 42,Ingegneria civile                                           ,4,0,4,2,10,2021
TOS,  ,F 43,Lavori di costruzione specializzati                         ,53,50,1373,5,1481,2021
TOS,  ,G   ,Commercio all'ingrosso e al dettaglio; riparazione di aut...,246,201,877,3,1327,2021
TOS,  ,G 45,Commercio all'ingrosso e al dettaglio e riparazione di au...,29,18,50,1,98,2021
TOS,  ,G 46,Commercio all'ingrosso (escluso quello di autoveicoli e d...,127,71,308,0,506,2021
TOS,  ,G 47,Commercio al dettaglio (escluso quello di autoveicoli e d...,90,112,519,2,723,2021
TOS,  ,H   ,Trasporto e magazzinaggio                                   ,31,11,140,1,183,2021
TOS,  ,H 49,Trasporto terrestre e mediante condotte                     ,18,7,125,1,151,2021
TOS,  ,H 50,Trasporto marittimo e per vie d'acqua                       ,0,0,0,0,0,2021
TOS,  ,H 51,Trasporto aereo                                             ,0,0,0,0,0,2021
TOS,  ,H 52,Magazzinaggio e attività di supporto ai trasporti           ,10,4,9,0,23,2021
TOS,  ,H 53,Servizi postali e attività di corriere                      ,3,0,6,0,9,2021
TOS,  ,I   ,Attività dei servizi alloggio e ristorazione                ,119,169,105,1,394,2021
TOS,  ,I 55,Alloggio                                                    ,17,5,17,0,39,2021
TOS,  ,I 56,Attività dei servizi di ristorazione                        ,102,164,88,1,355,2021
TOS,  ,J   ,Servizi di informazione e comunicazione                     ,40,12,55,0,107,2021
TOS,  ,J 58,Attività editoriali                                         ,7,4,4,0,15,2021
TOS,  ,J 59,"Attività di produzione cinematografica, di video e di pro...",5,0,4,0,9,2021
TOS,  ,J 60,Attività di programmazione e trasmissione                   ,1,0,0,0,1,2021
TOS,  ,J 61,Telecomunicazioni                                           ,4,2,25,0,31,2021
TOS,  ,J 62,"Produzione di software, consulenza informatica e attività...",12,2,12,0,26,2021
TOS,  ,J 63,Attività dei servizi d'informazione e altri servizi infor...,11,4,10,0,25,2021
TOS,  ,K   ,Attività finanziarie e assicurative                         ,11,4,13,0,28,2021
TOS,  ,K 64,Attività di servizi finanziari (escluse le assicurazioni ...,3,1,0,0,4,2021
TOS,  ,K 65,"Assicurazioni, riassicurazioni e fondi pensione (escluse ...",0,0,0,0,0,2021
TOS,  ,K 66,Attività ausiliarie dei servizi finanziari e delle attivi...,8,3,13,0,24,2021
TOS,  ,L   ,Attivita' immobiliari                                       ,98,37,19,0,154,2021
TOS,  ,L 68,Attivita' immobiliari                                       ,98,37,19,0,154,2021
TOS,  ,M   ,"Attività professionali, scientifiche e tecniche             ",47,12,57,3,119,2021
TOS,  ,M 69,Attività legali e contabilità                               ,0,2,0,0,2,2021
TOS,  ,M 70,Attività di direzione aziendale e di consulenza gestional...,13,1,3,3,20,2021
TOS,  ,M 71,Attività degli studi di architettura e d'ingegneria; coll...,8,1,4,0,13,2021
TOS,  ,M 72,Ricerca scientifica e sviluppo                              ,0,1,1,0,2,2021
TOS,  ,M 73,Pubblicità e ricerche di mercato                            ,13,2,24,0,39,2021
TOS,  ,M 74,"Altre attività professionali, scientifiche e tecniche       ",13,5,25,0,43,2021
TOS,  ,M 75,Servizi veterinari                                          ,0,0,0,0,0,2021
TOS,  ,N   ,"Noleggio, agenzie di viaggio, servizi di supporto alle im...",42,17,92,6,157,2021
TOS,  ,N 77,Attività di noleggio e leasing operativo                    ,8,1,8,0,17,2021
TOS,  ,N 78,"Attività di ricerca, selezione, fornitura di personale      ",0,0,0,0,0,2021
TOS,  ,N 79,"Attività dei servizi delle agenzie di viaggio, dei tour o...",8,1,5,1,15,2021
TOS,  ,N 80,Servizi di vigilanza e investigazione                       ,3,0,1,0,4,2021
TOS,  ,N 81,Attività di servizi per edifici e paesaggio                 ,9,4,34,3,50,2021
TOS,  ,N 82,Attività di supporto per le funzioni d'ufficio e altri se...,14,11,44,2,71,2021
TOS,  ,O   ,Amministrazione pubblica e difesa; assicurazione sociale ...,0,0,0,0,0,2021
TOS,  ,O 84,Amministrazione pubblica e difesa; assicurazione sociale ...,0,0,0,0,0,2021
TOS,  ,P   ,Istruzione                                                  ,12,1,3,0,16,2021
TOS,  ,P 85,Istruzione                                                  ,12,1,3,0,16,2021
TOS,  ,Q   ,Sanita' e assistenza sociale                                ,5,1,0,1,7,2021
TOS,  ,Q 86,Assistenza sanitaria                                        ,3,1,0,0,4,2021
TOS,  ,Q 87,Servizi di assistenza sociale residenziale                  ,0,0,0,0,0,2021
TOS,  ,Q 88,Assistenza sociale non residenziale                         ,2,0,0,1,3,2021
TOS,  ,R   ,"Attività artistiche, sportive, di intrattenimento e diver...",33,10,28,1,72,2021
TOS,  ,R 90,"Attività creative, artistiche e di intrattenimento          ",1,5,14,1,21,2021
TOS,  ,R 91,"Attività di biblioteche, archivi, musei ed altre attività...",0,0,1,0,1,2021
TOS,  ,R 92,"Attività riguardanti le lotterie, le scommesse, le case d...",4,1,0,0,5,2021
TOS,  ,R 93,"Attività sportive, di intrattenimento e di divertimento     ",28,4,13,0,45,2021
TOS,  ,S   ,Altre attività di servizi                                   ,10,21,63,1,95,2021
TOS,  ,S 94,Attività di organizzazioni associative                      ,0,0,0,0,0,2021
TOS,  ,S 95,Riparazione di computer e di beni per uso personale e per...,1,3,28,0,32,2021
TOS,  ,S 96,Altre attività di servizi per la persona                    ,9,18,35,1,63,2021
TOS,  ,T   ,Attività di famiglie e convivenze come datori di lavoro p...,0,0,0,0,0,2021
TOS,  ,T 97,Attività di famiglie e convivenze come datori di lavoro p...,0,0,0,0,0,2021
TOS,  ,T 98,Produzione di beni e servizi indifferenziati per uso prop...,0,0,0,0,0,2021
TOS,  ,U   ,Organizzazioni ed organismi extraterritoriali               ,0,0,0,0,0,2021
TOS,  ,U 99,Organizzazioni ed organismi extraterritoriali               ,0,0,0,0,0,2021
TOS,  ,XX  ,Imprese non classificate                                    ,187,173,12,4,376,2021
TOS,  ,TOT ,TOTALE                                                      ,1283,916,3720,40,5959,2021
TOS,MS,A   ,"Agricoltura, silvicoltura pesca                             ",0,0,3,0,3,2021
TOS,MS,A 01,"Coltivazioni agricole e produzione di prodotti animali, c...",0,0,3,0,3,2021
TOS,MS,A 02,Silvicoltura ed utilizzo di aree forestali                  ,0,0,0,0,0,2021
TOS,MS,A 03,Pesca e acquacoltura                                        ,0,0,0,0,0,2021
TOS,MS,B   ,Estrazione di minerali da cave e miniere                    ,0,0,0,0,0,2021
TOS,MS,B 05,Estrazione di carbone (esclusa torba)                       ,0,0,0,0,0,2021
TOS,MS,B 06,Estraz.di petrolio greggio e di gas naturale                ,0,0,0,0,0,2021
TOS,MS,B 07,Estrazione di minerali metalliferi                          ,0,0,0,0,0,2021
TOS,MS,B 08,Altre attività di estrazione di minerali da cave e miniere  ,0,0,0,0,0,2021
TOS,MS,B 09,Attività dei servizi di supporto all'estrazione             ,0,0,0,0,0,2021
TOS,MS,C   ,Attività manifatturiere                                     ,0,0,56,0,56,2021
TOS,MS,C 10,Industrie alimentari                                        ,0,0,6,0,6,2021
TOS,MS,C 11,Industria delle bevande                                     ,0,0,0,0,0,2021
TOS,MS,C 12,Industria del tabacco                                       ,0,0,0,0,0,2021
TOS,MS,C 13,Industrie tessili                                           ,0,0,1,0,1,2021
TOS,MS,C 14,Confezione di articoli di abbigliamento; confezione di ar...,0,0,1,0,1,2021
TOS,MS,C 15,Fabbricazione di articoli in pelle e simili                 ,0,0,0,0,0,2021
TOS,MS,C 16,Industria del legno e dei prodotti in legno e sughero (es...,0,0,3,0,3,2021
TOS,MS,C 17,Fabbricazione di carta e di prodotti di carta               ,0,0,0,0,0,2021
TOS,MS,C 18,Stampa e riproduzione di supporti registrati                ,0,0,1,0,1,2021
TOS,MS,C 19,Fabbricazione di coke e prodotti derivanti dalla raffinaz...,0,0,0,0,0,2021
TOS,MS,C 20,Fabbricazione di prodotti chimici                           ,0,0,0,0,0,2021
TOS,MS,C 21,Fabbricazione di prodotti farmaceutici di base e di prepa...,0,0,0,0,0,2021
TOS,MS,C 22,Fabbricazione di articoli in gomma e materie plastiche      ,0,0,3,0,3,2021
TOS,MS,C 23,Fabbricazione di altri prodotti della lavorazione di miner..,0,0,3,0,3,2021
TOS,MS,C 24,Metallurgia                                                 ,0,0,1,0,1,2021
TOS,MS,C 25,Fabbricazione di prodotti in metallo (esclusi macchinari ...,0,0,15,0,15,2021
TOS,MS,C 26,Fabbricazione di computer e prodotti di elettronica e ott...,0,0,0,0,0,2021
TOS,MS,C 27,Fabbricazione di apparecchiature elettriche ed apparecchi...,0,0,1,0,1,2021
TOS,MS,C 28,Fabbricazione di macchinari ed apparecchiature nca          ,0,0,1,0,1,2021
TOS,MS,C 29,"Fabbricazione di autoveicoli, rimorchi e semirimorchi       ",0,0,0,0,0,2021
TOS,MS,C 30,Fabbricazione di altri mezzi di trasporto                   ,0,0,8,0,8,2021
TOS,MS,C 31,Fabbricazione di mobili                                     ,0,0,0,0,0,2021
TOS,MS,C 32,Altre industrie manifatturiere                              ,0,0,2,0,2,2021
TOS,MS,C 33,"Riparazione, manutenzione ed installazione di macchine ed...",0,0,10,0,10,2021
TOS,MS,D   ,"Fornitura di energia elettrica, gas, vapore e aria condiz...",0,0,0,0,0,2021
TOS,MS,D 35,"Fornitura di energia elettrica, gas, vapore e aria condiz...",0,0,0,0,0,2021
TOS,MS,E   ,"Fornitura di acqua; reti fognarie, attività di gestione d...",0,0,0,0,0,2021
TOS,MS,E 36,"Raccolta, trattamento e fornitura di acqua                  ",0,0,0,0,0,2021
TOS,MS,E 37,Gestione delle reti fognarie                                ,0,0,0,0,0,2021
TOS,MS,E 38,"Attività di raccolta, trattamento e smaltimento dei rifiu...",0,0,0,0,0,2021
TOS,MS,E 39,Attività di risanamento e altri servizi di gestione dei r...,0,0,0,0,0,2021
TOS,MS,F   ,Costruzioni                                                 ,0,0,229,0,229,2021
TOS,MS,F 41,Costruzione di edifici                                      ,0,0,44,0,44,2021
TOS,MS,F 42,Ingegneria civile                                           ,0,0,0,0,0,2021
TOS,MS,F 43,Lavori di costruzione specializzati                         ,0,0,185,0,185,2021
TOS,MS,G   ,Commercio all'ingrosso e al dettaglio; riparazione di aut...,0,0,54,0,54,2021
TOS,MS,G 45,Commercio all'ingrosso e al dettaglio e riparazione di au...,0,0,4,0,4,2021
TOS,MS,G 46,Commercio all'ingrosso (escluso quello di autoveicoli e d...,0,0,8,0,8,2021
TOS,MS,G 47,Commercio al dettaglio (escluso quello di autoveicoli e d...,0,0,42,0,42,2021
TOS,MS,H   ,Trasporto e magazzinaggio                                   ,0,0,18,0,18,2021
TOS,MS,H 49,Trasporto terrestre e mediante condotte                     ,0,0,17,0,17,2021
TOS,MS,H 50,Trasporto marittimo e per vie d'acqua                       ,0,0,0,0,0,2021
TOS,MS,H 51,Trasporto aereo                                             ,0,0,0,0,0,2021
TOS,MS,H 52,Magazzinaggio e attività di supporto ai trasporti           ,0,0,1,0,1,2021
TOS,MS,H 53,Servizi postali e attività di corriere                      ,0,0,0,0,0,2021
TOS,MS,I   ,Attività dei servizi alloggio e ristorazione                ,0,0,14,0,14,2021
TOS,MS,I 55,Alloggio                                                    ,0,0,3,0,3,2021
TOS,MS,I 56,Attività dei servizi di ristorazione                        ,0,0,11,0,11,2021
TOS,MS,J   ,Servizi di informazione e comunicazione                     ,0,0,3,0,3,2021
TOS,MS,J 58,Attività editoriali                                         ,0,0,0,0,0,2021
TOS,MS,J 59,"Attività di produzione cinematografica, di video e di pro...",0,0,2,0,2,2021
TOS,MS,J 60,Attività di programmazione e trasmissione                   ,0,0,0,0,0,2021
TOS,MS,J 61,Telecomunicazioni                                           ,0,0,1,0,1,2021
TOS,MS,J 62,"Produzione di software, consulenza informatica e attività...",0,0,0,0,0,2021
TOS,MS,J 63,Attività dei servizi d'informazione e altri servizi infor...,0,0,0,0,0,2021
TOS,MS,K   ,Attività finanziarie e assicurative                         ,0,0,1,0,1,2021
TOS,MS,K 64,Attività di servizi finanziari (escluse le assicurazioni ...,0,0,0,0,0,2021
TOS,MS,K 65,"Assicurazioni, riassicurazioni e fondi pensione (escluse ...",0,0,0,0,0,2021
TOS,MS,K 66,Attività ausiliarie dei servizi finanziari e delle attivi...,0,0,1,0,1,2021
TOS,MS,L   ,Attivita' immobiliari                                       ,0,0,0,0,0,2021
TOS,MS,L 68,Attivita' immobiliari                                       ,0,0,0,0,0,2021
TOS,MS,M   ,"Attività professionali, scientifiche e tecniche             ",0,0,3,0,3,2021
TOS,MS,M 69,Attività legali e contabilità                               ,0,0,0,0,0,2021
TOS,MS,M 70,Attività di direzione aziendale e di consulenza gestional...,0,0,0,0,0,2021
TOS,MS,M 71,Attività degli studi di architettura e d'ingegneria; coll...,0,0,0,0,0,2021
TOS,MS,M 72,Ricerca scientifica e sviluppo                              ,0,0,0,0,0,2021
TOS,MS,M 73,Pubblicità e ricerche di mercato                            ,0,0,3,0,3,2021
TOS,MS,M 74,"Altre attività professionali, scientifiche e tecniche       ",0,0,0,0,0,2021
TOS,MS,M 75,Servizi veterinari                                          ,0,0,0,0,0,2021
TOS,MS,N   ,"Noleggio, agenzie di viaggio, servizi di supporto alle im...",0,0,5,0,5,2021
TOS,MS,N 77,Attività di noleggio e leasing operativo                    ,0,0,0,0,0,2021
TOS,MS,N 78,"Attività di ricerca, selezione, fornitura di personale      ",0,0,0,0,0,2021
TOS,MS,N 79,"Attività dei servizi delle agenzie di viaggio, dei tour o...",0,0,1,0,1,2021
TOS,MS,N 80,Servizi di vigilanza e investigazione                       ,0,0,0,0,0,2021
TOS,MS,N 81,Attività di servizi per edifici e paesaggio                 ,0,0,3,0,3,2021
TOS,MS,N 82,Attività di supporto per le funzioni d'ufficio e altri se...,0,0,1,0,1,2021
TOS,MS,O   ,Amministrazione pubblica e difesa; assicurazione sociale ...,0,0,0,0,0,2021
TOS,MS,O 84,Amministrazione pubblica e difesa; assicurazione sociale ...,0,0,0,0,0,2021
TOS,MS,P   ,Istruzione                                                  ,0,0,0,0,0,2021
TOS,MS,P 85,Istruzione                                                  ,0,0,0,0,0,2021
TOS,MS,Q   ,Sanita' e assistenza sociale                                ,0,0,0,0,0,2021
TOS,MS,Q 86,Assistenza sanitaria                                        ,0,0,0,0,0,2021
TOS,MS,Q 87,Servizi di assistenza sociale residenziale                  ,0,0,0,0,0,2021
TOS,MS,Q 88,Assistenza sociale non residenziale                         ,0,0,0,0,0,2021
TOS,MS,R   ,"Attività artistiche, sportive, di intrattenimento e diver...",0,0,1,0,1,2021
TOS,MS,R 90,"Attività creative, artistiche e di intrattenimento          ",0,0,0,0,0,2021
TOS,MS,R 91,"Attività di biblioteche, archivi, musei ed altre attività...",0,0,0,0,0,2021
TOS,MS,R 92,"Attività riguardanti le lotterie, le scommesse, le case d...",0,0,0,0,0,2021
TOS,MS,R 93,"Attività sportive, di intrattenimento e di divertimento     ",0,0,1,0,1,2021
TOS,MS,S   ,Altre attività di servizi                                   ,0,0,11,0,11,2021
TOS,MS,S 94,Attività di organizzazioni associative                      ,0,0,0,0,0,2021
TOS,MS,S 95,Riparazione di computer e di beni per uso personale e per...,0,0,5,0,5,2021
TOS,MS,S 96,Altre attività di servizi per la persona                    ,0,0,6,0,6,2021
TOS,MS,T   ,Attività di famiglie e convivenze come datori di lavoro p...,0,0,0,0,0,2021
TOS,MS,T 97,Attività di famiglie e convivenze come datori di lavoro p...,0,0,0,0,0,2021
TOS,MS,T 98,Produzione di beni e servizi indifferenziati per uso prop...,0,0,0,0,0,2021
TOS,MS,U   ,Organizzazioni ed organismi extraterritoriali               ,0,0,0,0,0,2021
TOS,MS,U 99,Organizzazioni ed organismi extraterritoriali               ,0,0,0,0,0,2021
TOS,MS,XX  ,Imprese non classificate                                    ,0,0,0,0,0,2021
TOS,MS,TOT ,TOTALE                                                      ,0,0,398,0,398,2021
TOS,LU,A   ,"Agricoltura, silvicoltura pesca                             ",0,0,0,0,0,2021
TOS,LU,A 01,"Coltivazioni agricole e produzione di prodotti animali, c...",0,0,0,0,0,2021
TOS,LU,A 02,Silvicoltura ed utilizzo di aree forestali                  ,0,0,0,0,0,2021
TOS,LU,A 03,Pesca e acquacoltura                                        ,0,0,0,0,0,2021
TOS,LU,B   ,Estrazione di minerali da cave e miniere                    ,0,0,0,0,0,2021
TOS,LU,B 05,Estrazione di carbone (esclusa torba)                       ,0,0,0,0,0,2021
TOS,LU,B 06,Estraz.di petrolio greggio e di gas naturale                ,0,0,0,0,0,2021
TOS,LU,B 07,Estrazione di minerali metalliferi                          ,0,0,0,0,0,2021
TOS,LU,B 08,Altre attività di estrazione di minerali da cave e miniere  ,0,0,0,0,0,2021
TOS,LU,B 09,Attività dei servizi di supporto all'estrazione             ,0,0,0,0,0,2021
TOS,LU,C   ,Attività manifatturiere                                     ,33,1,7,4,45,2021
TOS,LU,C 10,Industrie alimentari                                        ,2,0,0,1,3,2021
TOS,LU,C 11,Industria delle bevande                                     ,0,0,0,0,0,2021
TOS,LU,C 12,Industria del tabacco                                       ,0,0,0,0,0,2021
TOS,LU,C 13,Industrie tessili                                           ,1,0,0,0,1,2021
TOS,LU,C 14,Confezione di articoli di abbigliamento; confezione di ar...,1,0,0,1,2,2021
TOS,LU,C 15,Fabbricazione di articoli in pelle e simili                 ,4,0,0,1,5,2021
TOS,LU,C 16,Industria del legno e dei prodotti in legno e sughero (es...,1,1,3,0,5,2021
TOS,LU,C 17,Fabbricazione di carta e di prodotti di carta               ,2,0,0,0,2,2021
TOS,LU,C 18,Stampa e riproduzione di supporti registrati                ,0,0,0,0,0,2021
TOS,LU,C 19,Fabbricazione di coke e prodotti derivanti dalla raffinaz...,0,0,0,0,0,2021
TOS,LU,C 20,Fabbricazione di prodotti chimici                           ,0,0,0,0,0,2021
TOS,LU,C 21,Fabbricazione di prodotti farmaceutici di base e di prepa...,0,0,0,0,0,2021
TOS,LU,C 22,Fabbricazione di articoli in gomma e materie plastiche      ,0,0,0,0,0,2021
TOS,LU,C 23,Fabbricazione di altri prodotti della lavorazione di miner..,5,0,1,0,6,2021
TOS,LU,C 24,Metallurgia                                                 ,0,0,1,0,1,2021
TOS,LU,C 25,Fabbricazione di prodotti in metallo (esclusi macchinari ...,3,0,1,0,4,2021
TOS,LU,C 26,Fabbricazione di computer e prodotti di elettronica e ott...,0,0,0,0,0,2021
TOS,LU,C 27,Fabbricazione di apparecchiature elettriche ed apparecchi...,0,0,0,0,0,2021
TOS,LU,C 28,Fabbricazione di macchinari ed apparecchiature nca          ,2,0,0,0,2,2021
TOS,LU,C 29,"Fabbricazione di autoveicoli, rimorchi e semirimorchi       ",0,0,0,0,0,2021
TOS,LU,C 30,Fabbricazione di altri mezzi di trasporto                   ,5,0,0,0,5,2021
TOS,LU,C 31,Fabbricazione di mobili                                     ,4,0,0,0,4,2021
TOS,LU,C 32,Altre industrie manifatturiere                              ,1,0,1,0,2,2021
TOS,LU,C 33,"Riparazione, manutenzione ed installazione di macchine ed...",2,0,0,1,3,2021
TOS,LU,D   ,"Fornitura di energia elettrica, gas, vapore e aria condiz...",2,0,0,0,2,2021
TOS,LU,D 35,"Fornitura di energia elettrica, gas, vapore e aria condiz...",2,0,0,0,2,2021
TOS,LU,E   ,"Fornitura di acqua; reti fognarie, attività di gestione d...",0,0,0,0,0,2021
TOS,LU,E 36,"Raccolta, trattamento e fornitura di acqua                  ",0,0,0,0,0,2021
TOS,LU,E 37,Gestione delle reti fognarie                                ,0,0,0,0,0,2021
TOS,LU,E 38,"Attività di raccolta, trattamento e smaltimento dei rifiu...",0,0,0,0,0,2021
TOS,LU,E 39,Attività di risanamento e altri servizi di gestione dei r...,0,0,0,0,0,2021
TOS,LU,F   ,Costruzioni                                                 ,23,0,23,10,56,2021
TOS,LU,F 41,Costruzione di edifici                                      ,12,0,5,4,21,2021
TOS,LU,F 42,Ingegneria civile                                           ,2,0,0,1,3,2021
TOS,LU,F 43,Lavori di costruzione specializzati                         ,9,0,18,5,32,2021
TOS,LU,G   ,Commercio all'ingrosso e al dettaglio; riparazione di aut...,40,0,2,2,44,2021
TOS,LU,G 45,Commercio all'ingrosso e al dettaglio e riparazione di au...,6,0,1,1,8,2021
TOS,LU,G 46,Commercio all'ingrosso (escluso quello di autoveicoli e d...,16,0,0,0,16,2021
TOS,LU,G 47,Commercio al dettaglio (escluso quello di autoveicoli e d...,18,0,1,1,20,2021
TOS,LU,H   ,Trasporto e magazzinaggio                                   ,1,0,3,1,5,2021
TOS,LU,H 49,Trasporto terrestre e mediante condotte                     ,1,0,3,1,5,2021
TOS,LU,H 50,Trasporto marittimo e per vie d'acqua                       ,0,0,0,0,0,2021
TOS,LU,H 51,Trasporto aereo                                             ,0,0,0,0,0,2021
TOS,LU,H 52,Magazzinaggio e attività di supporto ai trasporti           ,0,0,0,0,0,2021
TOS,LU,H 53,Servizi postali e attività di corriere                      ,0,0,0,0,0,2021
TOS,LU,I   ,Attività dei servizi alloggio e ristorazione                ,24,0,1,1,26,2021
TOS,LU,I 55,Alloggio                                                    ,6,0,0,0,6,2021
TOS,LU,I 56,Attività dei servizi di ristorazione                        ,18,0,1,1,20,2021
TOS,LU,J   ,Servizi di informazione e comunicazione                     ,5,0,1,0,6,2021
TOS,LU,J 58,Attività editoriali                                         ,0,0,0,0,0,2021
TOS,LU,J 59,"Attività di produzione cinematografica, di video e di pro...",1,0,0,0,1,2021
TOS,LU,J 60,Attività di programmazione e trasmissione                   ,0,0,0,0,0,2021
TOS,LU,J 61,Telecomunicazioni                                           ,0,0,0,0,0,2021
TOS,LU,J 62,"Produzione di software, consulenza informatica e attività...",1,0,0,0,1,2021
TOS,LU,J 63,Attività dei servizi d'informazione e altri servizi infor...,3,0,1,0,4,2021
TOS,LU,K   ,Attività finanziarie e assicurative                         ,3,0,0,0,3,2021
TOS,LU,K 64,Attività di servizi finanziari (escluse le assicurazioni ...,1,0,0,0,1,2021
TOS,LU,K 65,"Assicurazioni, riassicurazioni e fondi pensione (escluse ...",0,0,0,0,0,2021
TOS,LU,K 66,Attività ausiliarie dei servizi finanziari e delle attivi...,2,0,0,0,2,2021
TOS,LU,L   ,Attivita' immobiliari                                       ,17,0,0,0,17,2021
TOS,LU,L 68,Attivita' immobiliari                                       ,17,0,0,0,17,2021
TOS,LU,M   ,"Attività professionali, scientifiche e tecniche             ",9,0,1,3,13,2021
TOS,LU,M 69,Attività legali e contabilità                               ,0,0,0,0,0,2021
TOS,LU,M 70,Attività di direzione aziendale e di consulenza gestional...,4,0,0,3,7,2021
TOS,LU,M 71,Attività degli studi di architettura e d'ingegneria; coll...,2,0,0,0,2,2021
TOS,LU,M 72,Ricerca scientifica e sviluppo                              ,0,0,0,0,0,2021
TOS,LU,M 73,Pubblicità e ricerche di mercato                            ,0,0,0,0,0,2021
TOS,LU,M 74,"Altre attività professionali, scientifiche e tecniche       ",3,0,1,0,4,2021
TOS,LU,M 75,Servizi veterinari                                          ,0,0,0,0,0,2021
TOS,LU,N   ,"Noleggio, agenzie di viaggio, servizi di supporto alle im...",5,0,0,3,8,2021
TOS,LU,N 77,Attività di noleggio e leasing operativo                    ,1,0,0,0,1,2021
TOS,LU,N 78,"Attività di ricerca, selezione, fornitura di personale      ",0,0,0,0,0,2021
TOS,LU,N 79,"Attività dei servizi delle agenzie di viaggio, dei tour o...",0,0,0,0,0,2021
TOS,LU,N 80,Servizi di vigilanza e investigazione                       ,1,0,0,0,1,2021
TOS,LU,N 81,Attività di servizi per edifici e paesaggio                 ,3,0,0,2,5,2021
TOS,LU,N 82,Attività di supporto per le funzioni d'ufficio e altri se...,0,0,0,1,1,2021
TOS,LU,O   ,Amministrazione pubblica e difesa; assicurazione sociale ...,0,0,0,0,0,2021
TOS,LU,O 84,Amministrazione pubblica e difesa; assicurazione sociale ...,0,0,0,0,0,2021
TOS,LU,P   ,Istruzione                                                  ,1,0,0,0,1,2021
TOS,LU,P 85,Istruzione                                                  ,1,0,0,0,1,2021
TOS,LU,Q   ,Sanita' e assistenza sociale                                ,2,0,0,1,3,2021
TOS,LU,Q 86,Assistenza sanitaria                                        ,2,0,0,0,2,2021
TOS,LU,Q 87,Servizi di assistenza sociale residenziale                  ,0,0,0,0,0,2021
TOS,LU,Q 88,Assistenza sociale non residenziale                         ,0,0,0,1,1,2021
TOS,LU,R   ,"Attività artistiche, sportive, di intrattenimento e diver...",4,0,0,0,4,2021
TOS,LU,R 90,"Attività creative, artistiche e di intrattenimento          ",0,0,0,0,0,2021
TOS,LU,R 91,"Attività di biblioteche, archivi, musei ed altre attività...",0,0,0,0,0,2021
TOS,LU,R 92,"Attività riguardanti le lotterie, le scommesse, le case d...",1,0,0,0,1,2021
TOS,LU,R 93,"Attività sportive, di intrattenimento e di divertimento     ",3,0,0,0,3,2021
TOS,LU,S   ,Altre attività di servizi                                   ,2,0,0,1,3,2021
TOS,LU,S 94,Attività di organizzazioni associative                      ,0,0,0,0,0,2021
TOS,LU,S 95,Riparazione di computer e di beni per uso personale e per...,0,0,0,0,0,2021
TOS,LU,S 96,Altre attività di servizi per la persona                    ,2,0,0,1,3,2021
TOS,LU,T   ,Attività di famiglie e convivenze come datori di lavoro p...,0,0,0,0,0,2021
TOS,LU,T 97,Attività di famiglie e convivenze come datori di lavoro p...,0,0,0,0,0,2021
TOS,LU,T 98,Produzione di beni e servizi indifferenziati per uso prop...,0,0,0,0,0,2021
TOS,LU,U   ,Organizzazioni ed organismi extraterritoriali               ,0,0,0,0,0,2021
TOS,LU,U 99,Organizzazioni ed organismi extraterritoriali               ,0,0,0,0,0,2021
TOS,LU,XX  ,Imprese non classificate                                    ,20,0,0,1,21,2021
TOS,LU,TOT ,TOTALE                                                      ,191,1,38,27,257,2021
TOS,PT,A   ,"Agricoltura, silvicoltura pesca                             ",0,0,0,0,0,2021
TOS,PT,A 01,"Coltivazioni agricole e produzione di prodotti animali, c...",0,0,0,0,0,2021
TOS,PT,A 02,Silvicoltura ed utilizzo di aree forestali                  ,0,0,0,0,0,2021
TOS,PT,A 03,Pesca e acquacoltura                                        ,0,0,0,0,0,2021
TOS,PT,B   ,Estrazione di minerali da cave e miniere                    ,0,0,0,0,0,2021
TOS,PT,B 05,Estrazione di carbone (esclusa torba)                       ,0,0,0,0,0,2021
TOS,PT,B 06,Estraz.di petrolio greggio e di gas naturale                ,0,0,0,0,0,2021
TOS,PT,B 07,Estrazione di minerali metalliferi                          ,0,0,0,0,0,2021
TOS,PT,B 08,Altre attività di estrazione di minerali da cave e miniere  ,0,0,0,0,0,2021
TOS,PT,B 09,Attività dei servizi di supporto all'estrazione             ,0,0,0,0,0,2021
TOS,PT,C   ,Attività manifatturiere                                     ,0,0,0,0,0,2021
TOS,PT,C 10,Industrie alimentari                                        ,0,0,0,0,0,2021
TOS,PT,C 11,Industria delle bevande                                     ,0,0,0,0,0,2021
TOS,PT,C 12,Industria del tabacco                                       ,0,0,0,0,0,2021
TOS,PT,C 13,Industrie tessili                                           ,0,0,0,0,0,2021
TOS,PT,C 14,Confezione di articoli di abbigliamento; confezione di ar...,0,0,0,0,0,2021
TOS,PT,C 15,Fabbricazione di articoli in pelle e simili                 ,0,0,0,0,0,2021
TOS,PT,C 16,Industria del legno e dei prodotti in legno e sughero (es...,0,0,0,0,0,2021
TOS,PT,C 17,Fabbricazione di carta e di prodotti di carta               ,0,0,0,0,0,2021
TOS,PT,C 18,Stampa e riproduzione di supporti registrati                ,0,0,0,0,0,2021
TOS,PT,C 19,Fabbricazione di coke e prodotti derivanti dalla raffinaz...,0,0,0,0,0,2021
TOS,PT,C 20,Fabbricazione di prodotti chimici                           ,0,0,0,0,0,2021
TOS,PT,C 21,Fabbricazione di prodotti farmaceutici di base e di prepa...,0,0,0,0,0,2021
TOS,PT,C 22,Fabbricazione di articoli in gomma e materie plastiche      ,0,0,0,0,0,2021
TOS,PT,C 23,Fabbricazione di altri prodotti della lavorazione di miner..,0,0,0,0,0,2021
TOS,PT,C 24,Metallurgia                                                 ,0,0,0,0,0,2021
TOS,PT,C 25,Fabbricazione di prodotti in metallo (esclusi macchinari ...,0,0,0,0,0,2021
TOS,PT,C 26,Fabbricazione di computer e prodotti di elettronica e ott...,0,0,0,0,0,2021
TOS,PT,C 27,Fabbricazione di apparecchiature elettriche ed apparecchi...,0,0,0,0,0,2021
TOS,PT,C 28,Fabbricazione di macchinari ed apparecchiature nca          ,0,0,0,0,0,2021
TOS,PT,C 29,"Fabbricazione di autoveicoli, rimorchi e semirimorchi       ",0,0,0,0,0,2021
TOS,PT,C 30,Fabbricazione di altri mezzi di trasporto                   ,0,0,0,0,0,2021
TOS,PT,C 31,Fabbricazione di mobili                                     ,0,0,0,0,0,2021
TOS,PT,C 32,Altre industrie manifatturiere                              ,0,0,0,0,0,2021
TOS,PT,C 33,"Riparazione, manutenzione ed installazione di macchine ed...",0,0,0,0,0,2021
TOS,PT,D   ,"Fornitura di energia elettrica, gas, vapore e aria condiz...",0,0,0,0,0,2021
TOS,PT,D 35,"Fornitura di energia elettrica, gas, vapore e aria condiz...",0,0,0,0,0,2021
TOS,PT,E   ,"Fornitura di acqua; reti fognarie, attività di gestione d...",0,0,0,0,0,2021
TOS,PT,E 36,"Raccolta, trattamento e fornitura di acqua                  ",0,0,0,0,0,2021
TOS,PT,E 37,Gestione delle reti fognarie                                ,0,0,0,0,0,2021
TOS,PT,E 38,"Attività di raccolta, trattamento e smaltimento dei rifiu...",0,0,0,0,0,2021
TOS,PT,E 39,Attività di risanamento e altri servizi di gestione dei r...,0,0,0,0,0,2021
TOS,PT,F   ,Costruzioni                                                 ,0,0,0,0,0,2021
TOS,PT,F 41,Costruzione di edifici                                      ,0,0,0,0,0,2021
TOS,PT,F 42,Ingegneria civile                                           ,0,0,0,0,0,2021
TOS,PT,F 43,Lavori di costruzione specializzati                         ,0,0,0,0,0,2021
TOS,PT,G   ,Commercio all'ingrosso e al dettaglio; riparazione di aut...,0,0,0,0,0,2021
TOS,PT,G 45,Commercio all'ingrosso e al dettaglio e riparazione di au...,0,0,0,0,0,2021
TOS,PT,G 46,Commercio all'ingrosso (escluso quello di autoveicoli e d...,0,0,0,0,0,2021
TOS,PT,G 47,Commercio al dettaglio (escluso quello di autoveicoli e d...,0,0,0,0,0,2021
TOS,PT,H   ,Trasporto e magazzinaggio                                   ,0,0,0,0,0,2021
TOS,PT,H 49,Trasporto terrestre e mediante condotte                     ,0,0,0,0,0,2021
TOS,PT,H 50,Trasporto marittimo e per vie d'acqua                       ,0,0,0,0,0,2021
TOS,PT,H 51,Trasporto aereo                                             ,0,0,0,0,0,2021
TOS,PT,H 52,Magazzinaggio e attività di supporto ai trasporti           ,0,0,0,0,0,2021
TOS,PT,H 53,Servizi postali e attività di corriere                      ,0,0,0,0,0,2021
TOS,PT,I   ,Attività dei servizi alloggio e ristorazione                ,0,0,0,0,0,2021
TOS,PT,I 55,Alloggio                                                    ,0,0,0,0,0,2021
TOS,PT,I 56,Attività dei servizi di ristorazione                        ,0,0,0,0,0,2021
TOS,PT,J   ,Servizi di informazione e comunicazione                     ,0,0,0,0,0,2021
TOS,PT,J 58,Attività editoriali                                         ,0,0,0,0,0,2021
TOS,PT,J 59,"Attività di produzione cinematografica, di video e di pro...",0,0,0,0,0,2021
TOS,PT,J 60,Attività di programmazione e trasmissione                   ,0,0,0,0,0,2021
TOS,PT,J 61,Telecomunicazioni                                           ,0,0,0,0,0,2021
TOS,PT,J 62,"Produzione di software, consulenza informatica e attività...",0,0,0,0,0,2021
TOS,PT,J 63,Attività dei servizi d'informazione e altri servizi infor...,0,0,0,0,0,2021
TOS,PT,K   ,Attività finanziarie e assicurative                         ,0,0,0,0,0,2021
TOS,PT,K 64,Attività di servizi finanziari (escluse le assicurazioni ...,0,0,0,0,0,2021
TOS,PT,K 65,"Assicurazioni, riassicurazioni e fondi pensione (escluse ...",0,0,0,0,0,2021
TOS,PT,K 66,Attività ausiliarie dei servizi finanziari e delle attivi...,0,0,0,0,0,2021
TOS,PT,L   ,Attivita' immobiliari                                       ,0,0,0,0,0,2021
TOS,PT,L 68,Attivita' immobiliari                                       ,0,0,0,0,0,2021
TOS,PT,M   ,"Attività professionali, scientifiche e tecniche             ",0,0,0,0,0,2021
TOS,PT,M 69,Attività legali e contabilità                               ,0,0,0,0,0,2021
TOS,PT,M 70,Attività di direzione aziendale e di consulenza gestional...,0,0,0,0,0,2021
TOS,PT,M 71,Attività degli studi di architettura e d'ingegneria; coll...,0,0,0,0,0,2021
TOS,PT,M 72,Ricerca scientifica e sviluppo                              ,0,0,0,0,0,2021
TOS,PT,M 73,Pubblicità e ricerche di mercato                            ,0,0,0,0,0,2021
TOS,PT,M 74,"Altre attività professionali, scientifiche e tecniche       ",0,0,0,0,0,2021
TOS,PT,M 75,Servizi veterinari                                          ,0,0,0,0,0,2021
TOS,PT,N   ,"Noleggio, agenzie di viaggio, servizi di supporto alle im...",0,0,0,0,0,2021
TOS,PT,N 77,Attività di noleggio e leasing operativo                    ,0,0,0,0,0,2021
TOS,PT,N 78,"Attività di ricerca, selezione, fornitura di personale      ",0,0,0,0,0,2021
TOS,PT,N 79,"Attività dei servizi delle agenzie di viaggio, dei tour o...",0,0,0,0,0,2021
TOS,PT,N 80,Servizi di vigilanza e investigazione                       ,0,0,0,0,0,2021
TOS,PT,N 81,Attività di servizi per edifici e paesaggio                 ,0,0,0,0,0,2021
TOS,PT,N 82,Attività di supporto per le funzioni d'ufficio e altri se...,0,0,0,0,0,2021
TOS,PT,O   ,Amministrazione pubblica e difesa; assicurazione sociale ...,0,0,0,0,0,2021
TOS,PT,O 84,Amministrazione pubblica e difesa; assicurazione sociale ...,0,0,0,0,0,2021
TOS,PT,P   ,Istruzione                                                  ,0,0,0,0,0,2021
TOS,PT,P 85,Istruzione                                                  ,0,0,0,0,0,2021
TOS,PT,Q   ,Sanita' e assistenza sociale                                ,0,0,0,0,0,2021
TOS,PT,Q 86,Assistenza sanitaria                                        ,0,0,0,0,0,2021
TOS,PT,Q 87,Servizi di assistenza sociale residenziale                  ,0,0,0,0,0,2021
TOS,PT,Q 88,Assistenza sociale non residenziale                         ,0,0,0,0,0,2021
TOS,PT,R   ,"Attività artistiche, sportive, di intrattenimento e diver...",0,0,0,0,0,2021
TOS,PT,R 90,"Attività creative, artistiche e di intrattenimento          ",0,0,0,0,0,2021
TOS,PT,R 91,"Attività di biblioteche, archivi, musei ed altre attività...",0,0,0,0,0,2021
TOS,PT,R 92,"Attività riguardanti le lotterie, le scommesse, le case d...",0,0,0,0,0,2021
TOS,PT,R 93,"Attività sportive, di intrattenimento e di divertimento     ",0,0,0,0,0,2021
TOS,PT,S   ,Altre attività di servizi                                   ,0,0,0,0,0,2021
TOS,PT,S 94,Attività di organizzazioni associative                      ,0,0,0,0,0,2021
TOS,PT,S 95,Riparazione di computer e di beni per uso personale e per...,0,0,0,0,0,2021
TOS,PT,S 96,Altre attività di servizi per la persona                    ,0,0,0,0,0,2021
TOS,PT,T   ,Attività di famiglie e convivenze come datori di lavoro p...,0,0,0,0,0,2021
TOS,PT,T 97,Attività di famiglie e convivenze come datori di lavoro p...,0,0,0,0,0,2021
TOS,PT,T 98,Produzione di beni e servizi indifferenziati per uso prop...,0,0,0,0,0,2021
TOS,PT,U   ,Organizzazioni ed organismi extraterritoriali               ,0,0,0,0,0,2021
TOS,PT,U 99,Organizzazioni ed organismi extraterritoriali               ,0,0,0,0,0,2021
TOS,PT,XX  ,Imprese non classificate                                    ,0,0,0,0,0,2021
TOS,PT,TOT ,TOTALE                                                      ,0,0,0,0,0,2021
TOS,FI,A   ,"Agricoltura, silvicoltura pesca                             ",0,0,90,0,90,2021
TOS,FI,A 01,"Coltivazioni agricole e produzione di prodotti animali, c...",0,0,86,0,86,2021
TOS,FI,A 02,Silvicoltura ed utilizzo di aree forestali                  ,0,0,4,0,4,2021
TOS,FI,A 03,Pesca e acquacoltura                                        ,0,0,0,0,0,2021
TOS,FI,B   ,Estrazione di minerali da cave e miniere                    ,0,0,0,0,0,2021
TOS,FI,B 05,Estrazione di carbone (esclusa torba)                       ,0,0,0,0,0,2021
TOS,FI,B 06,Estraz.di petrolio greggio e di gas naturale                ,0,0,0,0,0,2021
TOS,FI,B 07,Estrazione di minerali metalliferi                          ,0,0,0,0,0,2021
TOS,FI,B 08,Altre attività di estrazione di minerali da cave e miniere  ,0,0,0,0,0,2021
TOS,FI,B 09,Attività dei servizi di supporto all'estrazione             ,0,0,0,0,0,2021
TOS,FI,C   ,Attività manifatturiere                                     ,2,0,287,0,289,2021
TOS,FI,C 10,Industrie alimentari                                        ,0,0,5,0,5,2021
TOS,FI,C 11,Industria delle bevande                                     ,0,0,0,0,0,2021
TOS,FI,C 12,Industria del tabacco                                       ,0,0,0,0,0,2021
TOS,FI,C 13,Industrie tessili                                           ,0,0,6,0,6,2021
TOS,FI,C 14,Confezione di articoli di abbigliamento; confezione di ar...,0,0,62,0,62,2021
TOS,FI,C 15,Fabbricazione di articoli in pelle e simili                 ,1,0,125,0,126,2021
TOS,FI,C 16,Industria del legno e dei prodotti in legno e sughero (es...,0,0,16,0,16,2021
TOS,FI,C 17,Fabbricazione di carta e di prodotti di carta               ,0,0,1,0,1,2021
TOS,FI,C 18,Stampa e riproduzione di supporti registrati                ,0,0,4,0,4,2021
TOS,FI,C 19,Fabbricazione di coke e prodotti derivanti dalla raffinaz...,0,0,0,0,0,2021
TOS,FI,C 20,Fabbricazione di prodotti chimici                           ,0,0,0,0,0,2021
TOS,FI,C 21,Fabbricazione di prodotti farmaceutici di base e di prepa...,0,0,0,0,0,2021
TOS,FI,C 22,Fabbricazione di articoli in gomma e materie plastiche      ,0,0,2,0,2,2021
TOS,FI,C 23,Fabbricazione di altri prodotti della lavorazione di miner..,1,0,5,0,6,2021
TOS,FI,C 24,Metallurgia                                                 ,0,0,0,0,0,2021
TOS,FI,C 25,Fabbricazione di prodotti in metallo (esclusi macchinari ...,0,0,19,0,19,2021
TOS,FI,C 26,Fabbricazione di computer e prodotti di elettronica e ott...,0,0,2,0,2,2021
TOS,FI,C 27,Fabbricazione di apparecchiature elettriche ed apparecchi...,0,0,2,0,2,2021
TOS,FI,C 28,Fabbricazione di macchinari ed apparecchiature nca          ,0,0,7,0,7,2021
TOS,FI,C 29,"Fabbricazione di autoveicoli, rimorchi e semirimorchi       ",0,0,0,0,0,2021
TOS,FI,C 30,Fabbricazione di altri mezzi di trasporto                   ,0,0,1,0,1,2021
TOS,FI,C 31,Fabbricazione di mobili                                     ,0,0,7,0,7,2021
TOS,FI,C 32,Altre industrie manifatturiere                              ,0,0,19,0,19,2021
TOS,FI,C 33,"Riparazione, manutenzione ed installazione di macchine ed...",0,0,4,0,4,2021
TOS,FI,D   ,"Fornitura di energia elettrica, gas, vapore e aria condiz...",0,0,1,0,1,2021
TOS,FI,D 35,"Fornitura di energia elettrica, gas, vapore e aria condiz...",0,0,1,0,1,2021
TOS,FI,E   ,"Fornitura di acqua; reti fognarie, attività di gestione d...",0,0,1,0,1,2021
TOS,FI,E 36,"Raccolta, trattamento e fornitura di acqua                  ",0,0,0,0,0,2021
TOS,FI,E 37,Gestione delle reti fognarie                                ,0,0,0,0,0,2021
TOS,FI,E 38,"Attività di raccolta, trattamento e smaltimento dei rifiu...",0,0,1,0,1,2021
TOS,FI,E 39,Attività di risanamento e altri servizi di gestione dei r...,0,0,0,0,0,2021
TOS,FI,F   ,Costruzioni                                                 ,1,1,997,0,999,2021
TOS,FI,F 41,Costruzione di edifici                                      ,1,0,119,0,120,2021
TOS,FI,F 42,Ingegneria civile                                           ,0,0,3,0,3,2021
TOS,FI,F 43,Lavori di costruzione specializzati                         ,0,1,875,0,876,2021
TOS,FI,G   ,Commercio all'ingrosso e al dettaglio; riparazione di aut...,2,7,614,0,623,2021
TOS,FI,G 45,Commercio all'ingrosso e al dettaglio e riparazione di au...,0,0,31,0,31,2021
TOS,FI,G 46,Commercio all'ingrosso (escluso quello di autoveicoli e d...,0,1,211,0,212,2021
TOS,FI,G 47,Commercio al dettaglio (escluso quello di autoveicoli e d...,2,6,372,0,380,2021
TOS,FI,H   ,Trasporto e magazzinaggio                                   ,0,0,94,0,94,2021
TOS,FI,H 49,Trasporto terrestre e mediante condotte                     ,0,0,84,0,84,2021
TOS,FI,H 50,Trasporto marittimo e per vie d'acqua                       ,0,0,0,0,0,2021
TOS,FI,H 51,Trasporto aereo                                             ,0,0,0,0,0,2021
TOS,FI,H 52,Magazzinaggio e attività di supporto ai trasporti           ,0,0,6,0,6,2021
TOS,FI,H 53,Servizi postali e attività di corriere                      ,0,0,4,0,4,2021
TOS,FI,I   ,Attività dei servizi alloggio e ristorazione                ,0,3,62,0,65,2021
TOS,FI,I 55,Alloggio                                                    ,0,1,7,0,8,2021
TOS,FI,I 56,Attività dei servizi di ristorazione                        ,0,2,55,0,57,2021
TOS,FI,J   ,Servizi di informazione e comunicazione                     ,1,0,41,0,42,2021
TOS,FI,J 58,Attività editoriali                                         ,0,0,3,0,3,2021
TOS,FI,J 59,"Attività di produzione cinematografica, di video e di pro...",0,0,2,0,2,2021
TOS,FI,J 60,Attività di programmazione e trasmissione                   ,1,0,0,0,1,2021
TOS,FI,J 61,Telecomunicazioni                                           ,0,0,17,0,17,2021
TOS,FI,J 62,"Produzione di software, consulenza informatica e attività...",0,0,11,0,11,2021
TOS,FI,J 63,Attività dei servizi d'informazione e altri servizi infor...,0,0,8,0,8,2021
TOS,FI,K   ,Attività finanziarie e assicurative                         ,1,1,8,0,10,2021
TOS,FI,K 64,Attività di servizi finanziari (escluse le assicurazioni ...,1,0,0,0,1,2021
TOS,FI,K 65,"Assicurazioni, riassicurazioni e fondi pensione (escluse ...",0,0,0,0,0,2021
TOS,FI,K 66,Attività ausiliarie dei servizi finanziari e delle attivi...,0,1,8,0,9,2021
TOS,FI,L   ,Attivita' immobiliari                                       ,1,1,14,0,16,2021
TOS,FI,L 68,Attivita' immobiliari                                       ,1,1,14,0,16,2021
TOS,FI,M   ,"Attività professionali, scientifiche e tecniche             ",0,0,42,0,42,2021
TOS,FI,M 69,Attività legali e contabilità                               ,0,0,0,0,0,2021
TOS,FI,M 70,Attività di direzione aziendale e di consulenza gestional...,0,0,2,0,2,2021
TOS,FI,M 71,Attività degli studi di architettura e d'ingegneria; coll...,0,0,4,0,4,2021
TOS,FI,M 72,Ricerca scientifica e sviluppo                              ,0,0,1,0,1,2021
TOS,FI,M 73,Pubblicità e ricerche di mercato                            ,0,0,17,0,17,2021
TOS,FI,M 74,"Altre attività professionali, scientifiche e tecniche       ",0,0,18,0,18,2021
TOS,FI,M 75,Servizi veterinari                                          ,0,0,0,0,0,2021
TOS,FI,N   ,"Noleggio, agenzie di viaggio, servizi di supporto alle im...",0,0,67,0,67,2021
TOS,FI,N 77,Attività di noleggio e leasing operativo                    ,0,0,8,0,8,2021
TOS,FI,N 78,"Attività di ricerca, selezione, fornitura di personale      ",0,0,0,0,0,2021
TOS,FI,N 79,"Attività dei servizi delle agenzie di viaggio, dei tour o...",0,0,3,0,3,2021
TOS,FI,N 80,Servizi di vigilanza e investigazione                       ,0,0,1,0,1,2021
TOS,FI,N 81,Attività di servizi per edifici e paesaggio                 ,0,0,28,0,28,2021
TOS,FI,N 82,Attività di supporto per le funzioni d'ufficio e altri se...,0,0,27,0,27,2021
TOS,FI,O   ,Amministrazione pubblica e difesa; assicurazione sociale ...,0,0,0,0,0,2021
TOS,FI,O 84,Amministrazione pubblica e difesa; assicurazione sociale ...,0,0,0,0,0,2021
TOS,FI,P   ,Istruzione                                                  ,0,0,3,0,3,2021
TOS,FI,P 85,Istruzione                                                  ,0,0,3,0,3,2021
TOS,FI,Q   ,Sanita' e assistenza sociale                                ,0,0,0,0,0,2021
TOS,FI,Q 86,Assistenza sanitaria                                        ,0,0,0,0,0,2021
TOS,FI,Q 87,Servizi di assistenza sociale residenziale                  ,0,0,0,0,0,2021
TOS,FI,Q 88,Assistenza sociale non residenziale                         ,0,0,0,0,0,2021
TOS,FI,R   ,"Attività artistiche, sportive, di intrattenimento e diver...",0,0,19,0,19,2021
TOS,FI,R 90,"Attività creative, artistiche e di intrattenimento          ",0,0,11,0,11,2021
TOS,FI,R 91,"Attività di biblioteche, archivi, musei ed altre attività...",0,0,1,0,1,2021
TOS,FI,R 92,"Attività riguardanti le lotterie, le scommesse, le case d...",0,0,0,0,0,2021
TOS,FI,R 93,"Attività sportive, di intrattenimento e di divertimento     ",0,0,7,0,7,2021
TOS,FI,S   ,Altre attività di servizi                                   ,0,0,43,0,43,2021
TOS,FI,S 94,Attività di organizzazioni associative                      ,0,0,0,0,0,2021
TOS,FI,S 95,Riparazione di computer e di beni per uso personale e per...,0,0,18,0,18,2021
TOS,FI,S 96,Altre attività di servizi per la persona                    ,0,0,25,0,25,2021
TOS,FI,T   ,Attività di famiglie e convivenze come datori di lavoro p...,0,0,0,0,0,2021
TOS,FI,T 97,Attività di famiglie e convivenze come datori di lavoro p...,0,0,0,0,0,2021
TOS,FI,T 98,Produzione di beni e servizi indifferenziati per uso prop...,0,0,0,0,0,2021
TOS,FI,U   ,Organizzazioni ed organismi extraterritoriali               ,0,0,0,0,0,2021
TOS,FI,U 99,Organizzazioni ed organismi extraterritoriali               ,0,0,0,0,0,2021
TOS,FI,XX  ,Imprese non classificate                                    ,1,2,1,0,4,2021
TOS,FI,TOT ,TOTALE                                                      ,9,15,2384,0,2408,2021
TOS,LI,A   ,"Agricoltura, silvicoltura pesca                             ",1,0,0,0,1,2021
TOS,LI,A 01,"Coltivazioni agricole e produzione di prodotti animali, c...",0,0,0,0,0,2021
TOS,LI,A 02,Silvicoltura ed utilizzo di aree forestali                  ,1,0,0,0,1,2021
TOS,LI,A 03,Pesca e acquacoltura                                        ,0,0,0,0,0,2021
TOS,LI,B   ,Estrazione di minerali da cave e miniere                    ,0,0,0,0,0,2021
TOS,LI,B 05,Estrazione di carbone (esclusa torba)                       ,0,0,0,0,0,2021
TOS,LI,B 06,Estraz.di petrolio greggio e di gas naturale                ,0,0,0,0,0,2021
TOS,LI,B 07,Estrazione di minerali metalliferi                          ,0,0,0,0,0,2021
TOS,LI,B 08,Altre attività di estrazione di minerali da cave e miniere  ,0,0,0,0,0,2021
TOS,LI,B 09,Attività dei servizi di supporto all'estrazione             ,0,0,0,0,0,2021
TOS,LI,C   ,Attività manifatturiere                                     ,31,2,2,1,36,2021
TOS,LI,C 10,Industrie alimentari                                        ,0,0,0,0,0,2021
TOS,LI,C 11,Industria delle bevande                                     ,0,0,0,0,0,2021
TOS,LI,C 12,Industria del tabacco                                       ,0,0,0,0,0,2021
TOS,LI,C 13,Industrie tessili                                           ,2,0,0,0,2,2021
TOS,LI,C 14,Confezione di articoli di abbigliamento; confezione di ar...,0,0,0,0,0,2021
TOS,LI,C 15,Fabbricazione di articoli in pelle e simili                 ,0,0,0,0,0,2021
TOS,LI,C 16,Industria del legno e dei prodotti in legno e sughero (es...,0,0,0,0,0,2021
TOS,LI,C 17,Fabbricazione di carta e di prodotti di carta               ,0,0,0,0,0,2021
TOS,LI,C 18,Stampa e riproduzione di supporti registrati                ,3,0,0,0,3,2021
TOS,LI,C 19,Fabbricazione di coke e prodotti derivanti dalla raffinaz...,0,0,0,0,0,2021
TOS,LI,C 20,Fabbricazione di prodotti chimici                           ,0,1,0,0,1,2021
TOS,LI,C 21,Fabbricazione di prodotti farmaceutici di base e di prepa...,0,0,0,0,0,2021
TOS,LI,C 22,Fabbricazione di articoli in gomma e materie plastiche      ,3,0,0,0,3,2021
TOS,LI,C 23,Fabbricazione di altri prodotti della lavorazione di miner..,1,0,0,0,1,2021
TOS,LI,C 24,Metallurgia                                                 ,0,0,0,0,0,2021
TOS,LI,C 25,Fabbricazione di prodotti in metallo (esclusi macchinari ...,16,0,1,0,17,2021
TOS,LI,C 26,Fabbricazione di computer e prodotti di elettronica e ott...,1,0,0,0,1,2021
TOS,LI,C 27,Fabbricazione di apparecchiature elettriche ed apparecchi...,0,0,0,0,0,2021
TOS,LI,C 28,Fabbricazione di macchinari ed apparecchiature nca          ,1,0,0,0,1,2021
TOS,LI,C 29,"Fabbricazione di autoveicoli, rimorchi e semirimorchi       ",1,0,0,0,1,2021
TOS,LI,C 30,Fabbricazione di altri mezzi di trasporto                   ,2,1,0,0,3,2021
TOS,LI,C 31,Fabbricazione di mobili                                     ,0,0,0,0,0,2021
TOS,LI,C 32,Altre industrie manifatturiere                              ,1,0,1,0,2,2021
TOS,LI,C 33,"Riparazione, manutenzione ed installazione di macchine ed...",0,0,0,1,1,2021
TOS,LI,D   ,"Fornitura di energia elettrica, gas, vapore e aria condiz...",1,0,0,0,1,2021
TOS,LI,D 35,"Fornitura di energia elettrica, gas, vapore e aria condiz...",1,0,0,0,1,2021
TOS,LI,E   ,"Fornitura di acqua; reti fognarie, attività di gestione d...",4,0,0,0,4,2021
TOS,LI,E 36,"Raccolta, trattamento e fornitura di acqua                  ",0,0,0,0,0,2021
TOS,LI,E 37,Gestione delle reti fognarie                                ,1,0,0,0,1,2021
TOS,LI,E 38,"Attività di raccolta, trattamento e smaltimento dei rifiu...",3,0,0,0,3,2021
TOS,LI,E 39,Attività di risanamento e altri servizi di gestione dei r...,0,0,0,0,0,2021
TOS,LI,F   ,Costruzioni                                                 ,45,1,9,1,56,2021
TOS,LI,F 41,Costruzione di edifici                                      ,29,0,4,0,33,2021
TOS,LI,F 42,Ingegneria civile                                           ,0,0,0,1,1,2021
TOS,LI,F 43,Lavori di costruzione specializzati                         ,16,1,5,0,22,2021
TOS,LI,G   ,Commercio all'ingrosso e al dettaglio; riparazione di aut...,56,2,4,0,62,2021
TOS,LI,G 45,Commercio all'ingrosso e al dettaglio e riparazione di au...,7,0,0,0,7,2021
TOS,LI,G 46,Commercio all'ingrosso (escluso quello di autoveicoli e d...,21,0,0,0,21,2021
TOS,LI,G 47,Commercio al dettaglio (escluso quello di autoveicoli e d...,28,2,4,0,34,2021
TOS,LI,H   ,Trasporto e magazzinaggio                                   ,15,0,3,0,18,2021
TOS,LI,H 49,Trasporto terrestre e mediante condotte                     ,7,0,1,0,8,2021
TOS,LI,H 50,Trasporto marittimo e per vie d'acqua                       ,0,0,0,0,0,2021
TOS,LI,H 51,Trasporto aereo                                             ,0,0,0,0,0,2021
TOS,LI,H 52,Magazzinaggio e attività di supporto ai trasporti           ,7,0,1,0,8,2021
TOS,LI,H 53,Servizi postali e attività di corriere                      ,1,0,1,0,2,2021
TOS,LI,I   ,Attività dei servizi alloggio e ristorazione                ,32,1,1,0,34,2021
TOS,LI,I 55,Alloggio                                                    ,5,0,0,0,5,2021
TOS,LI,I 56,Attività dei servizi di ristorazione                        ,27,1,1,0,29,2021
TOS,LI,J   ,Servizi di informazione e comunicazione                     ,9,0,1,0,10,2021
TOS,LI,J 58,Attività editoriali                                         ,2,0,0,0,2,2021
TOS,LI,J 59,"Attività di produzione cinematografica, di video e di pro...",1,0,0,0,1,2021
TOS,LI,J 60,Attività di programmazione e trasmissione                   ,0,0,0,0,0,2021
TOS,LI,J 61,Telecomunicazioni                                           ,3,0,1,0,4,2021
TOS,LI,J 62,"Produzione di software, consulenza informatica e attività...",2,0,0,0,2,2021
TOS,LI,J 63,Attività dei servizi d'informazione e altri servizi infor...,1,0,0,0,1,2021
TOS,LI,K   ,Attività finanziarie e assicurative                         ,2,0,0,0,2,2021
TOS,LI,K 64,Attività di servizi finanziari (escluse le assicurazioni ...,0,0,0,0,0,2021
TOS,LI,K 65,"Assicurazioni, riassicurazioni e fondi pensione (escluse ...",0,0,0,0,0,2021
TOS,LI,K 66,Attività ausiliarie dei servizi finanziari e delle attivi...,2,0,0,0,2,2021
TOS,LI,L   ,Attivita' immobiliari                                       ,22,1,0,0,23,2021
TOS,LI,L 68,Attivita' immobiliari                                       ,22,1,0,0,23,2021
TOS,LI,M   ,"Attività professionali, scientifiche e tecniche             ",13,0,0,0,13,2021
TOS,LI,M 69,Attività legali e contabilità                               ,0,0,0,0,0,2021
TOS,LI,M 70,Attività di direzione aziendale e di consulenza gestional...,1,0,0,0,1,2021
TOS,LI,M 71,Attività degli studi di architettura e d'ingegneria; coll...,3,0,0,0,3,2021
TOS,LI,M 72,Ricerca scientifica e sviluppo                              ,0,0,0,0,0,2021
TOS,LI,M 73,Pubblicità e ricerche di mercato                            ,6,0,0,0,6,2021
TOS,LI,M 74,"Altre attività professionali, scientifiche e tecniche       ",3,0,0,0,3,2021
TOS,LI,M 75,Servizi veterinari                                          ,0,0,0,0,0,2021
TOS,LI,N   ,"Noleggio, agenzie di viaggio, servizi di supporto alle im...",17,0,1,0,18,2021
TOS,LI,N 77,Attività di noleggio e leasing operativo                    ,2,0,0,0,2,2021
TOS,LI,N 78,"Attività di ricerca, selezione, fornitura di personale      ",0,0,0,0,0,2021
TOS,LI,N 79,"Attività dei servizi delle agenzie di viaggio, dei tour o...",4,0,0,0,4,2021
TOS,LI,N 80,Servizi di vigilanza e investigazione                       ,0,0,0,0,0,2021
TOS,LI,N 81,Attività di servizi per edifici e paesaggio                 ,5,0,0,0,5,2021
TOS,LI,N 82,Attività di supporto per le funzioni d'ufficio e altri se...,6,0,1,0,7,2021
TOS,LI,O   ,Amministrazione pubblica e difesa; assicurazione sociale ...,0,0,0,0,0,2021
TOS,LI,O 84,Amministrazione pubblica e difesa; assicurazione sociale ...,0,0,0,0,0,2021
TOS,LI,P   ,Istruzione                                                  ,6,0,0,0,6,2021
TOS,LI,P 85,Istruzione                                                  ,6,0,0,0,6,2021
TOS,LI,Q   ,Sanita' e assistenza sociale                                ,2,0,0,0,2,2021
TOS,LI,Q 86,Assistenza sanitaria                                        ,0,0,0,0,0,2021
TOS,LI,Q 87,Servizi di assistenza sociale residenziale                  ,0,0,0,0,0,2021
TOS,LI,Q 88,Assistenza sociale non residenziale                         ,2,0,0,0,2,2021
TOS,LI,R   ,"Attività artistiche, sportive, di intrattenimento e diver...",9,0,1,0,10,2021
TOS,LI,R 90,"Attività creative, artistiche e di intrattenimento          ",1,0,1,0,2,2021
TOS,LI,R 91,"Attività di biblioteche, archivi, musei ed altre attività...",0,0,0,0,0,2021
TOS,LI,R 92,"Attività riguardanti le lotterie, le scommesse, le case d...",0,0,0,0,0,2021
TOS,LI,R 93,"Attività sportive, di intrattenimento e di divertimento     ",8,0,0,0,8,2021
TOS,LI,S   ,Altre attività di servizi                                   ,3,0,1,0,4,2021
TOS,LI,S 94,Attività di organizzazioni associative                      ,0,0,0,0,0,2021
TOS,LI,S 95,Riparazione di computer e di beni per uso personale e per...,0,0,0,0,0,2021
TOS,LI,S 96,Altre attività di servizi per la persona                    ,3,0,1,0,4,2021
TOS,LI,T   ,Attività di famiglie e convivenze come datori di lavoro p...,0,0,0,0,0,2021
TOS,LI,T 97,Attività di famiglie e convivenze come datori di lavoro p...,0,0,0,0,0,2021
TOS,LI,T 98,Produzione di beni e servizi indifferenziati per uso prop...,0,0,0,0,0,2021
TOS,LI,U   ,Organizzazioni ed organismi extraterritoriali               ,0,0,0,0,0,2021
TOS,LI,U 99,Organizzazioni ed organismi extraterritoriali               ,0,0,0,0,0,2021
TOS,LI,XX  ,Imprese non classificate                                    ,73,1,0,0,74,2021
TOS,LI,TOT ,TOTALE                                                      ,341,8,23,2,374,2021
TOS,PI,A   ,"Agricoltura, silvicoltura pesca                             ",0,8,1,0,9,2021
TOS,PI,A 01,"Coltivazioni agricole e produzione di prodotti animali, c...",0,7,1,0,8,2021
TOS,PI,A 02,Silvicoltura ed utilizzo di aree forestali                  ,0,1,0,0,1,2021
TOS,PI,A 03,Pesca e acquacoltura                                        ,0,0,0,0,0,2021
TOS,PI,B   ,Estrazione di minerali da cave e miniere                    ,0,0,0,0,0,2021
TOS,PI,B 05,Estrazione di carbone (esclusa torba)                       ,0,0,0,0,0,2021
TOS,PI,B 06,Estraz.di petrolio greggio e di gas naturale                ,0,0,0,0,0,2021
TOS,PI,B 07,Estrazione di minerali metalliferi                          ,0,0,0,0,0,2021
TOS,PI,B 08,Altre attività di estrazione di minerali da cave e miniere  ,0,0,0,0,0,2021
TOS,PI,B 09,Attività dei servizi di supporto all'estrazione             ,0,0,0,0,0,2021
TOS,PI,C   ,Attività manifatturiere                                     ,0,94,0,0,94,2021
TOS,PI,C 10,Industrie alimentari                                        ,0,13,0,0,13,2021
TOS,PI,C 11,Industria delle bevande                                     ,0,0,0,0,0,2021
TOS,PI,C 12,Industria del tabacco                                       ,0,0,0,0,0,2021
TOS,PI,C 13,Industrie tessili                                           ,0,1,0,0,1,2021
TOS,PI,C 14,Confezione di articoli di abbigliamento; confezione di ar...,0,15,0,0,15,2021
TOS,PI,C 15,Fabbricazione di articoli in pelle e simili                 ,0,33,0,0,33,2021
TOS,PI,C 16,Industria del legno e dei prodotti in legno e sughero (es...,0,3,0,0,3,2021
TOS,PI,C 17,Fabbricazione di carta e di prodotti di carta               ,0,0,0,0,0,2021
TOS,PI,C 18,Stampa e riproduzione di supporti registrati                ,0,6,0,0,6,2021
TOS,PI,C 19,Fabbricazione di coke e prodotti derivanti dalla raffinaz...,0,0,0,0,0,2021
TOS,PI,C 20,Fabbricazione di prodotti chimici                           ,0,0,0,0,0,2021
TOS,PI,C 21,Fabbricazione di prodotti farmaceutici di base e di prepa...,0,0,0,0,0,2021
TOS,PI,C 22,Fabbricazione di articoli in gomma e materie plastiche      ,0,0,0,0,0,2021
TOS,PI,C 23,Fabbricazione di altri prodotti della lavorazione di miner..,0,2,0,0,2,2021
TOS,PI,C 24,Metallurgia                                                 ,0,0,0,0,0,2021
TOS,PI,C 25,Fabbricazione di prodotti in metallo (esclusi macchinari ...,0,8,0,0,8,2021
TOS,PI,C 26,Fabbricazione di computer e prodotti di elettronica e ott...,0,1,0,0,1,2021
TOS,PI,C 27,Fabbricazione di apparecchiature elettriche ed apparecchi...,0,0,0,0,0,2021
TOS,PI,C 28,Fabbricazione di macchinari ed apparecchiature nca          ,0,1,0,0,1,2021
TOS,PI,C 29,"Fabbricazione di autoveicoli, rimorchi e semirimorchi       ",0,0,0,0,0,2021
TOS,PI,C 30,Fabbricazione di altri mezzi di trasporto                   ,0,0,0,0,0,2021
TOS,PI,C 31,Fabbricazione di mobili                                     ,0,7,0,0,7,2021
TOS,PI,C 32,Altre industrie manifatturiere                              ,0,4,0,0,4,2021
TOS,PI,C 33,"Riparazione, manutenzione ed installazione di macchine ed...",0,0,0,0,0,2021
TOS,PI,D   ,"Fornitura di energia elettrica, gas, vapore e aria condiz...",0,0,0,0,0,2021
TOS,PI,D 35,"Fornitura di energia elettrica, gas, vapore e aria condiz...",0,0,0,0,0,2021
TOS,PI,E   ,"Fornitura di acqua; reti fognarie, attività di gestione d...",0,1,0,0,1,2021
TOS,PI,E 36,"Raccolta, trattamento e fornitura di acqua                  ",0,0,0,0,0,2021
TOS,PI,E 37,Gestione delle reti fognarie                                ,0,0,0,0,0,2021
TOS,PI,E 38,"Attività di raccolta, trattamento e smaltimento dei rifiu...",0,1,0,0,1,2021
TOS,PI,E 39,Attività di risanamento e altri servizi di gestione dei r...,0,0,0,0,0,2021
TOS,PI,F   ,Costruzioni                                                 ,0,67,1,0,68,2021
TOS,PI,F 41,Costruzione di edifici                                      ,0,30,0,0,30,2021
TOS,PI,F 42,Ingegneria civile                                           ,0,0,0,0,0,2021
TOS,PI,F 43,Lavori di costruzione specializzati                         ,0,37,1,0,38,2021
TOS,PI,G   ,Commercio all'ingrosso e al dettaglio; riparazione di aut...,0,137,2,0,139,2021
TOS,PI,G 45,Commercio all'ingrosso e al dettaglio e riparazione di au...,0,15,0,0,15,2021
TOS,PI,G 46,Commercio all'ingrosso (escluso quello di autoveicoli e d...,0,54,1,0,55,2021
TOS,PI,G 47,Commercio al dettaglio (escluso quello di autoveicoli e d...,0,68,1,0,69,2021
TOS,PI,H   ,Trasporto e magazzinaggio                                   ,0,7,0,0,7,2021
TOS,PI,H 49,Trasporto terrestre e mediante condotte                     ,0,4,0,0,4,2021
TOS,PI,H 50,Trasporto marittimo e per vie d'acqua                       ,0,0,0,0,0,2021
TOS,PI,H 51,Trasporto aereo                                             ,0,0,0,0,0,2021
TOS,PI,H 52,Magazzinaggio e attività di supporto ai trasporti           ,0,3,0,0,3,2021
TOS,PI,H 53,Servizi postali e attività di corriere                      ,0,0,0,0,0,2021
TOS,PI,I   ,Attività dei servizi alloggio e ristorazione                ,0,117,0,0,117,2021
TOS,PI,I 55,Alloggio                                                    ,0,3,0,0,3,2021
TOS,PI,I 56,Attività dei servizi di ristorazione                        ,0,114,0,0,114,2021
TOS,PI,J   ,Servizi di informazione e comunicazione                     ,1,9,0,0,10,2021
TOS,PI,J 58,Attività editoriali                                         ,0,3,0,0,3,2021
TOS,PI,J 59,"Attività di produzione cinematografica, di video e di pro...",0,0,0,0,0,2021
TOS,PI,J 60,Attività di programmazione e trasmissione                   ,0,0,0,0,0,2021
TOS,PI,J 61,Telecomunicazioni                                           ,0,1,0,0,1,2021
TOS,PI,J 62,"Produzione di software, consulenza informatica e attività...",0,2,0,0,2,2021
TOS,PI,J 63,Attività dei servizi d'informazione e altri servizi infor...,1,3,0,0,4,2021
TOS,PI,K   ,Attività finanziarie e assicurative                         ,0,2,0,0,2,2021
TOS,PI,K 64,Attività di servizi finanziari (escluse le assicurazioni ...,0,0,0,0,0,2021
TOS,PI,K 65,"Assicurazioni, riassicurazioni e fondi pensione (escluse ...",0,0,0,0,0,2021
TOS,PI,K 66,Attività ausiliarie dei servizi finanziari e delle attivi...,0,2,0,0,2,2021
TOS,PI,L   ,Attivita' immobiliari                                       ,0,19,1,0,20,2021
TOS,PI,L 68,Attivita' immobiliari                                       ,0,19,1,0,20,2021
TOS,PI,M   ,"Attività professionali, scientifiche e tecniche             ",0,10,0,0,10,2021
TOS,PI,M 69,Attività legali e contabilità                               ,0,2,0,0,2,2021
TOS,PI,M 70,Attività di direzione aziendale e di consulenza gestional...,0,0,0,0,0,2021
TOS,PI,M 71,Attività degli studi di architettura e d'ingegneria; coll...,0,1,0,0,1,2021
TOS,PI,M 72,Ricerca scientifica e sviluppo                              ,0,0,0,0,0,2021
TOS,PI,M 73,Pubblicità e ricerche di mercato                            ,0,2,0,0,2,2021
TOS,PI,M 74,"Altre attività professionali, scientifiche e tecniche       ",0,5,0,0,5,2021
TOS,PI,M 75,Servizi veterinari                                          ,0,0,0,0,0,2021
TOS,PI,N   ,"Noleggio, agenzie di viaggio, servizi di supporto alle im...",0,12,0,0,12,2021
TOS,PI,N 77,Attività di noleggio e leasing operativo                    ,0,0,0,0,0,2021
TOS,PI,N 78,"Attività di ricerca, selezione, fornitura di personale      ",0,0,0,0,0,2021
TOS,PI,N 79,"Attività dei servizi delle agenzie di viaggio, dei tour o...",0,1,0,0,1,2021
TOS,PI,N 80,Servizi di vigilanza e investigazione                       ,0,0,0,0,0,2021
TOS,PI,N 81,Attività di servizi per edifici e paesaggio                 ,0,4,0,0,4,2021
TOS,PI,N 82,Attività di supporto per le funzioni d'ufficio e altri se...,0,7,0,0,7,2021
TOS,PI,O   ,Amministrazione pubblica e difesa; assicurazione sociale ...,0,0,0,0,0,2021
TOS,PI,O 84,Amministrazione pubblica e difesa; assicurazione sociale ...,0,0,0,0,0,2021
TOS,PI,P   ,Istruzione                                                  ,0,1,0,0,1,2021
TOS,PI,P 85,Istruzione                                                  ,0,1,0,0,1,2021
TOS,PI,Q   ,Sanita' e assistenza sociale                                ,0,0,0,0,0,2021
TOS,PI,Q 86,Assistenza sanitaria                                        ,0,0,0,0,0,2021
TOS,PI,Q 87,Servizi di assistenza sociale residenziale                  ,0,0,0,0,0,2021
TOS,PI,Q 88,Assistenza sociale non residenziale                         ,0,0,0,0,0,2021
TOS,PI,R   ,"Attività artistiche, sportive, di intrattenimento e diver...",0,7,0,0,7,2021
TOS,PI,R 90,"Attività creative, artistiche e di intrattenimento          ",0,4,0,0,4,2021
TOS,PI,R 91,"Attività di biblioteche, archivi, musei ed altre attività...",0,0,0,0,0,2021
TOS,PI,R 92,"Attività riguardanti le lotterie, le scommesse, le case d...",0,0,0,0,0,2021
TOS,PI,R 93,"Attività sportive, di intrattenimento e di divertimento     ",0,3,0,0,3,2021
TOS,PI,S   ,Altre attività di servizi                                   ,0,12,0,0,12,2021
TOS,PI,S 94,Attività di organizzazioni associative                      ,0,0,0,0,0,2021
TOS,PI,S 95,Riparazione di computer e di beni per uso personale e per...,0,2,0,0,2,2021
TOS,PI,S 96,Altre attività di servizi per la persona                    ,0,10,0,0,10,2021
TOS,PI,T   ,Attività di famiglie e convivenze come datori di lavoro p...,0,0,0,0,0,2021
TOS,PI,T 97,Attività di famiglie e convivenze come datori di lavoro p...,0,0,0,0,0,2021
TOS,PI,T 98,Produzione di beni e servizi indifferenziati per uso prop...,0,0,0,0,0,2021
TOS,PI,U   ,Organizzazioni ed organismi extraterritoriali               ,0,0,0,0,0,2021
TOS,PI,U 99,Organizzazioni ed organismi extraterritoriali               ,0,0,0,0,0,2021
TOS,PI,XX  ,Imprese non classificate                                    ,0,154,1,0,155,2021
TOS,PI,TOT ,TOTALE                                                      ,1,657,6,0,664,2021
TOS,AR,A   ,"Agricoltura, silvicoltura pesca                             ",1,0,19,0,20,2021
TOS,AR,A 01,"Coltivazioni agricole e produzione di prodotti animali, c...",1,0,18,0,19,2021
TOS,AR,A 02,Silvicoltura ed utilizzo di aree forestali                  ,0,0,1,0,1,2021
TOS,AR,A 03,Pesca e acquacoltura                                        ,0,0,0,0,0,2021
TOS,AR,B   ,Estrazione di minerali da cave e miniere                    ,0,0,0,0,0,2021
TOS,AR,B 05,Estrazione di carbone (esclusa torba)                       ,0,0,0,0,0,2021
TOS,AR,B 06,Estraz.di petrolio greggio e di gas naturale                ,0,0,0,0,0,2021
TOS,AR,B 07,Estrazione di minerali metalliferi                          ,0,0,0,0,0,2021
TOS,AR,B 08,Altre attività di estrazione di minerali da cave e miniere  ,0,0,0,0,0,2021
TOS,AR,B 09,Attività dei servizi di supporto all'estrazione             ,0,0,0,0,0,2021
TOS,AR,C   ,Attività manifatturiere                                     ,93,1,5,0,99,2021
TOS,AR,C 10,Industrie alimentari                                        ,2,0,1,0,3,2021
TOS,AR,C 11,Industria delle bevande                                     ,0,0,0,0,0,2021
TOS,AR,C 12,Industria del tabacco                                       ,0,0,0,0,0,2021
TOS,AR,C 13,Industrie tessili                                           ,5,0,0,0,5,2021
TOS,AR,C 14,Confezione di articoli di abbigliamento; confezione di ar...,8,0,0,0,8,2021
TOS,AR,C 15,Fabbricazione di articoli in pelle e simili                 ,10,0,0,0,10,2021
TOS,AR,C 16,Industria del legno e dei prodotti in legno e sughero (es...,3,1,1,0,5,2021
TOS,AR,C 17,Fabbricazione di carta e di prodotti di carta               ,0,0,0,0,0,2021
TOS,AR,C 18,Stampa e riproduzione di supporti registrati                ,1,0,0,0,1,2021
TOS,AR,C 19,Fabbricazione di coke e prodotti derivanti dalla raffinaz...,0,0,0,0,0,2021
TOS,AR,C 20,Fabbricazione di prodotti chimici                           ,1,0,0,0,1,2021
TOS,AR,C 21,Fabbricazione di prodotti farmaceutici di base e di prepa...,0,0,0,0,0,2021
TOS,AR,C 22,Fabbricazione di articoli in gomma e materie plastiche      ,0,0,0,0,0,2021
TOS,AR,C 23,Fabbricazione di altri prodotti della lavorazione di miner..,3,0,0,0,3,2021
TOS,AR,C 24,Metallurgia                                                 ,1,0,0,0,1,2021
TOS,AR,C 25,Fabbricazione di prodotti in metallo (esclusi macchinari ...,18,0,1,0,19,2021
TOS,AR,C 26,Fabbricazione di computer e prodotti di elettronica e ott...,1,0,0,0,1,2021
TOS,AR,C 27,Fabbricazione di apparecchiature elettriche ed apparecchi...,1,0,0,0,1,2021
TOS,AR,C 28,Fabbricazione di macchinari ed apparecchiature nca          ,3,0,0,0,3,2021
TOS,AR,C 29,"Fabbricazione di autoveicoli, rimorchi e semirimorchi       ",0,0,0,0,0,2021
TOS,AR,C 30,Fabbricazione di altri mezzi di trasporto                   ,0,0,0,0,0,2021
TOS,AR,C 31,Fabbricazione di mobili                                     ,7,0,1,0,8,2021
TOS,AR,C 32,Altre industrie manifatturiere                              ,26,0,1,0,27,2021
TOS,AR,C 33,"Riparazione, manutenzione ed installazione di macchine ed...",3,0,0,0,3,2021
TOS,AR,D   ,"Fornitura di energia elettrica, gas, vapore e aria condiz...",0,0,0,0,0,2021
TOS,AR,D 35,"Fornitura di energia elettrica, gas, vapore e aria condiz...",0,0,0,0,0,2021
TOS,AR,E   ,"Fornitura di acqua; reti fognarie, attività di gestione d...",1,0,0,0,1,2021
TOS,AR,E 36,"Raccolta, trattamento e fornitura di acqua                  ",0,0,0,0,0,2021
TOS,AR,E 37,Gestione delle reti fognarie                                ,0,0,0,0,0,2021
TOS,AR,E 38,"Attività di raccolta, trattamento e smaltimento dei rifiu...",1,0,0,0,1,2021
TOS,AR,E 39,Attività di risanamento e altri servizi di gestione dei r...,0,0,0,0,0,2021
TOS,AR,F   ,Costruzioni                                                 ,65,1,4,0,70,2021
TOS,AR,F 41,Costruzione di edifici                                      ,45,0,0,0,45,2021
TOS,AR,F 42,Ingegneria civile                                           ,2,0,0,0,2,2021
TOS,AR,F 43,Lavori di costruzione specializzati                         ,18,1,4,0,23,2021
TOS,AR,G   ,Commercio all'ingrosso e al dettaglio; riparazione di aut...,104,2,3,0,109,2021
TOS,AR,G 45,Commercio all'ingrosso e al dettaglio e riparazione di au...,12,0,1,0,13,2021
TOS,AR,G 46,Commercio all'ingrosso (escluso quello di autoveicoli e d...,61,1,0,0,62,2021
TOS,AR,G 47,Commercio al dettaglio (escluso quello di autoveicoli e d...,31,1,2,0,34,2021
TOS,AR,H   ,Trasporto e magazzinaggio                                   ,9,0,2,0,11,2021
TOS,AR,H 49,Trasporto terrestre e mediante condotte                     ,7,0,2,0,9,2021
TOS,AR,H 50,Trasporto marittimo e per vie d'acqua                       ,0,0,0,0,0,2021
TOS,AR,H 51,Trasporto aereo                                             ,0,0,0,0,0,2021
TOS,AR,H 52,Magazzinaggio e attività di supporto ai trasporti           ,1,0,0,0,1,2021
TOS,AR,H 53,Servizi postali e attività di corriere                      ,1,0,0,0,1,2021
TOS,AR,I   ,Attività dei servizi alloggio e ristorazione                ,38,0,2,0,40,2021
TOS,AR,I 55,Alloggio                                                    ,4,0,1,0,5,2021
TOS,AR,I 56,Attività dei servizi di ristorazione                        ,34,0,1,0,35,2021
TOS,AR,J   ,Servizi di informazione e comunicazione                     ,14,1,1,0,16,2021
TOS,AR,J 58,Attività editoriali                                         ,3,0,1,0,4,2021
TOS,AR,J 59,"Attività di produzione cinematografica, di video e di pro...",1,0,0,0,1,2021
TOS,AR,J 60,Attività di programmazione e trasmissione                   ,0,0,0,0,0,2021
TOS,AR,J 61,Telecomunicazioni                                           ,1,1,0,0,2,2021
TOS,AR,J 62,"Produzione di software, consulenza informatica e attività...",3,0,0,0,3,2021
TOS,AR,J 63,Attività dei servizi d'informazione e altri servizi infor...,6,0,0,0,6,2021
TOS,AR,K   ,Attività finanziarie e assicurative                         ,2,0,0,0,2,2021
TOS,AR,K 64,Attività di servizi finanziari (escluse le assicurazioni ...,1,0,0,0,1,2021
TOS,AR,K 65,"Assicurazioni, riassicurazioni e fondi pensione (escluse ...",0,0,0,0,0,2021
TOS,AR,K 66,Attività ausiliarie dei servizi finanziari e delle attivi...,1,0,0,0,1,2021
TOS,AR,L   ,Attivita' immobiliari                                       ,27,0,0,0,27,2021
TOS,AR,L 68,Attivita' immobiliari                                       ,27,0,0,0,27,2021
TOS,AR,M   ,"Attività professionali, scientifiche e tecniche             ",8,0,2,0,10,2021
TOS,AR,M 69,Attività legali e contabilità                               ,0,0,0,0,0,2021
TOS,AR,M 70,Attività di direzione aziendale e di consulenza gestional...,2,0,0,0,2,2021
TOS,AR,M 71,Attività degli studi di architettura e d'ingegneria; coll...,0,0,0,0,0,2021
TOS,AR,M 72,Ricerca scientifica e sviluppo                              ,0,0,0,0,0,2021
TOS,AR,M 73,Pubblicità e ricerche di mercato                            ,3,0,1,0,4,2021
TOS,AR,M 74,"Altre attività professionali, scientifiche e tecniche       ",3,0,1,0,4,2021
TOS,AR,M 75,Servizi veterinari                                          ,0,0,0,0,0,2021
TOS,AR,N   ,"Noleggio, agenzie di viaggio, servizi di supporto alle im...",11,0,0,0,11,2021
TOS,AR,N 77,Attività di noleggio e leasing operativo                    ,2,0,0,0,2,2021
TOS,AR,N 78,"Attività di ricerca, selezione, fornitura di personale      ",0,0,0,0,0,2021
TOS,AR,N 79,"Attività dei servizi delle agenzie di viaggio, dei tour o...",2,0,0,0,2,2021
TOS,AR,N 80,Servizi di vigilanza e investigazione                       ,2,0,0,0,2,2021
TOS,AR,N 81,Attività di servizi per edifici e paesaggio                 ,0,0,0,0,0,2021
TOS,AR,N 82,Attività di supporto per le funzioni d'ufficio e altri se...,5,0,0,0,5,2021
TOS,AR,O   ,Amministrazione pubblica e difesa; assicurazione sociale ...,0,0,0,0,0,2021
TOS,AR,O 84,Amministrazione pubblica e difesa; assicurazione sociale ...,0,0,0,0,0,2021
TOS,AR,P   ,Istruzione                                                  ,2,0,0,0,2,2021
TOS,AR,P 85,Istruzione                                                  ,2,0,0,0,2,2021
TOS,AR,Q   ,Sanita' e assistenza sociale                                ,1,0,0,0,1,2021
TOS,AR,Q 86,Assistenza sanitaria                                        ,1,0,0,0,1,2021
TOS,AR,Q 87,Servizi di assistenza sociale residenziale                  ,0,0,0,0,0,2021
TOS,AR,Q 88,Assistenza sociale non residenziale                         ,0,0,0,0,0,2021
TOS,AR,R   ,"Attività artistiche, sportive, di intrattenimento e diver...",12,0,0,1,13,2021
TOS,AR,R 90,"Attività creative, artistiche e di intrattenimento          ",0,0,0,1,1,2021
TOS,AR,R 91,"Attività di biblioteche, archivi, musei ed altre attività...",0,0,0,0,0,2021
TOS,AR,R 92,"Attività riguardanti le lotterie, le scommesse, le case d...",2,0,0,0,2,2021
TOS,AR,R 93,"Attività sportive, di intrattenimento e di divertimento     ",10,0,0,0,10,2021
TOS,AR,S   ,Altre attività di servizi                                   ,3,0,1,0,4,2021
TOS,AR,S 94,Attività di organizzazioni associative                      ,0,0,0,0,0,2021
TOS,AR,S 95,Riparazione di computer e di beni per uso personale e per...,0,0,0,0,0,2021
TOS,AR,S 96,Altre attività di servizi per la persona                    ,3,0,1,0,4,2021
TOS,AR,T   ,Attività di famiglie e convivenze come datori di lavoro p...,0,0,0,0,0,2021
TOS,AR,T 97,Attività di famiglie e convivenze come datori di lavoro p...,0,0,0,0,0,2021
TOS,AR,T 98,Produzione di beni e servizi indifferenziati per uso prop...,0,0,0,0,0,2021
TOS,AR,U   ,Organizzazioni ed organismi extraterritoriali               ,0,0,0,0,0,2021
TOS,AR,U 99,Organizzazioni ed organismi extraterritoriali               ,0,0,0,0,0,2021
TOS,AR,XX  ,Imprese non classificate                                    ,37,0,2,0,39,2021
TOS,AR,TOT ,TOTALE                                                      ,428,5,41,1,475,2021
TOS,SI,A   ,"Agricoltura, silvicoltura pesca                             ",0,0,27,0,27,2021
TOS,SI,A 01,"Coltivazioni agricole e produzione di prodotti animali, c...",0,0,27,0,27,2021
TOS,SI,A 02,Silvicoltura ed utilizzo di aree forestali                  ,0,0,0,0,0,2021
TOS,SI,A 03,Pesca e acquacoltura                                        ,0,0,0,0,0,2021
TOS,SI,B   ,Estrazione di minerali da cave e miniere                    ,0,0,0,0,0,2021
TOS,SI,B 05,Estrazione di carbone (esclusa torba)                       ,0,0,0,0,0,2021
TOS,SI,B 06,Estraz.di petrolio greggio e di gas naturale                ,0,0,0,0,0,2021
TOS,SI,B 07,Estrazione di minerali metalliferi                          ,0,0,0,0,0,2021
TOS,SI,B 08,Altre attività di estrazione di minerali da cave e miniere  ,0,0,0,0,0,2021
TOS,SI,B 09,Attività dei servizi di supporto all'estrazione             ,0,0,0,0,0,2021
TOS,SI,C   ,Attività manifatturiere                                     ,7,5,7,0,19,2021
TOS,SI,C 10,Industrie alimentari                                        ,0,0,0,0,0,2021
TOS,SI,C 11,Industria delle bevande                                     ,0,0,0,0,0,2021
TOS,SI,C 12,Industria del tabacco                                       ,0,0,0,0,0,2021
TOS,SI,C 13,Industrie tessili                                           ,0,0,0,0,0,2021
TOS,SI,C 14,Confezione di articoli di abbigliamento; confezione di ar...,0,1,0,0,1,2021
TOS,SI,C 15,Fabbricazione di articoli in pelle e simili                 ,0,1,0,0,1,2021
TOS,SI,C 16,Industria del legno e dei prodotti in legno e sughero (es...,0,0,1,0,1,2021
TOS,SI,C 17,Fabbricazione di carta e di prodotti di carta               ,0,0,0,0,0,2021
TOS,SI,C 18,Stampa e riproduzione di supporti registrati                ,0,0,1,0,1,2021
TOS,SI,C 19,Fabbricazione di coke e prodotti derivanti dalla raffinaz...,0,0,0,0,0,2021
TOS,SI,C 20,Fabbricazione di prodotti chimici                           ,1,0,0,0,1,2021
TOS,SI,C 21,Fabbricazione di prodotti farmaceutici di base e di prepa...,0,0,0,0,0,2021
TOS,SI,C 22,Fabbricazione di articoli in gomma e materie plastiche      ,0,1,0,0,1,2021
TOS,SI,C 23,Fabbricazione di altri prodotti della lavorazione di miner..,2,1,1,0,4,2021
TOS,SI,C 24,Metallurgia                                                 ,0,0,0,0,0,2021
TOS,SI,C 25,Fabbricazione di prodotti in metallo (esclusi macchinari ...,1,1,3,0,5,2021
TOS,SI,C 26,Fabbricazione di computer e prodotti di elettronica e ott...,0,0,0,0,0,2021
TOS,SI,C 27,Fabbricazione di apparecchiature elettriche ed apparecchi...,2,0,0,0,2,2021
TOS,SI,C 28,Fabbricazione di macchinari ed apparecchiature nca          ,0,0,0,0,0,2021
TOS,SI,C 29,"Fabbricazione di autoveicoli, rimorchi e semirimorchi       ",0,0,0,0,0,2021
TOS,SI,C 30,Fabbricazione di altri mezzi di trasporto                   ,0,0,0,0,0,2021
TOS,SI,C 31,Fabbricazione di mobili                                     ,1,0,0,0,1,2021
TOS,SI,C 32,Altre industrie manifatturiere                              ,0,0,1,0,1,2021
TOS,SI,C 33,"Riparazione, manutenzione ed installazione di macchine ed...",0,0,0,0,0,2021
TOS,SI,D   ,"Fornitura di energia elettrica, gas, vapore e aria condiz...",0,0,0,0,0,2021
TOS,SI,D 35,"Fornitura di energia elettrica, gas, vapore e aria condiz...",0,0,0,0,0,2021
TOS,SI,E   ,"Fornitura di acqua; reti fognarie, attività di gestione d...",0,0,0,0,0,2021
TOS,SI,E 36,"Raccolta, trattamento e fornitura di acqua                  ",0,0,0,0,0,2021
TOS,SI,E 37,Gestione delle reti fognarie                                ,0,0,0,0,0,2021
TOS,SI,E 38,"Attività di raccolta, trattamento e smaltimento dei rifiu...",0,0,0,0,0,2021
TOS,SI,E 39,Attività di risanamento e altri servizi di gestione dei r...,0,0,0,0,0,2021
TOS,SI,F   ,Costruzioni                                                 ,7,8,86,0,101,2021
TOS,SI,F 41,Costruzione di edifici                                      ,6,6,23,0,35,2021
TOS,SI,F 42,Ingegneria civile                                           ,0,0,0,0,0,2021
TOS,SI,F 43,Lavori di costruzione specializzati                         ,1,2,63,0,66,2021
TOS,SI,G   ,Commercio all'ingrosso e al dettaglio; riparazione di aut...,8,8,31,0,47,2021
TOS,SI,G 45,Commercio all'ingrosso e al dettaglio e riparazione di au...,2,0,2,0,4,2021
TOS,SI,G 46,Commercio all'ingrosso (escluso quello di autoveicoli e d...,5,1,11,0,17,2021
TOS,SI,G 47,Commercio al dettaglio (escluso quello di autoveicoli e d...,1,7,18,0,26,2021
TOS,SI,H   ,Trasporto e magazzinaggio                                   ,1,1,8,0,10,2021
TOS,SI,H 49,Trasporto terrestre e mediante condotte                     ,0,1,8,0,9,2021
TOS,SI,H 50,Trasporto marittimo e per vie d'acqua                       ,0,0,0,0,0,2021
TOS,SI,H 51,Trasporto aereo                                             ,0,0,0,0,0,2021
TOS,SI,H 52,Magazzinaggio e attività di supporto ai trasporti           ,1,0,0,0,1,2021
TOS,SI,H 53,Servizi postali e attività di corriere                      ,0,0,0,0,0,2021
TOS,SI,I   ,Attività dei servizi alloggio e ristorazione                ,1,18,13,0,32,2021
TOS,SI,I 55,Alloggio                                                    ,0,0,5,0,5,2021
TOS,SI,I 56,Attività dei servizi di ristorazione                        ,1,18,8,0,27,2021
TOS,SI,J   ,Servizi di informazione e comunicazione                     ,2,1,3,0,6,2021
TOS,SI,J 58,Attività editoriali                                         ,1,1,0,0,2,2021
TOS,SI,J 59,"Attività di produzione cinematografica, di video e di pro...",0,0,0,0,0,2021
TOS,SI,J 60,Attività di programmazione e trasmissione                   ,0,0,0,0,0,2021
TOS,SI,J 61,Telecomunicazioni                                           ,0,0,2,0,2,2021
TOS,SI,J 62,"Produzione di software, consulenza informatica e attività...",1,0,0,0,1,2021
TOS,SI,J 63,Attività dei servizi d'informazione e altri servizi infor...,0,0,1,0,1,2021
TOS,SI,K   ,Attività finanziarie e assicurative                         ,0,0,1,0,1,2021
TOS,SI,K 64,Attività di servizi finanziari (escluse le assicurazioni ...,0,0,0,0,0,2021
TOS,SI,K 65,"Assicurazioni, riassicurazioni e fondi pensione (escluse ...",0,0,0,0,0,2021
TOS,SI,K 66,Attività ausiliarie dei servizi finanziari e delle attivi...,0,0,1,0,1,2021
TOS,SI,L   ,Attivita' immobiliari                                       ,6,2,1,0,9,2021
TOS,SI,L 68,Attivita' immobiliari                                       ,6,2,1,0,9,2021
TOS,SI,M   ,"Attività professionali, scientifiche e tecniche             ",4,0,0,0,4,2021
TOS,SI,M 69,Attività legali e contabilità                               ,0,0,0,0,0,2021
TOS,SI,M 70,Attività di direzione aziendale e di consulenza gestional...,2,0,0,0,2,2021
TOS,SI,M 71,Attività degli studi di architettura e d'ingegneria; coll...,1,0,0,0,1,2021
TOS,SI,M 72,Ricerca scientifica e sviluppo                              ,0,0,0,0,0,2021
TOS,SI,M 73,Pubblicità e ricerche di mercato                            ,1,0,0,0,1,2021
TOS,SI,M 74,"Altre attività professionali, scientifiche e tecniche       ",0,0,0,0,0,2021
TOS,SI,M 75,Servizi veterinari                                          ,0,0,0,0,0,2021
TOS,SI,N   ,"Noleggio, agenzie di viaggio, servizi di supporto alle im...",0,1,6,0,7,2021
TOS,SI,N 77,Attività di noleggio e leasing operativo                    ,0,0,0,0,0,2021
TOS,SI,N 78,"Attività di ricerca, selezione, fornitura di personale      ",0,0,0,0,0,2021
TOS,SI,N 79,"Attività dei servizi delle agenzie di viaggio, dei tour o...",0,0,1,0,1,2021
TOS,SI,N 80,Servizi di vigilanza e investigazione                       ,0,0,0,0,0,2021
TOS,SI,N 81,Attività di servizi per edifici e paesaggio                 ,0,0,2,0,2,2021
TOS,SI,N 82,Attività di supporto per le funzioni d'ufficio e altri se...,0,1,3,0,4,2021
TOS,SI,O   ,Amministrazione pubblica e difesa; assicurazione sociale ...,0,0,0,0,0,2021
TOS,SI,O 84,Amministrazione pubblica e difesa; assicurazione sociale ...,0,0,0,0,0,2021
TOS,SI,P   ,Istruzione                                                  ,0,0,0,0,0,2021
TOS,SI,P 85,Istruzione                                                  ,0,0,0,0,0,2021
TOS,SI,Q   ,Sanita' e assistenza sociale                                ,0,1,0,0,1,2021
TOS,SI,Q 86,Assistenza sanitaria                                        ,0,1,0,0,1,2021
TOS,SI,Q 87,Servizi di assistenza sociale residenziale                  ,0,0,0,0,0,2021
TOS,SI,Q 88,Assistenza sociale non residenziale                         ,0,0,0,0,0,2021
TOS,SI,R   ,"Attività artistiche, sportive, di intrattenimento e diver...",1,2,1,0,4,2021
TOS,SI,R 90,"Attività creative, artistiche e di intrattenimento          ",0,1,0,0,1,2021
TOS,SI,R 91,"Attività di biblioteche, archivi, musei ed altre attività...",0,0,0,0,0,2021
TOS,SI,R 92,"Attività riguardanti le lotterie, le scommesse, le case d...",0,0,0,0,0,2021
TOS,SI,R 93,"Attività sportive, di intrattenimento e di divertimento     ",1,1,1,0,3,2021
TOS,SI,S   ,Altre attività di servizi                                   ,1,3,3,0,7,2021
TOS,SI,S 94,Attività di organizzazioni associative                      ,0,0,0,0,0,2021
TOS,SI,S 95,Riparazione di computer e di beni per uso personale e per...,1,1,3,0,5,2021
TOS,SI,S 96,Altre attività di servizi per la persona                    ,0,2,0,0,2,2021
TOS,SI,T   ,Attività di famiglie e convivenze come datori di lavoro p...,0,0,0,0,0,2021
TOS,SI,T 97,Attività di famiglie e convivenze come datori di lavoro p...,0,0,0,0,0,2021
TOS,SI,T 98,Produzione di beni e servizi indifferenziati per uso prop...,0,0,0,0,0,2021
TOS,SI,U   ,Organizzazioni ed organismi extraterritoriali               ,0,0,0,0,0,2021
TOS,SI,U 99,Organizzazioni ed organismi extraterritoriali               ,0,0,0,0,0,2021
TOS,SI,XX  ,Imprese non classificate                                    ,4,7,4,0,15,2021
TOS,SI,TOT ,TOTALE                                                      ,42,57,191,0,290,2021
TOS,GR,A   ,"Agricoltura, silvicoltura pesca                             ",6,24,0,1,31,2021
TOS,GR,A 01,"Coltivazioni agricole e produzione di prodotti animali, c...",6,22,0,1,29,2021
TOS,GR,A 02,Silvicoltura ed utilizzo di aree forestali                  ,0,1,0,0,1,2021
TOS,GR,A 03,Pesca e acquacoltura                                        ,0,1,0,0,1,2021
TOS,GR,B   ,Estrazione di minerali da cave e miniere                    ,0,0,0,0,0,2021
TOS,GR,B 05,Estrazione di carbone (esclusa torba)                       ,0,0,0,0,0,2021
TOS,GR,B 06,Estraz.di petrolio greggio e di gas naturale                ,0,0,0,0,0,2021
TOS,GR,B 07,Estrazione di minerali metalliferi                          ,0,0,0,0,0,2021
TOS,GR,B 08,Altre attività di estrazione di minerali da cave e miniere  ,0,0,0,0,0,2021
TOS,GR,B 09,Attività dei servizi di supporto all'estrazione             ,0,0,0,0,0,2021
TOS,GR,C   ,Attività manifatturiere                                     ,12,17,0,1,30,2021
TOS,GR,C 10,Industrie alimentari                                        ,1,4,0,0,5,2021
TOS,GR,C 11,Industria delle bevande                                     ,0,0,0,0,0,2021
TOS,GR,C 12,Industria del tabacco                                       ,0,0,0,0,0,2021
TOS,GR,C 13,Industrie tessili                                           ,0,1,0,0,1,2021
TOS,GR,C 14,Confezione di articoli di abbigliamento; confezione di ar...,1,0,0,0,1,2021
TOS,GR,C 15,Fabbricazione di articoli in pelle e simili                 ,0,0,0,0,0,2021
TOS,GR,C 16,Industria del legno e dei prodotti in legno e sughero (es...,2,1,0,0,3,2021
TOS,GR,C 17,Fabbricazione di carta e di prodotti di carta               ,1,0,0,0,1,2021
TOS,GR,C 18,Stampa e riproduzione di supporti registrati                ,0,2,0,1,3,2021
TOS,GR,C 19,Fabbricazione di coke e prodotti derivanti dalla raffinaz...,0,0,0,0,0,2021
TOS,GR,C 20,Fabbricazione di prodotti chimici                           ,0,0,0,0,0,2021
TOS,GR,C 21,Fabbricazione di prodotti farmaceutici di base e di prepa...,0,0,0,0,0,2021
TOS,GR,C 22,Fabbricazione di articoli in gomma e materie plastiche      ,0,0,0,0,0,2021
TOS,GR,C 23,Fabbricazione di altri prodotti della lavorazione di miner..,1,0,0,0,1,2021
TOS,GR,C 24,Metallurgia                                                 ,0,0,0,0,0,2021
TOS,GR,C 25,Fabbricazione di prodotti in metallo (esclusi macchinari ...,2,2,0,0,4,2021
TOS,GR,C 26,Fabbricazione di computer e prodotti di elettronica e ott...,0,0,0,0,0,2021
TOS,GR,C 27,Fabbricazione di apparecchiature elettriche ed apparecchi...,2,0,0,0,2,2021
TOS,GR,C 28,Fabbricazione di macchinari ed apparecchiature nca          ,0,0,0,0,0,2021
TOS,GR,C 29,"Fabbricazione di autoveicoli, rimorchi e semirimorchi       ",0,0,0,0,0,2021
TOS,GR,C 30,Fabbricazione di altri mezzi di trasporto                   ,0,0,0,0,0,2021
TOS,GR,C 31,Fabbricazione di mobili                                     ,0,2,0,0,2,2021
TOS,GR,C 32,Altre industrie manifatturiere                              ,0,5,0,0,5,2021
TOS,GR,C 33,"Riparazione, manutenzione ed installazione di macchine ed...",2,0,0,0,2,2021
TOS,GR,D   ,"Fornitura di energia elettrica, gas, vapore e aria condiz...",0,0,0,0,0,2021
TOS,GR,D 35,"Fornitura di energia elettrica, gas, vapore e aria condiz...",0,0,0,0,0,2021
TOS,GR,E   ,"Fornitura di acqua; reti fognarie, attività di gestione d...",2,0,0,0,2,2021
TOS,GR,E 36,"Raccolta, trattamento e fornitura di acqua                  ",0,0,0,0,0,2021
TOS,GR,E 37,Gestione delle reti fognarie                                ,0,0,0,0,0,2021
TOS,GR,E 38,"Attività di raccolta, trattamento e smaltimento dei rifiu...",2,0,0,0,2,2021
TOS,GR,E 39,Attività di risanamento e altri servizi di gestione dei r...,0,0,0,0,0,2021
TOS,GR,F   ,Costruzioni                                                 ,28,13,0,1,42,2021
TOS,GR,F 41,Costruzione di edifici                                      ,23,5,0,1,29,2021
TOS,GR,F 42,Ingegneria civile                                           ,0,0,0,0,0,2021
TOS,GR,F 43,Lavori di costruzione specializzati                         ,5,8,0,0,13,2021
TOS,GR,G   ,Commercio all'ingrosso e al dettaglio; riparazione di aut...,20,39,0,1,60,2021
TOS,GR,G 45,Commercio all'ingrosso e al dettaglio e riparazione di au...,2,3,0,0,5,2021
TOS,GR,G 46,Commercio all'ingrosso (escluso quello di autoveicoli e d...,10,11,0,0,21,2021
TOS,GR,G 47,Commercio al dettaglio (escluso quello di autoveicoli e d...,8,25,0,1,34,2021
TOS,GR,H   ,Trasporto e magazzinaggio                                   ,4,3,0,0,7,2021
TOS,GR,H 49,Trasporto terrestre e mediante condotte                     ,3,2,0,0,5,2021
TOS,GR,H 50,Trasporto marittimo e per vie d'acqua                       ,0,0,0,0,0,2021
TOS,GR,H 51,Trasporto aereo                                             ,0,0,0,0,0,2021
TOS,GR,H 52,Magazzinaggio e attività di supporto ai trasporti           ,0,1,0,0,1,2021
TOS,GR,H 53,Servizi postali e attività di corriere                      ,1,0,0,0,1,2021
TOS,GR,I   ,Attività dei servizi alloggio e ristorazione                ,19,29,0,0,48,2021
TOS,GR,I 55,Alloggio                                                    ,1,1,0,0,2,2021
TOS,GR,I 56,Attività dei servizi di ristorazione                        ,18,28,0,0,46,2021
TOS,GR,J   ,Servizi di informazione e comunicazione                     ,7,0,0,0,7,2021
TOS,GR,J 58,Attività editoriali                                         ,1,0,0,0,1,2021
TOS,GR,J 59,"Attività di produzione cinematografica, di video e di pro...",2,0,0,0,2,2021
TOS,GR,J 60,Attività di programmazione e trasmissione                   ,0,0,0,0,0,2021
TOS,GR,J 61,Telecomunicazioni                                           ,0,0,0,0,0,2021
TOS,GR,J 62,"Produzione di software, consulenza informatica e attività...",4,0,0,0,4,2021
TOS,GR,J 63,Attività dei servizi d'informazione e altri servizi infor...,0,0,0,0,0,2021
TOS,GR,K   ,Attività finanziarie e assicurative                         ,3,1,0,0,4,2021
TOS,GR,K 64,Attività di servizi finanziari (escluse le assicurazioni ...,0,1,0,0,1,2021
TOS,GR,K 65,"Assicurazioni, riassicurazioni e fondi pensione (escluse ...",0,0,0,0,0,2021
TOS,GR,K 66,Attività ausiliarie dei servizi finanziari e delle attivi...,3,0,0,0,3,2021
TOS,GR,L   ,Attivita' immobiliari                                       ,17,12,0,0,29,2021
TOS,GR,L 68,Attivita' immobiliari                                       ,17,12,0,0,29,2021
TOS,GR,M   ,"Attività professionali, scientifiche e tecniche             ",8,1,0,0,9,2021
TOS,GR,M 69,Attività legali e contabilità                               ,0,0,0,0,0,2021
TOS,GR,M 70,Attività di direzione aziendale e di consulenza gestional...,2,0,0,0,2,2021
TOS,GR,M 71,Attività degli studi di architettura e d'ingegneria; coll...,1,0,0,0,1,2021
TOS,GR,M 72,Ricerca scientifica e sviluppo                              ,0,1,0,0,1,2021
TOS,GR,M 73,Pubblicità e ricerche di mercato                            ,2,0,0,0,2,2021
TOS,GR,M 74,"Altre attività professionali, scientifiche e tecniche       ",3,0,0,0,3,2021
TOS,GR,M 75,Servizi veterinari                                          ,0,0,0,0,0,2021
TOS,GR,N   ,"Noleggio, agenzie di viaggio, servizi di supporto alle im...",7,4,0,2,13,2021
TOS,GR,N 77,Attività di noleggio e leasing operativo                    ,3,1,0,0,4,2021
TOS,GR,N 78,"Attività di ricerca, selezione, fornitura di personale      ",0,0,0,0,0,2021
TOS,GR,N 79,"Attività dei servizi delle agenzie di viaggio, dei tour o...",2,0,0,1,3,2021
TOS,GR,N 80,Servizi di vigilanza e investigazione                       ,0,0,0,0,0,2021
TOS,GR,N 81,Attività di servizi per edifici e paesaggio                 ,0,0,0,0,0,2021
TOS,GR,N 82,Attività di supporto per le funzioni d'ufficio e altri se...,2,3,0,1,6,2021
TOS,GR,O   ,Amministrazione pubblica e difesa; assicurazione sociale ...,0,0,0,0,0,2021
TOS,GR,O 84,Amministrazione pubblica e difesa; assicurazione sociale ...,0,0,0,0,0,2021
TOS,GR,P   ,Istruzione                                                  ,2,0,0,0,2,2021
TOS,GR,P 85,Istruzione                                                  ,2,0,0,0,2,2021
TOS,GR,Q   ,Sanita' e assistenza sociale                                ,0,0,0,0,0,2021
TOS,GR,Q 86,Assistenza sanitaria                                        ,0,0,0,0,0,2021
TOS,GR,Q 87,Servizi di assistenza sociale residenziale                  ,0,0,0,0,0,2021
TOS,GR,Q 88,Assistenza sociale non residenziale                         ,0,0,0,0,0,2021
TOS,GR,R   ,"Attività artistiche, sportive, di intrattenimento e diver...",7,1,0,0,8,2021
TOS,GR,R 90,"Attività creative, artistiche e di intrattenimento          ",0,0,0,0,0,2021
TOS,GR,R 91,"Attività di biblioteche, archivi, musei ed altre attività...",0,0,0,0,0,2021
TOS,GR,R 92,"Attività riguardanti le lotterie, le scommesse, le case d...",1,1,0,0,2,2021
TOS,GR,R 93,"Attività sportive, di intrattenimento e di divertimento     ",6,0,0,0,6,2021
TOS,GR,S   ,Altre attività di servizi                                   ,0,5,0,0,5,2021
TOS,GR,S 94,Attività di organizzazioni associative                      ,0,0,0,0,0,2021
TOS,GR,S 95,Riparazione di computer e di beni per uso personale e per...,0,0,0,0,0,2021
TOS,GR,S 96,Altre attività di servizi per la persona                    ,0,5,0,0,5,2021
TOS,GR,T   ,Attività di famiglie e convivenze come datori di lavoro p...,0,0,0,0,0,2021
TOS,GR,T 97,Attività di famiglie e convivenze come datori di lavoro p...,0,0,0,0,0,2021
TOS,GR,T 98,Produzione di beni e servizi indifferenziati per uso prop...,0,0,0,0,0,2021
TOS,GR,U   ,Organizzazioni ed organismi extraterritoriali               ,0,0,0,0,0,2021
TOS,GR,U 99,Organizzazioni ed organismi extraterritoriali               ,0,0,0,0,0,2021
TOS,GR,XX  ,Imprese non classificate                                    ,45,6,0,3,54,2021
TOS,GR,TOT ,TOTALE                                                      ,187,155,0,9,351,2021
TOS,PO,A   ,"Agricoltura, silvicoltura pesca                             ",0,0,3,0,3,2021
TOS,PO,A 01,"Coltivazioni agricole e produzione di prodotti animali, c...",0,0,2,0,2,2021
TOS,PO,A 02,Silvicoltura ed utilizzo di aree forestali                  ,0,0,1,0,1,2021
TOS,PO,A 03,Pesca e acquacoltura                                        ,0,0,0,0,0,2021
TOS,PO,B   ,Estrazione di minerali da cave e miniere                    ,0,0,0,0,0,2021
TOS,PO,B 05,Estrazione di carbone (esclusa torba)                       ,0,0,0,0,0,2021
TOS,PO,B 06,Estraz.di petrolio greggio e di gas naturale                ,0,0,0,0,0,2021
TOS,PO,B 07,Estrazione di minerali metalliferi                          ,0,0,0,0,0,2021
TOS,PO,B 08,Altre attività di estrazione di minerali da cave e miniere  ,0,0,0,0,0,2021
TOS,PO,B 09,Attività dei servizi di supporto all'estrazione             ,0,0,0,0,0,2021
TOS,PO,C   ,Attività manifatturiere                                     ,30,2,150,0,182,2021
TOS,PO,C 10,Industrie alimentari                                        ,1,0,1,0,2,2021
TOS,PO,C 11,Industria delle bevande                                     ,0,0,0,0,0,2021
TOS,PO,C 12,Industria del tabacco                                       ,0,0,0,0,0,2021
TOS,PO,C 13,Industrie tessili                                           ,16,0,12,0,28,2021
TOS,PO,C 14,Confezione di articoli di abbigliamento; confezione di ar...,5,1,115,0,121,2021
TOS,PO,C 15,Fabbricazione di articoli in pelle e simili                 ,0,0,3,0,3,2021
TOS,PO,C 16,Industria del legno e dei prodotti in legno e sughero (es...,1,0,3,0,4,2021
TOS,PO,C 17,Fabbricazione di carta e di prodotti di carta               ,0,0,0,0,0,2021
TOS,PO,C 18,Stampa e riproduzione di supporti registrati                ,0,0,0,0,0,2021
TOS,PO,C 19,Fabbricazione di coke e prodotti derivanti dalla raffinaz...,0,0,0,0,0,2021
TOS,PO,C 20,Fabbricazione di prodotti chimici                           ,1,0,0,0,1,2021
TOS,PO,C 21,Fabbricazione di prodotti farmaceutici di base e di prepa...,0,0,0,0,0,2021
TOS,PO,C 22,Fabbricazione di articoli in gomma e materie plastiche      ,0,0,0,0,0,2021
TOS,PO,C 23,Fabbricazione di altri prodotti della lavorazione di miner..,0,0,1,0,1,2021
TOS,PO,C 24,Metallurgia                                                 ,0,0,0,0,0,2021
TOS,PO,C 25,Fabbricazione di prodotti in metallo (esclusi macchinari ...,1,0,5,0,6,2021
TOS,PO,C 26,Fabbricazione di computer e prodotti di elettronica e ott...,0,0,1,0,1,2021
TOS,PO,C 27,Fabbricazione di apparecchiature elettriche ed apparecchi...,0,0,0,0,0,2021
TOS,PO,C 28,Fabbricazione di macchinari ed apparecchiature nca          ,0,0,1,0,1,2021
TOS,PO,C 29,"Fabbricazione di autoveicoli, rimorchi e semirimorchi       ",0,0,1,0,1,2021
TOS,PO,C 30,Fabbricazione di altri mezzi di trasporto                   ,0,0,0,0,0,2021
TOS,PO,C 31,Fabbricazione di mobili                                     ,3,1,4,0,8,2021
TOS,PO,C 32,Altre industrie manifatturiere                              ,2,0,2,0,4,2021
TOS,PO,C 33,"Riparazione, manutenzione ed installazione di macchine ed...",0,0,1,0,1,2021
TOS,PO,D   ,"Fornitura di energia elettrica, gas, vapore e aria condiz...",0,0,0,0,0,2021
TOS,PO,D 35,"Fornitura di energia elettrica, gas, vapore e aria condiz...",0,0,0,0,0,2021
TOS,PO,E   ,"Fornitura di acqua; reti fognarie, attività di gestione d...",0,0,2,0,2,2021
TOS,PO,E 36,"Raccolta, trattamento e fornitura di acqua                  ",0,0,0,0,0,2021
TOS,PO,E 37,Gestione delle reti fognarie                                ,0,0,0,0,0,2021
TOS,PO,E 38,"Attività di raccolta, trattamento e smaltimento dei rifiu...",0,0,2,0,2,2021
TOS,PO,E 39,Attività di risanamento e altri servizi di gestione dei r...,0,0,0,0,0,2021
TOS,PO,F   ,Costruzioni                                                 ,7,1,246,0,254,2021
TOS,PO,F 41,Costruzione di edifici                                      ,3,1,23,0,27,2021
TOS,PO,F 42,Ingegneria civile                                           ,0,0,1,0,1,2021
TOS,PO,F 43,Lavori di costruzione specializzati                         ,4,0,222,0,226,2021
TOS,PO,G   ,Commercio all'ingrosso e al dettaglio; riparazione di aut...,16,6,167,0,189,2021
TOS,PO,G 45,Commercio all'ingrosso e al dettaglio e riparazione di au...,0,0,11,0,11,2021
TOS,PO,G 46,Commercio all'ingrosso (escluso quello di autoveicoli e d...,14,3,77,0,94,2021
TOS,PO,G 47,Commercio al dettaglio (escluso quello di autoveicoli e d...,2,3,79,0,84,2021
TOS,PO,H   ,Trasporto e magazzinaggio                                   ,1,0,12,0,13,2021
TOS,PO,H 49,Trasporto terrestre e mediante condotte                     ,0,0,10,0,10,2021
TOS,PO,H 50,Trasporto marittimo e per vie d'acqua                       ,0,0,0,0,0,2021
TOS,PO,H 51,Trasporto aereo                                             ,0,0,0,0,0,2021
TOS,PO,H 52,Magazzinaggio e attività di supporto ai trasporti           ,1,0,1,0,2,2021
TOS,PO,H 53,Servizi postali e attività di corriere                      ,0,0,1,0,1,2021
TOS,PO,I   ,Attività dei servizi alloggio e ristorazione                ,5,1,12,0,18,2021
TOS,PO,I 55,Alloggio                                                    ,1,0,1,0,2,2021
TOS,PO,I 56,Attività dei servizi di ristorazione                        ,4,1,11,0,16,2021
TOS,PO,J   ,Servizi di informazione e comunicazione                     ,1,1,5,0,7,2021
TOS,PO,J 58,Attività editoriali                                         ,0,0,0,0,0,2021
TOS,PO,J 59,"Attività di produzione cinematografica, di video e di pro...",0,0,0,0,0,2021
TOS,PO,J 60,Attività di programmazione e trasmissione                   ,0,0,0,0,0,2021
TOS,PO,J 61,Telecomunicazioni                                           ,0,0,4,0,4,2021
TOS,PO,J 62,"Produzione di software, consulenza informatica e attività...",1,0,1,0,2,2021
TOS,PO,J 63,Attività dei servizi d'informazione e altri servizi infor...,0,1,0,0,1,2021
TOS,PO,K   ,Attività finanziarie e assicurative                         ,0,0,3,0,3,2021
TOS,PO,K 64,Attività di servizi finanziari (escluse le assicurazioni ...,0,0,0,0,0,2021
TOS,PO,K 65,"Assicurazioni, riassicurazioni e fondi pensione (escluse ...",0,0,0,0,0,2021
TOS,PO,K 66,Attività ausiliarie dei servizi finanziari e delle attivi...,0,0,3,0,3,2021
TOS,PO,L   ,Attivita' immobiliari                                       ,8,2,3,0,13,2021
TOS,PO,L 68,Attivita' immobiliari                                       ,8,2,3,0,13,2021
TOS,PO,M   ,"Attività professionali, scientifiche e tecniche             ",5,1,9,0,15,2021
TOS,PO,M 69,Attività legali e contabilità                               ,0,0,0,0,0,2021
TOS,PO,M 70,Attività di direzione aziendale e di consulenza gestional...,2,1,1,0,4,2021
TOS,PO,M 71,Attività degli studi di architettura e d'ingegneria; coll...,1,0,0,0,1,2021
TOS,PO,M 72,Ricerca scientifica e sviluppo                              ,0,0,0,0,0,2021
TOS,PO,M 73,Pubblicità e ricerche di mercato                            ,1,0,3,0,4,2021
TOS,PO,M 74,"Altre attività professionali, scientifiche e tecniche       ",1,0,5,0,6,2021
TOS,PO,M 75,Servizi veterinari                                          ,0,0,0,0,0,2021
TOS,PO,N   ,"Noleggio, agenzie di viaggio, servizi di supporto alle im...",2,0,13,1,16,2021
TOS,PO,N 77,Attività di noleggio e leasing operativo                    ,0,0,0,0,0,2021
TOS,PO,N 78,"Attività di ricerca, selezione, fornitura di personale      ",0,0,0,0,0,2021
TOS,PO,N 79,"Attività dei servizi delle agenzie di viaggio, dei tour o...",0,0,0,0,0,2021
TOS,PO,N 80,Servizi di vigilanza e investigazione                       ,0,0,0,0,0,2021
TOS,PO,N 81,Attività di servizi per edifici e paesaggio                 ,1,0,1,1,3,2021
TOS,PO,N 82,Attività di supporto per le funzioni d'ufficio e altri se...,1,0,12,0,13,2021
TOS,PO,O   ,Amministrazione pubblica e difesa; assicurazione sociale ...,0,0,0,0,0,2021
TOS,PO,O 84,Amministrazione pubblica e difesa; assicurazione sociale ...,0,0,0,0,0,2021
TOS,PO,P   ,Istruzione                                                  ,1,0,0,0,1,2021
TOS,PO,P 85,Istruzione                                                  ,1,0,0,0,1,2021
TOS,PO,Q   ,Sanita' e assistenza sociale                                ,0,0,0,0,0,2021
TOS,PO,Q 86,Assistenza sanitaria                                        ,0,0,0,0,0,2021
TOS,PO,Q 87,Servizi di assistenza sociale residenziale                  ,0,0,0,0,0,2021
TOS,PO,Q 88,Assistenza sociale non residenziale                         ,0,0,0,0,0,2021
TOS,PO,R   ,"Attività artistiche, sportive, di intrattenimento e diver...",0,0,6,0,6,2021
TOS,PO,R 90,"Attività creative, artistiche e di intrattenimento          ",0,0,2,0,2,2021
TOS,PO,R 91,"Attività di biblioteche, archivi, musei ed altre attività...",0,0,0,0,0,2021
TOS,PO,R 92,"Attività riguardanti le lotterie, le scommesse, le case d...",0,0,0,0,0,2021
TOS,PO,R 93,"Attività sportive, di intrattenimento e di divertimento     ",0,0,4,0,4,2021
TOS,PO,S   ,Altre attività di servizi                                   ,1,1,4,0,6,2021
TOS,PO,S 94,Attività di organizzazioni associative                      ,0,0,0,0,0,2021
TOS,PO,S 95,Riparazione di computer e di beni per uso personale e per...,0,0,2,0,2,2021
TOS,PO,S 96,Altre attività di servizi per la persona                    ,1,1,2,0,4,2021
TOS,PO,T   ,Attività di famiglie e convivenze come datori di lavoro p...,0,0,0,0,0,2021
TOS,PO,T 97,Attività di famiglie e convivenze come datori di lavoro p...,0,0,0,0,0,2021
TOS,PO,T 98,Produzione di beni e servizi indifferenziati per uso prop...,0,0,0,0,0,2021
TOS,PO,U   ,Organizzazioni ed organismi extraterritoriali               ,0,0,0,0,0,2021
TOS,PO,U 99,Organizzazioni ed organismi extraterritoriali               ,0,0,0,0,0,2021
TOS,PO,XX  ,Imprese non classificate                                    ,7,3,4,0,14,2021
TOS,PO,TOT ,TOTALE                                                      ,84,18,639,1,742,2021
UMB,  ,A   ,"Agricoltura, silvicoltura pesca                             ",0,0,19,0,19,2021
UMB,  ,A 01,"Coltivazioni agricole e produzione di prodotti animali, c...",0,0,18,0,18,2021
UMB,  ,A 02,Silvicoltura ed utilizzo di aree forestali                  ,0,0,1,0,1,2021
UMB,  ,A 03,Pesca e acquacoltura                                        ,0,0,0,0,0,2021
UMB,  ,B   ,Estrazione di minerali da cave e miniere                    ,0,0,0,0,0,2021
UMB,  ,B 05,Estrazione di carbone (esclusa torba)                       ,0,0,0,0,0,2021
UMB,  ,B 06,Estraz.di petrolio greggio e di gas naturale                ,0,0,0,0,0,2021
UMB,  ,B 07,Estrazione di minerali metalliferi                          ,0,0,0,0,0,2021
UMB,  ,B 08,Altre attività di estrazione di minerali da cave e miniere  ,0,0,0,0,0,2021
UMB,  ,B 09,Attività dei servizi di supporto all'estrazione             ,0,0,0,0,0,2021
UMB,  ,C   ,Attività manifatturiere                                     ,0,0,20,0,20,2021
UMB,  ,C 10,Industrie alimentari                                        ,0,0,0,0,0,2021
UMB,  ,C 11,Industria delle bevande                                     ,0,0,0,0,0,2021
UMB,  ,C 12,Industria del tabacco                                       ,0,0,0,0,0,2021
UMB,  ,C 13,Industrie tessili                                           ,0,0,0,0,0,2021
UMB,  ,C 14,Confezione di articoli di abbigliamento; confezione di ar...,0,0,6,0,6,2021
UMB,  ,C 15,Fabbricazione di articoli in pelle e simili                 ,0,0,1,0,1,2021
UMB,  ,C 16,Industria del legno e dei prodotti in legno e sughero (es...,0,0,5,0,5,2021
UMB,  ,C 17,Fabbricazione di carta e di prodotti di carta               ,0,0,0,0,0,2021
UMB,  ,C 18,Stampa e riproduzione di supporti registrati                ,0,0,0,0,0,2021
UMB,  ,C 19,Fabbricazione di coke e prodotti derivanti dalla raffinaz...,0,0,0,0,0,2021
UMB,  ,C 20,Fabbricazione di prodotti chimici                           ,0,0,0,0,0,2021
UMB,  ,C 21,Fabbricazione di prodotti farmaceutici di base e di prepa...,0,0,0,0,0,2021
UMB,  ,C 22,Fabbricazione di articoli in gomma e materie plastiche      ,0,0,0,0,0,2021
UMB,  ,C 23,Fabbricazione di altri prodotti della lavorazione di miner..,0,0,1,0,1,2021
UMB,  ,C 24,Metallurgia                                                 ,0,0,0,0,0,2021
UMB,  ,C 25,Fabbricazione di prodotti in metallo (esclusi macchinari ...,0,0,5,0,5,2021
UMB,  ,C 26,Fabbricazione di computer e prodotti di elettronica e ott...,0,0,0,0,0,2021
UMB,  ,C 27,Fabbricazione di apparecchiature elettriche ed apparecchi...,0,0,0,0,0,2021
UMB,  ,C 28,Fabbricazione di macchinari ed apparecchiature nca          ,0,0,0,0,0,2021
UMB,  ,C 29,"Fabbricazione di autoveicoli, rimorchi e semirimorchi       ",0,0,0,0,0,2021
UMB,  ,C 30,Fabbricazione di altri mezzi di trasporto                   ,0,0,0,0,0,2021
UMB,  ,C 31,Fabbricazione di mobili                                     ,0,0,1,0,1,2021
UMB,  ,C 32,Altre industrie manifatturiere                              ,0,0,1,0,1,2021
UMB,  ,C 33,"Riparazione, manutenzione ed installazione di macchine ed...",0,0,0,0,0,2021
UMB,  ,D   ,"Fornitura di energia elettrica, gas, vapore e aria condiz...",0,0,0,0,0,2021
UMB,  ,D 35,"Fornitura di energia elettrica, gas, vapore e aria condiz...",0,0,0,0,0,2021
UMB,  ,E   ,"Fornitura di acqua; reti fognarie, attività di gestione d...",0,0,0,0,0,2021
UMB,  ,E 36,"Raccolta, trattamento e fornitura di acqua                  ",0,0,0,0,0,2021
UMB,  ,E 37,Gestione delle reti fognarie                                ,0,0,0,0,0,2021
UMB,  ,E 38,"Attività di raccolta, trattamento e smaltimento dei rifiu...",0,0,0,0,0,2021
UMB,  ,E 39,Attività di risanamento e altri servizi di gestione dei r...,0,0,0,0,0,2021
UMB,  ,F   ,Costruzioni                                                 ,1,0,41,0,42,2021
UMB,  ,F 41,Costruzione di edifici                                      ,1,0,9,0,10,2021
UMB,  ,F 42,Ingegneria civile                                           ,0,0,0,0,0,2021
UMB,  ,F 43,Lavori di costruzione specializzati                         ,0,0,32,0,32,2021
UMB,  ,G   ,Commercio all'ingrosso e al dettaglio; riparazione di aut...,0,0,39,0,39,2021
UMB,  ,G 45,Commercio all'ingrosso e al dettaglio e riparazione di au...,0,0,4,0,4,2021
UMB,  ,G 46,Commercio all'ingrosso (escluso quello di autoveicoli e d...,0,0,4,0,4,2021
UMB,  ,G 47,Commercio al dettaglio (escluso quello di autoveicoli e d...,0,0,31,0,31,2021
UMB,  ,H   ,Trasporto e magazzinaggio                                   ,0,0,11,0,11,2021
UMB,  ,H 49,Trasporto terrestre e mediante condotte                     ,0,0,10,0,10,2021
UMB,  ,H 50,Trasporto marittimo e per vie d'acqua                       ,0,0,0,0,0,2021
UMB,  ,H 51,Trasporto aereo                                             ,0,0,0,0,0,2021
UMB,  ,H 52,Magazzinaggio e attività di supporto ai trasporti           ,0,0,1,0,1,2021
UMB,  ,H 53,Servizi postali e attività di corriere                      ,0,0,0,0,0,2021
UMB,  ,I   ,Attività dei servizi alloggio e ristorazione                ,0,0,11,0,11,2021
UMB,  ,I 55,Alloggio                                                    ,0,0,2,0,2,2021
UMB,  ,I 56,Attività dei servizi di ristorazione                        ,0,0,9,0,9,2021
UMB,  ,J   ,Servizi di informazione e comunicazione                     ,0,0,1,0,1,2021
UMB,  ,J 58,Attività editoriali                                         ,0,0,0,0,0,2021
UMB,  ,J 59,"Attività di produzione cinematografica, di video e di pro...",0,0,0,0,0,2021
UMB,  ,J 60,Attività di programmazione e trasmissione                   ,0,0,0,0,0,2021
UMB,  ,J 61,Telecomunicazioni                                           ,0,0,0,0,0,2021
UMB,  ,J 62,"Produzione di software, consulenza informatica e attività...",0,0,0,0,0,2021
UMB,  ,J 63,Attività dei servizi d'informazione e altri servizi infor...,0,0,1,0,1,2021
UMB,  ,K   ,Attività finanziarie e assicurative                         ,0,0,1,0,1,2021
UMB,  ,K 64,Attività di servizi finanziari (escluse le assicurazioni ...,0,0,0,0,0,2021
UMB,  ,K 65,"Assicurazioni, riassicurazioni e fondi pensione (escluse ...",0,0,0,0,0,2021
UMB,  ,K 66,Attività ausiliarie dei servizi finanziari e delle attivi...,0,0,1,0,1,2021
UMB,  ,L   ,Attivita' immobiliari                                       ,0,0,0,0,0,2021
UMB,  ,L 68,Attivita' immobiliari                                       ,0,0,0,0,0,2021
UMB,  ,M   ,"Attività professionali, scientifiche e tecniche             ",0,0,0,0,0,2021
UMB,  ,M 69,Attività legali e contabilità                               ,0,0,0,0,0,2021
UMB,  ,M 70,Attività di direzione aziendale e di consulenza gestional...,0,0,0,0,0,2021
UMB,  ,M 71,Attività degli studi di architettura e d'ingegneria; coll...,0,0,0,0,0,2021
UMB,  ,M 72,Ricerca scientifica e sviluppo                              ,0,0,0,0,0,2021
UMB,  ,M 73,Pubblicità e ricerche di mercato                            ,0,0,0,0,0,2021
UMB,  ,M 74,"Altre attività professionali, scientifiche e tecniche       ",0,0,0,0,0,2021
UMB,  ,M 75,Servizi veterinari                                          ,0,0,0,0,0,2021
UMB,  ,N   ,"Noleggio, agenzie di viaggio, servizi di supporto alle im...",0,0,2,0,2,2021
UMB,  ,N 77,Attività di noleggio e leasing operativo                    ,0,0,0,0,0,2021
UMB,  ,N 78,"Attività di ricerca, selezione, fornitura di personale      ",0,0,0,0,0,2021
UMB,  ,N 79,"Attività dei servizi delle agenzie di viaggio, dei tour o...",0,0,1,0,1,2021
UMB,  ,N 80,Servizi di vigilanza e investigazione                       ,0,0,0,0,0,2021
UMB,  ,N 81,Attività di servizi per edifici e paesaggio                 ,0,0,0,0,0,2021
UMB,  ,N 82,Attività di supporto per le funzioni d'ufficio e altri se...,0,0,1,0,1,2021
UMB,  ,O   ,Amministrazione pubblica e difesa; assicurazione sociale ...,0,0,0,0,0,2021
UMB,  ,O 84,Amministrazione pubblica e difesa; assicurazione sociale ...,0,0,0,0,0,2021
UMB,  ,P   ,Istruzione                                                  ,0,0,0,1,1,2021
UMB,  ,P 85,Istruzione                                                  ,0,0,0,1,1,2021
UMB,  ,Q   ,Sanita' e assistenza sociale                                ,0,0,0,0,0,2021
UMB,  ,Q 86,Assistenza sanitaria                                        ,0,0,0,0,0,2021
UMB,  ,Q 87,Servizi di assistenza sociale residenziale                  ,0,0,0,0,0,2021
UMB,  ,Q 88,Assistenza sociale non residenziale                         ,0,0,0,0,0,2021
UMB,  ,R   ,"Attività artistiche, sportive, di intrattenimento e diver...",0,0,0,0,0,2021
UMB,  ,R 90,"Attività creative, artistiche e di intrattenimento          ",0,0,0,0,0,2021
UMB,  ,R 91,"Attività di biblioteche, archivi, musei ed altre attività...",0,0,0,0,0,2021
UMB,  ,R 92,"Attività riguardanti le lotterie, le scommesse, le case d...",0,0,0,0,0,2021
UMB,  ,R 93,"Attività sportive, di intrattenimento e di divertimento     ",0,0,0,0,0,2021
UMB,  ,S   ,Altre attività di servizi                                   ,0,0,3,0,3,2021
UMB,  ,S 94,Attività di organizzazioni associative                      ,0,0,0,0,0,2021
UMB,  ,S 95,Riparazione di computer e di beni per uso personale e per...,0,0,0,0,0,2021
UMB,  ,S 96,Altre attività di servizi per la persona                    ,0,0,3,0,3,2021
UMB,  ,T   ,Attività di famiglie e convivenze come datori di lavoro p...,0,0,0,0,0,2021
UMB,  ,T 97,Attività di famiglie e convivenze come datori di lavoro p...,0,0,0,0,0,2021
UMB,  ,T 98,Produzione di beni e servizi indifferenziati per uso prop...,0,0,0,0,0,2021
UMB,  ,U   ,Organizzazioni ed organismi extraterritoriali               ,0,0,0,0,0,2021
UMB,  ,U 99,Organizzazioni ed organismi extraterritoriali               ,0,0,0,0,0,2021
UMB,  ,XX  ,Imprese non classificate                                    ,1,0,1,0,2,2021
UMB,  ,TOT ,TOTALE                                                      ,2,0,149,1,152,2021
UMB,PG,A   ,"Agricoltura, silvicoltura pesca                             ",0,0,19,0,19,2021
UMB,PG,A 01,"Coltivazioni agricole e produzione di prodotti animali, c...",0,0,18,0,18,2021
UMB,PG,A 02,Silvicoltura ed utilizzo di aree forestali                  ,0,0,1,0,1,2021
UMB,PG,A 03,Pesca e acquacoltura                                        ,0,0,0,0,0,2021
UMB,PG,B   ,Estrazione di minerali da cave e miniere                    ,0,0,0,0,0,2021
UMB,PG,B 05,Estrazione di carbone (esclusa torba)                       ,0,0,0,0,0,2021
UMB,PG,B 06,Estraz.di petrolio greggio e di gas naturale                ,0,0,0,0,0,2021
UMB,PG,B 07,Estrazione di minerali metalliferi                          ,0,0,0,0,0,2021
UMB,PG,B 08,Altre attività di estrazione di minerali da cave e miniere  ,0,0,0,0,0,2021
UMB,PG,B 09,Attività dei servizi di supporto all'estrazione             ,0,0,0,0,0,2021
UMB,PG,C   ,Attività manifatturiere                                     ,0,0,20,0,20,2021
UMB,PG,C 10,Industrie alimentari                                        ,0,0,0,0,0,2021
UMB,PG,C 11,Industria delle bevande                                     ,0,0,0,0,0,2021
UMB,PG,C 12,Industria del tabacco                                       ,0,0,0,0,0,2021
UMB,PG,C 13,Industrie tessili                                           ,0,0,0,0,0,2021
UMB,PG,C 14,Confezione di articoli di abbigliamento; confezione di ar...,0,0,6,0,6,2021
UMB,PG,C 15,Fabbricazione di articoli in pelle e simili                 ,0,0,1,0,1,2021
UMB,PG,C 16,Industria del legno e dei prodotti in legno e sughero (es...,0,0,5,0,5,2021
UMB,PG,C 17,Fabbricazione di carta e di prodotti di carta               ,0,0,0,0,0,2021
UMB,PG,C 18,Stampa e riproduzione di supporti registrati                ,0,0,0,0,0,2021
UMB,PG,C 19,Fabbricazione di coke e prodotti derivanti dalla raffinaz...,0,0,0,0,0,2021
UMB,PG,C 20,Fabbricazione di prodotti chimici                           ,0,0,0,0,0,2021
UMB,PG,C 21,Fabbricazione di prodotti farmaceutici di base e di prepa...,0,0,0,0,0,2021
UMB,PG,C 22,Fabbricazione di articoli in gomma e materie plastiche      ,0,0,0,0,0,2021
UMB,PG,C 23,Fabbricazione di altri prodotti della lavorazione di miner..,0,0,1,0,1,2021
UMB,PG,C 24,Metallurgia                                                 ,0,0,0,0,0,2021
UMB,PG,C 25,Fabbricazione di prodotti in metallo (esclusi macchinari ...,0,0,5,0,5,2021
UMB,PG,C 26,Fabbricazione di computer e prodotti di elettronica e ott...,0,0,0,0,0,2021
UMB,PG,C 27,Fabbricazione di apparecchiature elettriche ed apparecchi...,0,0,0,0,0,2021
UMB,PG,C 28,Fabbricazione di macchinari ed apparecchiature nca          ,0,0,0,0,0,2021
UMB,PG,C 29,"Fabbricazione di autoveicoli, rimorchi e semirimorchi       ",0,0,0,0,0,2021
UMB,PG,C 30,Fabbricazione di altri mezzi di trasporto                   ,0,0,0,0,0,2021
UMB,PG,C 31,Fabbricazione di mobili                                     ,0,0,1,0,1,2021
UMB,PG,C 32,Altre industrie manifatturiere                              ,0,0,1,0,1,2021
UMB,PG,C 33,"Riparazione, manutenzione ed installazione di macchine ed...",0,0,0,0,0,2021
UMB,PG,D   ,"Fornitura di energia elettrica, gas, vapore e aria condiz...",0,0,0,0,0,2021
UMB,PG,D 35,"Fornitura di energia elettrica, gas, vapore e aria condiz...",0,0,0,0,0,2021
UMB,PG,E   ,"Fornitura di acqua; reti fognarie, attività di gestione d...",0,0,0,0,0,2021
UMB,PG,E 36,"Raccolta, trattamento e fornitura di acqua                  ",0,0,0,0,0,2021
UMB,PG,E 37,Gestione delle reti fognarie                                ,0,0,0,0,0,2021
UMB,PG,E 38,"Attività di raccolta, trattamento e smaltimento dei rifiu...",0,0,0,0,0,2021
UMB,PG,E 39,Attività di risanamento e altri servizi di gestione dei r...,0,0,0,0,0,2021
UMB,PG,F   ,Costruzioni                                                 ,1,0,41,0,42,2021
UMB,PG,F 41,Costruzione di edifici                                      ,1,0,9,0,10,2021
UMB,PG,F 42,Ingegneria civile                                           ,0,0,0,0,0,2021
UMB,PG,F 43,Lavori di costruzione specializzati                         ,0,0,32,0,32,2021
UMB,PG,G   ,Commercio all'ingrosso e al dettaglio; riparazione di aut...,0,0,38,0,38,2021
UMB,PG,G 45,Commercio all'ingrosso e al dettaglio e riparazione di au...,0,0,4,0,4,2021
UMB,PG,G 46,Commercio all'ingrosso (escluso quello di autoveicoli e d...,0,0,4,0,4,2021
UMB,PG,G 47,Commercio al dettaglio (escluso quello di autoveicoli e d...,0,0,30,0,30,2021
UMB,PG,H   ,Trasporto e magazzinaggio                                   ,0,0,11,0,11,2021
UMB,PG,H 49,Trasporto terrestre e mediante condotte                     ,0,0,10,0,10,2021
UMB,PG,H 50,Trasporto marittimo e per vie d'acqua                       ,0,0,0,0,0,2021
UMB,PG,H 51,Trasporto aereo                                             ,0,0,0,0,0,2021
UMB,PG,H 52,Magazzinaggio e attività di supporto ai trasporti           ,0,0,1,0,1,2021
UMB,PG,H 53,Servizi postali e attività di corriere                      ,0,0,0,0,0,2021
UMB,PG,I   ,Attività dei servizi alloggio e ristorazione                ,0,0,11,0,11,2021
UMB,PG,I 55,Alloggio                                                    ,0,0,2,0,2,2021
UMB,PG,I 56,Attività dei servizi di ristorazione                        ,0,0,9,0,9,2021
UMB,PG,J   ,Servizi di informazione e comunicazione                     ,0,0,1,0,1,2021
UMB,PG,J 58,Attività editoriali                                         ,0,0,0,0,0,2021
UMB,PG,J 59,"Attività di produzione cinematografica, di video e di pro...",0,0,0,0,0,2021
UMB,PG,J 60,Attività di programmazione e trasmissione                   ,0,0,0,0,0,2021
UMB,PG,J 61,Telecomunicazioni                                           ,0,0,0,0,0,2021
UMB,PG,J 62,"Produzione di software, consulenza informatica e attività...",0,0,0,0,0,2021
UMB,PG,J 63,Attività dei servizi d'informazione e altri servizi infor...,0,0,1,0,1,2021
UMB,PG,K   ,Attività finanziarie e assicurative                         ,0,0,1,0,1,2021
UMB,PG,K 64,Attività di servizi finanziari (escluse le assicurazioni ...,0,0,0,0,0,2021
UMB,PG,K 65,"Assicurazioni, riassicurazioni e fondi pensione (escluse ...",0,0,0,0,0,2021
UMB,PG,K 66,Attività ausiliarie dei servizi finanziari e delle attivi...,0,0,1,0,1,2021
UMB,PG,L   ,Attivita' immobiliari                                       ,0,0,0,0,0,2021
UMB,PG,L 68,Attivita' immobiliari                                       ,0,0,0,0,0,2021
UMB,PG,M   ,"Attività professionali, scientifiche e tecniche             ",0,0,0,0,0,2021
UMB,PG,M 69,Attività legali e contabilità                               ,0,0,0,0,0,2021
UMB,PG,M 70,Attività di direzione aziendale e di consulenza gestional...,0,0,0,0,0,2021
UMB,PG,M 71,Attività degli studi di architettura e d'ingegneria; coll...,0,0,0,0,0,2021
UMB,PG,M 72,Ricerca scientifica e sviluppo                              ,0,0,0,0,0,2021
UMB,PG,M 73,Pubblicità e ricerche di mercato                            ,0,0,0,0,0,2021
UMB,PG,M 74,"Altre attività professionali, scientifiche e tecniche       ",0,0,0,0,0,2021
UMB,PG,M 75,Servizi veterinari                                          ,0,0,0,0,0,2021
UMB,PG,N   ,"Noleggio, agenzie di viaggio, servizi di supporto alle im...",0,0,2,0,2,2021
UMB,PG,N 77,Attività di noleggio e leasing operativo                    ,0,0,0,0,0,2021
UMB,PG,N 78,"Attività di ricerca, selezione, fornitura di personale      ",0,0,0,0,0,2021
UMB,PG,N 79,"Attività dei servizi delle agenzie di viaggio, dei tour o...",0,0,1,0,1,2021
UMB,PG,N 80,Servizi di vigilanza e investigazione                       ,0,0,0,0,0,2021
UMB,PG,N 81,Attività di servizi per edifici e paesaggio                 ,0,0,0,0,0,2021
UMB,PG,N 82,Attività di supporto per le funzioni d'ufficio e altri se...,0,0,1,0,1,2021
UMB,PG,O   ,Amministrazione pubblica e difesa; assicurazione sociale ...,0,0,0,0,0,2021
UMB,PG,O 84,Amministrazione pubblica e difesa; assicurazione sociale ...,0,0,0,0,0,2021
UMB,PG,P   ,Istruzione                                                  ,0,0,0,1,1,2021
UMB,PG,P 85,Istruzione                                                  ,0,0,0,1,1,2021
UMB,PG,Q   ,Sanita' e assistenza sociale                                ,0,0,0,0,0,2021
UMB,PG,Q 86,Assistenza sanitaria                                        ,0,0,0,0,0,2021
UMB,PG,Q 87,Servizi di assistenza sociale residenziale                  ,0,0,0,0,0,2021
UMB,PG,Q 88,Assistenza sociale non residenziale                         ,0,0,0,0,0,2021
UMB,PG,R   ,"Attività artistiche, sportive, di intrattenimento e diver...",0,0,0,0,0,2021
UMB,PG,R 90,"Attività creative, artistiche e di intrattenimento          ",0,0,0,0,0,2021
UMB,PG,R 91,"Attività di biblioteche, archivi, musei ed altre attività...",0,0,0,0,0,2021
UMB,PG,R 92,"Attività riguardanti le lotterie, le scommesse, le case d...",0,0,0,0,0,2021
UMB,PG,R 93,"Attività sportive, di intrattenimento e di divertimento     ",0,0,0,0,0,2021
UMB,PG,S   ,Altre attività di servizi                                   ,0,0,3,0,3,2021
UMB,PG,S 94,Attività di organizzazioni associative                      ,0,0,0,0,0,2021
UMB,PG,S 95,Riparazione di computer e di beni per uso personale e per...,0,0,0,0,0,2021
UMB,PG,S 96,Altre attività di servizi per la persona                    ,0,0,3,0,3,2021
UMB,PG,T   ,Attività di famiglie e convivenze come datori di lavoro p...,0,0,0,0,0,2021
UMB,PG,T 97,Attività di famiglie e convivenze come datori di lavoro p...,0,0,0,0,0,2021
UMB,PG,T 98,Produzione di beni e servizi indifferenziati per uso prop...,0,0,0,0,0,2021
UMB,PG,U   ,Organizzazioni ed organismi extraterritoriali               ,0,0,0,0,0,2021
UMB,PG,U 99,Organizzazioni ed organismi extraterritoriali               ,0,0,0,0,0,2021
UMB,PG,XX  ,Imprese non classificate                                    ,1,0,1,0,2,2021
UMB,PG,TOT ,TOTALE                                                      ,2,0,148,1,151,2021
UMB,TR,A   ,"Agricoltura, silvicoltura pesca                             ",0,0,0,0,0,2021
UMB,TR,A 01,"Coltivazioni agricole e produzione di prodotti animali, c...",0,0,0,0,0,2021
UMB,TR,A 02,Silvicoltura ed utilizzo di aree forestali                  ,0,0,0,0,0,2021
UMB,TR,A 03,Pesca e acquacoltura                                        ,0,0,0,0,0,2021
UMB,TR,B   ,Estrazione di minerali da cave e miniere                    ,0,0,0,0,0,2021
UMB,TR,B 05,Estrazione di carbone (esclusa torba)                       ,0,0,0,0,0,2021
UMB,TR,B 06,Estraz.di petrolio greggio e di gas naturale                ,0,0,0,0,0,2021
UMB,TR,B 07,Estrazione di minerali metalliferi                          ,0,0,0,0,0,2021
UMB,TR,B 08,Altre attività di estrazione di minerali da cave e miniere  ,0,0,0,0,0,2021
UMB,TR,B 09,Attività dei servizi di supporto all'estrazione             ,0,0,0,0,0,2021
UMB,TR,C   ,Attività manifatturiere                                     ,0,0,0,0,0,2021
UMB,TR,C 10,Industrie alimentari                                        ,0,0,0,0,0,2021
UMB,TR,C 11,Industria delle bevande                                     ,0,0,0,0,0,2021
UMB,TR,C 12,Industria del tabacco                                       ,0,0,0,0,0,2021
UMB,TR,C 13,Industrie tessili                                           ,0,0,0,0,0,2021
UMB,TR,C 14,Confezione di articoli di abbigliamento; confezione di ar...,0,0,0,0,0,2021
UMB,TR,C 15,Fabbricazione di articoli in pelle e simili                 ,0,0,0,0,0,2021
UMB,TR,C 16,Industria del legno e dei prodotti in legno e sughero (es...,0,0,0,0,0,2021
UMB,TR,C 17,Fabbricazione di carta e di prodotti di carta               ,0,0,0,0,0,2021
UMB,TR,C 18,Stampa e riproduzione di supporti registrati                ,0,0,0,0,0,2021
UMB,TR,C 19,Fabbricazione di coke e prodotti derivanti dalla raffinaz...,0,0,0,0,0,2021
UMB,TR,C 20,Fabbricazione di prodotti chimici                           ,0,0,0,0,0,2021
UMB,TR,C 21,Fabbricazione di prodotti farmaceutici di base e di prepa...,0,0,0,0,0,2021
UMB,TR,C 22,Fabbricazione di articoli in gomma e materie plastiche      ,0,0,0,0,0,2021
UMB,TR,C 23,Fabbricazione di altri prodotti della lavorazione di miner..,0,0,0,0,0,2021
UMB,TR,C 24,Metallurgia                                                 ,0,0,0,0,0,2021
UMB,TR,C 25,Fabbricazione di prodotti in metallo (esclusi macchinari ...,0,0,0,0,0,2021
UMB,TR,C 26,Fabbricazione di computer e prodotti di elettronica e ott...,0,0,0,0,0,2021
UMB,TR,C 27,Fabbricazione di apparecchiature elettriche ed apparecchi...,0,0,0,0,0,2021
UMB,TR,C 28,Fabbricazione di macchinari ed apparecchiature nca          ,0,0,0,0,0,2021
UMB,TR,C 29,"Fabbricazione di autoveicoli, rimorchi e semirimorchi       ",0,0,0,0,0,2021
UMB,TR,C 30,Fabbricazione di altri mezzi di trasporto                   ,0,0,0,0,0,2021
UMB,TR,C 31,Fabbricazione di mobili                                     ,0,0,0,0,0,2021
UMB,TR,C 32,Altre industrie manifatturiere                              ,0,0,0,0,0,2021
UMB,TR,C 33,"Riparazione, manutenzione ed installazione di macchine ed...",0,0,0,0,0,2021
UMB,TR,D   ,"Fornitura di energia elettrica, gas, vapore e aria condiz...",0,0,0,0,0,2021
UMB,TR,D 35,"Fornitura di energia elettrica, gas, vapore e aria condiz...",0,0,0,0,0,2021
UMB,TR,E   ,"Fornitura di acqua; reti fognarie, attività di gestione d...",0,0,0,0,0,2021
UMB,TR,E 36,"Raccolta, trattamento e fornitura di acqua                  ",0,0,0,0,0,2021
UMB,TR,E 37,Gestione delle reti fognarie                                ,0,0,0,0,0,2021
UMB,TR,E 38,"Attività di raccolta, trattamento e smaltimento dei rifiu...",0,0,0,0,0,2021
UMB,TR,E 39,Attività di risanamento e altri servizi di gestione dei r...,0,0,0,0,0,2021
UMB,TR,F   ,Costruzioni                                                 ,0,0,0,0,0,2021
UMB,TR,F 41,Costruzione di edifici                                      ,0,0,0,0,0,2021
UMB,TR,F 42,Ingegneria civile                                           ,0,0,0,0,0,2021
UMB,TR,F 43,Lavori di costruzione specializzati                         ,0,0,0,0,0,2021
UMB,TR,G   ,Commercio all'ingrosso e al dettaglio; riparazione di aut...,0,0,1,0,1,2021
UMB,TR,G 45,Commercio all'ingrosso e al dettaglio e riparazione di au...,0,0,0,0,0,2021
UMB,TR,G 46,Commercio all'ingrosso (escluso quello di autoveicoli e d...,0,0,0,0,0,2021
UMB,TR,G 47,Commercio al dettaglio (escluso quello di autoveicoli e d...,0,0,1,0,1,2021
UMB,TR,H   ,Trasporto e magazzinaggio                                   ,0,0,0,0,0,2021
UMB,TR,H 49,Trasporto terrestre e mediante condotte                     ,0,0,0,0,0,2021
UMB,TR,H 50,Trasporto marittimo e per vie d'acqua                       ,0,0,0,0,0,2021
UMB,TR,H 51,Trasporto aereo                                             ,0,0,0,0,0,2021
UMB,TR,H 52,Magazzinaggio e attività di supporto ai trasporti           ,0,0,0,0,0,2021
UMB,TR,H 53,Servizi postali e attività di corriere                      ,0,0,0,0,0,2021
UMB,TR,I   ,Attività dei servizi alloggio e ristorazione                ,0,0,0,0,0,2021
UMB,TR,I 55,Alloggio                                                    ,0,0,0,0,0,2021
UMB,TR,I 56,Attività dei servizi di ristorazione                        ,0,0,0,0,0,2021
UMB,TR,J   ,Servizi di informazione e comunicazione                     ,0,0,0,0,0,2021
UMB,TR,J 58,Attività editoriali                                         ,0,0,0,0,0,2021
UMB,TR,J 59,"Attività di produzione cinematografica, di video e di pro...",0,0,0,0,0,2021
UMB,TR,J 60,Attività di programmazione e trasmissione                   ,0,0,0,0,0,2021
UMB,TR,J 61,Telecomunicazioni                                           ,0,0,0,0,0,2021
UMB,TR,J 62,"Produzione di software, consulenza informatica e attività...",0,0,0,0,0,2021
UMB,TR,J 63,Attività dei servizi d'informazione e altri servizi infor...,0,0,0,0,0,2021
UMB,TR,K   ,Attività finanziarie e assicurative                         ,0,0,0,0,0,2021
UMB,TR,K 64,Attività di servizi finanziari (escluse le assicurazioni ...,0,0,0,0,0,2021
UMB,TR,K 65,"Assicurazioni, riassicurazioni e fondi pensione (escluse ...",0,0,0,0,0,2021
UMB,TR,K 66,Attività ausiliarie dei servizi finanziari e delle attivi...,0,0,0,0,0,2021
UMB,TR,L   ,Attivita' immobiliari                                       ,0,0,0,0,0,2021
UMB,TR,L 68,Attivita' immobiliari                                       ,0,0,0,0,0,2021
UMB,TR,M   ,"Attività professionali, scientifiche e tecniche             ",0,0,0,0,0,2021
UMB,TR,M 69,Attività legali e contabilità                               ,0,0,0,0,0,2021
UMB,TR,M 70,Attività di direzione aziendale e di consulenza gestional...,0,0,0,0,0,2021
UMB,TR,M 71,Attività degli studi di architettura e d'ingegneria; coll...,0,0,0,0,0,2021
UMB,TR,M 72,Ricerca scientifica e sviluppo                              ,0,0,0,0,0,2021
UMB,TR,M 73,Pubblicità e ricerche di mercato                            ,0,0,0,0,0,2021
UMB,TR,M 74,"Altre attività professionali, scientifiche e tecniche       ",0,0,0,0,0,2021
UMB,TR,M 75,Servizi veterinari                                          ,0,0,0,0,0,2021
UMB,TR,N   ,"Noleggio, agenzie di viaggio, servizi di supporto alle im...",0,0,0,0,0,2021
UMB,TR,N 77,Attività di noleggio e leasing operativo                    ,0,0,0,0,0,2021
UMB,TR,N 78,"Attività di ricerca, selezione, fornitura di personale      ",0,0,0,0,0,2021
UMB,TR,N 79,"Attività dei servizi delle agenzie di viaggio, dei tour o...",0,0,0,0,0,2021
UMB,TR,N 80,Servizi di vigilanza e investigazione                       ,0,0,0,0,0,2021
UMB,TR,N 81,Attività di servizi per edifici e paesaggio                 ,0,0,0,0,0,2021
UMB,TR,N 82,Attività di supporto per le funzioni d'ufficio e altri se...,0,0,0,0,0,2021
UMB,TR,O   ,Amministrazione pubblica e difesa; assicurazione sociale ...,0,0,0,0,0,2021
UMB,TR,O 84,Amministrazione pubblica e difesa; assicurazione sociale ...,0,0,0,0,0,2021
UMB,TR,P   ,Istruzione                                                  ,0,0,0,0,0,2021
UMB,TR,P 85,Istruzione                                                  ,0,0,0,0,0,2021
UMB,TR,Q   ,Sanita' e assistenza sociale                                ,0,0,0,0,0,2021
UMB,TR,Q 86,Assistenza sanitaria                                        ,0,0,0,0,0,2021
UMB,TR,Q 87,Servizi di assistenza sociale residenziale                  ,0,0,0,0,0,2021
UMB,TR,Q 88,Assistenza sociale non residenziale                         ,0,0,0,0,0,2021
UMB,TR,R   ,"Attività artistiche, sportive, di intrattenimento e diver...",0,0,0,0,0,2021
UMB,TR,R 90,"Attività creative, artistiche e di intrattenimento          ",0,0,0,0,0,2021
UMB,TR,R 91,"Attività di biblioteche, archivi, musei ed altre attività...",0,0,0,0,0,2021
UMB,TR,R 92,"Attività riguardanti le lotterie, le scommesse, le case d...",0,0,0,0,0,2021
UMB,TR,R 93,"Attività sportive, di intrattenimento e di divertimento     ",0,0,0,0,0,2021
UMB,TR,S   ,Altre attività di servizi                                   ,0,0,0,0,0,2021
UMB,TR,S 94,Attività di organizzazioni associative                      ,0,0,0,0,0,2021
UMB,TR,S 95,Riparazione di computer e di beni per uso personale e per...,0,0,0,0,0,2021
UMB,TR,S 96,Altre attività di servizi per la persona                    ,0,0,0,0,0,2021
UMB,TR,T   ,Attività di famiglie e convivenze come datori di lavoro p...,0,0,0,0,0,2021
UMB,TR,T 97,Attività di famiglie e convivenze come datori di lavoro p...,0,0,0,0,0,2021
UMB,TR,T 98,Produzione di beni e servizi indifferenziati per uso prop...,0,0,0,0,0,2021
UMB,TR,U   ,Organizzazioni ed organismi extraterritoriali               ,0,0,0,0,0,2021
UMB,TR,U 99,Organizzazioni ed organismi extraterritoriali               ,0,0,0,0,0,2021
UMB,TR,XX  ,Imprese non classificate                                    ,0,0,0,0,0,2021
UMB,TR,TOT ,TOTALE                                                      ,0,0,1,0,1,2021
MAR,  ,A   ,"Agricoltura, silvicoltura pesca                             ",1,30,245,1,277,2021
MAR,  ,A 01,"Coltivazioni agricole e produzione di prodotti animali, c...",1,29,243,1,274,2021
MAR,  ,A 02,Silvicoltura ed utilizzo di aree forestali                  ,0,0,2,0,2,2021
MAR,  ,A 03,Pesca e acquacoltura                                        ,0,1,0,0,1,2021
MAR,  ,B   ,Estrazione di minerali da cave e miniere                    ,0,0,0,0,0,2021
MAR,  ,B 05,Estrazione di carbone (esclusa torba)                       ,0,0,0,0,0,2021
MAR,  ,B 06,Estraz.di petrolio greggio e di gas naturale                ,0,0,0,0,0,2021
MAR,  ,B 07,Estrazione di minerali metalliferi                          ,0,0,0,0,0,2021
MAR,  ,B 08,Altre attività di estrazione di minerali da cave e miniere  ,0,0,0,0,0,2021
MAR,  ,B 09,Attività dei servizi di supporto all'estrazione             ,0,0,0,0,0,2021
MAR,  ,C   ,Attività manifatturiere                                     ,91,86,118,0,295,2021
MAR,  ,C 10,Industrie alimentari                                        ,1,5,2,0,8,2021
MAR,  ,C 11,Industria delle bevande                                     ,0,0,0,0,0,2021
MAR,  ,C 12,Industria del tabacco                                       ,0,0,0,0,0,2021
MAR,  ,C 13,Industrie tessili                                           ,0,2,2,0,4,2021
MAR,  ,C 14,Confezione di articoli di abbigliamento; confezione di ar...,7,2,21,0,30,2021
MAR,  ,C 15,Fabbricazione di articoli in pelle e simili                 ,36,45,24,0,105,2021
MAR,  ,C 16,Industria del legno e dei prodotti in legno e sughero (es...,6,1,9,0,16,2021
MAR,  ,C 17,Fabbricazione di carta e di prodotti di carta               ,1,1,1,0,3,2021
MAR,  ,C 18,Stampa e riproduzione di supporti registrati                ,1,0,1,0,2,2021
MAR,  ,C 19,Fabbricazione di coke e prodotti derivanti dalla raffinaz...,0,0,0,0,0,2021
MAR,  ,C 20,Fabbricazione di prodotti chimici                           ,0,0,0,0,0,2021
MAR,  ,C 21,Fabbricazione di prodotti farmaceutici di base e di prepa...,0,0,0,0,0,2021
MAR,  ,C 22,Fabbricazione di articoli in gomma e materie plastiche      ,4,4,5,0,13,2021
MAR,  ,C 23,Fabbricazione di altri prodotti della lavorazione di miner..,3,2,2,0,7,2021
MAR,  ,C 24,Metallurgia                                                 ,0,1,1,0,2,2021
MAR,  ,C 25,Fabbricazione di prodotti in metallo (esclusi macchinari ...,6,10,21,0,37,2021
MAR,  ,C 26,Fabbricazione di computer e prodotti di elettronica e ott...,1,1,2,0,4,2021
MAR,  ,C 27,Fabbricazione di apparecchiature elettriche ed apparecchi...,1,2,3,0,6,2021
MAR,  ,C 28,Fabbricazione di macchinari ed apparecchiature nca          ,6,5,1,0,12,2021
MAR,  ,C 29,"Fabbricazione di autoveicoli, rimorchi e semirimorchi       ",0,0,0,0,0,2021
MAR,  ,C 30,Fabbricazione di altri mezzi di trasporto                   ,4,0,6,0,10,2021
MAR,  ,C 31,Fabbricazione di mobili                                     ,5,2,11,0,18,2021
MAR,  ,C 32,Altre industrie manifatturiere                              ,4,1,2,0,7,2021
MAR,  ,C 33,"Riparazione, manutenzione ed installazione di macchine ed...",5,2,4,0,11,2021
MAR,  ,D   ,"Fornitura di energia elettrica, gas, vapore e aria condiz...",0,0,0,0,0,2021
MAR,  ,D 35,"Fornitura di energia elettrica, gas, vapore e aria condiz...",0,0,0,0,0,2021
MAR,  ,E   ,"Fornitura di acqua; reti fognarie, attività di gestione d...",1,0,1,0,2,2021
MAR,  ,E 36,"Raccolta, trattamento e fornitura di acqua                  ",0,0,0,0,0,2021
MAR,  ,E 37,Gestione delle reti fognarie                                ,0,0,0,0,0,2021
MAR,  ,E 38,"Attività di raccolta, trattamento e smaltimento dei rifiu...",1,0,1,0,2,2021
MAR,  ,E 39,Attività di risanamento e altri servizi di gestione dei r...,0,0,0,0,0,2021
MAR,  ,F   ,Costruzioni                                                 ,62,62,376,2,502,2021
MAR,  ,F 41,Costruzione di edifici                                      ,50,29,74,2,155,2021
MAR,  ,F 42,Ingegneria civile                                           ,0,0,4,0,4,2021
MAR,  ,F 43,Lavori di costruzione specializzati                         ,12,33,298,0,343,2021
MAR,  ,G   ,Commercio all'ingrosso e al dettaglio; riparazione di aut...,105,97,172,4,378,2021
MAR,  ,G 45,Commercio all'ingrosso e al dettaglio e riparazione di au...,13,5,13,0,31,2021
MAR,  ,G 46,Commercio all'ingrosso (escluso quello di autoveicoli e d...,50,26,48,1,125,2021
MAR,  ,G 47,Commercio al dettaglio (escluso quello di autoveicoli e d...,42,66,111,3,222,2021
MAR,  ,H   ,Trasporto e magazzinaggio                                   ,5,12,26,2,45,2021
MAR,  ,H 49,Trasporto terrestre e mediante condotte                     ,2,11,26,1,40,2021
MAR,  ,H 50,Trasporto marittimo e per vie d'acqua                       ,0,0,0,0,0,2021
MAR,  ,H 51,Trasporto aereo                                             ,0,0,0,0,0,2021
MAR,  ,H 52,Magazzinaggio e attività di supporto ai trasporti           ,3,1,0,1,5,2021
MAR,  ,H 53,Servizi postali e attività di corriere                      ,0,0,0,0,0,2021
MAR,  ,I   ,Attività dei servizi alloggio e ristorazione                ,30,132,31,0,193,2021
MAR,  ,I 55,Alloggio                                                    ,6,4,3,0,13,2021
MAR,  ,I 56,Attività dei servizi di ristorazione                        ,24,128,28,0,180,2021
MAR,  ,J   ,Servizi di informazione e comunicazione                     ,5,7,11,0,23,2021
MAR,  ,J 58,Attività editoriali                                         ,1,1,3,0,5,2021
MAR,  ,J 59,"Attività di produzione cinematografica, di video e di pro...",0,1,1,0,2,2021
MAR,  ,J 60,Attività di programmazione e trasmissione                   ,0,0,0,0,0,2021
MAR,  ,J 61,Telecomunicazioni                                           ,1,3,2,0,6,2021
MAR,  ,J 62,"Produzione di software, consulenza informatica e attività...",1,0,2,0,3,2021
MAR,  ,J 63,Attività dei servizi d'informazione e altri servizi infor...,2,2,3,0,7,2021
MAR,  ,K   ,Attività finanziarie e assicurative                         ,1,4,7,0,12,2021
MAR,  ,K 64,Attività di servizi finanziari (escluse le assicurazioni ...,1,0,0,0,1,2021
MAR,  ,K 65,"Assicurazioni, riassicurazioni e fondi pensione (escluse ...",0,0,0,0,0,2021
MAR,  ,K 66,Attività ausiliarie dei servizi finanziari e delle attivi...,0,4,7,0,11,2021
MAR,  ,L   ,Attivita' immobiliari                                       ,25,7,4,0,36,2021
MAR,  ,L 68,Attivita' immobiliari                                       ,25,7,4,0,36,2021
MAR,  ,M   ,"Attività professionali, scientifiche e tecniche             ",13,4,11,2,30,2021
MAR,  ,M 69,Attività legali e contabilità                               ,0,0,0,0,0,2021
MAR,  ,M 70,Attività di direzione aziendale e di consulenza gestional...,9,1,4,2,16,2021
MAR,  ,M 71,Attività degli studi di architettura e d'ingegneria; coll...,0,0,1,0,1,2021
MAR,  ,M 72,Ricerca scientifica e sviluppo                              ,0,0,0,0,0,2021
MAR,  ,M 73,Pubblicità e ricerche di mercato                            ,3,1,0,0,4,2021
MAR,  ,M 74,"Altre attività professionali, scientifiche e tecniche       ",1,2,6,0,9,2021
MAR,  ,M 75,Servizi veterinari                                          ,0,0,0,0,0,2021
MAR,  ,N   ,"Noleggio, agenzie di viaggio, servizi di supporto alle im...",11,12,16,1,40,2021
MAR,  ,N 77,Attività di noleggio e leasing operativo                    ,1,4,2,0,7,2021
MAR,  ,N 78,"Attività di ricerca, selezione, fornitura di personale      ",0,0,0,0,0,2021
MAR,  ,N 79,"Attività dei servizi delle agenzie di viaggio, dei tour o...",2,1,0,1,4,2021
MAR,  ,N 80,Servizi di vigilanza e investigazione                       ,0,0,1,0,1,2021
MAR,  ,N 81,Attività di servizi per edifici e paesaggio                 ,3,3,7,0,13,2021
MAR,  ,N 82,Attività di supporto per le funzioni d'ufficio e altri se...,5,4,6,0,15,2021
MAR,  ,O   ,Amministrazione pubblica e difesa; assicurazione sociale ...,0,0,0,0,0,2021
MAR,  ,O 84,Amministrazione pubblica e difesa; assicurazione sociale ...,0,0,0,0,0,2021
MAR,  ,P   ,Istruzione                                                  ,1,3,0,0,4,2021
MAR,  ,P 85,Istruzione                                                  ,1,3,0,0,4,2021
MAR,  ,Q   ,Sanita' e assistenza sociale                                ,0,1,0,0,1,2021
MAR,  ,Q 86,Assistenza sanitaria                                        ,0,0,0,0,0,2021
MAR,  ,Q 87,Servizi di assistenza sociale residenziale                  ,0,0,0,0,0,2021
MAR,  ,Q 88,Assistenza sociale non residenziale                         ,0,1,0,0,1,2021
MAR,  ,R   ,"Attività artistiche, sportive, di intrattenimento e diver...",11,9,10,0,30,2021
MAR,  ,R 90,"Attività creative, artistiche e di intrattenimento          ",2,0,3,0,5,2021
MAR,  ,R 91,"Attività di biblioteche, archivi, musei ed altre attività...",0,0,0,0,0,2021
MAR,  ,R 92,"Attività riguardanti le lotterie, le scommesse, le case d...",1,3,0,0,4,2021
MAR,  ,R 93,"Attività sportive, di intrattenimento e di divertimento     ",8,6,7,0,21,2021
MAR,  ,S   ,Altre attività di servizi                                   ,5,20,30,1,56,2021
MAR,  ,S 94,Attività di organizzazioni associative                      ,0,0,0,0,0,2021
MAR,  ,S 95,Riparazione di computer e di beni per uso personale e per...,1,3,14,0,18,2021
MAR,  ,S 96,Altre attività di servizi per la persona                    ,4,17,16,1,38,2021
MAR,  ,T   ,Attività di famiglie e convivenze come datori di lavoro p...,0,0,0,0,0,2021
MAR,  ,T 97,Attività di famiglie e convivenze come datori di lavoro p...,0,0,0,0,0,2021
MAR,  ,T 98,Produzione di beni e servizi indifferenziati per uso prop...,0,0,0,0,0,2021
MAR,  ,U   ,Organizzazioni ed organismi extraterritoriali               ,0,0,0,0,0,2021
MAR,  ,U 99,Organizzazioni ed organismi extraterritoriali               ,0,0,0,0,0,2021
MAR,  ,XX  ,Imprese non classificate                                    ,55,79,13,6,153,2021
MAR,  ,TOT ,TOTALE                                                      ,422,565,1071,19,2077,2021
MAR,PS,A   ,"Agricoltura, silvicoltura pesca                             ",0,1,23,0,24,2021
MAR,PS,A 01,"Coltivazioni agricole e produzione di prodotti animali, c...",0,1,23,0,24,2021
MAR,PS,A 02,Silvicoltura ed utilizzo di aree forestali                  ,0,0,0,0,0,2021
MAR,PS,A 03,Pesca e acquacoltura                                        ,0,0,0,0,0,2021
MAR,PS,B   ,Estrazione di minerali da cave e miniere                    ,0,0,0,0,0,2021
MAR,PS,B 05,Estrazione di carbone (esclusa torba)                       ,0,0,0,0,0,2021
MAR,PS,B 06,Estraz.di petrolio greggio e di gas naturale                ,0,0,0,0,0,2021
MAR,PS,B 07,Estrazione di minerali metalliferi                          ,0,0,0,0,0,2021
MAR,PS,B 08,Altre attività di estrazione di minerali da cave e miniere  ,0,0,0,0,0,2021
MAR,PS,B 09,Attività dei servizi di supporto all'estrazione             ,0,0,0,0,0,2021
MAR,PS,C   ,Attività manifatturiere                                     ,12,4,38,0,54,2021
MAR,PS,C 10,Industrie alimentari                                        ,0,0,0,0,0,2021
MAR,PS,C 11,Industria delle bevande                                     ,0,0,0,0,0,2021
MAR,PS,C 12,Industria del tabacco                                       ,0,0,0,0,0,2021
MAR,PS,C 13,Industrie tessili                                           ,0,1,0,0,1,2021
MAR,PS,C 14,Confezione di articoli di abbigliamento; confezione di ar...,1,1,10,0,12,2021
MAR,PS,C 15,Fabbricazione di articoli in pelle e simili                 ,0,0,1,0,1,2021
MAR,PS,C 16,Industria del legno e dei prodotti in legno e sughero (es...,1,0,2,0,3,2021
MAR,PS,C 17,Fabbricazione di carta e di prodotti di carta               ,0,0,0,0,0,2021
MAR,PS,C 18,Stampa e riproduzione di supporti registrati                ,0,0,0,0,0,2021
MAR,PS,C 19,Fabbricazione di coke e prodotti derivanti dalla raffinaz...,0,0,0,0,0,2021
MAR,PS,C 20,Fabbricazione di prodotti chimici                           ,0,0,0,0,0,2021
MAR,PS,C 21,Fabbricazione di prodotti farmaceutici di base e di prepa...,0,0,0,0,0,2021
MAR,PS,C 22,Fabbricazione di articoli in gomma e materie plastiche      ,0,0,4,0,4,2021
MAR,PS,C 23,Fabbricazione di altri prodotti della lavorazione di miner..,0,0,0,0,0,2021
MAR,PS,C 24,Metallurgia                                                 ,0,0,0,0,0,2021
MAR,PS,C 25,Fabbricazione di prodotti in metallo (esclusi macchinari ...,1,1,5,0,7,2021
MAR,PS,C 26,Fabbricazione di computer e prodotti di elettronica e ott...,1,0,1,0,2,2021
MAR,PS,C 27,Fabbricazione di apparecchiature elettriche ed apparecchi...,0,1,0,0,1,2021
MAR,PS,C 28,Fabbricazione di macchinari ed apparecchiature nca          ,1,0,0,0,1,2021
MAR,PS,C 29,"Fabbricazione di autoveicoli, rimorchi e semirimorchi       ",0,0,0,0,0,2021
MAR,PS,C 30,Fabbricazione di altri mezzi di trasporto                   ,3,0,6,0,9,2021
MAR,PS,C 31,Fabbricazione di mobili                                     ,4,0,8,0,12,2021
MAR,PS,C 32,Altre industrie manifatturiere                              ,0,0,0,0,0,2021
MAR,PS,C 33,"Riparazione, manutenzione ed installazione di macchine ed...",0,0,1,0,1,2021
MAR,PS,D   ,"Fornitura di energia elettrica, gas, vapore e aria condiz...",0,0,0,0,0,2021
MAR,PS,D 35,"Fornitura di energia elettrica, gas, vapore e aria condiz...",0,0,0,0,0,2021
MAR,PS,E   ,"Fornitura di acqua; reti fognarie, attività di gestione d...",0,0,0,0,0,2021
MAR,PS,E 36,"Raccolta, trattamento e fornitura di acqua                  ",0,0,0,0,0,2021
MAR,PS,E 37,Gestione delle reti fognarie                                ,0,0,0,0,0,2021
MAR,PS,E 38,"Attività di raccolta, trattamento e smaltimento dei rifiu...",0,0,0,0,0,2021
MAR,PS,E 39,Attività di risanamento e altri servizi di gestione dei r...,0,0,0,0,0,2021
MAR,PS,F   ,Costruzioni                                                 ,8,1,69,0,78,2021
MAR,PS,F 41,Costruzione di edifici                                      ,7,1,16,0,24,2021
MAR,PS,F 42,Ingegneria civile                                           ,0,0,1,0,1,2021
MAR,PS,F 43,Lavori di costruzione specializzati                         ,1,0,52,0,53,2021
MAR,PS,G   ,Commercio all'ingrosso e al dettaglio; riparazione di aut...,10,4,54,1,69,2021
MAR,PS,G 45,Commercio all'ingrosso e al dettaglio e riparazione di au...,4,0,3,0,7,2021
MAR,PS,G 46,Commercio all'ingrosso (escluso quello di autoveicoli e d...,4,0,16,0,20,2021
MAR,PS,G 47,Commercio al dettaglio (escluso quello di autoveicoli e d...,2,4,35,1,42,2021
MAR,PS,H   ,Trasporto e magazzinaggio                                   ,0,1,6,0,7,2021
MAR,PS,H 49,Trasporto terrestre e mediante condotte                     ,0,1,6,0,7,2021
MAR,PS,H 50,Trasporto marittimo e per vie d'acqua                       ,0,0,0,0,0,2021
MAR,PS,H 51,Trasporto aereo                                             ,0,0,0,0,0,2021
MAR,PS,H 52,Magazzinaggio e attività di supporto ai trasporti           ,0,0,0,0,0,2021
MAR,PS,H 53,Servizi postali e attività di corriere                      ,0,0,0,0,0,2021
MAR,PS,I   ,Attività dei servizi alloggio e ristorazione                ,1,3,10,0,14,2021
MAR,PS,I 55,Alloggio                                                    ,1,0,2,0,3,2021
MAR,PS,I 56,Attività dei servizi di ristorazione                        ,0,3,8,0,11,2021
MAR,PS,J   ,Servizi di informazione e comunicazione                     ,2,0,4,0,6,2021
MAR,PS,J 58,Attività editoriali                                         ,0,0,1,0,1,2021
MAR,PS,J 59,"Attività di produzione cinematografica, di video e di pro...",0,0,1,0,1,2021
MAR,PS,J 60,Attività di programmazione e trasmissione                   ,0,0,0,0,0,2021
MAR,PS,J 61,Telecomunicazioni                                           ,0,0,0,0,0,2021
MAR,PS,J 62,"Produzione di software, consulenza informatica e attività...",0,0,1,0,1,2021
MAR,PS,J 63,Attività dei servizi d'informazione e altri servizi infor...,2,0,1,0,3,2021
MAR,PS,K   ,Attività finanziarie e assicurative                         ,0,2,3,0,5,2021
MAR,PS,K 64,Attività di servizi finanziari (escluse le assicurazioni ...,0,0,0,0,0,2021
MAR,PS,K 65,"Assicurazioni, riassicurazioni e fondi pensione (escluse ...",0,0,0,0,0,2021
MAR,PS,K 66,Attività ausiliarie dei servizi finanziari e delle attivi...,0,2,3,0,5,2021
MAR,PS,L   ,Attivita' immobiliari                                       ,5,0,2,0,7,2021
MAR,PS,L 68,Attivita' immobiliari                                       ,5,0,2,0,7,2021
MAR,PS,M   ,"Attività professionali, scientifiche e tecniche             ",1,0,4,1,6,2021
MAR,PS,M 69,Attività legali e contabilità                               ,0,0,0,0,0,2021
MAR,PS,M 70,Attività di direzione aziendale e di consulenza gestional...,1,0,1,1,3,2021
MAR,PS,M 71,Attività degli studi di architettura e d'ingegneria; coll...,0,0,0,0,0,2021
MAR,PS,M 72,Ricerca scientifica e sviluppo                              ,0,0,0,0,0,2021
MAR,PS,M 73,Pubblicità e ricerche di mercato                            ,0,0,0,0,0,2021
MAR,PS,M 74,"Altre attività professionali, scientifiche e tecniche       ",0,0,3,0,3,2021
MAR,PS,M 75,Servizi veterinari                                          ,0,0,0,0,0,2021
MAR,PS,N   ,"Noleggio, agenzie di viaggio, servizi di supporto alle im...",3,0,4,0,7,2021
MAR,PS,N 77,Attività di noleggio e leasing operativo                    ,0,0,1,0,1,2021
MAR,PS,N 78,"Attività di ricerca, selezione, fornitura di personale      ",0,0,0,0,0,2021
MAR,PS,N 79,"Attività dei servizi delle agenzie di viaggio, dei tour o...",0,0,0,0,0,2021
MAR,PS,N 80,Servizi di vigilanza e investigazione                       ,0,0,0,0,0,2021
MAR,PS,N 81,Attività di servizi per edifici e paesaggio                 ,3,0,2,0,5,2021
MAR,PS,N 82,Attività di supporto per le funzioni d'ufficio e altri se...,0,0,1,0,1,2021
MAR,PS,O   ,Amministrazione pubblica e difesa; assicurazione sociale ...,0,0,0,0,0,2021
MAR,PS,O 84,Amministrazione pubblica e difesa; assicurazione sociale ...,0,0,0,0,0,2021
MAR,PS,P   ,Istruzione                                                  ,0,0,0,0,0,2021
MAR,PS,P 85,Istruzione                                                  ,0,0,0,0,0,2021
MAR,PS,Q   ,Sanita' e assistenza sociale                                ,0,0,0,0,0,2021
MAR,PS,Q 86,Assistenza sanitaria                                        ,0,0,0,0,0,2021
MAR,PS,Q 87,Servizi di assistenza sociale residenziale                  ,0,0,0,0,0,2021
MAR,PS,Q 88,Assistenza sociale non residenziale                         ,0,0,0,0,0,2021
MAR,PS,R   ,"Attività artistiche, sportive, di intrattenimento e diver...",3,0,4,0,7,2021
MAR,PS,R 90,"Attività creative, artistiche e di intrattenimento          ",1,0,1,0,2,2021
MAR,PS,R 91,"Attività di biblioteche, archivi, musei ed altre attività...",0,0,0,0,0,2021
MAR,PS,R 92,"Attività riguardanti le lotterie, le scommesse, le case d...",0,0,0,0,0,2021
MAR,PS,R 93,"Attività sportive, di intrattenimento e di divertimento     ",2,0,3,0,5,2021
MAR,PS,S   ,Altre attività di servizi                                   ,1,0,6,0,7,2021
MAR,PS,S 94,Attività di organizzazioni associative                      ,0,0,0,0,0,2021
MAR,PS,S 95,Riparazione di computer e di beni per uso personale e per...,0,0,3,0,3,2021
MAR,PS,S 96,Altre attività di servizi per la persona                    ,1,0,3,0,4,2021
MAR,PS,T   ,Attività di famiglie e convivenze come datori di lavoro p...,0,0,0,0,0,2021
MAR,PS,T 97,Attività di famiglie e convivenze come datori di lavoro p...,0,0,0,0,0,2021
MAR,PS,T 98,Produzione di beni e servizi indifferenziati per uso prop...,0,0,0,0,0,2021
MAR,PS,U   ,Organizzazioni ed organismi extraterritoriali               ,0,0,0,0,0,2021
MAR,PS,U 99,Organizzazioni ed organismi extraterritoriali               ,0,0,0,0,0,2021
MAR,PS,XX  ,Imprese non classificate                                    ,3,0,4,0,7,2021
MAR,PS,TOT ,TOTALE                                                      ,49,16,231,2,298,2021
MAR,AN,A   ,"Agricoltura, silvicoltura pesca                             ",0,0,63,0,63,2021
MAR,AN,A 01,"Coltivazioni agricole e produzione di prodotti animali, c...",0,0,63,0,63,2021
MAR,AN,A 02,Silvicoltura ed utilizzo di aree forestali                  ,0,0,0,0,0,2021
MAR,AN,A 03,Pesca e acquacoltura                                        ,0,0,0,0,0,2021
MAR,AN,B   ,Estrazione di minerali da cave e miniere                    ,0,0,0,0,0,2021
MAR,AN,B 05,Estrazione di carbone (esclusa torba)                       ,0,0,0,0,0,2021
MAR,AN,B 06,Estraz.di petrolio greggio e di gas naturale                ,0,0,0,0,0,2021
MAR,AN,B 07,Estrazione di minerali metalliferi                          ,0,0,0,0,0,2021
MAR,AN,B 08,Altre attività di estrazione di minerali da cave e miniere  ,0,0,0,0,0,2021
MAR,AN,B 09,Attività dei servizi di supporto all'estrazione             ,0,0,0,0,0,2021
MAR,AN,C   ,Attività manifatturiere                                     ,0,0,10,0,10,2021
MAR,AN,C 10,Industrie alimentari                                        ,0,0,0,0,0,2021
MAR,AN,C 11,Industria delle bevande                                     ,0,0,0,0,0,2021
MAR,AN,C 12,Industria del tabacco                                       ,0,0,0,0,0,2021
MAR,AN,C 13,Industrie tessili                                           ,0,0,0,0,0,2021
MAR,AN,C 14,Confezione di articoli di abbigliamento; confezione di ar...,0,0,3,0,3,2021
MAR,AN,C 15,Fabbricazione di articoli in pelle e simili                 ,0,0,1,0,1,2021
MAR,AN,C 16,Industria del legno e dei prodotti in legno e sughero (es...,0,0,1,0,1,2021
MAR,AN,C 17,Fabbricazione di carta e di prodotti di carta               ,0,0,0,0,0,2021
MAR,AN,C 18,Stampa e riproduzione di supporti registrati                ,0,0,0,0,0,2021
MAR,AN,C 19,Fabbricazione di coke e prodotti derivanti dalla raffinaz...,0,0,0,0,0,2021
MAR,AN,C 20,Fabbricazione di prodotti chimici                           ,0,0,0,0,0,2021
MAR,AN,C 21,Fabbricazione di prodotti farmaceutici di base e di prepa...,0,0,0,0,0,2021
MAR,AN,C 22,Fabbricazione di articoli in gomma e materie plastiche      ,0,0,0,0,0,2021
MAR,AN,C 23,Fabbricazione di altri prodotti della lavorazione di miner..,0,0,0,0,0,2021
MAR,AN,C 24,Metallurgia                                                 ,0,0,0,0,0,2021
MAR,AN,C 25,Fabbricazione di prodotti in metallo (esclusi macchinari ...,0,0,3,0,3,2021
MAR,AN,C 26,Fabbricazione di computer e prodotti di elettronica e ott...,0,0,0,0,0,2021
MAR,AN,C 27,Fabbricazione di apparecchiature elettriche ed apparecchi...,0,0,1,0,1,2021
MAR,AN,C 28,Fabbricazione di macchinari ed apparecchiature nca          ,0,0,0,0,0,2021
MAR,AN,C 29,"Fabbricazione di autoveicoli, rimorchi e semirimorchi       ",0,0,0,0,0,2021
MAR,AN,C 30,Fabbricazione di altri mezzi di trasporto                   ,0,0,0,0,0,2021
MAR,AN,C 31,Fabbricazione di mobili                                     ,0,0,0,0,0,2021
MAR,AN,C 32,Altre industrie manifatturiere                              ,0,0,0,0,0,2021
MAR,AN,C 33,"Riparazione, manutenzione ed installazione di macchine ed...",0,0,1,0,1,2021
MAR,AN,D   ,"Fornitura di energia elettrica, gas, vapore e aria condiz...",0,0,0,0,0,2021
MAR,AN,D 35,"Fornitura di energia elettrica, gas, vapore e aria condiz...",0,0,0,0,0,2021
MAR,AN,E   ,"Fornitura di acqua; reti fognarie, attività di gestione d...",0,0,0,0,0,2021
MAR,AN,E 36,"Raccolta, trattamento e fornitura di acqua                  ",0,0,0,0,0,2021
MAR,AN,E 37,Gestione delle reti fognarie                                ,0,0,0,0,0,2021
MAR,AN,E 38,"Attività di raccolta, trattamento e smaltimento dei rifiu...",0,0,0,0,0,2021
MAR,AN,E 39,Attività di risanamento e altri servizi di gestione dei r...,0,0,0,0,0,2021
MAR,AN,F   ,Costruzioni                                                 ,0,0,29,0,29,2021
MAR,AN,F 41,Costruzione di edifici                                      ,0,0,8,0,8,2021
MAR,AN,F 42,Ingegneria civile                                           ,0,0,0,0,0,2021
MAR,AN,F 43,Lavori di costruzione specializzati                         ,0,0,21,0,21,2021
MAR,AN,G   ,Commercio all'ingrosso e al dettaglio; riparazione di aut...,0,0,55,2,57,2021
MAR,AN,G 45,Commercio all'ingrosso e al dettaglio e riparazione di au...,0,0,4,0,4,2021
MAR,AN,G 46,Commercio all'ingrosso (escluso quello di autoveicoli e d...,0,0,14,1,15,2021
MAR,AN,G 47,Commercio al dettaglio (escluso quello di autoveicoli e d...,0,0,37,1,38,2021
MAR,AN,H   ,Trasporto e magazzinaggio                                   ,0,0,8,0,8,2021
MAR,AN,H 49,Trasporto terrestre e mediante condotte                     ,0,0,8,0,8,2021
MAR,AN,H 50,Trasporto marittimo e per vie d'acqua                       ,0,0,0,0,0,2021
MAR,AN,H 51,Trasporto aereo                                             ,0,0,0,0,0,2021
MAR,AN,H 52,Magazzinaggio e attività di supporto ai trasporti           ,0,0,0,0,0,2021
MAR,AN,H 53,Servizi postali e attività di corriere                      ,0,0,0,0,0,2021
MAR,AN,I   ,Attività dei servizi alloggio e ristorazione                ,0,0,8,0,8,2021
MAR,AN,I 55,Alloggio                                                    ,0,0,0,0,0,2021
MAR,AN,I 56,Attività dei servizi di ristorazione                        ,0,0,8,0,8,2021
MAR,AN,J   ,Servizi di informazione e comunicazione                     ,0,0,3,0,3,2021
MAR,AN,J 58,Attività editoriali                                         ,0,0,0,0,0,2021
MAR,AN,J 59,"Attività di produzione cinematografica, di video e di pro...",0,0,0,0,0,2021
MAR,AN,J 60,Attività di programmazione e trasmissione                   ,0,0,0,0,0,2021
MAR,AN,J 61,Telecomunicazioni                                           ,0,0,2,0,2,2021
MAR,AN,J 62,"Produzione di software, consulenza informatica e attività...",0,0,1,0,1,2021
MAR,AN,J 63,Attività dei servizi d'informazione e altri servizi infor...,0,0,0,0,0,2021
MAR,AN,K   ,Attività finanziarie e assicurative                         ,0,0,1,0,1,2021
MAR,AN,K 64,Attività di servizi finanziari (escluse le assicurazioni ...,0,0,0,0,0,2021
MAR,AN,K 65,"Assicurazioni, riassicurazioni e fondi pensione (escluse ...",0,0,0,0,0,2021
MAR,AN,K 66,Attività ausiliarie dei servizi finanziari e delle attivi...,0,0,1,0,1,2021
MAR,AN,L   ,Attivita' immobiliari                                       ,0,0,2,0,2,2021
MAR,AN,L 68,Attivita' immobiliari                                       ,0,0,2,0,2,2021
MAR,AN,M   ,"Attività professionali, scientifiche e tecniche             ",0,0,2,1,3,2021
MAR,AN,M 69,Attività legali e contabilità                               ,0,0,0,0,0,2021
MAR,AN,M 70,Attività di direzione aziendale e di consulenza gestional...,0,0,1,1,2,2021
MAR,AN,M 71,Attività degli studi di architettura e d'ingegneria; coll...,0,0,0,0,0,2021
MAR,AN,M 72,Ricerca scientifica e sviluppo                              ,0,0,0,0,0,2021
MAR,AN,M 73,Pubblicità e ricerche di mercato                            ,0,0,0,0,0,2021
MAR,AN,M 74,"Altre attività professionali, scientifiche e tecniche       ",0,0,1,0,1,2021
MAR,AN,M 75,Servizi veterinari                                          ,0,0,0,0,0,2021
MAR,AN,N   ,"Noleggio, agenzie di viaggio, servizi di supporto alle im...",0,0,2,0,2,2021
MAR,AN,N 77,Attività di noleggio e leasing operativo                    ,0,0,1,0,1,2021
MAR,AN,N 78,"Attività di ricerca, selezione, fornitura di personale      ",0,0,0,0,0,2021
MAR,AN,N 79,"Attività dei servizi delle agenzie di viaggio, dei tour o...",0,0,0,0,0,2021
MAR,AN,N 80,Servizi di vigilanza e investigazione                       ,0,0,0,0,0,2021
MAR,AN,N 81,Attività di servizi per edifici e paesaggio                 ,0,0,1,0,1,2021
MAR,AN,N 82,Attività di supporto per le funzioni d'ufficio e altri se...,0,0,0,0,0,2021
MAR,AN,O   ,Amministrazione pubblica e difesa; assicurazione sociale ...,0,0,0,0,0,2021
MAR,AN,O 84,Amministrazione pubblica e difesa; assicurazione sociale ...,0,0,0,0,0,2021
MAR,AN,P   ,Istruzione                                                  ,0,0,0,0,0,2021
MAR,AN,P 85,Istruzione                                                  ,0,0,0,0,0,2021
MAR,AN,Q   ,Sanita' e assistenza sociale                                ,0,0,0,0,0,2021
MAR,AN,Q 86,Assistenza sanitaria                                        ,0,0,0,0,0,2021
MAR,AN,Q 87,Servizi di assistenza sociale residenziale                  ,0,0,0,0,0,2021
MAR,AN,Q 88,Assistenza sociale non residenziale                         ,0,0,0,0,0,2021
MAR,AN,R   ,"Attività artistiche, sportive, di intrattenimento e diver...",0,0,0,0,0,2021
MAR,AN,R 90,"Attività creative, artistiche e di intrattenimento          ",0,0,0,0,0,2021
MAR,AN,R 91,"Attività di biblioteche, archivi, musei ed altre attività...",0,0,0,0,0,2021
MAR,AN,R 92,"Attività riguardanti le lotterie, le scommesse, le case d...",0,0,0,0,0,2021
MAR,AN,R 93,"Attività sportive, di intrattenimento e di divertimento     ",0,0,0,0,0,2021
MAR,AN,S   ,Altre attività di servizi                                   ,0,1,5,0,6,2021
MAR,AN,S 94,Attività di organizzazioni associative                      ,0,0,0,0,0,2021
MAR,AN,S 95,Riparazione di computer e di beni per uso personale e per...,0,0,1,0,1,2021
MAR,AN,S 96,Altre attività di servizi per la persona                    ,0,1,4,0,5,2021
MAR,AN,T   ,Attività di famiglie e convivenze come datori di lavoro p...,0,0,0,0,0,2021
MAR,AN,T 97,Attività di famiglie e convivenze come datori di lavoro p...,0,0,0,0,0,2021
MAR,AN,T 98,Produzione di beni e servizi indifferenziati per uso prop...,0,0,0,0,0,2021
MAR,AN,U   ,Organizzazioni ed organismi extraterritoriali               ,0,0,0,0,0,2021
MAR,AN,U 99,Organizzazioni ed organismi extraterritoriali               ,0,0,0,0,0,2021
MAR,AN,XX  ,Imprese non classificate                                    ,0,0,0,4,4,2021
MAR,AN,TOT ,TOTALE                                                      ,0,1,188,7,196,2021
MAR,MC,A   ,"Agricoltura, silvicoltura pesca                             ",0,20,35,1,56,2021
MAR,MC,A 01,"Coltivazioni agricole e produzione di prodotti animali, c...",0,19,34,1,54,2021
MAR,MC,A 02,Silvicoltura ed utilizzo di aree forestali                  ,0,0,1,0,1,2021
MAR,MC,A 03,Pesca e acquacoltura                                        ,0,1,0,0,1,2021
MAR,MC,B   ,Estrazione di minerali da cave e miniere                    ,0,0,0,0,0,2021
MAR,MC,B 05,Estrazione di carbone (esclusa torba)                       ,0,0,0,0,0,2021
MAR,MC,B 06,Estraz.di petrolio greggio e di gas naturale                ,0,0,0,0,0,2021
MAR,MC,B 07,Estrazione di minerali metalliferi                          ,0,0,0,0,0,2021
MAR,MC,B 08,Altre attività di estrazione di minerali da cave e miniere  ,0,0,0,0,0,2021
MAR,MC,B 09,Attività dei servizi di supporto all'estrazione             ,0,0,0,0,0,2021
MAR,MC,C   ,Attività manifatturiere                                     ,43,44,66,0,153,2021
MAR,MC,C 10,Industrie alimentari                                        ,0,3,2,0,5,2021
MAR,MC,C 11,Industria delle bevande                                     ,0,0,0,0,0,2021
MAR,MC,C 12,Industria del tabacco                                       ,0,0,0,0,0,2021
MAR,MC,C 13,Industrie tessili                                           ,0,1,2,0,3,2021
MAR,MC,C 14,Confezione di articoli di abbigliamento; confezione di ar...,4,1,7,0,12,2021
MAR,MC,C 15,Fabbricazione di articoli in pelle e simili                 ,19,18,22,0,59,2021
MAR,MC,C 16,Industria del legno e dei prodotti in legno e sughero (es...,5,1,5,0,11,2021
MAR,MC,C 17,Fabbricazione di carta e di prodotti di carta               ,1,1,1,0,3,2021
MAR,MC,C 18,Stampa e riproduzione di supporti registrati                ,0,0,1,0,1,2021
MAR,MC,C 19,Fabbricazione di coke e prodotti derivanti dalla raffinaz...,0,0,0,0,0,2021
MAR,MC,C 20,Fabbricazione di prodotti chimici                           ,0,0,0,0,0,2021
MAR,MC,C 21,Fabbricazione di prodotti farmaceutici di base e di prepa...,0,0,0,0,0,2021
MAR,MC,C 22,Fabbricazione di articoli in gomma e materie plastiche      ,2,2,1,0,5,2021
MAR,MC,C 23,Fabbricazione di altri prodotti della lavorazione di miner..,2,1,1,0,4,2021
MAR,MC,C 24,Metallurgia                                                 ,0,1,1,0,2,2021
MAR,MC,C 25,Fabbricazione di prodotti in metallo (esclusi macchinari ...,3,8,13,0,24,2021
MAR,MC,C 26,Fabbricazione di computer e prodotti di elettronica e ott...,0,1,1,0,2,2021
MAR,MC,C 27,Fabbricazione di apparecchiature elettriche ed apparecchi...,0,1,2,0,3,2021
MAR,MC,C 28,Fabbricazione di macchinari ed apparecchiature nca          ,3,2,0,0,5,2021
MAR,MC,C 29,"Fabbricazione di autoveicoli, rimorchi e semirimorchi       ",0,0,0,0,0,2021
MAR,MC,C 30,Fabbricazione di altri mezzi di trasporto                   ,1,0,0,0,1,2021
MAR,MC,C 31,Fabbricazione di mobili                                     ,1,0,3,0,4,2021
MAR,MC,C 32,Altre industrie manifatturiere                              ,2,1,2,0,5,2021
MAR,MC,C 33,"Riparazione, manutenzione ed installazione di macchine ed...",0,2,2,0,4,2021
MAR,MC,D   ,"Fornitura di energia elettrica, gas, vapore e aria condiz...",0,0,0,0,0,2021
MAR,MC,D 35,"Fornitura di energia elettrica, gas, vapore e aria condiz...",0,0,0,0,0,2021
MAR,MC,E   ,"Fornitura di acqua; reti fognarie, attività di gestione d...",0,0,1,0,1,2021
MAR,MC,E 36,"Raccolta, trattamento e fornitura di acqua                  ",0,0,0,0,0,2021
MAR,MC,E 37,Gestione delle reti fognarie                                ,0,0,0,0,0,2021
MAR,MC,E 38,"Attività di raccolta, trattamento e smaltimento dei rifiu...",0,0,1,0,1,2021
MAR,MC,E 39,Attività di risanamento e altri servizi di gestione dei r...,0,0,0,0,0,2021
MAR,MC,F   ,Costruzioni                                                 ,32,42,270,1,345,2021
MAR,MC,F 41,Costruzione di edifici                                      ,24,17,49,1,91,2021
MAR,MC,F 42,Ingegneria civile                                           ,0,0,3,0,3,2021
MAR,MC,F 43,Lavori di costruzione specializzati                         ,8,25,218,0,251,2021
MAR,MC,G   ,Commercio all'ingrosso e al dettaglio; riparazione di aut...,53,57,40,0,150,2021
MAR,MC,G 45,Commercio all'ingrosso e al dettaglio e riparazione di au...,6,4,6,0,16,2021
MAR,MC,G 46,Commercio all'ingrosso (escluso quello di autoveicoli e d...,24,13,9,0,46,2021
MAR,MC,G 47,Commercio al dettaglio (escluso quello di autoveicoli e d...,23,40,25,0,88,2021
MAR,MC,H   ,Trasporto e magazzinaggio                                   ,4,7,11,2,24,2021
MAR,MC,H 49,Trasporto terrestre e mediante condotte                     ,2,6,11,1,20,2021
MAR,MC,H 50,Trasporto marittimo e per vie d'acqua                       ,0,0,0,0,0,2021
MAR,MC,H 51,Trasporto aereo                                             ,0,0,0,0,0,2021
MAR,MC,H 52,Magazzinaggio e attività di supporto ai trasporti           ,2,1,0,1,4,2021
MAR,MC,H 53,Servizi postali e attività di corriere                      ,0,0,0,0,0,2021
MAR,MC,I   ,Attività dei servizi alloggio e ristorazione                ,16,80,10,0,106,2021
MAR,MC,I 55,Alloggio                                                    ,3,2,0,0,5,2021
MAR,MC,I 56,Attività dei servizi di ristorazione                        ,13,78,10,0,101,2021
MAR,MC,J   ,Servizi di informazione e comunicazione                     ,1,4,1,0,6,2021
MAR,MC,J 58,Attività editoriali                                         ,0,1,0,0,1,2021
MAR,MC,J 59,"Attività di produzione cinematografica, di video e di pro...",0,0,0,0,0,2021
MAR,MC,J 60,Attività di programmazione e trasmissione                   ,0,0,0,0,0,2021
MAR,MC,J 61,Telecomunicazioni                                           ,1,3,0,0,4,2021
MAR,MC,J 62,"Produzione di software, consulenza informatica e attività...",0,0,0,0,0,2021
MAR,MC,J 63,Attività dei servizi d'informazione e altri servizi infor...,0,0,1,0,1,2021
MAR,MC,K   ,Attività finanziarie e assicurative                         ,1,2,2,0,5,2021
MAR,MC,K 64,Attività di servizi finanziari (escluse le assicurazioni ...,1,0,0,0,1,2021
MAR,MC,K 65,"Assicurazioni, riassicurazioni e fondi pensione (escluse ...",0,0,0,0,0,2021
MAR,MC,K 66,Attività ausiliarie dei servizi finanziari e delle attivi...,0,2,2,0,4,2021
MAR,MC,L   ,Attivita' immobiliari                                       ,11,3,0,0,14,2021
MAR,MC,L 68,Attivita' immobiliari                                       ,11,3,0,0,14,2021
MAR,MC,M   ,"Attività professionali, scientifiche e tecniche             ",8,3,3,0,14,2021
MAR,MC,M 69,Attività legali e contabilità                               ,0,0,0,0,0,2021
MAR,MC,M 70,Attività di direzione aziendale e di consulenza gestional...,6,1,0,0,7,2021
MAR,MC,M 71,Attività degli studi di architettura e d'ingegneria; coll...,0,0,1,0,1,2021
MAR,MC,M 72,Ricerca scientifica e sviluppo                              ,0,0,0,0,0,2021
MAR,MC,M 73,Pubblicità e ricerche di mercato                            ,2,1,0,0,3,2021
MAR,MC,M 74,"Altre attività professionali, scientifiche e tecniche       ",0,1,2,0,3,2021
MAR,MC,M 75,Servizi veterinari                                          ,0,0,0,0,0,2021
MAR,MC,N   ,"Noleggio, agenzie di viaggio, servizi di supporto alle im...",4,6,8,1,19,2021
MAR,MC,N 77,Attività di noleggio e leasing operativo                    ,1,3,0,0,4,2021
MAR,MC,N 78,"Attività di ricerca, selezione, fornitura di personale      ",0,0,0,0,0,2021
MAR,MC,N 79,"Attività dei servizi delle agenzie di viaggio, dei tour o...",1,0,0,1,2,2021
MAR,MC,N 80,Servizi di vigilanza e investigazione                       ,0,0,0,0,0,2021
MAR,MC,N 81,Attività di servizi per edifici e paesaggio                 ,0,1,3,0,4,2021
MAR,MC,N 82,Attività di supporto per le funzioni d'ufficio e altri se...,2,2,5,0,9,2021
MAR,MC,O   ,Amministrazione pubblica e difesa; assicurazione sociale ...,0,0,0,0,0,2021
MAR,MC,O 84,Amministrazione pubblica e difesa; assicurazione sociale ...,0,0,0,0,0,2021
MAR,MC,P   ,Istruzione                                                  ,0,3,0,0,3,2021
MAR,MC,P 85,Istruzione                                                  ,0,3,0,0,3,2021
MAR,MC,Q   ,Sanita' e assistenza sociale                                ,0,0,0,0,0,2021
MAR,MC,Q 86,Assistenza sanitaria                                        ,0,0,0,0,0,2021
MAR,MC,Q 87,Servizi di assistenza sociale residenziale                  ,0,0,0,0,0,2021
MAR,MC,Q 88,Assistenza sociale non residenziale                         ,0,0,0,0,0,2021
MAR,MC,R   ,"Attività artistiche, sportive, di intrattenimento e diver...",2,6,5,0,13,2021
MAR,MC,R 90,"Attività creative, artistiche e di intrattenimento          ",0,0,2,0,2,2021
MAR,MC,R 91,"Attività di biblioteche, archivi, musei ed altre attività...",0,0,0,0,0,2021
MAR,MC,R 92,"Attività riguardanti le lotterie, le scommesse, le case d...",0,1,0,0,1,2021
MAR,MC,R 93,"Attività sportive, di intrattenimento e di divertimento     ",2,5,3,0,10,2021
MAR,MC,S   ,Altre attività di servizi                                   ,3,15,16,1,35,2021
MAR,MC,S 94,Attività di organizzazioni associative                      ,0,0,0,0,0,2021
MAR,MC,S 95,Riparazione di computer e di beni per uso personale e per...,0,3,9,0,12,2021
MAR,MC,S 96,Altre attività di servizi per la persona                    ,3,12,7,1,23,2021
MAR,MC,T   ,Attività di famiglie e convivenze come datori di lavoro p...,0,0,0,0,0,2021
MAR,MC,T 97,Attività di famiglie e convivenze come datori di lavoro p...,0,0,0,0,0,2021
MAR,MC,T 98,Produzione di beni e servizi indifferenziati per uso prop...,0,0,0,0,0,2021
MAR,MC,U   ,Organizzazioni ed organismi extraterritoriali               ,0,0,0,0,0,2021
MAR,MC,U 99,Organizzazioni ed organismi extraterritoriali               ,0,0,0,0,0,2021
MAR,MC,XX  ,Imprese non classificate                                    ,26,43,9,1,79,2021
MAR,MC,TOT ,TOTALE                                                      ,204,335,477,7,1023,2021
MAR,AP,A   ,"Agricoltura, silvicoltura pesca                             ",0,0,124,0,124,2021
MAR,AP,A 01,"Coltivazioni agricole e produzione di prodotti animali, c...",0,0,123,0,123,2021
MAR,AP,A 02,Silvicoltura ed utilizzo di aree forestali                  ,0,0,1,0,1,2021
MAR,AP,A 03,Pesca e acquacoltura                                        ,0,0,0,0,0,2021
MAR,AP,B   ,Estrazione di minerali da cave e miniere                    ,0,0,0,0,0,2021
MAR,AP,B 05,Estrazione di carbone (esclusa torba)                       ,0,0,0,0,0,2021
MAR,AP,B 06,Estraz.di petrolio greggio e di gas naturale                ,0,0,0,0,0,2021
MAR,AP,B 07,Estrazione di minerali metalliferi                          ,0,0,0,0,0,2021
MAR,AP,B 08,Altre attività di estrazione di minerali da cave e miniere  ,0,0,0,0,0,2021
MAR,AP,B 09,Attività dei servizi di supporto all'estrazione             ,0,0,0,0,0,2021
MAR,AP,C   ,Attività manifatturiere                                     ,5,0,4,0,9,2021
MAR,AP,C 10,Industrie alimentari                                        ,1,0,0,0,1,2021
MAR,AP,C 11,Industria delle bevande                                     ,0,0,0,0,0,2021
MAR,AP,C 12,Industria del tabacco                                       ,0,0,0,0,0,2021
MAR,AP,C 13,Industrie tessili                                           ,0,0,0,0,0,2021
MAR,AP,C 14,Confezione di articoli di abbigliamento; confezione di ar...,1,0,1,0,2,2021
MAR,AP,C 15,Fabbricazione di articoli in pelle e simili                 ,1,0,0,0,1,2021
MAR,AP,C 16,Industria del legno e dei prodotti in legno e sughero (es...,0,0,1,0,1,2021
MAR,AP,C 17,Fabbricazione di carta e di prodotti di carta               ,0,0,0,0,0,2021
MAR,AP,C 18,Stampa e riproduzione di supporti registrati                ,0,0,0,0,0,2021
MAR,AP,C 19,Fabbricazione di coke e prodotti derivanti dalla raffinaz...,0,0,0,0,0,2021
MAR,AP,C 20,Fabbricazione di prodotti chimici                           ,0,0,0,0,0,2021
MAR,AP,C 21,Fabbricazione di prodotti farmaceutici di base e di prepa...,0,0,0,0,0,2021
MAR,AP,C 22,Fabbricazione di articoli in gomma e materie plastiche      ,0,0,0,0,0,2021
MAR,AP,C 23,Fabbricazione di altri prodotti della lavorazione di miner..,0,0,1,0,1,2021
MAR,AP,C 24,Metallurgia                                                 ,0,0,0,0,0,2021
MAR,AP,C 25,Fabbricazione di prodotti in metallo (esclusi macchinari ...,0,0,0,0,0,2021
MAR,AP,C 26,Fabbricazione di computer e prodotti di elettronica e ott...,0,0,0,0,0,2021
MAR,AP,C 27,Fabbricazione di apparecchiature elettriche ed apparecchi...,0,0,0,0,0,2021
MAR,AP,C 28,Fabbricazione di macchinari ed apparecchiature nca          ,1,0,1,0,2,2021
MAR,AP,C 29,"Fabbricazione di autoveicoli, rimorchi e semirimorchi       ",0,0,0,0,0,2021
MAR,AP,C 30,Fabbricazione di altri mezzi di trasporto                   ,0,0,0,0,0,2021
MAR,AP,C 31,Fabbricazione di mobili                                     ,0,0,0,0,0,2021
MAR,AP,C 32,Altre industrie manifatturiere                              ,0,0,0,0,0,2021
MAR,AP,C 33,"Riparazione, manutenzione ed installazione di macchine ed...",1,0,0,0,1,2021
MAR,AP,D   ,"Fornitura di energia elettrica, gas, vapore e aria condiz...",0,0,0,0,0,2021
MAR,AP,D 35,"Fornitura di energia elettrica, gas, vapore e aria condiz...",0,0,0,0,0,2021
MAR,AP,E   ,"Fornitura di acqua; reti fognarie, attività di gestione d...",0,0,0,0,0,2021
MAR,AP,E 36,"Raccolta, trattamento e fornitura di acqua                  ",0,0,0,0,0,2021
MAR,AP,E 37,Gestione delle reti fognarie                                ,0,0,0,0,0,2021
MAR,AP,E 38,"Attività di raccolta, trattamento e smaltimento dei rifiu...",0,0,0,0,0,2021
MAR,AP,E 39,Attività di risanamento e altri servizi di gestione dei r...,0,0,0,0,0,2021
MAR,AP,F   ,Costruzioni                                                 ,3,0,8,1,12,2021
MAR,AP,F 41,Costruzione di edifici                                      ,2,0,1,1,4,2021
MAR,AP,F 42,Ingegneria civile                                           ,0,0,0,0,0,2021
MAR,AP,F 43,Lavori di costruzione specializzati                         ,1,0,7,0,8,2021
MAR,AP,G   ,Commercio all'ingrosso e al dettaglio; riparazione di aut...,12,0,23,0,35,2021
MAR,AP,G 45,Commercio all'ingrosso e al dettaglio e riparazione di au...,1,0,0,0,1,2021
MAR,AP,G 46,Commercio all'ingrosso (escluso quello di autoveicoli e d...,4,0,9,0,13,2021
MAR,AP,G 47,Commercio al dettaglio (escluso quello di autoveicoli e d...,7,0,14,0,21,2021
MAR,AP,H   ,Trasporto e magazzinaggio                                   ,0,0,1,0,1,2021
MAR,AP,H 49,Trasporto terrestre e mediante condotte                     ,0,0,1,0,1,2021
MAR,AP,H 50,Trasporto marittimo e per vie d'acqua                       ,0,0,0,0,0,2021
MAR,AP,H 51,Trasporto aereo                                             ,0,0,0,0,0,2021
MAR,AP,H 52,Magazzinaggio e attività di supporto ai trasporti           ,0,0,0,0,0,2021
MAR,AP,H 53,Servizi postali e attività di corriere                      ,0,0,0,0,0,2021
MAR,AP,I   ,Attività dei servizi alloggio e ristorazione                ,3,0,3,0,6,2021
MAR,AP,I 55,Alloggio                                                    ,0,0,1,0,1,2021
MAR,AP,I 56,Attività dei servizi di ristorazione                        ,3,0,2,0,5,2021
MAR,AP,J   ,Servizi di informazione e comunicazione                     ,1,0,3,0,4,2021
MAR,AP,J 58,Attività editoriali                                         ,1,0,2,0,3,2021
MAR,AP,J 59,"Attività di produzione cinematografica, di video e di pro...",0,0,0,0,0,2021
MAR,AP,J 60,Attività di programmazione e trasmissione                   ,0,0,0,0,0,2021
MAR,AP,J 61,Telecomunicazioni                                           ,0,0,0,0,0,2021
MAR,AP,J 62,"Produzione di software, consulenza informatica e attività...",0,0,0,0,0,2021
MAR,AP,J 63,Attività dei servizi d'informazione e altri servizi infor...,0,0,1,0,1,2021
MAR,AP,K   ,Attività finanziarie e assicurative                         ,0,0,1,0,1,2021
MAR,AP,K 64,Attività di servizi finanziari (escluse le assicurazioni ...,0,0,0,0,0,2021
MAR,AP,K 65,"Assicurazioni, riassicurazioni e fondi pensione (escluse ...",0,0,0,0,0,2021
MAR,AP,K 66,Attività ausiliarie dei servizi finanziari e delle attivi...,0,0,1,0,1,2021
MAR,AP,L   ,Attivita' immobiliari                                       ,3,0,0,0,3,2021
MAR,AP,L 68,Attivita' immobiliari                                       ,3,0,0,0,3,2021
MAR,AP,M   ,"Attività professionali, scientifiche e tecniche             ",1,0,2,0,3,2021
MAR,AP,M 69,Attività legali e contabilità                               ,0,0,0,0,0,2021
MAR,AP,M 70,Attività di direzione aziendale e di consulenza gestional...,1,0,2,0,3,2021
MAR,AP,M 71,Attività degli studi di architettura e d'ingegneria; coll...,0,0,0,0,0,2021
MAR,AP,M 72,Ricerca scientifica e sviluppo                              ,0,0,0,0,0,2021
MAR,AP,M 73,Pubblicità e ricerche di mercato                            ,0,0,0,0,0,2021
MAR,AP,M 74,"Altre attività professionali, scientifiche e tecniche       ",0,0,0,0,0,2021
MAR,AP,M 75,Servizi veterinari                                          ,0,0,0,0,0,2021
MAR,AP,N   ,"Noleggio, agenzie di viaggio, servizi di supporto alle im...",1,0,2,0,3,2021
MAR,AP,N 77,Attività di noleggio e leasing operativo                    ,0,0,0,0,0,2021
MAR,AP,N 78,"Attività di ricerca, selezione, fornitura di personale      ",0,0,0,0,0,2021
MAR,AP,N 79,"Attività dei servizi delle agenzie di viaggio, dei tour o...",1,0,0,0,1,2021
MAR,AP,N 80,Servizi di vigilanza e investigazione                       ,0,0,1,0,1,2021
MAR,AP,N 81,Attività di servizi per edifici e paesaggio                 ,0,0,1,0,1,2021
MAR,AP,N 82,Attività di supporto per le funzioni d'ufficio e altri se...,0,0,0,0,0,2021
MAR,AP,O   ,Amministrazione pubblica e difesa; assicurazione sociale ...,0,0,0,0,0,2021
MAR,AP,O 84,Amministrazione pubblica e difesa; assicurazione sociale ...,0,0,0,0,0,2021
MAR,AP,P   ,Istruzione                                                  ,1,0,0,0,1,2021
MAR,AP,P 85,Istruzione                                                  ,1,0,0,0,1,2021
MAR,AP,Q   ,Sanita' e assistenza sociale                                ,0,0,0,0,0,2021
MAR,AP,Q 86,Assistenza sanitaria                                        ,0,0,0,0,0,2021
MAR,AP,Q 87,Servizi di assistenza sociale residenziale                  ,0,0,0,0,0,2021
MAR,AP,Q 88,Assistenza sociale non residenziale                         ,0,0,0,0,0,2021
MAR,AP,R   ,"Attività artistiche, sportive, di intrattenimento e diver...",3,0,1,0,4,2021
MAR,AP,R 90,"Attività creative, artistiche e di intrattenimento          ",0,0,0,0,0,2021
MAR,AP,R 91,"Attività di biblioteche, archivi, musei ed altre attività...",0,0,0,0,0,2021
MAR,AP,R 92,"Attività riguardanti le lotterie, le scommesse, le case d...",1,0,0,0,1,2021
MAR,AP,R 93,"Attività sportive, di intrattenimento e di divertimento     ",2,0,1,0,3,2021
MAR,AP,S   ,Altre attività di servizi                                   ,1,0,3,0,4,2021
MAR,AP,S 94,Attività di organizzazioni associative                      ,0,0,0,0,0,2021
MAR,AP,S 95,Riparazione di computer e di beni per uso personale e per...,1,0,1,0,2,2021
MAR,AP,S 96,Altre attività di servizi per la persona                    ,0,0,2,0,2,2021
MAR,AP,T   ,Attività di famiglie e convivenze come datori di lavoro p...,0,0,0,0,0,2021
MAR,AP,T 97,Attività di famiglie e convivenze come datori di lavoro p...,0,0,0,0,0,2021
MAR,AP,T 98,Produzione di beni e servizi indifferenziati per uso prop...,0,0,0,0,0,2021
MAR,AP,U   ,Organizzazioni ed organismi extraterritoriali               ,0,0,0,0,0,2021
MAR,AP,U 99,Organizzazioni ed organismi extraterritoriali               ,0,0,0,0,0,2021
MAR,AP,XX  ,Imprese non classificate                                    ,8,1,0,0,9,2021
MAR,AP,TOT ,TOTALE                                                      ,42,1,175,1,219,2021
MAR,FM,A   ,"Agricoltura, silvicoltura pesca                             ",1,9,0,0,10,2021
MAR,FM,A 01,"Coltivazioni agricole e produzione di prodotti animali, c...",1,9,0,0,10,2021
MAR,FM,A 02,Silvicoltura ed utilizzo di aree forestali                  ,0,0,0,0,0,2021
MAR,FM,A 03,Pesca e acquacoltura                                        ,0,0,0,0,0,2021
MAR,FM,B   ,Estrazione di minerali da cave e miniere                    ,0,0,0,0,0,2021
MAR,FM,B 05,Estrazione di carbone (esclusa torba)                       ,0,0,0,0,0,2021
MAR,FM,B 06,Estraz.di petrolio greggio e di gas naturale                ,0,0,0,0,0,2021
MAR,FM,B 07,Estrazione di minerali metalliferi                          ,0,0,0,0,0,2021
MAR,FM,B 08,Altre attività di estrazione di minerali da cave e miniere  ,0,0,0,0,0,2021
MAR,FM,B 09,Attività dei servizi di supporto all'estrazione             ,0,0,0,0,0,2021
MAR,FM,C   ,Attività manifatturiere                                     ,31,38,0,0,69,2021
MAR,FM,C 10,Industrie alimentari                                        ,0,2,0,0,2,2021
MAR,FM,C 11,Industria delle bevande                                     ,0,0,0,0,0,2021
MAR,FM,C 12,Industria del tabacco                                       ,0,0,0,0,0,2021
MAR,FM,C 13,Industrie tessili                                           ,0,0,0,0,0,2021
MAR,FM,C 14,Confezione di articoli di abbigliamento; confezione di ar...,1,0,0,0,1,2021
MAR,FM,C 15,Fabbricazione di articoli in pelle e simili                 ,16,27,0,0,43,2021
MAR,FM,C 16,Industria del legno e dei prodotti in legno e sughero (es...,0,0,0,0,0,2021
MAR,FM,C 17,Fabbricazione di carta e di prodotti di carta               ,0,0,0,0,0,2021
MAR,FM,C 18,Stampa e riproduzione di supporti registrati                ,1,0,0,0,1,2021
MAR,FM,C 19,Fabbricazione di coke e prodotti derivanti dalla raffinaz...,0,0,0,0,0,2021
MAR,FM,C 20,Fabbricazione di prodotti chimici                           ,0,0,0,0,0,2021
MAR,FM,C 21,Fabbricazione di prodotti farmaceutici di base e di prepa...,0,0,0,0,0,2021
MAR,FM,C 22,Fabbricazione di articoli in gomma e materie plastiche      ,2,2,0,0,4,2021
MAR,FM,C 23,Fabbricazione di altri prodotti della lavorazione di miner..,1,1,0,0,2,2021
MAR,FM,C 24,Metallurgia                                                 ,0,0,0,0,0,2021
MAR,FM,C 25,Fabbricazione di prodotti in metallo (esclusi macchinari ...,2,1,0,0,3,2021
MAR,FM,C 26,Fabbricazione di computer e prodotti di elettronica e ott...,0,0,0,0,0,2021
MAR,FM,C 27,Fabbricazione di apparecchiature elettriche ed apparecchi...,1,0,0,0,1,2021
MAR,FM,C 28,Fabbricazione di macchinari ed apparecchiature nca          ,1,3,0,0,4,2021
MAR,FM,C 29,"Fabbricazione di autoveicoli, rimorchi e semirimorchi       ",0,0,0,0,0,2021
MAR,FM,C 30,Fabbricazione di altri mezzi di trasporto                   ,0,0,0,0,0,2021
MAR,FM,C 31,Fabbricazione di mobili                                     ,0,2,0,0,2,2021
MAR,FM,C 32,Altre industrie manifatturiere                              ,2,0,0,0,2,2021
MAR,FM,C 33,"Riparazione, manutenzione ed installazione di macchine ed...",4,0,0,0,4,2021
MAR,FM,D   ,"Fornitura di energia elettrica, gas, vapore e aria condiz...",0,0,0,0,0,2021
MAR,FM,D 35,"Fornitura di energia elettrica, gas, vapore e aria condiz...",0,0,0,0,0,2021
MAR,FM,E   ,"Fornitura di acqua; reti fognarie, attività di gestione d...",1,0,0,0,1,2021
MAR,FM,E 36,"Raccolta, trattamento e fornitura di acqua                  ",0,0,0,0,0,2021
MAR,FM,E 37,Gestione delle reti fognarie                                ,0,0,0,0,0,2021
MAR,FM,E 38,"Attività di raccolta, trattamento e smaltimento dei rifiu...",1,0,0,0,1,2021
MAR,FM,E 39,Attività di risanamento e altri servizi di gestione dei r...,0,0,0,0,0,2021
MAR,FM,F   ,Costruzioni                                                 ,19,19,0,0,38,2021
MAR,FM,F 41,Costruzione di edifici                                      ,17,11,0,0,28,2021
MAR,FM,F 42,Ingegneria civile                                           ,0,0,0,0,0,2021
MAR,FM,F 43,Lavori di costruzione specializzati                         ,2,8,0,0,10,2021
MAR,FM,G   ,Commercio all'ingrosso e al dettaglio; riparazione di aut...,30,36,0,1,67,2021
MAR,FM,G 45,Commercio all'ingrosso e al dettaglio e riparazione di au...,2,1,0,0,3,2021
MAR,FM,G 46,Commercio all'ingrosso (escluso quello di autoveicoli e d...,18,13,0,0,31,2021
MAR,FM,G 47,Commercio al dettaglio (escluso quello di autoveicoli e d...,10,22,0,1,33,2021
MAR,FM,H   ,Trasporto e magazzinaggio                                   ,1,4,0,0,5,2021
MAR,FM,H 49,Trasporto terrestre e mediante condotte                     ,0,4,0,0,4,2021
MAR,FM,H 50,Trasporto marittimo e per vie d'acqua                       ,0,0,0,0,0,2021
MAR,FM,H 51,Trasporto aereo                                             ,0,0,0,0,0,2021
MAR,FM,H 52,Magazzinaggio e attività di supporto ai trasporti           ,1,0,0,0,1,2021
MAR,FM,H 53,Servizi postali e attività di corriere                      ,0,0,0,0,0,2021
MAR,FM,I   ,Attività dei servizi alloggio e ristorazione                ,10,49,0,0,59,2021
MAR,FM,I 55,Alloggio                                                    ,2,2,0,0,4,2021
MAR,FM,I 56,Attività dei servizi di ristorazione                        ,8,47,0,0,55,2021
MAR,FM,J   ,Servizi di informazione e comunicazione                     ,1,3,0,0,4,2021
MAR,FM,J 58,Attività editoriali                                         ,0,0,0,0,0,2021
MAR,FM,J 59,"Attività di produzione cinematografica, di video e di pro...",0,1,0,0,1,2021
MAR,FM,J 60,Attività di programmazione e trasmissione                   ,0,0,0,0,0,2021
MAR,FM,J 61,Telecomunicazioni                                           ,0,0,0,0,0,2021
MAR,FM,J 62,"Produzione di software, consulenza informatica e attività...",1,0,0,0,1,2021
MAR,FM,J 63,Attività dei servizi d'informazione e altri servizi infor...,0,2,0,0,2,2021
MAR,FM,K   ,Attività finanziarie e assicurative                         ,0,0,0,0,0,2021
MAR,FM,K 64,Attività di servizi finanziari (escluse le assicurazioni ...,0,0,0,0,0,2021
MAR,FM,K 65,"Assicurazioni, riassicurazioni e fondi pensione (escluse ...",0,0,0,0,0,2021
MAR,FM,K 66,Attività ausiliarie dei servizi finanziari e delle attivi...,0,0,0,0,0,2021
MAR,FM,L   ,Attivita' immobiliari                                       ,6,4,0,0,10,2021
MAR,FM,L 68,Attivita' immobiliari                                       ,6,4,0,0,10,2021
MAR,FM,M   ,"Attività professionali, scientifiche e tecniche             ",3,1,0,0,4,2021
MAR,FM,M 69,Attività legali e contabilità                               ,0,0,0,0,0,2021
MAR,FM,M 70,Attività di direzione aziendale e di consulenza gestional...,1,0,0,0,1,2021
MAR,FM,M 71,Attività degli studi di architettura e d'ingegneria; coll...,0,0,0,0,0,2021
MAR,FM,M 72,Ricerca scientifica e sviluppo                              ,0,0,0,0,0,2021
MAR,FM,M 73,Pubblicità e ricerche di mercato                            ,1,0,0,0,1,2021
MAR,FM,M 74,"Altre attività professionali, scientifiche e tecniche       ",1,1,0,0,2,2021
MAR,FM,M 75,Servizi veterinari                                          ,0,0,0,0,0,2021
MAR,FM,N   ,"Noleggio, agenzie di viaggio, servizi di supporto alle im...",3,6,0,0,9,2021
MAR,FM,N 77,Attività di noleggio e leasing operativo                    ,0,1,0,0,1,2021
MAR,FM,N 78,"Attività di ricerca, selezione, fornitura di personale      ",0,0,0,0,0,2021
MAR,FM,N 79,"Attività dei servizi delle agenzie di viaggio, dei tour o...",0,1,0,0,1,2021
MAR,FM,N 80,Servizi di vigilanza e investigazione                       ,0,0,0,0,0,2021
MAR,FM,N 81,Attività di servizi per edifici e paesaggio                 ,0,2,0,0,2,2021
MAR,FM,N 82,Attività di supporto per le funzioni d'ufficio e altri se...,3,2,0,0,5,2021
MAR,FM,O   ,Amministrazione pubblica e difesa; assicurazione sociale ...,0,0,0,0,0,2021
MAR,FM,O 84,Amministrazione pubblica e difesa; assicurazione sociale ...,0,0,0,0,0,2021
MAR,FM,P   ,Istruzione                                                  ,0,0,0,0,0,2021
MAR,FM,P 85,Istruzione                                                  ,0,0,0,0,0,2021
MAR,FM,Q   ,Sanita' e assistenza sociale                                ,0,1,0,0,1,2021
MAR,FM,Q 86,Assistenza sanitaria                                        ,0,0,0,0,0,2021
MAR,FM,Q 87,Servizi di assistenza sociale residenziale                  ,0,0,0,0,0,2021
MAR,FM,Q 88,Assistenza sociale non residenziale                         ,0,1,0,0,1,2021
MAR,FM,R   ,"Attività artistiche, sportive, di intrattenimento e diver...",3,3,0,0,6,2021
MAR,FM,R 90,"Attività creative, artistiche e di intrattenimento          ",1,0,0,0,1,2021
MAR,FM,R 91,"Attività di biblioteche, archivi, musei ed altre attività...",0,0,0,0,0,2021
MAR,FM,R 92,"Attività riguardanti le lotterie, le scommesse, le case d...",0,2,0,0,2,2021
MAR,FM,R 93,"Attività sportive, di intrattenimento e di divertimento     ",2,1,0,0,3,2021
MAR,FM,S   ,Altre attività di servizi                                   ,0,4,0,0,4,2021
MAR,FM,S 94,Attività di organizzazioni associative                      ,0,0,0,0,0,2021
MAR,FM,S 95,Riparazione di computer e di beni per uso personale e per...,0,0,0,0,0,2021
MAR,FM,S 96,Altre attività di servizi per la persona                    ,0,4,0,0,4,2021
MAR,FM,T   ,Attività di famiglie e convivenze come datori di lavoro p...,0,0,0,0,0,2021
MAR,FM,T 97,Attività di famiglie e convivenze come datori di lavoro p...,0,0,0,0,0,2021
MAR,FM,T 98,Produzione di beni e servizi indifferenziati per uso prop...,0,0,0,0,0,2021
MAR,FM,U   ,Organizzazioni ed organismi extraterritoriali               ,0,0,0,0,0,2021
MAR,FM,U 99,Organizzazioni ed organismi extraterritoriali               ,0,0,0,0,0,2021
MAR,FM,XX  ,Imprese non classificate                                    ,18,35,0,1,54,2021
MAR,FM,TOT ,TOTALE                                                      ,127,212,0,2,341,2021
LAZ,  ,A   ,"Agricoltura, silvicoltura pesca                             ",214,30,454,1,699,2021
LAZ,  ,A 01,"Coltivazioni agricole e produzione di prodotti animali, c...",186,30,439,1,656,2021
LAZ,  ,A 02,Silvicoltura ed utilizzo di aree forestali                  ,11,0,7,0,18,2021
LAZ,  ,A 03,Pesca e acquacoltura                                        ,17,0,8,0,25,2021
LAZ,  ,B   ,Estrazione di minerali da cave e miniere                    ,40,1,5,1,47,2021
LAZ,  ,B 05,Estrazione di carbone (esclusa torba)                       ,1,0,0,0,1,2021
LAZ,  ,B 06,Estraz.di petrolio greggio e di gas naturale                ,1,0,0,0,1,2021
LAZ,  ,B 07,Estrazione di minerali metalliferi                          ,2,1,0,0,3,2021
LAZ,  ,B 08,Altre attività di estrazione di minerali da cave e miniere  ,35,0,5,1,41,2021
LAZ,  ,B 09,Attività dei servizi di supporto all'estrazione             ,1,0,0,0,1,2021
LAZ,  ,C   ,Attività manifatturiere                                     ,2876,184,1052,4,4116,2021
LAZ,  ,C 10,Industrie alimentari                                        ,213,29,100,1,343,2021
LAZ,  ,C 11,Industria delle bevande                                     ,22,2,3,0,27,2021
LAZ,  ,C 12,Industria del tabacco                                       ,2,0,0,0,2,2021
LAZ,  ,C 13,Industrie tessili                                           ,59,4,17,0,80,2021
LAZ,  ,C 14,Confezione di articoli di abbigliamento; confezione di ar...,358,17,182,0,557,2021
LAZ,  ,C 15,Fabbricazione di articoli in pelle e simili                 ,69,7,29,0,105,2021
LAZ,  ,C 16,Industria del legno e dei prodotti in legno e sughero (es...,102,11,155,0,268,2021
LAZ,  ,C 17,Fabbricazione di carta e di prodotti di carta               ,52,3,7,0,62,2021
LAZ,  ,C 18,Stampa e riproduzione di supporti registrati                ,250,24,56,0,330,2021
LAZ,  ,C 19,Fabbricazione di coke e prodotti derivanti dalla raffinaz...,13,0,0,0,13,2021
LAZ,  ,C 20,Fabbricazione di prodotti chimici                           ,119,5,4,0,128,2021
LAZ,  ,C 21,Fabbricazione di prodotti farmaceutici di base e di prepa...,22,0,0,0,22,2021
LAZ,  ,C 22,Fabbricazione di articoli in gomma e materie plastiche      ,75,6,10,0,91,2021
LAZ,  ,C 23,Fabbricazione di altri prodotti della lavorazione di miner..,147,10,30,0,187,2021
LAZ,  ,C 24,Metallurgia                                                 ,46,3,5,0,54,2021
LAZ,  ,C 25,Fabbricazione di prodotti in metallo (esclusi macchinari ...,277,20,155,2,454,2021
LAZ,  ,C 26,Fabbricazione di computer e prodotti di elettronica e ott...,308,11,11,0,330,2021
LAZ,  ,C 27,Fabbricazione di apparecchiature elettriche ed apparecchi...,111,8,19,0,138,2021
LAZ,  ,C 28,Fabbricazione di macchinari ed apparecchiature nca          ,158,5,13,0,176,2021
LAZ,  ,C 29,"Fabbricazione di autoveicoli, rimorchi e semirimorchi       ",30,1,1,0,32,2021
LAZ,  ,C 30,Fabbricazione di altri mezzi di trasporto                   ,81,5,11,0,97,2021
LAZ,  ,C 31,Fabbricazione di mobili                                     ,160,3,30,0,193,2021
LAZ,  ,C 32,Altre industrie manifatturiere                              ,109,6,170,1,286,2021
LAZ,  ,C 33,"Riparazione, manutenzione ed installazione di macchine ed...",93,4,44,0,141,2021
LAZ,  ,D   ,"Fornitura di energia elettrica, gas, vapore e aria condiz...",34,0,0,1,35,2021
LAZ,  ,D 35,"Fornitura di energia elettrica, gas, vapore e aria condiz...",34,0,0,1,35,2021
LAZ,  ,E   ,"Fornitura di acqua; reti fognarie, attività di gestione d...",87,4,22,1,114,2021
LAZ,  ,E 36,"Raccolta, trattamento e fornitura di acqua                  ",8,0,0,0,8,2021
LAZ,  ,E 37,Gestione delle reti fognarie                                ,4,0,0,0,4,2021
LAZ,  ,E 38,"Attività di raccolta, trattamento e smaltimento dei rifiu...",72,2,21,1,96,2021
LAZ,  ,E 39,Attività di risanamento e altri servizi di gestione dei r...,3,2,1,0,6,2021
LAZ,  ,F   ,Costruzioni                                                 ,5021,210,2075,64,7370,2021
LAZ,  ,F 41,Costruzione di edifici                                      ,3689,115,429,42,4275,2021
LAZ,  ,F 42,Ingegneria civile                                           ,80,2,20,5,107,2021
LAZ,  ,F 43,Lavori di costruzione specializzati                         ,1252,93,1626,17,2988,2021
LAZ,  ,G   ,Commercio all'ingrosso e al dettaglio; riparazione di aut...,10403,881,7924,10,19218,2021
LAZ,  ,G 45,Commercio all'ingrosso e al dettaglio e riparazione di au...,957,77,602,1,1637,2021
LAZ,  ,G 46,Commercio all'ingrosso (escluso quello di autoveicoli e d...,5509,354,1755,6,7624,2021
LAZ,  ,G 47,Commercio al dettaglio (escluso quello di autoveicoli e d...,3937,450,5567,3,9957,2021
LAZ,  ,H   ,Trasporto e magazzinaggio                                   ,661,56,762,23,1502,2021
LAZ,  ,H 49,Trasporto terrestre e mediante condotte                     ,412,36,638,11,1097,2021
LAZ,  ,H 50,Trasporto marittimo e per vie d'acqua                       ,17,0,0,0,17,2021
LAZ,  ,H 51,Trasporto aereo                                             ,13,0,3,0,16,2021
LAZ,  ,H 52,Magazzinaggio e attività di supporto ai trasporti           ,193,17,101,12,323,2021
LAZ,  ,H 53,Servizi postali e attività di corriere                      ,26,3,20,0,49,2021
LAZ,  ,I   ,Attività dei servizi alloggio e ristorazione                ,2352,331,1417,4,4104,2021
LAZ,  ,I 55,Alloggio                                                    ,305,12,84,1,402,2021
LAZ,  ,I 56,Attività dei servizi di ristorazione                        ,2047,319,1333,3,3702,2021
LAZ,  ,J   ,Servizi di informazione e comunicazione                     ,2472,73,662,6,3213,2021
LAZ,  ,J 58,Attività editoriali                                         ,519,20,60,0,599,2021
LAZ,  ,J 59,"Attività di produzione cinematografica, di video e di pro...",825,19,55,0,899,2021
LAZ,  ,J 60,Attività di programmazione e trasmissione                   ,74,4,3,0,81,2021
LAZ,  ,J 61,Telecomunicazioni                                           ,97,4,274,2,377,2021
LAZ,  ,J 62,"Produzione di software, consulenza informatica e attività...",601,12,176,2,791,2021
LAZ,  ,J 63,Attività dei servizi d'informazione e altri servizi infor...,356,14,94,2,466,2021
LAZ,  ,K   ,Attività finanziarie e assicurative                         ,876,29,230,1,1136,2021
LAZ,  ,K 64,Attività di servizi finanziari (escluse le assicurazioni ...,556,6,3,0,565,2021
LAZ,  ,K 65,"Assicurazioni, riassicurazioni e fondi pensione (escluse ...",32,3,1,0,36,2021
LAZ,  ,K 66,Attività ausiliarie dei servizi finanziari e delle attivi...,288,20,226,1,535,2021
LAZ,  ,L   ,Attivita' immobiliari                                       ,2937,59,99,2,3097,2021
LAZ,  ,L 68,Attivita' immobiliari                                       ,2937,59,99,2,3097,2021
LAZ,  ,M   ,"Attività professionali, scientifiche e tecniche             ",1546,67,590,19,2222,2021
LAZ,  ,M 69,Attività legali e contabilità                               ,150,8,16,1,175,2021
LAZ,  ,M 70,Attività di direzione aziendale e di consulenza gestional...,277,11,88,12,388,2021
LAZ,  ,M 71,Attività degli studi di architettura e d'ingegneria; coll...,129,7,10,1,147,2021
LAZ,  ,M 72,Ricerca scientifica e sviluppo                              ,45,0,2,1,48,2021
LAZ,  ,M 73,Pubblicità e ricerche di mercato                            ,526,10,191,2,729,2021
LAZ,  ,M 74,"Altre attività professionali, scientifiche e tecniche       ",416,30,282,2,730,2021
LAZ,  ,M 75,Servizi veterinari                                          ,3,1,1,0,5,2021
LAZ,  ,N   ,"Noleggio, agenzie di viaggio, servizi di supporto alle im...",1475,82,1365,27,2949,2021
LAZ,  ,N 77,Attività di noleggio e leasing operativo                    ,190,16,77,0,283,2021
LAZ,  ,N 78,"Attività di ricerca, selezione, fornitura di personale      ",8,1,2,0,11,2021
LAZ,  ,N 79,"Attività dei servizi delle agenzie di viaggio, dei tour o...",381,16,44,1,442,2021
LAZ,  ,N 80,Servizi di vigilanza e investigazione                       ,36,0,11,0,47,2021
LAZ,  ,N 81,Attività di servizi per edifici e paesaggio                 ,225,15,166,12,418,2021
LAZ,  ,N 82,Attività di supporto per le funzioni d'ufficio e altri se...,635,34,1065,14,1748,2021
LAZ,  ,O   ,Amministrazione pubblica e difesa; assicurazione sociale ...,5,0,0,0,5,2021
LAZ,  ,O 84,Amministrazione pubblica e difesa; assicurazione sociale ...,5,0,0,0,5,2021
LAZ,  ,P   ,Istruzione                                                  ,167,7,47,5,226,2021
LAZ,  ,P 85,Istruzione                                                  ,167,7,47,5,226,2021
LAZ,  ,Q   ,Sanita' e assistenza sociale                                ,227,10,22,3,262,2021
LAZ,  ,Q 86,Assistenza sanitaria                                        ,206,9,9,2,226,2021
LAZ,  ,Q 87,Servizi di assistenza sociale residenziale                  ,10,0,10,0,20,2021
LAZ,  ,Q 88,Assistenza sociale non residenziale                         ,11,1,3,1,16,2021
LAZ,  ,R   ,"Attività artistiche, sportive, di intrattenimento e diver...",769,30,213,5,1017,2021
LAZ,  ,R 90,"Attività creative, artistiche e di intrattenimento          ",239,8,62,3,312,2021
LAZ,  ,R 91,"Attività di biblioteche, archivi, musei ed altre attività...",21,0,0,0,21,2021
LAZ,  ,R 92,"Attività riguardanti le lotterie, le scommesse, le case d...",19,2,14,0,35,2021
LAZ,  ,R 93,"Attività sportive, di intrattenimento e di divertimento     ",490,20,137,2,649,2021
LAZ,  ,S   ,Altre attività di servizi                                   ,1603,108,706,14,2431,2021
LAZ,  ,S 94,Attività di organizzazioni associative                      ,13,0,0,2,15,2021
LAZ,  ,S 95,Riparazione di computer e di beni per uso personale e per...,80,12,205,1,298,2021
LAZ,  ,S 96,Altre attività di servizi per la persona                    ,1510,96,501,11,2118,2021
LAZ,  ,T   ,Attività di famiglie e convivenze come datori di lavoro p...,0,0,0,0,0,2021
LAZ,  ,T 97,Attività di famiglie e convivenze come datori di lavoro p...,0,0,0,0,0,2021
LAZ,  ,T 98,Produzione di beni e servizi indifferenziati per uso prop...,0,0,0,0,0,2021
LAZ,  ,U   ,Organizzazioni ed organismi extraterritoriali               ,0,0,0,1,1,2021
LAZ,  ,U 99,Organizzazioni ed organismi extraterritoriali               ,0,0,0,1,1,2021
LAZ,  ,XX  ,Imprese non classificate                                    ,3572,237,566,111,4486,2021
LAZ,  ,TOT ,TOTALE                                                      ,37337,2399,18211,303,58250,2021
LAZ,VT,A   ,"Agricoltura, silvicoltura pesca                             ",4,1,0,0,5,2021
LAZ,VT,A 01,"Coltivazioni agricole e produzione di prodotti animali, c...",2,1,0,0,3,2021
LAZ,VT,A 02,Silvicoltura ed utilizzo di aree forestali                  ,0,0,0,0,0,2021
LAZ,VT,A 03,Pesca e acquacoltura                                        ,2,0,0,0,2,2021
LAZ,VT,B   ,Estrazione di minerali da cave e miniere                    ,0,0,0,0,0,2021
LAZ,VT,B 05,Estrazione di carbone (esclusa torba)                       ,0,0,0,0,0,2021
LAZ,VT,B 06,Estraz.di petrolio greggio e di gas naturale                ,0,0,0,0,0,2021
LAZ,VT,B 07,Estrazione di minerali metalliferi                          ,0,0,0,0,0,2021
LAZ,VT,B 08,Altre attività di estrazione di minerali da cave e miniere  ,0,0,0,0,0,2021
LAZ,VT,B 09,Attività dei servizi di supporto all'estrazione             ,0,0,0,0,0,2021
LAZ,VT,C   ,Attività manifatturiere                                     ,12,5,0,0,17,2021
LAZ,VT,C 10,Industrie alimentari                                        ,2,1,0,0,3,2021
LAZ,VT,C 11,Industria delle bevande                                     ,0,0,0,0,0,2021
LAZ,VT,C 12,Industria del tabacco                                       ,0,0,0,0,0,2021
LAZ,VT,C 13,Industrie tessili                                           ,0,1,0,0,1,2021
LAZ,VT,C 14,Confezione di articoli di abbigliamento; confezione di ar...,0,1,0,0,1,2021
LAZ,VT,C 15,Fabbricazione di articoli in pelle e simili                 ,0,0,0,0,0,2021
LAZ,VT,C 16,Industria del legno e dei prodotti in legno e sughero (es...,1,0,0,0,1,2021
LAZ,VT,C 17,Fabbricazione di carta e di prodotti di carta               ,0,0,0,0,0,2021
LAZ,VT,C 18,Stampa e riproduzione di supporti registrati                ,0,0,0,0,0,2021
LAZ,VT,C 19,Fabbricazione di coke e prodotti derivanti dalla raffinaz...,0,0,0,0,0,2021
LAZ,VT,C 20,Fabbricazione di prodotti chimici                           ,0,0,0,0,0,2021
LAZ,VT,C 21,Fabbricazione di prodotti farmaceutici di base e di prepa...,0,0,0,0,0,2021
LAZ,VT,C 22,Fabbricazione di articoli in gomma e materie plastiche      ,0,1,0,0,1,2021
LAZ,VT,C 23,Fabbricazione di altri prodotti della lavorazione di miner..,5,1,0,0,6,2021
LAZ,VT,C 24,Metallurgia                                                 ,0,0,0,0,0,2021
LAZ,VT,C 25,Fabbricazione di prodotti in metallo (esclusi macchinari ...,1,0,0,0,1,2021
LAZ,VT,C 26,Fabbricazione di computer e prodotti di elettronica e ott...,0,0,0,0,0,2021
LAZ,VT,C 27,Fabbricazione di apparecchiature elettriche ed apparecchi...,0,0,0,0,0,2021
LAZ,VT,C 28,Fabbricazione di macchinari ed apparecchiature nca          ,1,0,0,0,1,2021
LAZ,VT,C 29,"Fabbricazione di autoveicoli, rimorchi e semirimorchi       ",0,0,0,0,0,2021
LAZ,VT,C 30,Fabbricazione di altri mezzi di trasporto                   ,0,0,0,0,0,2021
LAZ,VT,C 31,Fabbricazione di mobili                                     ,0,0,0,0,0,2021
LAZ,VT,C 32,Altre industrie manifatturiere                              ,1,0,0,0,1,2021
LAZ,VT,C 33,"Riparazione, manutenzione ed installazione di macchine ed...",1,0,0,0,1,2021
LAZ,VT,D   ,"Fornitura di energia elettrica, gas, vapore e aria condiz...",1,0,0,0,1,2021
LAZ,VT,D 35,"Fornitura di energia elettrica, gas, vapore e aria condiz...",1,0,0,0,1,2021
LAZ,VT,E   ,"Fornitura di acqua; reti fognarie, attività di gestione d...",0,0,0,0,0,2021
LAZ,VT,E 36,"Raccolta, trattamento e fornitura di acqua                  ",0,0,0,0,0,2021
LAZ,VT,E 37,Gestione delle reti fognarie                                ,0,0,0,0,0,2021
LAZ,VT,E 38,"Attività di raccolta, trattamento e smaltimento dei rifiu...",0,0,0,0,0,2021
LAZ,VT,E 39,Attività di risanamento e altri servizi di gestione dei r...,0,0,0,0,0,2021
LAZ,VT,F   ,Costruzioni                                                 ,26,1,0,0,27,2021
LAZ,VT,F 41,Costruzione di edifici                                      ,14,1,0,0,15,2021
LAZ,VT,F 42,Ingegneria civile                                           ,1,0,0,0,1,2021
LAZ,VT,F 43,Lavori di costruzione specializzati                         ,11,0,0,0,11,2021
LAZ,VT,G   ,Commercio all'ingrosso e al dettaglio; riparazione di aut...,51,2,1,0,54,2021
LAZ,VT,G 45,Commercio all'ingrosso e al dettaglio e riparazione di au...,11,0,0,0,11,2021
LAZ,VT,G 46,Commercio all'ingrosso (escluso quello di autoveicoli e d...,14,0,0,0,14,2021
LAZ,VT,G 47,Commercio al dettaglio (escluso quello di autoveicoli e d...,26,2,1,0,29,2021
LAZ,VT,H   ,Trasporto e magazzinaggio                                   ,5,0,0,0,5,2021
LAZ,VT,H 49,Trasporto terrestre e mediante condotte                     ,4,0,0,0,4,2021
LAZ,VT,H 50,Trasporto marittimo e per vie d'acqua                       ,0,0,0,0,0,2021
LAZ,VT,H 51,Trasporto aereo                                             ,0,0,0,0,0,2021
LAZ,VT,H 52,Magazzinaggio e attività di supporto ai trasporti           ,1,0,0,0,1,2021
LAZ,VT,H 53,Servizi postali e attività di corriere                      ,0,0,0,0,0,2021
LAZ,VT,I   ,Attività dei servizi alloggio e ristorazione                ,13,2,0,0,15,2021
LAZ,VT,I 55,Alloggio                                                    ,1,0,0,0,1,2021
LAZ,VT,I 56,Attività dei servizi di ristorazione                        ,12,2,0,0,14,2021
LAZ,VT,J   ,Servizi di informazione e comunicazione                     ,3,0,0,0,3,2021
LAZ,VT,J 58,Attività editoriali                                         ,1,0,0,0,1,2021
LAZ,VT,J 59,"Attività di produzione cinematografica, di video e di pro...",0,0,0,0,0,2021
LAZ,VT,J 60,Attività di programmazione e trasmissione                   ,1,0,0,0,1,2021
LAZ,VT,J 61,Telecomunicazioni                                           ,0,0,0,0,0,2021
LAZ,VT,J 62,"Produzione di software, consulenza informatica e attività...",1,0,0,0,1,2021
LAZ,VT,J 63,Attività dei servizi d'informazione e altri servizi infor...,0,0,0,0,0,2021
LAZ,VT,K   ,Attività finanziarie e assicurative                         ,0,0,0,0,0,2021
LAZ,VT,K 64,Attività di servizi finanziari (escluse le assicurazioni ...,0,0,0,0,0,2021
LAZ,VT,K 65,"Assicurazioni, riassicurazioni e fondi pensione (escluse ...",0,0,0,0,0,2021
LAZ,VT,K 66,Attività ausiliarie dei servizi finanziari e delle attivi...,0,0,0,0,0,2021
LAZ,VT,L   ,Attivita' immobiliari                                       ,10,1,0,0,11,2021
LAZ,VT,L 68,Attivita' immobiliari                                       ,10,1,0,0,11,2021
LAZ,VT,M   ,"Attività professionali, scientifiche e tecniche             ",8,0,0,0,8,2021
LAZ,VT,M 69,Attività legali e contabilità                               ,0,0,0,0,0,2021
LAZ,VT,M 70,Attività di direzione aziendale e di consulenza gestional...,3,0,0,0,3,2021
LAZ,VT,M 71,Attività degli studi di architettura e d'ingegneria; coll...,2,0,0,0,2,2021
LAZ,VT,M 72,Ricerca scientifica e sviluppo                              ,0,0,0,0,0,2021
LAZ,VT,M 73,Pubblicità e ricerche di mercato                            ,1,0,0,0,1,2021
LAZ,VT,M 74,"Altre attività professionali, scientifiche e tecniche       ",2,0,0,0,2,2021
LAZ,VT,M 75,Servizi veterinari                                          ,0,0,0,0,0,2021
LAZ,VT,N   ,"Noleggio, agenzie di viaggio, servizi di supporto alle im...",6,1,0,0,7,2021
LAZ,VT,N 77,Attività di noleggio e leasing operativo                    ,1,1,0,0,2,2021
LAZ,VT,N 78,"Attività di ricerca, selezione, fornitura di personale      ",0,0,0,0,0,2021
LAZ,VT,N 79,"Attività dei servizi delle agenzie di viaggio, dei tour o...",2,0,0,0,2,2021
LAZ,VT,N 80,Servizi di vigilanza e investigazione                       ,0,0,0,0,0,2021
LAZ,VT,N 81,Attività di servizi per edifici e paesaggio                 ,1,0,0,0,1,2021
LAZ,VT,N 82,Attività di supporto per le funzioni d'ufficio e altri se...,2,0,0,0,2,2021
LAZ,VT,O   ,Amministrazione pubblica e difesa; assicurazione sociale ...,0,0,0,0,0,2021
LAZ,VT,O 84,Amministrazione pubblica e difesa; assicurazione sociale ...,0,0,0,0,0,2021
LAZ,VT,P   ,Istruzione                                                  ,1,0,0,0,1,2021
LAZ,VT,P 85,Istruzione                                                  ,1,0,0,0,1,2021
LAZ,VT,Q   ,Sanita' e assistenza sociale                                ,0,0,0,0,0,2021
LAZ,VT,Q 86,Assistenza sanitaria                                        ,0,0,0,0,0,2021
LAZ,VT,Q 87,Servizi di assistenza sociale residenziale                  ,0,0,0,0,0,2021
LAZ,VT,Q 88,Assistenza sociale non residenziale                         ,0,0,0,0,0,2021
LAZ,VT,R   ,"Attività artistiche, sportive, di intrattenimento e diver...",1,0,0,0,1,2021
LAZ,VT,R 90,"Attività creative, artistiche e di intrattenimento          ",0,0,0,0,0,2021
LAZ,VT,R 91,"Attività di biblioteche, archivi, musei ed altre attività...",0,0,0,0,0,2021
LAZ,VT,R 92,"Attività riguardanti le lotterie, le scommesse, le case d...",0,0,0,0,0,2021
LAZ,VT,R 93,"Attività sportive, di intrattenimento e di divertimento     ",1,0,0,0,1,2021
LAZ,VT,S   ,Altre attività di servizi                                   ,4,0,0,0,4,2021
LAZ,VT,S 94,Attività di organizzazioni associative                      ,1,0,0,0,1,2021
LAZ,VT,S 95,Riparazione di computer e di beni per uso personale e per...,0,0,0,0,0,2021
LAZ,VT,S 96,Altre attività di servizi per la persona                    ,3,0,0,0,3,2021
LAZ,VT,T   ,Attività di famiglie e convivenze come datori di lavoro p...,0,0,0,0,0,2021
LAZ,VT,T 97,Attività di famiglie e convivenze come datori di lavoro p...,0,0,0,0,0,2021
LAZ,VT,T 98,Produzione di beni e servizi indifferenziati per uso prop...,0,0,0,0,0,2021
LAZ,VT,U   ,Organizzazioni ed organismi extraterritoriali               ,0,0,0,0,0,2021
LAZ,VT,U 99,Organizzazioni ed organismi extraterritoriali               ,0,0,0,0,0,2021
LAZ,VT,XX  ,Imprese non classificate                                    ,46,5,0,0,51,2021
LAZ,VT,TOT ,TOTALE                                                      ,191,18,1,0,210,2021
LAZ,RI,A   ,"Agricoltura, silvicoltura pesca                             ",0,0,0,0,0,2021
LAZ,RI,A 01,"Coltivazioni agricole e produzione di prodotti animali, c...",0,0,0,0,0,2021
LAZ,RI,A 02,Silvicoltura ed utilizzo di aree forestali                  ,0,0,0,0,0,2021
LAZ,RI,A 03,Pesca e acquacoltura                                        ,0,0,0,0,0,2021
LAZ,RI,B   ,Estrazione di minerali da cave e miniere                    ,1,0,0,0,1,2021
LAZ,RI,B 05,Estrazione di carbone (esclusa torba)                       ,0,0,0,0,0,2021
LAZ,RI,B 06,Estraz.di petrolio greggio e di gas naturale                ,0,0,0,0,0,2021
LAZ,RI,B 07,Estrazione di minerali metalliferi                          ,0,0,0,0,0,2021
LAZ,RI,B 08,Altre attività di estrazione di minerali da cave e miniere  ,1,0,0,0,1,2021
LAZ,RI,B 09,Attività dei servizi di supporto all'estrazione             ,0,0,0,0,0,2021
LAZ,RI,C   ,Attività manifatturiere                                     ,2,0,0,0,2,2021
LAZ,RI,C 10,Industrie alimentari                                        ,0,0,0,0,0,2021
LAZ,RI,C 11,Industria delle bevande                                     ,0,0,0,0,0,2021
LAZ,RI,C 12,Industria del tabacco                                       ,0,0,0,0,0,2021
LAZ,RI,C 13,Industrie tessili                                           ,0,0,0,0,0,2021
LAZ,RI,C 14,Confezione di articoli di abbigliamento; confezione di ar...,0,0,0,0,0,2021
LAZ,RI,C 15,Fabbricazione di articoli in pelle e simili                 ,0,0,0,0,0,2021
LAZ,RI,C 16,Industria del legno e dei prodotti in legno e sughero (es...,0,0,0,0,0,2021
LAZ,RI,C 17,Fabbricazione di carta e di prodotti di carta               ,0,0,0,0,0,2021
LAZ,RI,C 18,Stampa e riproduzione di supporti registrati                ,0,0,0,0,0,2021
LAZ,RI,C 19,Fabbricazione di coke e prodotti derivanti dalla raffinaz...,0,0,0,0,0,2021
LAZ,RI,C 20,Fabbricazione di prodotti chimici                           ,0,0,0,0,0,2021
LAZ,RI,C 21,Fabbricazione di prodotti farmaceutici di base e di prepa...,0,0,0,0,0,2021
LAZ,RI,C 22,Fabbricazione di articoli in gomma e materie plastiche      ,0,0,0,0,0,2021
LAZ,RI,C 23,Fabbricazione di altri prodotti della lavorazione di miner..,1,0,0,0,1,2021
LAZ,RI,C 24,Metallurgia                                                 ,0,0,0,0,0,2021
LAZ,RI,C 25,Fabbricazione di prodotti in metallo (esclusi macchinari ...,0,0,0,0,0,2021
LAZ,RI,C 26,Fabbricazione di computer e prodotti di elettronica e ott...,0,0,0,0,0,2021
LAZ,RI,C 27,Fabbricazione di apparecchiature elettriche ed apparecchi...,0,0,0,0,0,2021
LAZ,RI,C 28,Fabbricazione di macchinari ed apparecchiature nca          ,0,0,0,0,0,2021
LAZ,RI,C 29,"Fabbricazione di autoveicoli, rimorchi e semirimorchi       ",0,0,0,0,0,2021
LAZ,RI,C 30,Fabbricazione di altri mezzi di trasporto                   ,0,0,0,0,0,2021
LAZ,RI,C 31,Fabbricazione di mobili                                     ,0,0,0,0,0,2021
LAZ,RI,C 32,Altre industrie manifatturiere                              ,0,0,0,0,0,2021
LAZ,RI,C 33,"Riparazione, manutenzione ed installazione di macchine ed...",1,0,0,0,1,2021
LAZ,RI,D   ,"Fornitura di energia elettrica, gas, vapore e aria condiz...",0,0,0,0,0,2021
LAZ,RI,D 35,"Fornitura di energia elettrica, gas, vapore e aria condiz...",0,0,0,0,0,2021
LAZ,RI,E   ,"Fornitura di acqua; reti fognarie, attività di gestione d...",0,0,0,0,0,2021
LAZ,RI,E 36,"Raccolta, trattamento e fornitura di acqua                  ",0,0,0,0,0,2021
LAZ,RI,E 37,Gestione delle reti fognarie                                ,0,0,0,0,0,2021
LAZ,RI,E 38,"Attività di raccolta, trattamento e smaltimento dei rifiu...",0,0,0,0,0,2021
LAZ,RI,E 39,Attività di risanamento e altri servizi di gestione dei r...,0,0,0,0,0,2021
LAZ,RI,F   ,Costruzioni                                                 ,10,0,1,0,11,2021
LAZ,RI,F 41,Costruzione di edifici                                      ,8,0,1,0,9,2021
LAZ,RI,F 42,Ingegneria civile                                           ,1,0,0,0,1,2021
LAZ,RI,F 43,Lavori di costruzione specializzati                         ,1,0,0,0,1,2021
LAZ,RI,G   ,Commercio all'ingrosso e al dettaglio; riparazione di aut...,18,0,0,0,18,2021
LAZ,RI,G 45,Commercio all'ingrosso e al dettaglio e riparazione di au...,3,0,0,0,3,2021
LAZ,RI,G 46,Commercio all'ingrosso (escluso quello di autoveicoli e d...,5,0,0,0,5,2021
LAZ,RI,G 47,Commercio al dettaglio (escluso quello di autoveicoli e d...,10,0,0,0,10,2021
LAZ,RI,H   ,Trasporto e magazzinaggio                                   ,0,0,1,0,1,2021
LAZ,RI,H 49,Trasporto terrestre e mediante condotte                     ,0,0,1,0,1,2021
LAZ,RI,H 50,Trasporto marittimo e per vie d'acqua                       ,0,0,0,0,0,2021
LAZ,RI,H 51,Trasporto aereo                                             ,0,0,0,0,0,2021
LAZ,RI,H 52,Magazzinaggio e attività di supporto ai trasporti           ,0,0,0,0,0,2021
LAZ,RI,H 53,Servizi postali e attività di corriere                      ,0,0,0,0,0,2021
LAZ,RI,I   ,Attività dei servizi alloggio e ristorazione                ,12,0,0,0,12,2021
LAZ,RI,I 55,Alloggio                                                    ,1,0,0,0,1,2021
LAZ,RI,I 56,Attività dei servizi di ristorazione                        ,11,0,0,0,11,2021
LAZ,RI,J   ,Servizi di informazione e comunicazione                     ,2,0,0,0,2,2021
LAZ,RI,J 58,Attività editoriali                                         ,0,0,0,0,0,2021
LAZ,RI,J 59,"Attività di produzione cinematografica, di video e di pro...",1,0,0,0,1,2021
LAZ,RI,J 60,Attività di programmazione e trasmissione                   ,0,0,0,0,0,2021
LAZ,RI,J 61,Telecomunicazioni                                           ,0,0,0,0,0,2021
LAZ,RI,J 62,"Produzione di software, consulenza informatica e attività...",0,0,0,0,0,2021
LAZ,RI,J 63,Attività dei servizi d'informazione e altri servizi infor...,1,0,0,0,1,2021
LAZ,RI,K   ,Attività finanziarie e assicurative                         ,2,0,0,0,2,2021
LAZ,RI,K 64,Attività di servizi finanziari (escluse le assicurazioni ...,0,0,0,0,0,2021
LAZ,RI,K 65,"Assicurazioni, riassicurazioni e fondi pensione (escluse ...",0,0,0,0,0,2021
LAZ,RI,K 66,Attività ausiliarie dei servizi finanziari e delle attivi...,2,0,0,0,2,2021
LAZ,RI,L   ,Attivita' immobiliari                                       ,5,0,0,0,5,2021
LAZ,RI,L 68,Attivita' immobiliari                                       ,5,0,0,0,5,2021
LAZ,RI,M   ,"Attività professionali, scientifiche e tecniche             ",1,0,0,0,1,2021
LAZ,RI,M 69,Attività legali e contabilità                               ,0,0,0,0,0,2021
LAZ,RI,M 70,Attività di direzione aziendale e di consulenza gestional...,1,0,0,0,1,2021
LAZ,RI,M 71,Attività degli studi di architettura e d'ingegneria; coll...,0,0,0,0,0,2021
LAZ,RI,M 72,Ricerca scientifica e sviluppo                              ,0,0,0,0,0,2021
LAZ,RI,M 73,Pubblicità e ricerche di mercato                            ,0,0,0,0,0,2021
LAZ,RI,M 74,"Altre attività professionali, scientifiche e tecniche       ",0,0,0,0,0,2021
LAZ,RI,M 75,Servizi veterinari                                          ,0,0,0,0,0,2021
LAZ,RI,N   ,"Noleggio, agenzie di viaggio, servizi di supporto alle im...",1,0,0,0,1,2021
LAZ,RI,N 77,Attività di noleggio e leasing operativo                    ,0,0,0,0,0,2021
LAZ,RI,N 78,"Attività di ricerca, selezione, fornitura di personale      ",0,0,0,0,0,2021
LAZ,RI,N 79,"Attività dei servizi delle agenzie di viaggio, dei tour o...",0,0,0,0,0,2021
LAZ,RI,N 80,Servizi di vigilanza e investigazione                       ,0,0,0,0,0,2021
LAZ,RI,N 81,Attività di servizi per edifici e paesaggio                 ,1,0,0,0,1,2021
LAZ,RI,N 82,Attività di supporto per le funzioni d'ufficio e altri se...,0,0,0,0,0,2021
LAZ,RI,O   ,Amministrazione pubblica e difesa; assicurazione sociale ...,0,0,0,0,0,2021
LAZ,RI,O 84,Amministrazione pubblica e difesa; assicurazione sociale ...,0,0,0,0,0,2021
LAZ,RI,P   ,Istruzione                                                  ,0,0,0,0,0,2021
LAZ,RI,P 85,Istruzione                                                  ,0,0,0,0,0,2021
LAZ,RI,Q   ,Sanita' e assistenza sociale                                ,2,0,0,0,2,2021
LAZ,RI,Q 86,Assistenza sanitaria                                        ,1,0,0,0,1,2021
LAZ,RI,Q 87,Servizi di assistenza sociale residenziale                  ,1,0,0,0,1,2021
LAZ,RI,Q 88,Assistenza sociale non residenziale                         ,0,0,0,0,0,2021
LAZ,RI,R   ,"Attività artistiche, sportive, di intrattenimento e diver...",1,0,0,0,1,2021
LAZ,RI,R 90,"Attività creative, artistiche e di intrattenimento          ",0,0,0,0,0,2021
LAZ,RI,R 91,"Attività di biblioteche, archivi, musei ed altre attività...",0,0,0,0,0,2021
LAZ,RI,R 92,"Attività riguardanti le lotterie, le scommesse, le case d...",0,0,0,0,0,2021
LAZ,RI,R 93,"Attività sportive, di intrattenimento e di divertimento     ",1,0,0,0,1,2021
LAZ,RI,S   ,Altre attività di servizi                                   ,0,0,0,0,0,2021
LAZ,RI,S 94,Attività di organizzazioni associative                      ,0,0,0,0,0,2021
LAZ,RI,S 95,Riparazione di computer e di beni per uso personale e per...,0,0,0,0,0,2021
LAZ,RI,S 96,Altre attività di servizi per la persona                    ,0,0,0,0,0,2021
LAZ,RI,T   ,Attività di famiglie e convivenze come datori di lavoro p...,0,0,0,0,0,2021
LAZ,RI,T 97,Attività di famiglie e convivenze come datori di lavoro p...,0,0,0,0,0,2021
LAZ,RI,T 98,Produzione di beni e servizi indifferenziati per uso prop...,0,0,0,0,0,2021
LAZ,RI,U   ,Organizzazioni ed organismi extraterritoriali               ,0,0,0,0,0,2021
LAZ,RI,U 99,Organizzazioni ed organismi extraterritoriali               ,0,0,0,0,0,2021
LAZ,RI,XX  ,Imprese non classificate                                    ,23,0,0,0,23,2021
LAZ,RI,TOT ,TOTALE                                                      ,80,0,2,0,82,2021
LAZ,RM,A   ,"Agricoltura, silvicoltura pesca                             ",209,28,363,1,601,2021
LAZ,RM,A 01,"Coltivazioni agricole e produzione di prodotti animali, c...",183,28,351,1,563,2021
LAZ,RM,A 02,Silvicoltura ed utilizzo di aree forestali                  ,11,0,7,0,18,2021
LAZ,RM,A 03,Pesca e acquacoltura                                        ,15,0,5,0,20,2021
LAZ,RM,B   ,Estrazione di minerali da cave e miniere                    ,39,1,5,1,46,2021
LAZ,RM,B 05,Estrazione di carbone (esclusa torba)                       ,1,0,0,0,1,2021
LAZ,RM,B 06,Estraz.di petrolio greggio e di gas naturale                ,1,0,0,0,1,2021
LAZ,RM,B 07,Estrazione di minerali metalliferi                          ,2,1,0,0,3,2021
LAZ,RM,B 08,Altre attività di estrazione di minerali da cave e miniere  ,34,0,5,1,40,2021
LAZ,RM,B 09,Attività dei servizi di supporto all'estrazione             ,1,0,0,0,1,2021
LAZ,RM,C   ,Attività manifatturiere                                     ,2848,171,1020,4,4043,2021
LAZ,RM,C 10,Industrie alimentari                                        ,209,26,98,1,334,2021
LAZ,RM,C 11,Industria delle bevande                                     ,22,2,3,0,27,2021
LAZ,RM,C 12,Industria del tabacco                                       ,2,0,0,0,2,2021
LAZ,RM,C 13,Industrie tessili                                           ,59,3,17,0,79,2021
LAZ,RM,C 14,Confezione di articoli di abbigliamento; confezione di ar...,357,15,179,0,551,2021
LAZ,RM,C 15,Fabbricazione di articoli in pelle e simili                 ,69,7,29,0,105,2021
LAZ,RM,C 16,Industria del legno e dei prodotti in legno e sughero (es...,101,9,152,0,262,2021
LAZ,RM,C 17,Fabbricazione di carta e di prodotti di carta               ,52,3,7,0,62,2021
LAZ,RM,C 18,Stampa e riproduzione di supporti registrati                ,249,24,56,0,329,2021
LAZ,RM,C 19,Fabbricazione di coke e prodotti derivanti dalla raffinaz...,13,0,0,0,13,2021
LAZ,RM,C 20,Fabbricazione di prodotti chimici                           ,118,5,4,0,127,2021
LAZ,RM,C 21,Fabbricazione di prodotti farmaceutici di base e di prepa...,22,0,0,0,22,2021
LAZ,RM,C 22,Fabbricazione di articoli in gomma e materie plastiche      ,74,4,9,0,87,2021
LAZ,RM,C 23,Fabbricazione di altri prodotti della lavorazione di miner..,140,9,28,0,177,2021
LAZ,RM,C 24,Metallurgia                                                 ,45,3,4,0,52,2021
LAZ,RM,C 25,Fabbricazione di prodotti in metallo (esclusi macchinari ...,273,20,149,2,444,2021
LAZ,RM,C 26,Fabbricazione di computer e prodotti di elettronica e ott...,307,11,11,0,329,2021
LAZ,RM,C 27,Fabbricazione di apparecchiature elettriche ed apparecchi...,111,8,18,0,137,2021
LAZ,RM,C 28,Fabbricazione di macchinari ed apparecchiature nca          ,157,5,10,0,172,2021
LAZ,RM,C 29,"Fabbricazione di autoveicoli, rimorchi e semirimorchi       ",30,1,1,0,32,2021
LAZ,RM,C 30,Fabbricazione di altri mezzi di trasporto                   ,80,4,9,0,93,2021
LAZ,RM,C 31,Fabbricazione di mobili                                     ,160,2,28,0,190,2021
LAZ,RM,C 32,Altre industrie manifatturiere                              ,108,6,167,1,282,2021
LAZ,RM,C 33,"Riparazione, manutenzione ed installazione di macchine ed...",90,4,41,0,135,2021
LAZ,RM,D   ,"Fornitura di energia elettrica, gas, vapore e aria condiz...",31,0,0,1,32,2021
LAZ,RM,D 35,"Fornitura di energia elettrica, gas, vapore e aria condiz...",31,0,0,1,32,2021
LAZ,RM,E   ,"Fornitura di acqua; reti fognarie, attività di gestione d...",87,4,22,1,114,2021
LAZ,RM,E 36,"Raccolta, trattamento e fornitura di acqua                  ",8,0,0,0,8,2021
LAZ,RM,E 37,Gestione delle reti fognarie                                ,4,0,0,0,4,2021
LAZ,RM,E 38,"Attività di raccolta, trattamento e smaltimento dei rifiu...",72,2,21,1,96,2021
LAZ,RM,E 39,Attività di risanamento e altri servizi di gestione dei r...,3,2,1,0,6,2021
LAZ,RM,F   ,Costruzioni                                                 ,4965,203,1956,64,7188,2021
LAZ,RM,F 41,Costruzione di edifici                                      ,3650,113,396,42,4201,2021
LAZ,RM,F 42,Ingegneria civile                                           ,78,2,19,5,104,2021
LAZ,RM,F 43,Lavori di costruzione specializzati                         ,1237,88,1541,17,2883,2021
LAZ,RM,G   ,Commercio all'ingrosso e al dettaglio; riparazione di aut...,10310,853,7769,8,18940,2021
LAZ,RM,G 45,Commercio all'ingrosso e al dettaglio e riparazione di au...,940,73,582,1,1596,2021
LAZ,RM,G 46,Commercio all'ingrosso (escluso quello di autoveicoli e d...,5478,349,1716,4,7547,2021
LAZ,RM,G 47,Commercio al dettaglio (escluso quello di autoveicoli e d...,3892,431,5471,3,9797,2021
LAZ,RM,H   ,Trasporto e magazzinaggio                                   ,648,55,752,23,1478,2021
LAZ,RM,H 49,Trasporto terrestre e mediante condotte                     ,402,36,628,11,1077,2021
LAZ,RM,H 50,Trasporto marittimo e per vie d'acqua                       ,17,0,0,0,17,2021
LAZ,RM,H 51,Trasporto aereo                                             ,13,0,3,0,16,2021
LAZ,RM,H 52,Magazzinaggio e attività di supporto ai trasporti           ,191,16,101,12,320,2021
LAZ,RM,H 53,Servizi postali e attività di corriere                      ,25,3,20,0,48,2021
LAZ,RM,I   ,Attività dei servizi alloggio e ristorazione                ,2318,298,1374,4,3994,2021
LAZ,RM,I 55,Alloggio                                                    ,303,12,82,1,398,2021
LAZ,RM,I 56,Attività dei servizi di ristorazione                        ,2015,286,1292,3,3596,2021
LAZ,RM,J   ,Servizi di informazione e comunicazione                     ,2465,71,654,6,3196,2021
LAZ,RM,J 58,Attività editoriali                                         ,518,20,60,0,598,2021
LAZ,RM,J 59,"Attività di produzione cinematografica, di video e di pro...",824,19,55,0,898,2021
LAZ,RM,J 60,Attività di programmazione e trasmissione                   ,73,4,2,0,79,2021
LAZ,RM,J 61,Telecomunicazioni                                           ,97,3,270,2,372,2021
LAZ,RM,J 62,"Produzione di software, consulenza informatica e attività...",598,12,176,2,788,2021
LAZ,RM,J 63,Attività dei servizi d'informazione e altri servizi infor...,355,13,91,2,461,2021
LAZ,RM,K   ,Attività finanziarie e assicurative                         ,873,29,226,1,1129,2021
LAZ,RM,K 64,Attività di servizi finanziari (escluse le assicurazioni ...,555,6,3,0,564,2021
LAZ,RM,K 65,"Assicurazioni, riassicurazioni e fondi pensione (escluse ...",32,3,1,0,36,2021
LAZ,RM,K 66,Attività ausiliarie dei servizi finanziari e delle attivi...,286,20,222,1,529,2021
LAZ,RM,L   ,Attivita' immobiliari                                       ,2918,55,96,2,3071,2021
LAZ,RM,L 68,Attivita' immobiliari                                       ,2918,55,96,2,3071,2021
LAZ,RM,M   ,"Attività professionali, scientifiche e tecniche             ",1533,64,580,19,2196,2021
LAZ,RM,M 69,Attività legali e contabilità                               ,150,8,16,1,175,2021
LAZ,RM,M 70,Attività di direzione aziendale e di consulenza gestional...,272,9,88,12,381,2021
LAZ,RM,M 71,Attività degli studi di architettura e d'ingegneria; coll...,127,7,10,1,145,2021
LAZ,RM,M 72,Ricerca scientifica e sviluppo                              ,45,0,2,1,48,2021
LAZ,RM,M 73,Pubblicità e ricerche di mercato                            ,524,10,190,2,726,2021
LAZ,RM,M 74,"Altre attività professionali, scientifiche e tecniche       ",412,29,273,2,716,2021
LAZ,RM,M 75,Servizi veterinari                                          ,3,1,1,0,5,2021
LAZ,RM,N   ,"Noleggio, agenzie di viaggio, servizi di supporto alle im...",1467,78,1349,27,2921,2021
LAZ,RM,N 77,Attività di noleggio e leasing operativo                    ,189,13,77,0,279,2021
LAZ,RM,N 78,"Attività di ricerca, selezione, fornitura di personale      ",8,1,2,0,11,2021
LAZ,RM,N 79,"Attività dei servizi delle agenzie di viaggio, dei tour o...",379,16,44,1,440,2021
LAZ,RM,N 80,Servizi di vigilanza e investigazione                       ,36,0,10,0,46,2021
LAZ,RM,N 81,Attività di servizi per edifici e paesaggio                 ,222,14,160,12,408,2021
LAZ,RM,N 82,Attività di supporto per le funzioni d'ufficio e altri se...,633,34,1056,14,1737,2021
LAZ,RM,O   ,Amministrazione pubblica e difesa; assicurazione sociale ...,5,0,0,0,5,2021
LAZ,RM,O 84,Amministrazione pubblica e difesa; assicurazione sociale ...,5,0,0,0,5,2021
LAZ,RM,P   ,Istruzione                                                  ,165,7,46,5,223,2021
LAZ,RM,P 85,Istruzione                                                  ,165,7,46,5,223,2021
LAZ,RM,Q   ,Sanita' e assistenza sociale                                ,224,10,22,3,259,2021
LAZ,RM,Q 86,Assistenza sanitaria                                        ,205,9,9,2,225,2021
LAZ,RM,Q 87,Servizi di assistenza sociale residenziale                  ,9,0,10,0,19,2021
LAZ,RM,Q 88,Assistenza sociale non residenziale                         ,10,1,3,1,15,2021
LAZ,RM,R   ,"Attività artistiche, sportive, di intrattenimento e diver...",765,28,207,5,1005,2021
LAZ,RM,R 90,"Attività creative, artistiche e di intrattenimento          ",239,8,60,3,310,2021
LAZ,RM,R 91,"Attività di biblioteche, archivi, musei ed altre attività...",21,0,0,0,21,2021
LAZ,RM,R 92,"Attività riguardanti le lotterie, le scommesse, le case d...",19,1,12,0,32,2021
LAZ,RM,R 93,"Attività sportive, di intrattenimento e di divertimento     ",486,19,135,2,642,2021
LAZ,RM,S   ,Altre attività di servizi                                   ,1597,105,683,14,2399,2021
LAZ,RM,S 94,Attività di organizzazioni associative                      ,12,0,0,2,14,2021
LAZ,RM,S 95,Riparazione di computer e di beni per uso personale e per...,80,12,198,1,291,2021
LAZ,RM,S 96,Altre attività di servizi per la persona                    ,1505,93,485,11,2094,2021
LAZ,RM,T   ,Attività di famiglie e convivenze come datori di lavoro p...,0,0,0,0,0,2021
LAZ,RM,T 97,Attività di famiglie e convivenze come datori di lavoro p...,0,0,0,0,0,2021
LAZ,RM,T 98,Produzione di beni e servizi indifferenziati per uso prop...,0,0,0,0,0,2021
LAZ,RM,U   ,Organizzazioni ed organismi extraterritoriali               ,0,0,0,1,1,2021
LAZ,RM,U 99,Organizzazioni ed organismi extraterritoriali               ,0,0,0,1,1,2021
LAZ,RM,XX  ,Imprese non classificate                                    ,3479,227,535,110,4351,2021
LAZ,RM,TOT ,TOTALE                                                      ,36946,2287,17659,300,57192,2021
LAZ,LT,A   ,"Agricoltura, silvicoltura pesca                             ",1,1,39,0,41,2021
LAZ,LT,A 01,"Coltivazioni agricole e produzione di prodotti animali, c...",1,1,36,0,38,2021
LAZ,LT,A 02,Silvicoltura ed utilizzo di aree forestali                  ,0,0,0,0,0,2021
LAZ,LT,A 03,Pesca e acquacoltura                                        ,0,0,3,0,3,2021
LAZ,LT,B   ,Estrazione di minerali da cave e miniere                    ,0,0,0,0,0,2021
LAZ,LT,B 05,Estrazione di carbone (esclusa torba)                       ,0,0,0,0,0,2021
LAZ,LT,B 06,Estraz.di petrolio greggio e di gas naturale                ,0,0,0,0,0,2021
LAZ,LT,B 07,Estrazione di minerali metalliferi                          ,0,0,0,0,0,2021
LAZ,LT,B 08,Altre attività di estrazione di minerali da cave e miniere  ,0,0,0,0,0,2021
LAZ,LT,B 09,Attività dei servizi di supporto all'estrazione             ,0,0,0,0,0,2021
LAZ,LT,C   ,Attività manifatturiere                                     ,10,7,31,0,48,2021
LAZ,LT,C 10,Industrie alimentari                                        ,1,2,2,0,5,2021
LAZ,LT,C 11,Industria delle bevande                                     ,0,0,0,0,0,2021
LAZ,LT,C 12,Industria del tabacco                                       ,0,0,0,0,0,2021
LAZ,LT,C 13,Industrie tessili                                           ,0,0,0,0,0,2021
LAZ,LT,C 14,Confezione di articoli di abbigliamento; confezione di ar...,0,0,2,0,2,2021
LAZ,LT,C 15,Fabbricazione di articoli in pelle e simili                 ,0,0,0,0,0,2021
LAZ,LT,C 16,Industria del legno e dei prodotti in legno e sughero (es...,0,2,3,0,5,2021
LAZ,LT,C 17,Fabbricazione di carta e di prodotti di carta               ,0,0,0,0,0,2021
LAZ,LT,C 18,Stampa e riproduzione di supporti registrati                ,1,0,0,0,1,2021
LAZ,LT,C 19,Fabbricazione di coke e prodotti derivanti dalla raffinaz...,0,0,0,0,0,2021
LAZ,LT,C 20,Fabbricazione di prodotti chimici                           ,1,0,0,0,1,2021
LAZ,LT,C 21,Fabbricazione di prodotti farmaceutici di base e di prepa...,0,0,0,0,0,2021
LAZ,LT,C 22,Fabbricazione di articoli in gomma e materie plastiche      ,1,1,1,0,3,2021
LAZ,LT,C 23,Fabbricazione di altri prodotti della lavorazione di miner..,0,0,2,0,2,2021
LAZ,LT,C 24,Metallurgia                                                 ,1,0,1,0,2,2021
LAZ,LT,C 25,Fabbricazione di prodotti in metallo (esclusi macchinari ...,3,0,6,0,9,2021
LAZ,LT,C 26,Fabbricazione di computer e prodotti di elettronica e ott...,1,0,0,0,1,2021
LAZ,LT,C 27,Fabbricazione di apparecchiature elettriche ed apparecchi...,0,0,1,0,1,2021
LAZ,LT,C 28,Fabbricazione di macchinari ed apparecchiature nca          ,0,0,3,0,3,2021
LAZ,LT,C 29,"Fabbricazione di autoveicoli, rimorchi e semirimorchi       ",0,0,0,0,0,2021
LAZ,LT,C 30,Fabbricazione di altri mezzi di trasporto                   ,0,1,2,0,3,2021
LAZ,LT,C 31,Fabbricazione di mobili                                     ,0,1,2,0,3,2021
LAZ,LT,C 32,Altre industrie manifatturiere                              ,0,0,3,0,3,2021
LAZ,LT,C 33,"Riparazione, manutenzione ed installazione di macchine ed...",1,0,3,0,4,2021
LAZ,LT,D   ,"Fornitura di energia elettrica, gas, vapore e aria condiz...",2,0,0,0,2,2021
LAZ,LT,D 35,"Fornitura di energia elettrica, gas, vapore e aria condiz...",2,0,0,0,2,2021
LAZ,LT,E   ,"Fornitura di acqua; reti fognarie, attività di gestione d...",0,0,0,0,0,2021
LAZ,LT,E 36,"Raccolta, trattamento e fornitura di acqua                  ",0,0,0,0,0,2021
LAZ,LT,E 37,Gestione delle reti fognarie                                ,0,0,0,0,0,2021
LAZ,LT,E 38,"Attività di raccolta, trattamento e smaltimento dei rifiu...",0,0,0,0,0,2021
LAZ,LT,E 39,Attività di risanamento e altri servizi di gestione dei r...,0,0,0,0,0,2021
LAZ,LT,F   ,Costruzioni                                                 ,16,4,114,0,134,2021
LAZ,LT,F 41,Costruzione di edifici                                      ,14,1,30,0,45,2021
LAZ,LT,F 42,Ingegneria civile                                           ,0,0,0,0,0,2021
LAZ,LT,F 43,Lavori di costruzione specializzati                         ,2,3,84,0,89,2021
LAZ,LT,G   ,Commercio all'ingrosso e al dettaglio; riparazione di aut...,20,25,136,1,182,2021
LAZ,LT,G 45,Commercio all'ingrosso e al dettaglio e riparazione di au...,3,3,19,0,25,2021
LAZ,LT,G 46,Commercio all'ingrosso (escluso quello di autoveicoli e d...,10,5,32,1,48,2021
LAZ,LT,G 47,Commercio al dettaglio (escluso quello di autoveicoli e d...,7,17,85,0,109,2021
LAZ,LT,H   ,Trasporto e magazzinaggio                                   ,7,1,7,0,15,2021
LAZ,LT,H 49,Trasporto terrestre e mediante condotte                     ,5,0,7,0,12,2021
LAZ,LT,H 50,Trasporto marittimo e per vie d'acqua                       ,0,0,0,0,0,2021
LAZ,LT,H 51,Trasporto aereo                                             ,0,0,0,0,0,2021
LAZ,LT,H 52,Magazzinaggio e attività di supporto ai trasporti           ,1,1,0,0,2,2021
LAZ,LT,H 53,Servizi postali e attività di corriere                      ,1,0,0,0,1,2021
LAZ,LT,I   ,Attività dei servizi alloggio e ristorazione                ,9,29,36,0,74,2021
LAZ,LT,I 55,Alloggio                                                    ,0,0,1,0,1,2021
LAZ,LT,I 56,Attività dei servizi di ristorazione                        ,9,29,35,0,73,2021
LAZ,LT,J   ,Servizi di informazione e comunicazione                     ,2,2,8,0,12,2021
LAZ,LT,J 58,Attività editoriali                                         ,0,0,0,0,0,2021
LAZ,LT,J 59,"Attività di produzione cinematografica, di video e di pro...",0,0,0,0,0,2021
LAZ,LT,J 60,Attività di programmazione e trasmissione                   ,0,0,1,0,1,2021
LAZ,LT,J 61,Telecomunicazioni                                           ,0,1,4,0,5,2021
LAZ,LT,J 62,"Produzione di software, consulenza informatica e attività...",2,0,0,0,2,2021
LAZ,LT,J 63,Attività dei servizi d'informazione e altri servizi infor...,0,1,3,0,4,2021
LAZ,LT,K   ,Attività finanziarie e assicurative                         ,1,0,4,0,5,2021
LAZ,LT,K 64,Attività di servizi finanziari (escluse le assicurazioni ...,1,0,0,0,1,2021
LAZ,LT,K 65,"Assicurazioni, riassicurazioni e fondi pensione (escluse ...",0,0,0,0,0,2021
LAZ,LT,K 66,Attività ausiliarie dei servizi finanziari e delle attivi...,0,0,4,0,4,2021
LAZ,LT,L   ,Attivita' immobiliari                                       ,4,3,3,0,10,2021
LAZ,LT,L 68,Attivita' immobiliari                                       ,4,3,3,0,10,2021
LAZ,LT,M   ,"Attività professionali, scientifiche e tecniche             ",3,3,10,0,16,2021
LAZ,LT,M 69,Attività legali e contabilità                               ,0,0,0,0,0,2021
LAZ,LT,M 70,Attività di direzione aziendale e di consulenza gestional...,0,2,0,0,2,2021
LAZ,LT,M 71,Attività degli studi di architettura e d'ingegneria; coll...,0,0,0,0,0,2021
LAZ,LT,M 72,Ricerca scientifica e sviluppo                              ,0,0,0,0,0,2021
LAZ,LT,M 73,Pubblicità e ricerche di mercato                            ,1,0,1,0,2,2021
LAZ,LT,M 74,"Altre attività professionali, scientifiche e tecniche       ",2,1,9,0,12,2021
LAZ,LT,M 75,Servizi veterinari                                          ,0,0,0,0,0,2021
LAZ,LT,N   ,"Noleggio, agenzie di viaggio, servizi di supporto alle im...",1,3,16,0,20,2021
LAZ,LT,N 77,Attività di noleggio e leasing operativo                    ,0,2,0,0,2,2021
LAZ,LT,N 78,"Attività di ricerca, selezione, fornitura di personale      ",0,0,0,0,0,2021
LAZ,LT,N 79,"Attività dei servizi delle agenzie di viaggio, dei tour o...",0,0,0,0,0,2021
LAZ,LT,N 80,Servizi di vigilanza e investigazione                       ,0,0,1,0,1,2021
LAZ,LT,N 81,Attività di servizi per edifici e paesaggio                 ,1,1,6,0,8,2021
LAZ,LT,N 82,Attività di supporto per le funzioni d'ufficio e altri se...,0,0,9,0,9,2021
LAZ,LT,O   ,Amministrazione pubblica e difesa; assicurazione sociale ...,0,0,0,0,0,2021
LAZ,LT,O 84,Amministrazione pubblica e difesa; assicurazione sociale ...,0,0,0,0,0,2021
LAZ,LT,P   ,Istruzione                                                  ,1,0,1,0,2,2021
LAZ,LT,P 85,Istruzione                                                  ,1,0,1,0,2,2021
LAZ,LT,Q   ,Sanita' e assistenza sociale                                ,1,0,0,0,1,2021
LAZ,LT,Q 86,Assistenza sanitaria                                        ,0,0,0,0,0,2021
LAZ,LT,Q 87,Servizi di assistenza sociale residenziale                  ,0,0,0,0,0,2021
LAZ,LT,Q 88,Assistenza sociale non residenziale                         ,1,0,0,0,1,2021
LAZ,LT,R   ,"Attività artistiche, sportive, di intrattenimento e diver...",2,2,6,0,10,2021
LAZ,LT,R 90,"Attività creative, artistiche e di intrattenimento          ",0,0,2,0,2,2021
LAZ,LT,R 91,"Attività di biblioteche, archivi, musei ed altre attività...",0,0,0,0,0,2021
LAZ,LT,R 92,"Attività riguardanti le lotterie, le scommesse, le case d...",0,1,2,0,3,2021
LAZ,LT,R 93,"Attività sportive, di intrattenimento e di divertimento     ",2,1,2,0,5,2021
LAZ,LT,S   ,Altre attività di servizi                                   ,2,3,22,0,27,2021
LAZ,LT,S 94,Attività di organizzazioni associative                      ,0,0,0,0,0,2021
LAZ,LT,S 95,Riparazione di computer e di beni per uso personale e per...,0,0,7,0,7,2021
LAZ,LT,S 96,Altre attività di servizi per la persona                    ,2,3,15,0,20,2021
LAZ,LT,T   ,Attività di famiglie e convivenze come datori di lavoro p...,0,0,0,0,0,2021
LAZ,LT,T 97,Attività di famiglie e convivenze come datori di lavoro p...,0,0,0,0,0,2021
LAZ,LT,T 98,Produzione di beni e servizi indifferenziati per uso prop...,0,0,0,0,0,2021
LAZ,LT,U   ,Organizzazioni ed organismi extraterritoriali               ,0,0,0,0,0,2021
LAZ,LT,U 99,Organizzazioni ed organismi extraterritoriali               ,0,0,0,0,0,2021
LAZ,LT,XX  ,Imprese non classificate                                    ,15,2,30,0,47,2021
LAZ,LT,TOT ,TOTALE                                                      ,97,85,463,1,646,2021
LAZ,FR,A   ,"Agricoltura, silvicoltura pesca                             ",0,0,52,0,52,2021
LAZ,FR,A 01,"Coltivazioni agricole e produzione di prodotti animali, c...",0,0,52,0,52,2021
LAZ,FR,A 02,Silvicoltura ed utilizzo di aree forestali                  ,0,0,0,0,0,2021
LAZ,FR,A 03,Pesca e acquacoltura                                        ,0,0,0,0,0,2021
LAZ,FR,B   ,Estrazione di minerali da cave e miniere                    ,0,0,0,0,0,2021
LAZ,FR,B 05,Estrazione di carbone (esclusa torba)                       ,0,0,0,0,0,2021
LAZ,FR,B 06,Estraz.di petrolio greggio e di gas naturale                ,0,0,0,0,0,2021
LAZ,FR,B 07,Estrazione di minerali metalliferi                          ,0,0,0,0,0,2021
LAZ,FR,B 08,Altre attività di estrazione di minerali da cave e miniere  ,0,0,0,0,0,2021
LAZ,FR,B 09,Attività dei servizi di supporto all'estrazione             ,0,0,0,0,0,2021
LAZ,FR,C   ,Attività manifatturiere                                     ,4,1,1,0,6,2021
LAZ,FR,C 10,Industrie alimentari                                        ,1,0,0,0,1,2021
LAZ,FR,C 11,Industria delle bevande                                     ,0,0,0,0,0,2021
LAZ,FR,C 12,Industria del tabacco                                       ,0,0,0,0,0,2021
LAZ,FR,C 13,Industrie tessili                                           ,0,0,0,0,0,2021
LAZ,FR,C 14,Confezione di articoli di abbigliamento; confezione di ar...,1,1,1,0,3,2021
LAZ,FR,C 15,Fabbricazione di articoli in pelle e simili                 ,0,0,0,0,0,2021
LAZ,FR,C 16,Industria del legno e dei prodotti in legno e sughero (es...,0,0,0,0,0,2021
LAZ,FR,C 17,Fabbricazione di carta e di prodotti di carta               ,0,0,0,0,0,2021
LAZ,FR,C 18,Stampa e riproduzione di supporti registrati                ,0,0,0,0,0,2021
LAZ,FR,C 19,Fabbricazione di coke e prodotti derivanti dalla raffinaz...,0,0,0,0,0,2021
LAZ,FR,C 20,Fabbricazione di prodotti chimici                           ,0,0,0,0,0,2021
LAZ,FR,C 21,Fabbricazione di prodotti farmaceutici di base e di prepa...,0,0,0,0,0,2021
LAZ,FR,C 22,Fabbricazione di articoli in gomma e materie plastiche      ,0,0,0,0,0,2021
LAZ,FR,C 23,Fabbricazione di altri prodotti della lavorazione di miner..,1,0,0,0,1,2021
LAZ,FR,C 24,Metallurgia                                                 ,0,0,0,0,0,2021
LAZ,FR,C 25,Fabbricazione di prodotti in metallo (esclusi macchinari ...,0,0,0,0,0,2021
LAZ,FR,C 26,Fabbricazione di computer e prodotti di elettronica e ott...,0,0,0,0,0,2021
LAZ,FR,C 27,Fabbricazione di apparecchiature elettriche ed apparecchi...,0,0,0,0,0,2021
LAZ,FR,C 28,Fabbricazione di macchinari ed apparecchiature nca          ,0,0,0,0,0,2021
LAZ,FR,C 29,"Fabbricazione di autoveicoli, rimorchi e semirimorchi       ",0,0,0,0,0,2021
LAZ,FR,C 30,Fabbricazione di altri mezzi di trasporto                   ,1,0,0,0,1,2021
LAZ,FR,C 31,Fabbricazione di mobili                                     ,0,0,0,0,0,2021
LAZ,FR,C 32,Altre industrie manifatturiere                              ,0,0,0,0,0,2021
LAZ,FR,C 33,"Riparazione, manutenzione ed installazione di macchine ed...",0,0,0,0,0,2021
LAZ,FR,D   ,"Fornitura di energia elettrica, gas, vapore e aria condiz...",0,0,0,0,0,2021
LAZ,FR,D 35,"Fornitura di energia elettrica, gas, vapore e aria condiz...",0,0,0,0,0,2021
LAZ,FR,E   ,"Fornitura di acqua; reti fognarie, attività di gestione d...",0,0,0,0,0,2021
LAZ,FR,E 36,"Raccolta, trattamento e fornitura di acqua                  ",0,0,0,0,0,2021
LAZ,FR,E 37,Gestione delle reti fognarie                                ,0,0,0,0,0,2021
LAZ,FR,E 38,"Attività di raccolta, trattamento e smaltimento dei rifiu...",0,0,0,0,0,2021
LAZ,FR,E 39,Attività di risanamento e altri servizi di gestione dei r...,0,0,0,0,0,2021
LAZ,FR,F   ,Costruzioni                                                 ,4,2,4,0,10,2021
LAZ,FR,F 41,Costruzione di edifici                                      ,3,0,2,0,5,2021
LAZ,FR,F 42,Ingegneria civile                                           ,0,0,1,0,1,2021
LAZ,FR,F 43,Lavori di costruzione specializzati                         ,1,2,1,0,4,2021
LAZ,FR,G   ,Commercio all'ingrosso e al dettaglio; riparazione di aut...,4,1,18,1,24,2021
LAZ,FR,G 45,Commercio all'ingrosso e al dettaglio e riparazione di au...,0,1,1,0,2,2021
LAZ,FR,G 46,Commercio all'ingrosso (escluso quello di autoveicoli e d...,2,0,7,1,10,2021
LAZ,FR,G 47,Commercio al dettaglio (escluso quello di autoveicoli e d...,2,0,10,0,12,2021
LAZ,FR,H   ,Trasporto e magazzinaggio                                   ,1,0,2,0,3,2021
LAZ,FR,H 49,Trasporto terrestre e mediante condotte                     ,1,0,2,0,3,2021
LAZ,FR,H 50,Trasporto marittimo e per vie d'acqua                       ,0,0,0,0,0,2021
LAZ,FR,H 51,Trasporto aereo                                             ,0,0,0,0,0,2021
LAZ,FR,H 52,Magazzinaggio e attività di supporto ai trasporti           ,0,0,0,0,0,2021
LAZ,FR,H 53,Servizi postali e attività di corriere                      ,0,0,0,0,0,2021
LAZ,FR,I   ,Attività dei servizi alloggio e ristorazione                ,0,2,7,0,9,2021
LAZ,FR,I 55,Alloggio                                                    ,0,0,1,0,1,2021
LAZ,FR,I 56,Attività dei servizi di ristorazione                        ,0,2,6,0,8,2021
LAZ,FR,J   ,Servizi di informazione e comunicazione                     ,0,0,0,0,0,2021
LAZ,FR,J 58,Attività editoriali                                         ,0,0,0,0,0,2021
LAZ,FR,J 59,"Attività di produzione cinematografica, di video e di pro...",0,0,0,0,0,2021
LAZ,FR,J 60,Attività di programmazione e trasmissione                   ,0,0,0,0,0,2021
LAZ,FR,J 61,Telecomunicazioni                                           ,0,0,0,0,0,2021
LAZ,FR,J 62,"Produzione di software, consulenza informatica e attività...",0,0,0,0,0,2021
LAZ,FR,J 63,Attività dei servizi d'informazione e altri servizi infor...,0,0,0,0,0,2021
LAZ,FR,K   ,Attività finanziarie e assicurative                         ,0,0,0,0,0,2021
LAZ,FR,K 64,Attività di servizi finanziari (escluse le assicurazioni ...,0,0,0,0,0,2021
LAZ,FR,K 65,"Assicurazioni, riassicurazioni e fondi pensione (escluse ...",0,0,0,0,0,2021
LAZ,FR,K 66,Attività ausiliarie dei servizi finanziari e delle attivi...,0,0,0,0,0,2021
LAZ,FR,L   ,Attivita' immobiliari                                       ,0,0,0,0,0,2021
LAZ,FR,L 68,Attivita' immobiliari                                       ,0,0,0,0,0,2021
LAZ,FR,M   ,"Attività professionali, scientifiche e tecniche             ",1,0,0,0,1,2021
LAZ,FR,M 69,Attività legali e contabilità                               ,0,0,0,0,0,2021
LAZ,FR,M 70,Attività di direzione aziendale e di consulenza gestional...,1,0,0,0,1,2021
LAZ,FR,M 71,Attività degli studi di architettura e d'ingegneria; coll...,0,0,0,0,0,2021
LAZ,FR,M 72,Ricerca scientifica e sviluppo                              ,0,0,0,0,0,2021
LAZ,FR,M 73,Pubblicità e ricerche di mercato                            ,0,0,0,0,0,2021
LAZ,FR,M 74,"Altre attività professionali, scientifiche e tecniche       ",0,0,0,0,0,2021
LAZ,FR,M 75,Servizi veterinari                                          ,0,0,0,0,0,2021
LAZ,FR,N   ,"Noleggio, agenzie di viaggio, servizi di supporto alle im...",0,0,0,0,0,2021
LAZ,FR,N 77,Attività di noleggio e leasing operativo                    ,0,0,0,0,0,2021
LAZ,FR,N 78,"Attività di ricerca, selezione, fornitura di personale      ",0,0,0,0,0,2021
LAZ,FR,N 79,"Attività dei servizi delle agenzie di viaggio, dei tour o...",0,0,0,0,0,2021
LAZ,FR,N 80,Servizi di vigilanza e investigazione                       ,0,0,0,0,0,2021
LAZ,FR,N 81,Attività di servizi per edifici e paesaggio                 ,0,0,0,0,0,2021
LAZ,FR,N 82,Attività di supporto per le funzioni d'ufficio e altri se...,0,0,0,0,0,2021
LAZ,FR,O   ,Amministrazione pubblica e difesa; assicurazione sociale ...,0,0,0,0,0,2021
LAZ,FR,O 84,Amministrazione pubblica e difesa; assicurazione sociale ...,0,0,0,0,0,2021
LAZ,FR,P   ,Istruzione                                                  ,0,0,0,0,0,2021
LAZ,FR,P 85,Istruzione                                                  ,0,0,0,0,0,2021
LAZ,FR,Q   ,Sanita' e assistenza sociale                                ,0,0,0,0,0,2021
LAZ,FR,Q 86,Assistenza sanitaria                                        ,0,0,0,0,0,2021
LAZ,FR,Q 87,Servizi di assistenza sociale residenziale                  ,0,0,0,0,0,2021
LAZ,FR,Q 88,Assistenza sociale non residenziale                         ,0,0,0,0,0,2021
LAZ,FR,R   ,"Attività artistiche, sportive, di intrattenimento e diver...",0,0,0,0,0,2021
LAZ,FR,R 90,"Attività creative, artistiche e di intrattenimento          ",0,0,0,0,0,2021
LAZ,FR,R 91,"Attività di biblioteche, archivi, musei ed altre attività...",0,0,0,0,0,2021
LAZ,FR,R 92,"Attività riguardanti le lotterie, le scommesse, le case d...",0,0,0,0,0,2021
LAZ,FR,R 93,"Attività sportive, di intrattenimento e di divertimento     ",0,0,0,0,0,2021
LAZ,FR,S   ,Altre attività di servizi                                   ,0,0,1,0,1,2021
LAZ,FR,S 94,Attività di organizzazioni associative                      ,0,0,0,0,0,2021
LAZ,FR,S 95,Riparazione di computer e di beni per uso personale e per...,0,0,0,0,0,2021
LAZ,FR,S 96,Altre attività di servizi per la persona                    ,0,0,1,0,1,2021
LAZ,FR,T   ,Attività di famiglie e convivenze come datori di lavoro p...,0,0,0,0,0,2021
LAZ,FR,T 97,Attività di famiglie e convivenze come datori di lavoro p...,0,0,0,0,0,2021
LAZ,FR,T 98,Produzione di beni e servizi indifferenziati per uso prop...,0,0,0,0,0,2021
LAZ,FR,U   ,Organizzazioni ed organismi extraterritoriali               ,0,0,0,0,0,2021
LAZ,FR,U 99,Organizzazioni ed organismi extraterritoriali               ,0,0,0,0,0,2021
LAZ,FR,XX  ,Imprese non classificate                                    ,9,3,1,1,14,2021
LAZ,FR,TOT ,TOTALE                                                      ,23,9,86,2,120,2021
ABR,  ,A   ,"Agricoltura, silvicoltura pesca                             ",0,0,1,0,1,2021
ABR,  ,A 01,"Coltivazioni agricole e produzione di prodotti animali, c...",0,0,1,0,1,2021
ABR,  ,A 02,Silvicoltura ed utilizzo di aree forestali                  ,0,0,0,0,0,2021
ABR,  ,A 03,Pesca e acquacoltura                                        ,0,0,0,0,0,2021
ABR,  ,B   ,Estrazione di minerali da cave e miniere                    ,0,0,0,0,0,2021
ABR,  ,B 05,Estrazione di carbone (esclusa torba)                       ,0,0,0,0,0,2021
ABR,  ,B 06,Estraz.di petrolio greggio e di gas naturale                ,0,0,0,0,0,2021
ABR,  ,B 07,Estrazione di minerali metalliferi                          ,0,0,0,0,0,2021
ABR,  ,B 08,Altre attività di estrazione di minerali da cave e miniere  ,0,0,0,0,0,2021
ABR,  ,B 09,Attività dei servizi di supporto all'estrazione             ,0,0,0,0,0,2021
ABR,  ,C   ,Attività manifatturiere                                     ,1,0,29,0,30,2021
ABR,  ,C 10,Industrie alimentari                                        ,0,0,0,0,0,2021
ABR,  ,C 11,Industria delle bevande                                     ,0,0,0,0,0,2021
ABR,  ,C 12,Industria del tabacco                                       ,0,0,0,0,0,2021
ABR,  ,C 13,Industrie tessili                                           ,0,0,1,0,1,2021
ABR,  ,C 14,Confezione di articoli di abbigliamento; confezione di ar...,0,0,9,0,9,2021
ABR,  ,C 15,Fabbricazione di articoli in pelle e simili                 ,0,0,0,0,0,2021
ABR,  ,C 16,Industria del legno e dei prodotti in legno e sughero (es...,0,0,5,0,5,2021
ABR,  ,C 17,Fabbricazione di carta e di prodotti di carta               ,0,0,0,0,0,2021
ABR,  ,C 18,Stampa e riproduzione di supporti registrati                ,0,0,0,0,0,2021
ABR,  ,C 19,Fabbricazione di coke e prodotti derivanti dalla raffinaz...,0,0,0,0,0,2021
ABR,  ,C 20,Fabbricazione di prodotti chimici                           ,0,0,0,0,0,2021
ABR,  ,C 21,Fabbricazione di prodotti farmaceutici di base e di prepa...,0,0,0,0,0,2021
ABR,  ,C 22,Fabbricazione di articoli in gomma e materie plastiche      ,0,0,0,0,0,2021
ABR,  ,C 23,Fabbricazione di altri prodotti della lavorazione di miner..,0,0,0,0,0,2021
ABR,  ,C 24,Metallurgia                                                 ,0,0,0,0,0,2021
ABR,  ,C 25,Fabbricazione di prodotti in metallo (esclusi macchinari ...,0,0,3,0,3,2021
ABR,  ,C 26,Fabbricazione di computer e prodotti di elettronica e ott...,1,0,0,0,1,2021
ABR,  ,C 27,Fabbricazione di apparecchiature elettriche ed apparecchi...,0,0,0,0,0,2021
ABR,  ,C 28,Fabbricazione di macchinari ed apparecchiature nca          ,0,0,1,0,1,2021
ABR,  ,C 29,"Fabbricazione di autoveicoli, rimorchi e semirimorchi       ",0,0,0,0,0,2021
ABR,  ,C 30,Fabbricazione di altri mezzi di trasporto                   ,0,0,0,0,0,2021
ABR,  ,C 31,Fabbricazione di mobili                                     ,0,0,2,0,2,2021
ABR,  ,C 32,Altre industrie manifatturiere                              ,0,0,5,0,5,2021
ABR,  ,C 33,"Riparazione, manutenzione ed installazione di macchine ed...",0,0,3,0,3,2021
ABR,  ,D   ,"Fornitura di energia elettrica, gas, vapore e aria condiz...",0,0,0,0,0,2021
ABR,  ,D 35,"Fornitura di energia elettrica, gas, vapore e aria condiz...",0,0,0,0,0,2021
ABR,  ,E   ,"Fornitura di acqua; reti fognarie, attività di gestione d...",0,0,0,0,0,2021
ABR,  ,E 36,"Raccolta, trattamento e fornitura di acqua                  ",0,0,0,0,0,2021
ABR,  ,E 37,Gestione delle reti fognarie                                ,0,0,0,0,0,2021
ABR,  ,E 38,"Attività di raccolta, trattamento e smaltimento dei rifiu...",0,0,0,0,0,2021
ABR,  ,E 39,Attività di risanamento e altri servizi di gestione dei r...,0,0,0,0,0,2021
ABR,  ,F   ,Costruzioni                                                 ,0,0,78,0,78,2021
ABR,  ,F 41,Costruzione di edifici                                      ,0,0,26,0,26,2021
ABR,  ,F 42,Ingegneria civile                                           ,0,0,0,0,0,2021
ABR,  ,F 43,Lavori di costruzione specializzati                         ,0,0,52,0,52,2021
ABR,  ,G   ,Commercio all'ingrosso e al dettaglio; riparazione di aut...,0,0,71,0,71,2021
ABR,  ,G 45,Commercio all'ingrosso e al dettaglio e riparazione di au...,0,0,9,0,9,2021
ABR,  ,G 46,Commercio all'ingrosso (escluso quello di autoveicoli e d...,0,0,6,0,6,2021
ABR,  ,G 47,Commercio al dettaglio (escluso quello di autoveicoli e d...,0,0,56,0,56,2021
ABR,  ,H   ,Trasporto e magazzinaggio                                   ,0,0,11,1,12,2021
ABR,  ,H 49,Trasporto terrestre e mediante condotte                     ,0,0,11,1,12,2021
ABR,  ,H 50,Trasporto marittimo e per vie d'acqua                       ,0,0,0,0,0,2021
ABR,  ,H 51,Trasporto aereo                                             ,0,0,0,0,0,2021
ABR,  ,H 52,Magazzinaggio e attività di supporto ai trasporti           ,0,0,0,0,0,2021
ABR,  ,H 53,Servizi postali e attività di corriere                      ,0,0,0,0,0,2021
ABR,  ,I   ,Attività dei servizi alloggio e ristorazione                ,0,0,12,0,12,2021
ABR,  ,I 55,Alloggio                                                    ,0,0,0,0,0,2021
ABR,  ,I 56,Attività dei servizi di ristorazione                        ,0,0,12,0,12,2021
ABR,  ,J   ,Servizi di informazione e comunicazione                     ,0,0,0,0,0,2021
ABR,  ,J 58,Attività editoriali                                         ,0,0,0,0,0,2021
ABR,  ,J 59,"Attività di produzione cinematografica, di video e di pro...",0,0,0,0,0,2021
ABR,  ,J 60,Attività di programmazione e trasmissione                   ,0,0,0,0,0,2021
ABR,  ,J 61,Telecomunicazioni                                           ,0,0,0,0,0,2021
ABR,  ,J 62,"Produzione di software, consulenza informatica e attività...",0,0,0,0,0,2021
ABR,  ,J 63,Attività dei servizi d'informazione e altri servizi infor...,0,0,0,0,0,2021
ABR,  ,K   ,Attività finanziarie e assicurative                         ,0,0,2,0,2,2021
ABR,  ,K 64,Attività di servizi finanziari (escluse le assicurazioni ...,0,0,0,0,0,2021
ABR,  ,K 65,"Assicurazioni, riassicurazioni e fondi pensione (escluse ...",0,0,0,0,0,2021
ABR,  ,K 66,Attività ausiliarie dei servizi finanziari e delle attivi...,0,0,2,0,2,2021
ABR,  ,L   ,Attivita' immobiliari                                       ,0,0,0,0,0,2021
ABR,  ,L 68,Attivita' immobiliari                                       ,0,0,0,0,0,2021
ABR,  ,M   ,"Attività professionali, scientifiche e tecniche             ",1,0,2,0,3,2021
ABR,  ,M 69,Attività legali e contabilità                               ,0,0,0,0,0,2021
ABR,  ,M 70,Attività di direzione aziendale e di consulenza gestional...,1,0,1,0,2,2021
ABR,  ,M 71,Attività degli studi di architettura e d'ingegneria; coll...,0,0,0,0,0,2021
ABR,  ,M 72,Ricerca scientifica e sviluppo                              ,0,0,0,0,0,2021
ABR,  ,M 73,Pubblicità e ricerche di mercato                            ,0,0,0,0,0,2021
ABR,  ,M 74,"Altre attività professionali, scientifiche e tecniche       ",0,0,1,0,1,2021
ABR,  ,M 75,Servizi veterinari                                          ,0,0,0,0,0,2021
ABR,  ,N   ,"Noleggio, agenzie di viaggio, servizi di supporto alle im...",0,0,11,0,11,2021
ABR,  ,N 77,Attività di noleggio e leasing operativo                    ,0,0,1,0,1,2021
ABR,  ,N 78,"Attività di ricerca, selezione, fornitura di personale      ",0,0,0,0,0,2021
ABR,  ,N 79,"Attività dei servizi delle agenzie di viaggio, dei tour o...",0,0,2,0,2,2021
ABR,  ,N 80,Servizi di vigilanza e investigazione                       ,0,0,0,0,0,2021
ABR,  ,N 81,Attività di servizi per edifici e paesaggio                 ,0,0,5,0,5,2021
ABR,  ,N 82,Attività di supporto per le funzioni d'ufficio e altri se...,0,0,3,0,3,2021
ABR,  ,O   ,Amministrazione pubblica e difesa; assicurazione sociale ...,0,0,0,0,0,2021
ABR,  ,O 84,Amministrazione pubblica e difesa; assicurazione sociale ...,0,0,0,0,0,2021
ABR,  ,P   ,Istruzione                                                  ,0,0,0,0,0,2021
ABR,  ,P 85,Istruzione                                                  ,0,0,0,0,0,2021
ABR,  ,Q   ,Sanita' e assistenza sociale                                ,0,0,0,0,0,2021
ABR,  ,Q 86,Assistenza sanitaria                                        ,0,0,0,0,0,2021
ABR,  ,Q 87,Servizi di assistenza sociale residenziale                  ,0,0,0,0,0,2021
ABR,  ,Q 88,Assistenza sociale non residenziale                         ,0,0,0,0,0,2021
ABR,  ,R   ,"Attività artistiche, sportive, di intrattenimento e diver...",0,0,1,0,1,2021
ABR,  ,R 90,"Attività creative, artistiche e di intrattenimento          ",0,0,1,0,1,2021
ABR,  ,R 91,"Attività di biblioteche, archivi, musei ed altre attività...",0,0,0,0,0,2021
ABR,  ,R 92,"Attività riguardanti le lotterie, le scommesse, le case d...",0,0,0,0,0,2021
ABR,  ,R 93,"Attività sportive, di intrattenimento e di divertimento     ",0,0,0,0,0,2021
ABR,  ,S   ,Altre attività di servizi                                   ,0,0,12,0,12,2021
ABR,  ,S 94,Attività di organizzazioni associative                      ,0,0,0,0,0,2021
ABR,  ,S 95,Riparazione di computer e di beni per uso personale e per...,0,0,7,0,7,2021
ABR,  ,S 96,Altre attività di servizi per la persona                    ,0,0,5,0,5,2021
ABR,  ,T   ,Attività di famiglie e convivenze come datori di lavoro p...,0,0,0,0,0,2021
ABR,  ,T 97,Attività di famiglie e convivenze come datori di lavoro p...,0,0,0,0,0,2021
ABR,  ,T 98,Produzione di beni e servizi indifferenziati per uso prop...,0,0,0,0,0,2021
ABR,  ,U   ,Organizzazioni ed organismi extraterritoriali               ,0,0,0,0,0,2021
ABR,  ,U 99,Organizzazioni ed organismi extraterritoriali               ,0,0,0,0,0,2021
ABR,  ,XX  ,Imprese non classificate                                    ,0,0,1,4,5,2021
ABR,  ,TOT ,TOTALE                                                      ,2,0,231,5,238,2021
ABR,AQ,A   ,"Agricoltura, silvicoltura pesca                             ",0,0,0,0,0,2021
ABR,AQ,A 01,"Coltivazioni agricole e produzione di prodotti animali, c...",0,0,0,0,0,2021
ABR,AQ,A 02,Silvicoltura ed utilizzo di aree forestali                  ,0,0,0,0,0,2021
ABR,AQ,A 03,Pesca e acquacoltura                                        ,0,0,0,0,0,2021
ABR,AQ,B   ,Estrazione di minerali da cave e miniere                    ,0,0,0,0,0,2021
ABR,AQ,B 05,Estrazione di carbone (esclusa torba)                       ,0,0,0,0,0,2021
ABR,AQ,B 06,Estraz.di petrolio greggio e di gas naturale                ,0,0,0,0,0,2021
ABR,AQ,B 07,Estrazione di minerali metalliferi                          ,0,0,0,0,0,2021
ABR,AQ,B 08,Altre attività di estrazione di minerali da cave e miniere  ,0,0,0,0,0,2021
ABR,AQ,B 09,Attività dei servizi di supporto all'estrazione             ,0,0,0,0,0,2021
ABR,AQ,C   ,Attività manifatturiere                                     ,0,0,0,0,0,2021
ABR,AQ,C 10,Industrie alimentari                                        ,0,0,0,0,0,2021
ABR,AQ,C 11,Industria delle bevande                                     ,0,0,0,0,0,2021
ABR,AQ,C 12,Industria del tabacco                                       ,0,0,0,0,0,2021
ABR,AQ,C 13,Industrie tessili                                           ,0,0,0,0,0,2021
ABR,AQ,C 14,Confezione di articoli di abbigliamento; confezione di ar...,0,0,0,0,0,2021
ABR,AQ,C 15,Fabbricazione di articoli in pelle e simili                 ,0,0,0,0,0,2021
ABR,AQ,C 16,Industria del legno e dei prodotti in legno e sughero (es...,0,0,0,0,0,2021
ABR,AQ,C 17,Fabbricazione di carta e di prodotti di carta               ,0,0,0,0,0,2021
ABR,AQ,C 18,Stampa e riproduzione di supporti registrati                ,0,0,0,0,0,2021
ABR,AQ,C 19,Fabbricazione di coke e prodotti derivanti dalla raffinaz...,0,0,0,0,0,2021
ABR,AQ,C 20,Fabbricazione di prodotti chimici                           ,0,0,0,0,0,2021
ABR,AQ,C 21,Fabbricazione di prodotti farmaceutici di base e di prepa...,0,0,0,0,0,2021
ABR,AQ,C 22,Fabbricazione di articoli in gomma e materie plastiche      ,0,0,0,0,0,2021
ABR,AQ,C 23,Fabbricazione di altri prodotti della lavorazione di miner..,0,0,0,0,0,2021
ABR,AQ,C 24,Metallurgia                                                 ,0,0,0,0,0,2021
ABR,AQ,C 25,Fabbricazione di prodotti in metallo (esclusi macchinari ...,0,0,0,0,0,2021
ABR,AQ,C 26,Fabbricazione di computer e prodotti di elettronica e ott...,0,0,0,0,0,2021
ABR,AQ,C 27,Fabbricazione di apparecchiature elettriche ed apparecchi...,0,0,0,0,0,2021
ABR,AQ,C 28,Fabbricazione di macchinari ed apparecchiature nca          ,0,0,0,0,0,2021
ABR,AQ,C 29,"Fabbricazione di autoveicoli, rimorchi e semirimorchi       ",0,0,0,0,0,2021
ABR,AQ,C 30,Fabbricazione di altri mezzi di trasporto                   ,0,0,0,0,0,2021
ABR,AQ,C 31,Fabbricazione di mobili                                     ,0,0,0,0,0,2021
ABR,AQ,C 32,Altre industrie manifatturiere                              ,0,0,0,0,0,2021
ABR,AQ,C 33,"Riparazione, manutenzione ed installazione di macchine ed...",0,0,0,0,0,2021
ABR,AQ,D   ,"Fornitura di energia elettrica, gas, vapore e aria condiz...",0,0,0,0,0,2021
ABR,AQ,D 35,"Fornitura di energia elettrica, gas, vapore e aria condiz...",0,0,0,0,0,2021
ABR,AQ,E   ,"Fornitura di acqua; reti fognarie, attività di gestione d...",0,0,0,0,0,2021
ABR,AQ,E 36,"Raccolta, trattamento e fornitura di acqua                  ",0,0,0,0,0,2021
ABR,AQ,E 37,Gestione delle reti fognarie                                ,0,0,0,0,0,2021
ABR,AQ,E 38,"Attività di raccolta, trattamento e smaltimento dei rifiu...",0,0,0,0,0,2021
ABR,AQ,E 39,Attività di risanamento e altri servizi di gestione dei r...,0,0,0,0,0,2021
ABR,AQ,F   ,Costruzioni                                                 ,0,0,0,0,0,2021
ABR,AQ,F 41,Costruzione di edifici                                      ,0,0,0,0,0,2021
ABR,AQ,F 42,Ingegneria civile                                           ,0,0,0,0,0,2021
ABR,AQ,F 43,Lavori di costruzione specializzati                         ,0,0,0,0,0,2021
ABR,AQ,G   ,Commercio all'ingrosso e al dettaglio; riparazione di aut...,0,0,0,0,0,2021
ABR,AQ,G 45,Commercio all'ingrosso e al dettaglio e riparazione di au...,0,0,0,0,0,2021
ABR,AQ,G 46,Commercio all'ingrosso (escluso quello di autoveicoli e d...,0,0,0,0,0,2021
ABR,AQ,G 47,Commercio al dettaglio (escluso quello di autoveicoli e d...,0,0,0,0,0,2021
ABR,AQ,H   ,Trasporto e magazzinaggio                                   ,0,0,0,0,0,2021
ABR,AQ,H 49,Trasporto terrestre e mediante condotte                     ,0,0,0,0,0,2021
ABR,AQ,H 50,Trasporto marittimo e per vie d'acqua                       ,0,0,0,0,0,2021
ABR,AQ,H 51,Trasporto aereo                                             ,0,0,0,0,0,2021
ABR,AQ,H 52,Magazzinaggio e attività di supporto ai trasporti           ,0,0,0,0,0,2021
ABR,AQ,H 53,Servizi postali e attività di corriere                      ,0,0,0,0,0,2021
ABR,AQ,I   ,Attività dei servizi alloggio e ristorazione                ,0,0,0,0,0,2021
ABR,AQ,I 55,Alloggio                                                    ,0,0,0,0,0,2021
ABR,AQ,I 56,Attività dei servizi di ristorazione                        ,0,0,0,0,0,2021
ABR,AQ,J   ,Servizi di informazione e comunicazione                     ,0,0,0,0,0,2021
ABR,AQ,J 58,Attività editoriali                                         ,0,0,0,0,0,2021
ABR,AQ,J 59,"Attività di produzione cinematografica, di video e di pro...",0,0,0,0,0,2021
ABR,AQ,J 60,Attività di programmazione e trasmissione                   ,0,0,0,0,0,2021
ABR,AQ,J 61,Telecomunicazioni                                           ,0,0,0,0,0,2021
ABR,AQ,J 62,"Produzione di software, consulenza informatica e attività...",0,0,0,0,0,2021
ABR,AQ,J 63,Attività dei servizi d'informazione e altri servizi infor...,0,0,0,0,0,2021
ABR,AQ,K   ,Attività finanziarie e assicurative                         ,0,0,0,0,0,2021
ABR,AQ,K 64,Attività di servizi finanziari (escluse le assicurazioni ...,0,0,0,0,0,2021
ABR,AQ,K 65,"Assicurazioni, riassicurazioni e fondi pensione (escluse ...",0,0,0,0,0,2021
ABR,AQ,K 66,Attività ausiliarie dei servizi finanziari e delle attivi...,0,0,0,0,0,2021
ABR,AQ,L   ,Attivita' immobiliari                                       ,0,0,0,0,0,2021
ABR,AQ,L 68,Attivita' immobiliari                                       ,0,0,0,0,0,2021
ABR,AQ,M   ,"Attività professionali, scientifiche e tecniche             ",0,0,0,0,0,2021
ABR,AQ,M 69,Attività legali e contabilità                               ,0,0,0,0,0,2021
ABR,AQ,M 70,Attività di direzione aziendale e di consulenza gestional...,0,0,0,0,0,2021
ABR,AQ,M 71,Attività degli studi di architettura e d'ingegneria; coll...,0,0,0,0,0,2021
ABR,AQ,M 72,Ricerca scientifica e sviluppo                              ,0,0,0,0,0,2021
ABR,AQ,M 73,Pubblicità e ricerche di mercato                            ,0,0,0,0,0,2021
ABR,AQ,M 74,"Altre attività professionali, scientifiche e tecniche       ",0,0,0,0,0,2021
ABR,AQ,M 75,Servizi veterinari                                          ,0,0,0,0,0,2021
ABR,AQ,N   ,"Noleggio, agenzie di viaggio, servizi di supporto alle im...",0,0,0,0,0,2021
ABR,AQ,N 77,Attività di noleggio e leasing operativo                    ,0,0,0,0,0,2021
ABR,AQ,N 78,"Attività di ricerca, selezione, fornitura di personale      ",0,0,0,0,0,2021
ABR,AQ,N 79,"Attività dei servizi delle agenzie di viaggio, dei tour o...",0,0,0,0,0,2021
ABR,AQ,N 80,Servizi di vigilanza e investigazione                       ,0,0,0,0,0,2021
ABR,AQ,N 81,Attività di servizi per edifici e paesaggio                 ,0,0,0,0,0,2021
ABR,AQ,N 82,Attività di supporto per le funzioni d'ufficio e altri se...,0,0,0,0,0,2021
ABR,AQ,O   ,Amministrazione pubblica e difesa; assicurazione sociale ...,0,0,0,0,0,2021
ABR,AQ,O 84,Amministrazione pubblica e difesa; assicurazione sociale ...,0,0,0,0,0,2021
ABR,AQ,P   ,Istruzione                                                  ,0,0,0,0,0,2021
ABR,AQ,P 85,Istruzione                                                  ,0,0,0,0,0,2021
ABR,AQ,Q   ,Sanita' e assistenza sociale                                ,0,0,0,0,0,2021
ABR,AQ,Q 86,Assistenza sanitaria                                        ,0,0,0,0,0,2021
ABR,AQ,Q 87,Servizi di assistenza sociale residenziale                  ,0,0,0,0,0,2021
ABR,AQ,Q 88,Assistenza sociale non residenziale                         ,0,0,0,0,0,2021
ABR,AQ,R   ,"Attività artistiche, sportive, di intrattenimento e diver...",0,0,0,0,0,2021
ABR,AQ,R 90,"Attività creative, artistiche e di intrattenimento          ",0,0,0,0,0,2021
ABR,AQ,R 91,"Attività di biblioteche, archivi, musei ed altre attività...",0,0,0,0,0,2021
ABR,AQ,R 92,"Attività riguardanti le lotterie, le scommesse, le case d...",0,0,0,0,0,2021
ABR,AQ,R 93,"Attività sportive, di intrattenimento e di divertimento     ",0,0,0,0,0,2021
ABR,AQ,S   ,Altre attività di servizi                                   ,0,0,0,0,0,2021
ABR,AQ,S 94,Attività di organizzazioni associative                      ,0,0,0,0,0,2021
ABR,AQ,S 95,Riparazione di computer e di beni per uso personale e per...,0,0,0,0,0,2021
ABR,AQ,S 96,Altre attività di servizi per la persona                    ,0,0,0,0,0,2021
ABR,AQ,T   ,Attività di famiglie e convivenze come datori di lavoro p...,0,0,0,0,0,2021
ABR,AQ,T 97,Attività di famiglie e convivenze come datori di lavoro p...,0,0,0,0,0,2021
ABR,AQ,T 98,Produzione di beni e servizi indifferenziati per uso prop...,0,0,0,0,0,2021
ABR,AQ,U   ,Organizzazioni ed organismi extraterritoriali               ,0,0,0,0,0,2021
ABR,AQ,U 99,Organizzazioni ed organismi extraterritoriali               ,0,0,0,0,0,2021
ABR,AQ,XX  ,Imprese non classificate                                    ,0,0,0,0,0,2021
ABR,AQ,TOT ,TOTALE                                                      ,0,0,0,0,0,2021
ABR,TE,A   ,"Agricoltura, silvicoltura pesca                             ",0,0,0,0,0,2021
ABR,TE,A 01,"Coltivazioni agricole e produzione di prodotti animali, c...",0,0,0,0,0,2021
ABR,TE,A 02,Silvicoltura ed utilizzo di aree forestali                  ,0,0,0,0,0,2021
ABR,TE,A 03,Pesca e acquacoltura                                        ,0,0,0,0,0,2021
ABR,TE,B   ,Estrazione di minerali da cave e miniere                    ,0,0,0,0,0,2021
ABR,TE,B 05,Estrazione di carbone (esclusa torba)                       ,0,0,0,0,0,2021
ABR,TE,B 06,Estraz.di petrolio greggio e di gas naturale                ,0,0,0,0,0,2021
ABR,TE,B 07,Estrazione di minerali metalliferi                          ,0,0,0,0,0,2021
ABR,TE,B 08,Altre attività di estrazione di minerali da cave e miniere  ,0,0,0,0,0,2021
ABR,TE,B 09,Attività dei servizi di supporto all'estrazione             ,0,0,0,0,0,2021
ABR,TE,C   ,Attività manifatturiere                                     ,0,0,1,0,1,2021
ABR,TE,C 10,Industrie alimentari                                        ,0,0,0,0,0,2021
ABR,TE,C 11,Industria delle bevande                                     ,0,0,0,0,0,2021
ABR,TE,C 12,Industria del tabacco                                       ,0,0,0,0,0,2021
ABR,TE,C 13,Industrie tessili                                           ,0,0,0,0,0,2021
ABR,TE,C 14,Confezione di articoli di abbigliamento; confezione di ar...,0,0,1,0,1,2021
ABR,TE,C 15,Fabbricazione di articoli in pelle e simili                 ,0,0,0,0,0,2021
ABR,TE,C 16,Industria del legno e dei prodotti in legno e sughero (es...,0,0,0,0,0,2021
ABR,TE,C 17,Fabbricazione di carta e di prodotti di carta               ,0,0,0,0,0,2021
ABR,TE,C 18,Stampa e riproduzione di supporti registrati                ,0,0,0,0,0,2021
ABR,TE,C 19,Fabbricazione di coke e prodotti derivanti dalla raffinaz...,0,0,0,0,0,2021
ABR,TE,C 20,Fabbricazione di prodotti chimici                           ,0,0,0,0,0,2021
ABR,TE,C 21,Fabbricazione di prodotti farmaceutici di base e di prepa...,0,0,0,0,0,2021
ABR,TE,C 22,Fabbricazione di articoli in gomma e materie plastiche      ,0,0,0,0,0,2021
ABR,TE,C 23,Fabbricazione di altri prodotti della lavorazione di miner..,0,0,0,0,0,2021
ABR,TE,C 24,Metallurgia                                                 ,0,0,0,0,0,2021
ABR,TE,C 25,Fabbricazione di prodotti in metallo (esclusi macchinari ...,0,0,0,0,0,2021
ABR,TE,C 26,Fabbricazione di computer e prodotti di elettronica e ott...,0,0,0,0,0,2021
ABR,TE,C 27,Fabbricazione di apparecchiature elettriche ed apparecchi...,0,0,0,0,0,2021
ABR,TE,C 28,Fabbricazione di macchinari ed apparecchiature nca          ,0,0,0,0,0,2021
ABR,TE,C 29,"Fabbricazione di autoveicoli, rimorchi e semirimorchi       ",0,0,0,0,0,2021
ABR,TE,C 30,Fabbricazione di altri mezzi di trasporto                   ,0,0,0,0,0,2021
ABR,TE,C 31,Fabbricazione di mobili                                     ,0,0,0,0,0,2021
ABR,TE,C 32,Altre industrie manifatturiere                              ,0,0,0,0,0,2021
ABR,TE,C 33,"Riparazione, manutenzione ed installazione di macchine ed...",0,0,0,0,0,2021
ABR,TE,D   ,"Fornitura di energia elettrica, gas, vapore e aria condiz...",0,0,0,0,0,2021
ABR,TE,D 35,"Fornitura di energia elettrica, gas, vapore e aria condiz...",0,0,0,0,0,2021
ABR,TE,E   ,"Fornitura di acqua; reti fognarie, attività di gestione d...",0,0,0,0,0,2021
ABR,TE,E 36,"Raccolta, trattamento e fornitura di acqua                  ",0,0,0,0,0,2021
ABR,TE,E 37,Gestione delle reti fognarie                                ,0,0,0,0,0,2021
ABR,TE,E 38,"Attività di raccolta, trattamento e smaltimento dei rifiu...",0,0,0,0,0,2021
ABR,TE,E 39,Attività di risanamento e altri servizi di gestione dei r...,0,0,0,0,0,2021
ABR,TE,F   ,Costruzioni                                                 ,0,0,0,0,0,2021
ABR,TE,F 41,Costruzione di edifici                                      ,0,0,0,0,0,2021
ABR,TE,F 42,Ingegneria civile                                           ,0,0,0,0,0,2021
ABR,TE,F 43,Lavori di costruzione specializzati                         ,0,0,0,0,0,2021
ABR,TE,G   ,Commercio all'ingrosso e al dettaglio; riparazione di aut...,0,0,2,0,2,2021
ABR,TE,G 45,Commercio all'ingrosso e al dettaglio e riparazione di au...,0,0,0,0,0,2021
ABR,TE,G 46,Commercio all'ingrosso (escluso quello di autoveicoli e d...,0,0,0,0,0,2021
ABR,TE,G 47,Commercio al dettaglio (escluso quello di autoveicoli e d...,0,0,2,0,2,2021
ABR,TE,H   ,Trasporto e magazzinaggio                                   ,0,0,0,0,0,2021
ABR,TE,H 49,Trasporto terrestre e mediante condotte                     ,0,0,0,0,0,2021
ABR,TE,H 50,Trasporto marittimo e per vie d'acqua                       ,0,0,0,0,0,2021
ABR,TE,H 51,Trasporto aereo                                             ,0,0,0,0,0,2021
ABR,TE,H 52,Magazzinaggio e attività di supporto ai trasporti           ,0,0,0,0,0,2021
ABR,TE,H 53,Servizi postali e attività di corriere                      ,0,0,0,0,0,2021
ABR,TE,I   ,Attività dei servizi alloggio e ristorazione                ,0,0,0,0,0,2021
ABR,TE,I 55,Alloggio                                                    ,0,0,0,0,0,2021
ABR,TE,I 56,Attività dei servizi di ristorazione                        ,0,0,0,0,0,2021
ABR,TE,J   ,Servizi di informazione e comunicazione                     ,0,0,0,0,0,2021
ABR,TE,J 58,Attività editoriali                                         ,0,0,0,0,0,2021
ABR,TE,J 59,"Attività di produzione cinematografica, di video e di pro...",0,0,0,0,0,2021
ABR,TE,J 60,Attività di programmazione e trasmissione                   ,0,0,0,0,0,2021
ABR,TE,J 61,Telecomunicazioni                                           ,0,0,0,0,0,2021
ABR,TE,J 62,"Produzione di software, consulenza informatica e attività...",0,0,0,0,0,2021
ABR,TE,J 63,Attività dei servizi d'informazione e altri servizi infor...,0,0,0,0,0,2021
ABR,TE,K   ,Attività finanziarie e assicurative                         ,0,0,0,0,0,2021
ABR,TE,K 64,Attività di servizi finanziari (escluse le assicurazioni ...,0,0,0,0,0,2021
ABR,TE,K 65,"Assicurazioni, riassicurazioni e fondi pensione (escluse ...",0,0,0,0,0,2021
ABR,TE,K 66,Attività ausiliarie dei servizi finanziari e delle attivi...,0,0,0,0,0,2021
ABR,TE,L   ,Attivita' immobiliari                                       ,0,0,0,0,0,2021
ABR,TE,L 68,Attivita' immobiliari                                       ,0,0,0,0,0,2021
ABR,TE,M   ,"Attività professionali, scientifiche e tecniche             ",0,0,0,0,0,2021
ABR,TE,M 69,Attività legali e contabilità                               ,0,0,0,0,0,2021
ABR,TE,M 70,Attività di direzione aziendale e di consulenza gestional...,0,0,0,0,0,2021
ABR,TE,M 71,Attività degli studi di architettura e d'ingegneria; coll...,0,0,0,0,0,2021
ABR,TE,M 72,Ricerca scientifica e sviluppo                              ,0,0,0,0,0,2021
ABR,TE,M 73,Pubblicità e ricerche di mercato                            ,0,0,0,0,0,2021
ABR,TE,M 74,"Altre attività professionali, scientifiche e tecniche       ",0,0,0,0,0,2021
ABR,TE,M 75,Servizi veterinari                                          ,0,0,0,0,0,2021
ABR,TE,N   ,"Noleggio, agenzie di viaggio, servizi di supporto alle im...",0,0,0,0,0,2021
ABR,TE,N 77,Attività di noleggio e leasing operativo                    ,0,0,0,0,0,2021
ABR,TE,N 78,"Attività di ricerca, selezione, fornitura di personale      ",0,0,0,0,0,2021
ABR,TE,N 79,"Attività dei servizi delle agenzie di viaggio, dei tour o...",0,0,0,0,0,2021
ABR,TE,N 80,Servizi di vigilanza e investigazione                       ,0,0,0,0,0,2021
ABR,TE,N 81,Attività di servizi per edifici e paesaggio                 ,0,0,0,0,0,2021
ABR,TE,N 82,Attività di supporto per le funzioni d'ufficio e altri se...,0,0,0,0,0,2021
ABR,TE,O   ,Amministrazione pubblica e difesa; assicurazione sociale ...,0,0,0,0,0,2021
ABR,TE,O 84,Amministrazione pubblica e difesa; assicurazione sociale ...,0,0,0,0,0,2021
ABR,TE,P   ,Istruzione                                                  ,0,0,0,0,0,2021
ABR,TE,P 85,Istruzione                                                  ,0,0,0,0,0,2021
ABR,TE,Q   ,Sanita' e assistenza sociale                                ,0,0,0,0,0,2021
ABR,TE,Q 86,Assistenza sanitaria                                        ,0,0,0,0,0,2021
ABR,TE,Q 87,Servizi di assistenza sociale residenziale                  ,0,0,0,0,0,2021
ABR,TE,Q 88,Assistenza sociale non residenziale                         ,0,0,0,0,0,2021
ABR,TE,R   ,"Attività artistiche, sportive, di intrattenimento e diver...",0,0,0,0,0,2021
ABR,TE,R 90,"Attività creative, artistiche e di intrattenimento          ",0,0,0,0,0,2021
ABR,TE,R 91,"Attività di biblioteche, archivi, musei ed altre attività...",0,0,0,0,0,2021
ABR,TE,R 92,"Attività riguardanti le lotterie, le scommesse, le case d...",0,0,0,0,0,2021
ABR,TE,R 93,"Attività sportive, di intrattenimento e di divertimento     ",0,0,0,0,0,2021
ABR,TE,S   ,Altre attività di servizi                                   ,0,0,0,0,0,2021
ABR,TE,S 94,Attività di organizzazioni associative                      ,0,0,0,0,0,2021
ABR,TE,S 95,Riparazione di computer e di beni per uso personale e per...,0,0,0,0,0,2021
ABR,TE,S 96,Altre attività di servizi per la persona                    ,0,0,0,0,0,2021
ABR,TE,T   ,Attività di famiglie e convivenze come datori di lavoro p...,0,0,0,0,0,2021
ABR,TE,T 97,Attività di famiglie e convivenze come datori di lavoro p...,0,0,0,0,0,2021
ABR,TE,T 98,Produzione di beni e servizi indifferenziati per uso prop...,0,0,0,0,0,2021
ABR,TE,U   ,Organizzazioni ed organismi extraterritoriali               ,0,0,0,0,0,2021
ABR,TE,U 99,Organizzazioni ed organismi extraterritoriali               ,0,0,0,0,0,2021
ABR,TE,XX  ,Imprese non classificate                                    ,0,0,0,0,0,2021
ABR,TE,TOT ,TOTALE                                                      ,0,0,3,0,3,2021
ABR,PE,A   ,"Agricoltura, silvicoltura pesca                             ",0,0,1,0,1,2021
ABR,PE,A 01,"Coltivazioni agricole e produzione di prodotti animali, c...",0,0,1,0,1,2021
ABR,PE,A 02,Silvicoltura ed utilizzo di aree forestali                  ,0,0,0,0,0,2021
ABR,PE,A 03,Pesca e acquacoltura                                        ,0,0,0,0,0,2021
ABR,PE,B   ,Estrazione di minerali da cave e miniere                    ,0,0,0,0,0,2021
ABR,PE,B 05,Estrazione di carbone (esclusa torba)                       ,0,0,0,0,0,2021
ABR,PE,B 06,Estraz.di petrolio greggio e di gas naturale                ,0,0,0,0,0,2021
ABR,PE,B 07,Estrazione di minerali metalliferi                          ,0,0,0,0,0,2021
ABR,PE,B 08,Altre attività di estrazione di minerali da cave e miniere  ,0,0,0,0,0,2021
ABR,PE,B 09,Attività dei servizi di supporto all'estrazione             ,0,0,0,0,0,2021
ABR,PE,C   ,Attività manifatturiere                                     ,0,0,28,0,28,2021
ABR,PE,C 10,Industrie alimentari                                        ,0,0,0,0,0,2021
ABR,PE,C 11,Industria delle bevande                                     ,0,0,0,0,0,2021
ABR,PE,C 12,Industria del tabacco                                       ,0,0,0,0,0,2021
ABR,PE,C 13,Industrie tessili                                           ,0,0,1,0,1,2021
ABR,PE,C 14,Confezione di articoli di abbigliamento; confezione di ar...,0,0,8,0,8,2021
ABR,PE,C 15,Fabbricazione di articoli in pelle e simili                 ,0,0,0,0,0,2021
ABR,PE,C 16,Industria del legno e dei prodotti in legno e sughero (es...,0,0,5,0,5,2021
ABR,PE,C 17,Fabbricazione di carta e di prodotti di carta               ,0,0,0,0,0,2021
ABR,PE,C 18,Stampa e riproduzione di supporti registrati                ,0,0,0,0,0,2021
ABR,PE,C 19,Fabbricazione di coke e prodotti derivanti dalla raffinaz...,0,0,0,0,0,2021
ABR,PE,C 20,Fabbricazione di prodotti chimici                           ,0,0,0,0,0,2021
ABR,PE,C 21,Fabbricazione di prodotti farmaceutici di base e di prepa...,0,0,0,0,0,2021
ABR,PE,C 22,Fabbricazione di articoli in gomma e materie plastiche      ,0,0,0,0,0,2021
ABR,PE,C 23,Fabbricazione di altri prodotti della lavorazione di miner..,0,0,0,0,0,2021
ABR,PE,C 24,Metallurgia                                                 ,0,0,0,0,0,2021
ABR,PE,C 25,Fabbricazione di prodotti in metallo (esclusi macchinari ...,0,0,3,0,3,2021
ABR,PE,C 26,Fabbricazione di computer e prodotti di elettronica e ott...,0,0,0,0,0,2021
ABR,PE,C 27,Fabbricazione di apparecchiature elettriche ed apparecchi...,0,0,0,0,0,2021
ABR,PE,C 28,Fabbricazione di macchinari ed apparecchiature nca          ,0,0,1,0,1,2021
ABR,PE,C 29,"Fabbricazione di autoveicoli, rimorchi e semirimorchi       ",0,0,0,0,0,2021
ABR,PE,C 30,Fabbricazione di altri mezzi di trasporto                   ,0,0,0,0,0,2021
ABR,PE,C 31,Fabbricazione di mobili                                     ,0,0,2,0,2,2021
ABR,PE,C 32,Altre industrie manifatturiere                              ,0,0,5,0,5,2021
ABR,PE,C 33,"Riparazione, manutenzione ed installazione di macchine ed...",0,0,3,0,3,2021
ABR,PE,D   ,"Fornitura di energia elettrica, gas, vapore e aria condiz...",0,0,0,0,0,2021
ABR,PE,D 35,"Fornitura di energia elettrica, gas, vapore e aria condiz...",0,0,0,0,0,2021
ABR,PE,E   ,"Fornitura di acqua; reti fognarie, attività di gestione d...",0,0,0,0,0,2021
ABR,PE,E 36,"Raccolta, trattamento e fornitura di acqua                  ",0,0,0,0,0,2021
ABR,PE,E 37,Gestione delle reti fognarie                                ,0,0,0,0,0,2021
ABR,PE,E 38,"Attività di raccolta, trattamento e smaltimento dei rifiu...",0,0,0,0,0,2021
ABR,PE,E 39,Attività di risanamento e altri servizi di gestione dei r...,0,0,0,0,0,2021
ABR,PE,F   ,Costruzioni                                                 ,0,0,78,0,78,2021
ABR,PE,F 41,Costruzione di edifici                                      ,0,0,26,0,26,2021
ABR,PE,F 42,Ingegneria civile                                           ,0,0,0,0,0,2021
ABR,PE,F 43,Lavori di costruzione specializzati                         ,0,0,52,0,52,2021
ABR,PE,G   ,Commercio all'ingrosso e al dettaglio; riparazione di aut...,0,0,69,0,69,2021
ABR,PE,G 45,Commercio all'ingrosso e al dettaglio e riparazione di au...,0,0,9,0,9,2021
ABR,PE,G 46,Commercio all'ingrosso (escluso quello di autoveicoli e d...,0,0,6,0,6,2021
ABR,PE,G 47,Commercio al dettaglio (escluso quello di autoveicoli e d...,0,0,54,0,54,2021
ABR,PE,H   ,Trasporto e magazzinaggio                                   ,0,0,11,0,11,2021
ABR,PE,H 49,Trasporto terrestre e mediante condotte                     ,0,0,11,0,11,2021
ABR,PE,H 50,Trasporto marittimo e per vie d'acqua                       ,0,0,0,0,0,2021
ABR,PE,H 51,Trasporto aereo                                             ,0,0,0,0,0,2021
ABR,PE,H 52,Magazzinaggio e attività di supporto ai trasporti           ,0,0,0,0,0,2021
ABR,PE,H 53,Servizi postali e attività di corriere                      ,0,0,0,0,0,2021
ABR,PE,I   ,Attività dei servizi alloggio e ristorazione                ,0,0,12,0,12,2021
ABR,PE,I 55,Alloggio                                                    ,0,0,0,0,0,2021
ABR,PE,I 56,Attività dei servizi di ristorazione                        ,0,0,12,0,12,2021
ABR,PE,J   ,Servizi di informazione e comunicazione                     ,0,0,0,0,0,2021
ABR,PE,J 58,Attività editoriali                                         ,0,0,0,0,0,2021
ABR,PE,J 59,"Attività di produzione cinematografica, di video e di pro...",0,0,0,0,0,2021
ABR,PE,J 60,Attività di programmazione e trasmissione                   ,0,0,0,0,0,2021
ABR,PE,J 61,Telecomunicazioni                                           ,0,0,0,0,0,2021
ABR,PE,J 62,"Produzione di software, consulenza informatica e attività...",0,0,0,0,0,2021
ABR,PE,J 63,Attività dei servizi d'informazione e altri servizi infor...,0,0,0,0,0,2021
ABR,PE,K   ,Attività finanziarie e assicurative                         ,0,0,2,0,2,2021
ABR,PE,K 64,Attività di servizi finanziari (escluse le assicurazioni ...,0,0,0,0,0,2021
ABR,PE,K 65,"Assicurazioni, riassicurazioni e fondi pensione (escluse ...",0,0,0,0,0,2021
ABR,PE,K 66,Attività ausiliarie dei servizi finanziari e delle attivi...,0,0,2,0,2,2021
ABR,PE,L   ,Attivita' immobiliari                                       ,0,0,0,0,0,2021
ABR,PE,L 68,Attivita' immobiliari                                       ,0,0,0,0,0,2021
ABR,PE,M   ,"Attività professionali, scientifiche e tecniche             ",0,0,2,0,2,2021
ABR,PE,M 69,Attività legali e contabilità                               ,0,0,0,0,0,2021
ABR,PE,M 70,Attività di direzione aziendale e di consulenza gestional...,0,0,1,0,1,2021
ABR,PE,M 71,Attività degli studi di architettura e d'ingegneria; coll...,0,0,0,0,0,2021
ABR,PE,M 72,Ricerca scientifica e sviluppo                              ,0,0,0,0,0,2021
ABR,PE,M 73,Pubblicità e ricerche di mercato                            ,0,0,0,0,0,2021
ABR,PE,M 74,"Altre attività professionali, scientifiche e tecniche       ",0,0,1,0,1,2021
ABR,PE,M 75,Servizi veterinari                                          ,0,0,0,0,0,2021
ABR,PE,N   ,"Noleggio, agenzie di viaggio, servizi di supporto alle im...",0,0,11,0,11,2021
ABR,PE,N 77,Attività di noleggio e leasing operativo                    ,0,0,1,0,1,2021
ABR,PE,N 78,"Attività di ricerca, selezione, fornitura di personale      ",0,0,0,0,0,2021
ABR,PE,N 79,"Attività dei servizi delle agenzie di viaggio, dei tour o...",0,0,2,0,2,2021
ABR,PE,N 80,Servizi di vigilanza e investigazione                       ,0,0,0,0,0,2021
ABR,PE,N 81,Attività di servizi per edifici e paesaggio                 ,0,0,5,0,5,2021
ABR,PE,N 82,Attività di supporto per le funzioni d'ufficio e altri se...,0,0,3,0,3,2021
ABR,PE,O   ,Amministrazione pubblica e difesa; assicurazione sociale ...,0,0,0,0,0,2021
ABR,PE,O 84,Amministrazione pubblica e difesa; assicurazione sociale ...,0,0,0,0,0,2021
ABR,PE,P   ,Istruzione                                                  ,0,0,0,0,0,2021
ABR,PE,P 85,Istruzione                                                  ,0,0,0,0,0,2021
ABR,PE,Q   ,Sanita' e assistenza sociale                                ,0,0,0,0,0,2021
ABR,PE,Q 86,Assistenza sanitaria                                        ,0,0,0,0,0,2021
ABR,PE,Q 87,Servizi di assistenza sociale residenziale                  ,0,0,0,0,0,2021
ABR,PE,Q 88,Assistenza sociale non residenziale                         ,0,0,0,0,0,2021
ABR,PE,R   ,"Attività artistiche, sportive, di intrattenimento e diver...",0,0,1,0,1,2021
ABR,PE,R 90,"Attività creative, artistiche e di intrattenimento          ",0,0,1,0,1,2021
ABR,PE,R 91,"Attività di biblioteche, archivi, musei ed altre attività...",0,0,0,0,0,2021
ABR,PE,R 92,"Attività riguardanti le lotterie, le scommesse, le case d...",0,0,0,0,0,2021
ABR,PE,R 93,"Attività sportive, di intrattenimento e di divertimento     ",0,0,0,0,0,2021
ABR,PE,S   ,Altre attività di servizi                                   ,0,0,12,0,12,2021
ABR,PE,S 94,Attività di organizzazioni associative                      ,0,0,0,0,0,2021
ABR,PE,S 95,Riparazione di computer e di beni per uso personale e per...,0,0,7,0,7,2021
ABR,PE,S 96,Altre attività di servizi per la persona                    ,0,0,5,0,5,2021
ABR,PE,T   ,Attività di famiglie e convivenze come datori di lavoro p...,0,0,0,0,0,2021
ABR,PE,T 97,Attività di famiglie e convivenze come datori di lavoro p...,0,0,0,0,0,2021
ABR,PE,T 98,Produzione di beni e servizi indifferenziati per uso prop...,0,0,0,0,0,2021
ABR,PE,U   ,Organizzazioni ed organismi extraterritoriali               ,0,0,0,0,0,2021
ABR,PE,U 99,Organizzazioni ed organismi extraterritoriali               ,0,0,0,0,0,2021
ABR,PE,XX  ,Imprese non classificate                                    ,0,0,1,4,5,2021
ABR,PE,TOT ,TOTALE                                                      ,0,0,228,4,232,2021
ABR,CH,A   ,"Agricoltura, silvicoltura pesca                             ",0,0,0,0,0,2021
ABR,CH,A 01,"Coltivazioni agricole e produzione di prodotti animali, c...",0,0,0,0,0,2021
ABR,CH,A 02,Silvicoltura ed utilizzo di aree forestali                  ,0,0,0,0,0,2021
ABR,CH,A 03,Pesca e acquacoltura                                        ,0,0,0,0,0,2021
ABR,CH,B   ,Estrazione di minerali da cave e miniere                    ,0,0,0,0,0,2021
ABR,CH,B 05,Estrazione di carbone (esclusa torba)                       ,0,0,0,0,0,2021
ABR,CH,B 06,Estraz.di petrolio greggio e di gas naturale                ,0,0,0,0,0,2021
ABR,CH,B 07,Estrazione di minerali metalliferi                          ,0,0,0,0,0,2021
ABR,CH,B 08,Altre attività di estrazione di minerali da cave e miniere  ,0,0,0,0,0,2021
ABR,CH,B 09,Attività dei servizi di supporto all'estrazione             ,0,0,0,0,0,2021
ABR,CH,C   ,Attività manifatturiere                                     ,1,0,0,0,1,2021
ABR,CH,C 10,Industrie alimentari                                        ,0,0,0,0,0,2021
ABR,CH,C 11,Industria delle bevande                                     ,0,0,0,0,0,2021
ABR,CH,C 12,Industria del tabacco                                       ,0,0,0,0,0,2021
ABR,CH,C 13,Industrie tessili                                           ,0,0,0,0,0,2021
ABR,CH,C 14,Confezione di articoli di abbigliamento; confezione di ar...,0,0,0,0,0,2021
ABR,CH,C 15,Fabbricazione di articoli in pelle e simili                 ,0,0,0,0,0,2021
ABR,CH,C 16,Industria del legno e dei prodotti in legno e sughero (es...,0,0,0,0,0,2021
ABR,CH,C 17,Fabbricazione di carta e di prodotti di carta               ,0,0,0,0,0,2021
ABR,CH,C 18,Stampa e riproduzione di supporti registrati                ,0,0,0,0,0,2021
ABR,CH,C 19,Fabbricazione di coke e prodotti derivanti dalla raffinaz...,0,0,0,0,0,2021
ABR,CH,C 20,Fabbricazione di prodotti chimici                           ,0,0,0,0,0,2021
ABR,CH,C 21,Fabbricazione di prodotti farmaceutici di base e di prepa...,0,0,0,0,0,2021
ABR,CH,C 22,Fabbricazione di articoli in gomma e materie plastiche      ,0,0,0,0,0,2021
ABR,CH,C 23,Fabbricazione di altri prodotti della lavorazione di miner..,0,0,0,0,0,2021
ABR,CH,C 24,Metallurgia                                                 ,0,0,0,0,0,2021
ABR,CH,C 25,Fabbricazione di prodotti in metallo (esclusi macchinari ...,0,0,0,0,0,2021
ABR,CH,C 26,Fabbricazione di computer e prodotti di elettronica e ott...,1,0,0,0,1,2021
ABR,CH,C 27,Fabbricazione di apparecchiature elettriche ed apparecchi...,0,0,0,0,0,2021
ABR,CH,C 28,Fabbricazione di macchinari ed apparecchiature nca          ,0,0,0,0,0,2021
ABR,CH,C 29,"Fabbricazione di autoveicoli, rimorchi e semirimorchi       ",0,0,0,0,0,2021
ABR,CH,C 30,Fabbricazione di altri mezzi di trasporto                   ,0,0,0,0,0,2021
ABR,CH,C 31,Fabbricazione di mobili                                     ,0,0,0,0,0,2021
ABR,CH,C 32,Altre industrie manifatturiere                              ,0,0,0,0,0,2021
ABR,CH,C 33,"Riparazione, manutenzione ed installazione di macchine ed...",0,0,0,0,0,2021
ABR,CH,D   ,"Fornitura di energia elettrica, gas, vapore e aria condiz...",0,0,0,0,0,2021
ABR,CH,D 35,"Fornitura di energia elettrica, gas, vapore e aria condiz...",0,0,0,0,0,2021
ABR,CH,E   ,"Fornitura di acqua; reti fognarie, attività di gestione d...",0,0,0,0,0,2021
ABR,CH,E 36,"Raccolta, trattamento e fornitura di acqua                  ",0,0,0,0,0,2021
ABR,CH,E 37,Gestione delle reti fognarie                                ,0,0,0,0,0,2021
ABR,CH,E 38,"Attività di raccolta, trattamento e smaltimento dei rifiu...",0,0,0,0,0,2021
ABR,CH,E 39,Attività di risanamento e altri servizi di gestione dei r...,0,0,0,0,0,2021
ABR,CH,F   ,Costruzioni                                                 ,0,0,0,0,0,2021
ABR,CH,F 41,Costruzione di edifici                                      ,0,0,0,0,0,2021
ABR,CH,F 42,Ingegneria civile                                           ,0,0,0,0,0,2021
ABR,CH,F 43,Lavori di costruzione specializzati                         ,0,0,0,0,0,2021
ABR,CH,G   ,Commercio all'ingrosso e al dettaglio; riparazione di aut...,0,0,0,0,0,2021
ABR,CH,G 45,Commercio all'ingrosso e al dettaglio e riparazione di au...,0,0,0,0,0,2021
ABR,CH,G 46,Commercio all'ingrosso (escluso quello di autoveicoli e d...,0,0,0,0,0,2021
ABR,CH,G 47,Commercio al dettaglio (escluso quello di autoveicoli e d...,0,0,0,0,0,2021
ABR,CH,H   ,Trasporto e magazzinaggio                                   ,0,0,0,1,1,2021
ABR,CH,H 49,Trasporto terrestre e mediante condotte                     ,0,0,0,1,1,2021
ABR,CH,H 50,Trasporto marittimo e per vie d'acqua                       ,0,0,0,0,0,2021
ABR,CH,H 51,Trasporto aereo                                             ,0,0,0,0,0,2021
ABR,CH,H 52,Magazzinaggio e attività di supporto ai trasporti           ,0,0,0,0,0,2021
ABR,CH,H 53,Servizi postali e attività di corriere                      ,0,0,0,0,0,2021
ABR,CH,I   ,Attività dei servizi alloggio e ristorazione                ,0,0,0,0,0,2021
ABR,CH,I 55,Alloggio                                                    ,0,0,0,0,0,2021
ABR,CH,I 56,Attività dei servizi di ristorazione                        ,0,0,0,0,0,2021
ABR,CH,J   ,Servizi di informazione e comunicazione                     ,0,0,0,0,0,2021
ABR,CH,J 58,Attività editoriali                                         ,0,0,0,0,0,2021
ABR,CH,J 59,"Attività di produzione cinematografica, di video e di pro...",0,0,0,0,0,2021
ABR,CH,J 60,Attività di programmazione e trasmissione                   ,0,0,0,0,0,2021
ABR,CH,J 61,Telecomunicazioni                                           ,0,0,0,0,0,2021
ABR,CH,J 62,"Produzione di software, consulenza informatica e attività...",0,0,0,0,0,2021
ABR,CH,J 63,Attività dei servizi d'informazione e altri servizi infor...,0,0,0,0,0,2021
ABR,CH,K   ,Attività finanziarie e assicurative                         ,0,0,0,0,0,2021
ABR,CH,K 64,Attività di servizi finanziari (escluse le assicurazioni ...,0,0,0,0,0,2021
ABR,CH,K 65,"Assicurazioni, riassicurazioni e fondi pensione (escluse ...",0,0,0,0,0,2021
ABR,CH,K 66,Attività ausiliarie dei servizi finanziari e delle attivi...,0,0,0,0,0,2021
ABR,CH,L   ,Attivita' immobiliari                                       ,0,0,0,0,0,2021
ABR,CH,L 68,Attivita' immobiliari                                       ,0,0,0,0,0,2021
ABR,CH,M   ,"Attività professionali, scientifiche e tecniche             ",1,0,0,0,1,2021
ABR,CH,M 69,Attività legali e contabilità                               ,0,0,0,0,0,2021
ABR,CH,M 70,Attività di direzione aziendale e di consulenza gestional...,1,0,0,0,1,2021
ABR,CH,M 71,Attività degli studi di architettura e d'ingegneria; coll...,0,0,0,0,0,2021
ABR,CH,M 72,Ricerca scientifica e sviluppo                              ,0,0,0,0,0,2021
ABR,CH,M 73,Pubblicità e ricerche di mercato                            ,0,0,0,0,0,2021
ABR,CH,M 74,"Altre attività professionali, scientifiche e tecniche       ",0,0,0,0,0,2021
ABR,CH,M 75,Servizi veterinari                                          ,0,0,0,0,0,2021
ABR,CH,N   ,"Noleggio, agenzie di viaggio, servizi di supporto alle im...",0,0,0,0,0,2021
ABR,CH,N 77,Attività di noleggio e leasing operativo                    ,0,0,0,0,0,2021
ABR,CH,N 78,"Attività di ricerca, selezione, fornitura di personale      ",0,0,0,0,0,2021
ABR,CH,N 79,"Attività dei servizi delle agenzie di viaggio, dei tour o...",0,0,0,0,0,2021
ABR,CH,N 80,Servizi di vigilanza e investigazione                       ,0,0,0,0,0,2021
ABR,CH,N 81,Attività di servizi per edifici e paesaggio                 ,0,0,0,0,0,2021
ABR,CH,N 82,Attività di supporto per le funzioni d'ufficio e altri se...,0,0,0,0,0,2021
ABR,CH,O   ,Amministrazione pubblica e difesa; assicurazione sociale ...,0,0,0,0,0,2021
ABR,CH,O 84,Amministrazione pubblica e difesa; assicurazione sociale ...,0,0,0,0,0,2021
ABR,CH,P   ,Istruzione                                                  ,0,0,0,0,0,2021
ABR,CH,P 85,Istruzione                                                  ,0,0,0,0,0,2021
ABR,CH,Q   ,Sanita' e assistenza sociale                                ,0,0,0,0,0,2021
ABR,CH,Q 86,Assistenza sanitaria                                        ,0,0,0,0,0,2021
ABR,CH,Q 87,Servizi di assistenza sociale residenziale                  ,0,0,0,0,0,2021
ABR,CH,Q 88,Assistenza sociale non residenziale                         ,0,0,0,0,0,2021
ABR,CH,R   ,"Attività artistiche, sportive, di intrattenimento e diver...",0,0,0,0,0,2021
ABR,CH,R 90,"Attività creative, artistiche e di intrattenimento          ",0,0,0,0,0,2021
ABR,CH,R 91,"Attività di biblioteche, archivi, musei ed altre attività...",0,0,0,0,0,2021
ABR,CH,R 92,"Attività riguardanti le lotterie, le scommesse, le case d...",0,0,0,0,0,2021
ABR,CH,R 93,"Attività sportive, di intrattenimento e di divertimento     ",0,0,0,0,0,2021
ABR,CH,S   ,Altre attività di servizi                                   ,0,0,0,0,0,2021
ABR,CH,S 94,Attività di organizzazioni associative                      ,0,0,0,0,0,2021
ABR,CH,S 95,Riparazione di computer e di beni per uso personale e per...,0,0,0,0,0,2021
ABR,CH,S 96,Altre attività di servizi per la persona                    ,0,0,0,0,0,2021
ABR,CH,T   ,Attività di famiglie e convivenze come datori di lavoro p...,0,0,0,0,0,2021
ABR,CH,T 97,Attività di famiglie e convivenze come datori di lavoro p...,0,0,0,0,0,2021
ABR,CH,T 98,Produzione di beni e servizi indifferenziati per uso prop...,0,0,0,0,0,2021
ABR,CH,U   ,Organizzazioni ed organismi extraterritoriali               ,0,0,0,0,0,2021
ABR,CH,U 99,Organizzazioni ed organismi extraterritoriali               ,0,0,0,0,0,2021
ABR,CH,XX  ,Imprese non classificate                                    ,0,0,0,0,0,2021
ABR,CH,TOT ,TOTALE                                                      ,2,0,0,1,3,2021
MOL,  ,A   ,"Agricoltura, silvicoltura pesca                             ",2,0,0,0,2,2021
MOL,  ,A 01,"Coltivazioni agricole e produzione di prodotti animali, c...",2,0,0,0,2,2021
MOL,  ,A 02,Silvicoltura ed utilizzo di aree forestali                  ,0,0,0,0,0,2021
MOL,  ,A 03,Pesca e acquacoltura                                        ,0,0,0,0,0,2021
MOL,  ,B   ,Estrazione di minerali da cave e miniere                    ,0,0,0,0,0,2021
MOL,  ,B 05,Estrazione di carbone (esclusa torba)                       ,0,0,0,0,0,2021
MOL,  ,B 06,Estraz.di petrolio greggio e di gas naturale                ,0,0,0,0,0,2021
MOL,  ,B 07,Estrazione di minerali metalliferi                          ,0,0,0,0,0,2021
MOL,  ,B 08,Altre attività di estrazione di minerali da cave e miniere  ,0,0,0,0,0,2021
MOL,  ,B 09,Attività dei servizi di supporto all'estrazione             ,0,0,0,0,0,2021
MOL,  ,C   ,Attività manifatturiere                                     ,36,0,0,0,36,2021
MOL,  ,C 10,Industrie alimentari                                        ,0,0,0,0,0,2021
MOL,  ,C 11,Industria delle bevande                                     ,1,0,0,0,1,2021
MOL,  ,C 12,Industria del tabacco                                       ,0,0,0,0,0,2021
MOL,  ,C 13,Industrie tessili                                           ,5,0,0,0,5,2021
MOL,  ,C 14,Confezione di articoli di abbigliamento; confezione di ar...,3,0,0,0,3,2021
MOL,  ,C 15,Fabbricazione di articoli in pelle e simili                 ,0,0,0,0,0,2021
MOL,  ,C 16,Industria del legno e dei prodotti in legno e sughero (es...,2,0,0,0,2,2021
MOL,  ,C 17,Fabbricazione di carta e di prodotti di carta               ,0,0,0,0,0,2021
MOL,  ,C 18,Stampa e riproduzione di supporti registrati                ,2,0,0,0,2,2021
MOL,  ,C 19,Fabbricazione di coke e prodotti derivanti dalla raffinaz...,0,0,0,0,0,2021
MOL,  ,C 20,Fabbricazione di prodotti chimici                           ,2,0,0,0,2,2021
MOL,  ,C 21,Fabbricazione di prodotti farmaceutici di base e di prepa...,0,0,0,0,0,2021
MOL,  ,C 22,Fabbricazione di articoli in gomma e materie plastiche      ,2,0,0,0,2,2021
MOL,  ,C 23,Fabbricazione di altri prodotti della lavorazione di miner..,3,0,0,0,3,2021
MOL,  ,C 24,Metallurgia                                                 ,0,0,0,0,0,2021
MOL,  ,C 25,Fabbricazione di prodotti in metallo (esclusi macchinari ...,8,0,0,0,8,2021
MOL,  ,C 26,Fabbricazione di computer e prodotti di elettronica e ott...,1,0,0,0,1,2021
MOL,  ,C 27,Fabbricazione di apparecchiature elettriche ed apparecchi...,1,0,0,0,1,2021
MOL,  ,C 28,Fabbricazione di macchinari ed apparecchiature nca          ,3,0,0,0,3,2021
MOL,  ,C 29,"Fabbricazione di autoveicoli, rimorchi e semirimorchi       ",0,0,0,0,0,2021
MOL,  ,C 30,Fabbricazione di altri mezzi di trasporto                   ,0,0,0,0,0,2021
MOL,  ,C 31,Fabbricazione di mobili                                     ,1,0,0,0,1,2021
MOL,  ,C 32,Altre industrie manifatturiere                              ,1,0,0,0,1,2021
MOL,  ,C 33,"Riparazione, manutenzione ed installazione di macchine ed...",1,0,0,0,1,2021
MOL,  ,D   ,"Fornitura di energia elettrica, gas, vapore e aria condiz...",0,0,0,0,0,2021
MOL,  ,D 35,"Fornitura di energia elettrica, gas, vapore e aria condiz...",0,0,0,0,0,2021
MOL,  ,E   ,"Fornitura di acqua; reti fognarie, attività di gestione d...",0,0,0,0,0,2021
MOL,  ,E 36,"Raccolta, trattamento e fornitura di acqua                  ",0,0,0,0,0,2021
MOL,  ,E 37,Gestione delle reti fognarie                                ,0,0,0,0,0,2021
MOL,  ,E 38,"Attività di raccolta, trattamento e smaltimento dei rifiu...",0,0,0,0,0,2021
MOL,  ,E 39,Attività di risanamento e altri servizi di gestione dei r...,0,0,0,0,0,2021
MOL,  ,F   ,Costruzioni                                                 ,46,2,0,2,50,2021
MOL,  ,F 41,Costruzione di edifici                                      ,25,0,0,2,27,2021
MOL,  ,F 42,Ingegneria civile                                           ,2,0,0,0,2,2021
MOL,  ,F 43,Lavori di costruzione specializzati                         ,19,2,0,0,21,2021
MOL,  ,G   ,Commercio all'ingrosso e al dettaglio; riparazione di aut...,64,7,0,0,71,2021
MOL,  ,G 45,Commercio all'ingrosso e al dettaglio e riparazione di au...,15,1,0,0,16,2021
MOL,  ,G 46,Commercio all'ingrosso (escluso quello di autoveicoli e d...,21,0,0,0,21,2021
MOL,  ,G 47,Commercio al dettaglio (escluso quello di autoveicoli e d...,28,6,0,0,34,2021
MOL,  ,H   ,Trasporto e magazzinaggio                                   ,5,0,0,0,5,2021
MOL,  ,H 49,Trasporto terrestre e mediante condotte                     ,3,0,0,0,3,2021
MOL,  ,H 50,Trasporto marittimo e per vie d'acqua                       ,0,0,0,0,0,2021
MOL,  ,H 51,Trasporto aereo                                             ,0,0,0,0,0,2021
MOL,  ,H 52,Magazzinaggio e attività di supporto ai trasporti           ,2,0,0,0,2,2021
MOL,  ,H 53,Servizi postali e attività di corriere                      ,0,0,0,0,0,2021
MOL,  ,I   ,Attività dei servizi alloggio e ristorazione                ,19,7,0,0,26,2021
MOL,  ,I 55,Alloggio                                                    ,0,1,0,0,1,2021
MOL,  ,I 56,Attività dei servizi di ristorazione                        ,19,6,0,0,25,2021
MOL,  ,J   ,Servizi di informazione e comunicazione                     ,6,1,0,0,7,2021
MOL,  ,J 58,Attività editoriali                                         ,1,0,0,0,1,2021
MOL,  ,J 59,"Attività di produzione cinematografica, di video e di pro...",1,0,0,0,1,2021
MOL,  ,J 60,Attività di programmazione e trasmissione                   ,0,0,0,0,0,2021
MOL,  ,J 61,Telecomunicazioni                                           ,1,0,0,0,1,2021
MOL,  ,J 62,"Produzione di software, consulenza informatica e attività...",1,0,0,0,1,2021
MOL,  ,J 63,Attività dei servizi d'informazione e altri servizi infor...,2,1,0,0,3,2021
MOL,  ,K   ,Attività finanziarie e assicurative                         ,4,0,0,0,4,2021
MOL,  ,K 64,Attività di servizi finanziari (escluse le assicurazioni ...,1,0,0,0,1,2021
MOL,  ,K 65,"Assicurazioni, riassicurazioni e fondi pensione (escluse ...",0,0,0,0,0,2021
MOL,  ,K 66,Attività ausiliarie dei servizi finanziari e delle attivi...,3,0,0,0,3,2021
MOL,  ,L   ,Attivita' immobiliari                                       ,10,0,0,0,10,2021
MOL,  ,L 68,Attivita' immobiliari                                       ,10,0,0,0,10,2021
MOL,  ,M   ,"Attività professionali, scientifiche e tecniche             ",16,0,0,1,17,2021
MOL,  ,M 69,Attività legali e contabilità                               ,0,0,0,0,0,2021
MOL,  ,M 70,Attività di direzione aziendale e di consulenza gestional...,9,0,0,0,9,2021
MOL,  ,M 71,Attività degli studi di architettura e d'ingegneria; coll...,5,0,0,1,6,2021
MOL,  ,M 72,Ricerca scientifica e sviluppo                              ,0,0,0,0,0,2021
MOL,  ,M 73,Pubblicità e ricerche di mercato                            ,1,0,0,0,1,2021
MOL,  ,M 74,"Altre attività professionali, scientifiche e tecniche       ",1,0,0,0,1,2021
MOL,  ,M 75,Servizi veterinari                                          ,0,0,0,0,0,2021
MOL,  ,N   ,"Noleggio, agenzie di viaggio, servizi di supporto alle im...",14,0,0,0,14,2021
MOL,  ,N 77,Attività di noleggio e leasing operativo                    ,3,0,0,0,3,2021
MOL,  ,N 78,"Attività di ricerca, selezione, fornitura di personale      ",0,0,0,0,0,2021
MOL,  ,N 79,"Attività dei servizi delle agenzie di viaggio, dei tour o...",1,0,0,0,1,2021
MOL,  ,N 80,Servizi di vigilanza e investigazione                       ,0,0,0,0,0,2021
MOL,  ,N 81,Attività di servizi per edifici e paesaggio                 ,1,0,0,0,1,2021
MOL,  ,N 82,Attività di supporto per le funzioni d'ufficio e altri se...,9,0,0,0,9,2021
MOL,  ,O   ,Amministrazione pubblica e difesa; assicurazione sociale ...,0,0,0,0,0,2021
MOL,  ,O 84,Amministrazione pubblica e difesa; assicurazione sociale ...,0,0,0,0,0,2021
MOL,  ,P   ,Istruzione                                                  ,1,0,0,0,1,2021
MOL,  ,P 85,Istruzione                                                  ,1,0,0,0,1,2021
MOL,  ,Q   ,Sanita' e assistenza sociale                                ,2,0,0,0,2,2021
MOL,  ,Q 86,Assistenza sanitaria                                        ,2,0,0,0,2,2021
MOL,  ,Q 87,Servizi di assistenza sociale residenziale                  ,0,0,0,0,0,2021
MOL,  ,Q 88,Assistenza sociale non residenziale                         ,0,0,0,0,0,2021
MOL,  ,R   ,"Attività artistiche, sportive, di intrattenimento e diver...",7,0,0,0,7,2021
MOL,  ,R 90,"Attività creative, artistiche e di intrattenimento          ",2,0,0,0,2,2021
MOL,  ,R 91,"Attività di biblioteche, archivi, musei ed altre attività...",0,0,0,0,0,2021
MOL,  ,R 92,"Attività riguardanti le lotterie, le scommesse, le case d...",2,0,0,0,2,2021
MOL,  ,R 93,"Attività sportive, di intrattenimento e di divertimento     ",3,0,0,0,3,2021
MOL,  ,S   ,Altre attività di servizi                                   ,6,1,0,0,7,2021
MOL,  ,S 94,Attività di organizzazioni associative                      ,0,0,0,0,0,2021
MOL,  ,S 95,Riparazione di computer e di beni per uso personale e per...,1,0,0,0,1,2021
MOL,  ,S 96,Altre attività di servizi per la persona                    ,5,1,0,0,6,2021
MOL,  ,T   ,Attività di famiglie e convivenze come datori di lavoro p...,0,0,0,0,0,2021
MOL,  ,T 97,Attività di famiglie e convivenze come datori di lavoro p...,0,0,0,0,0,2021
MOL,  ,T 98,Produzione di beni e servizi indifferenziati per uso prop...,0,0,0,0,0,2021
MOL,  ,U   ,Organizzazioni ed organismi extraterritoriali               ,0,0,0,0,0,2021
MOL,  ,U 99,Organizzazioni ed organismi extraterritoriali               ,0,0,0,0,0,2021
MOL,  ,XX  ,Imprese non classificate                                    ,69,1,0,2,72,2021
MOL,  ,TOT ,TOTALE                                                      ,307,19,0,5,331,2021
MOL,CB,A   ,"Agricoltura, silvicoltura pesca                             ",2,0,0,0,2,2021
MOL,CB,A 01,"Coltivazioni agricole e produzione di prodotti animali, c...",2,0,0,0,2,2021
MOL,CB,A 02,Silvicoltura ed utilizzo di aree forestali                  ,0,0,0,0,0,2021
MOL,CB,A 03,Pesca e acquacoltura                                        ,0,0,0,0,0,2021
MOL,CB,B   ,Estrazione di minerali da cave e miniere                    ,0,0,0,0,0,2021
MOL,CB,B 05,Estrazione di carbone (esclusa torba)                       ,0,0,0,0,0,2021
MOL,CB,B 06,Estraz.di petrolio greggio e di gas naturale                ,0,0,0,0,0,2021
MOL,CB,B 07,Estrazione di minerali metalliferi                          ,0,0,0,0,0,2021
MOL,CB,B 08,Altre attività di estrazione di minerali da cave e miniere  ,0,0,0,0,0,2021
MOL,CB,B 09,Attività dei servizi di supporto all'estrazione             ,0,0,0,0,0,2021
MOL,CB,C   ,Attività manifatturiere                                     ,28,0,0,0,28,2021
MOL,CB,C 10,Industrie alimentari                                        ,0,0,0,0,0,2021
MOL,CB,C 11,Industria delle bevande                                     ,1,0,0,0,1,2021
MOL,CB,C 12,Industria del tabacco                                       ,0,0,0,0,0,2021
MOL,CB,C 13,Industrie tessili                                           ,4,0,0,0,4,2021
MOL,CB,C 14,Confezione di articoli di abbigliamento; confezione di ar...,3,0,0,0,3,2021
MOL,CB,C 15,Fabbricazione di articoli in pelle e simili                 ,0,0,0,0,0,2021
MOL,CB,C 16,Industria del legno e dei prodotti in legno e sughero (es...,1,0,0,0,1,2021
MOL,CB,C 17,Fabbricazione di carta e di prodotti di carta               ,0,0,0,0,0,2021
MOL,CB,C 18,Stampa e riproduzione di supporti registrati                ,1,0,0,0,1,2021
MOL,CB,C 19,Fabbricazione di coke e prodotti derivanti dalla raffinaz...,0,0,0,0,0,2021
MOL,CB,C 20,Fabbricazione di prodotti chimici                           ,1,0,0,0,1,2021
MOL,CB,C 21,Fabbricazione di prodotti farmaceutici di base e di prepa...,0,0,0,0,0,2021
MOL,CB,C 22,Fabbricazione di articoli in gomma e materie plastiche      ,2,0,0,0,2,2021
MOL,CB,C 23,Fabbricazione di altri prodotti della lavorazione di miner..,2,0,0,0,2,2021
MOL,CB,C 24,Metallurgia                                                 ,0,0,0,0,0,2021
MOL,CB,C 25,Fabbricazione di prodotti in metallo (esclusi macchinari ...,7,0,0,0,7,2021
MOL,CB,C 26,Fabbricazione di computer e prodotti di elettronica e ott...,1,0,0,0,1,2021
MOL,CB,C 27,Fabbricazione di apparecchiature elettriche ed apparecchi...,0,0,0,0,0,2021
MOL,CB,C 28,Fabbricazione di macchinari ed apparecchiature nca          ,3,0,0,0,3,2021
MOL,CB,C 29,"Fabbricazione di autoveicoli, rimorchi e semirimorchi       ",0,0,0,0,0,2021
MOL,CB,C 30,Fabbricazione di altri mezzi di trasporto                   ,0,0,0,0,0,2021
MOL,CB,C 31,Fabbricazione di mobili                                     ,1,0,0,0,1,2021
MOL,CB,C 32,Altre industrie manifatturiere                              ,0,0,0,0,0,2021
MOL,CB,C 33,"Riparazione, manutenzione ed installazione di macchine ed...",1,0,0,0,1,2021
MOL,CB,D   ,"Fornitura di energia elettrica, gas, vapore e aria condiz...",0,0,0,0,0,2021
MOL,CB,D 35,"Fornitura di energia elettrica, gas, vapore e aria condiz...",0,0,0,0,0,2021
MOL,CB,E   ,"Fornitura di acqua; reti fognarie, attività di gestione d...",0,0,0,0,0,2021
MOL,CB,E 36,"Raccolta, trattamento e fornitura di acqua                  ",0,0,0,0,0,2021
MOL,CB,E 37,Gestione delle reti fognarie                                ,0,0,0,0,0,2021
MOL,CB,E 38,"Attività di raccolta, trattamento e smaltimento dei rifiu...",0,0,0,0,0,2021
MOL,CB,E 39,Attività di risanamento e altri servizi di gestione dei r...,0,0,0,0,0,2021
MOL,CB,F   ,Costruzioni                                                 ,33,0,0,2,35,2021
MOL,CB,F 41,Costruzione di edifici                                      ,19,0,0,2,21,2021
MOL,CB,F 42,Ingegneria civile                                           ,1,0,0,0,1,2021
MOL,CB,F 43,Lavori di costruzione specializzati                         ,13,0,0,0,13,2021
MOL,CB,G   ,Commercio all'ingrosso e al dettaglio; riparazione di aut...,51,4,0,0,55,2021
MOL,CB,G 45,Commercio all'ingrosso e al dettaglio e riparazione di au...,11,0,0,0,11,2021
MOL,CB,G 46,Commercio all'ingrosso (escluso quello di autoveicoli e d...,18,0,0,0,18,2021
MOL,CB,G 47,Commercio al dettaglio (escluso quello di autoveicoli e d...,22,4,0,0,26,2021
MOL,CB,H   ,Trasporto e magazzinaggio                                   ,4,0,0,0,4,2021
MOL,CB,H 49,Trasporto terrestre e mediante condotte                     ,3,0,0,0,3,2021
MOL,CB,H 50,Trasporto marittimo e per vie d'acqua                       ,0,0,0,0,0,2021
MOL,CB,H 51,Trasporto aereo                                             ,0,0,0,0,0,2021
MOL,CB,H 52,Magazzinaggio e attività di supporto ai trasporti           ,1,0,0,0,1,2021
MOL,CB,H 53,Servizi postali e attività di corriere                      ,0,0,0,0,0,2021
MOL,CB,I   ,Attività dei servizi alloggio e ristorazione                ,16,3,0,0,19,2021
MOL,CB,I 55,Alloggio                                                    ,0,0,0,0,0,2021
MOL,CB,I 56,Attività dei servizi di ristorazione                        ,16,3,0,0,19,2021
MOL,CB,J   ,Servizi di informazione e comunicazione                     ,4,1,0,0,5,2021
MOL,CB,J 58,Attività editoriali                                         ,0,0,0,0,0,2021
MOL,CB,J 59,"Attività di produzione cinematografica, di video e di pro...",1,0,0,0,1,2021
MOL,CB,J 60,Attività di programmazione e trasmissione                   ,0,0,0,0,0,2021
MOL,CB,J 61,Telecomunicazioni                                           ,0,0,0,0,0,2021
MOL,CB,J 62,"Produzione di software, consulenza informatica e attività...",1,0,0,0,1,2021
MOL,CB,J 63,Attività dei servizi d'informazione e altri servizi infor...,2,1,0,0,3,2021
MOL,CB,K   ,Attività finanziarie e assicurative                         ,3,0,0,0,3,2021
MOL,CB,K 64,Attività di servizi finanziari (escluse le assicurazioni ...,0,0,0,0,0,2021
MOL,CB,K 65,"Assicurazioni, riassicurazioni e fondi pensione (escluse ...",0,0,0,0,0,2021
MOL,CB,K 66,Attività ausiliarie dei servizi finanziari e delle attivi...,3,0,0,0,3,2021
MOL,CB,L   ,Attivita' immobiliari                                       ,8,0,0,0,8,2021
MOL,CB,L 68,Attivita' immobiliari                                       ,8,0,0,0,8,2021
MOL,CB,M   ,"Attività professionali, scientifiche e tecniche             ",10,0,0,1,11,2021
MOL,CB,M 69,Attività legali e contabilità                               ,0,0,0,0,0,2021
MOL,CB,M 70,Attività di direzione aziendale e di consulenza gestional...,6,0,0,0,6,2021
MOL,CB,M 71,Attività degli studi di architettura e d'ingegneria; coll...,2,0,0,1,3,2021
MOL,CB,M 72,Ricerca scientifica e sviluppo                              ,0,0,0,0,0,2021
MOL,CB,M 73,Pubblicità e ricerche di mercato                            ,1,0,0,0,1,2021
MOL,CB,M 74,"Altre attività professionali, scientifiche e tecniche       ",1,0,0,0,1,2021
MOL,CB,M 75,Servizi veterinari                                          ,0,0,0,0,0,2021
MOL,CB,N   ,"Noleggio, agenzie di viaggio, servizi di supporto alle im...",7,0,0,0,7,2021
MOL,CB,N 77,Attività di noleggio e leasing operativo                    ,1,0,0,0,1,2021
MOL,CB,N 78,"Attività di ricerca, selezione, fornitura di personale      ",0,0,0,0,0,2021
MOL,CB,N 79,"Attività dei servizi delle agenzie di viaggio, dei tour o...",0,0,0,0,0,2021
MOL,CB,N 80,Servizi di vigilanza e investigazione                       ,0,0,0,0,0,2021
MOL,CB,N 81,Attività di servizi per edifici e paesaggio                 ,1,0,0,0,1,2021
MOL,CB,N 82,Attività di supporto per le funzioni d'ufficio e altri se...,5,0,0,0,5,2021
MOL,CB,O   ,Amministrazione pubblica e difesa; assicurazione sociale ...,0,0,0,0,0,2021
MOL,CB,O 84,Amministrazione pubblica e difesa; assicurazione sociale ...,0,0,0,0,0,2021
MOL,CB,P   ,Istruzione                                                  ,1,0,0,0,1,2021
MOL,CB,P 85,Istruzione                                                  ,1,0,0,0,1,2021
MOL,CB,Q   ,Sanita' e assistenza sociale                                ,2,0,0,0,2,2021
MOL,CB,Q 86,Assistenza sanitaria                                        ,2,0,0,0,2,2021
MOL,CB,Q 87,Servizi di assistenza sociale residenziale                  ,0,0,0,0,0,2021
MOL,CB,Q 88,Assistenza sociale non residenziale                         ,0,0,0,0,0,2021
MOL,CB,R   ,"Attività artistiche, sportive, di intrattenimento e diver...",7,0,0,0,7,2021
MOL,CB,R 90,"Attività creative, artistiche e di intrattenimento          ",2,0,0,0,2,2021
MOL,CB,R 91,"Attività di biblioteche, archivi, musei ed altre attività...",0,0,0,0,0,2021
MOL,CB,R 92,"Attività riguardanti le lotterie, le scommesse, le case d...",2,0,0,0,2,2021
MOL,CB,R 93,"Attività sportive, di intrattenimento e di divertimento     ",3,0,0,0,3,2021
MOL,CB,S   ,Altre attività di servizi                                   ,6,0,0,0,6,2021
MOL,CB,S 94,Attività di organizzazioni associative                      ,0,0,0,0,0,2021
MOL,CB,S 95,Riparazione di computer e di beni per uso personale e per...,1,0,0,0,1,2021
MOL,CB,S 96,Altre attività di servizi per la persona                    ,5,0,0,0,5,2021
MOL,CB,T   ,Attività di famiglie e convivenze come datori di lavoro p...,0,0,0,0,0,2021
MOL,CB,T 97,Attività di famiglie e convivenze come datori di lavoro p...,0,0,0,0,0,2021
MOL,CB,T 98,Produzione di beni e servizi indifferenziati per uso prop...,0,0,0,0,0,2021
MOL,CB,U   ,Organizzazioni ed organismi extraterritoriali               ,0,0,0,0,0,2021
MOL,CB,U 99,Organizzazioni ed organismi extraterritoriali               ,0,0,0,0,0,2021
MOL,CB,XX  ,Imprese non classificate                                    ,45,1,0,1,47,2021
MOL,CB,TOT ,TOTALE                                                      ,227,9,0,4,240,2021
MOL,IS,A   ,"Agricoltura, silvicoltura pesca                             ",0,0,0,0,0,2021
MOL,IS,A 01,"Coltivazioni agricole e produzione di prodotti animali, c...",0,0,0,0,0,2021
MOL,IS,A 02,Silvicoltura ed utilizzo di aree forestali                  ,0,0,0,0,0,2021
MOL,IS,A 03,Pesca e acquacoltura                                        ,0,0,0,0,0,2021
MOL,IS,B   ,Estrazione di minerali da cave e miniere                    ,0,0,0,0,0,2021
MOL,IS,B 05,Estrazione di carbone (esclusa torba)                       ,0,0,0,0,0,2021
MOL,IS,B 06,Estraz.di petrolio greggio e di gas naturale                ,0,0,0,0,0,2021
MOL,IS,B 07,Estrazione di minerali metalliferi                          ,0,0,0,0,0,2021
MOL,IS,B 08,Altre attività di estrazione di minerali da cave e miniere  ,0,0,0,0,0,2021
MOL,IS,B 09,Attività dei servizi di supporto all'estrazione             ,0,0,0,0,0,2021
MOL,IS,C   ,Attività manifatturiere                                     ,8,0,0,0,8,2021
MOL,IS,C 10,Industrie alimentari                                        ,0,0,0,0,0,2021
MOL,IS,C 11,Industria delle bevande                                     ,0,0,0,0,0,2021
MOL,IS,C 12,Industria del tabacco                                       ,0,0,0,0,0,2021
MOL,IS,C 13,Industrie tessili                                           ,1,0,0,0,1,2021
MOL,IS,C 14,Confezione di articoli di abbigliamento; confezione di ar...,0,0,0,0,0,2021
MOL,IS,C 15,Fabbricazione di articoli in pelle e simili                 ,0,0,0,0,0,2021
MOL,IS,C 16,Industria del legno e dei prodotti in legno e sughero (es...,1,0,0,0,1,2021
MOL,IS,C 17,Fabbricazione di carta e di prodotti di carta               ,0,0,0,0,0,2021
MOL,IS,C 18,Stampa e riproduzione di supporti registrati                ,1,0,0,0,1,2021
MOL,IS,C 19,Fabbricazione di coke e prodotti derivanti dalla raffinaz...,0,0,0,0,0,2021
MOL,IS,C 20,Fabbricazione di prodotti chimici                           ,1,0,0,0,1,2021
MOL,IS,C 21,Fabbricazione di prodotti farmaceutici di base e di prepa...,0,0,0,0,0,2021
MOL,IS,C 22,Fabbricazione di articoli in gomma e materie plastiche      ,0,0,0,0,0,2021
MOL,IS,C 23,Fabbricazione di altri prodotti della lavorazione di miner..,1,0,0,0,1,2021
MOL,IS,C 24,Metallurgia                                                 ,0,0,0,0,0,2021
MOL,IS,C 25,Fabbricazione di prodotti in metallo (esclusi macchinari ...,1,0,0,0,1,2021
MOL,IS,C 26,Fabbricazione di computer e prodotti di elettronica e ott...,0,0,0,0,0,2021
MOL,IS,C 27,Fabbricazione di apparecchiature elettriche ed apparecchi...,1,0,0,0,1,2021
MOL,IS,C 28,Fabbricazione di macchinari ed apparecchiature nca          ,0,0,0,0,0,2021
MOL,IS,C 29,"Fabbricazione di autoveicoli, rimorchi e semirimorchi       ",0,0,0,0,0,2021
MOL,IS,C 30,Fabbricazione di altri mezzi di trasporto                   ,0,0,0,0,0,2021
MOL,IS,C 31,Fabbricazione di mobili                                     ,0,0,0,0,0,2021
MOL,IS,C 32,Altre industrie manifatturiere                              ,1,0,0,0,1,2021
MOL,IS,C 33,"Riparazione, manutenzione ed installazione di macchine ed...",0,0,0,0,0,2021
MOL,IS,D   ,"Fornitura di energia elettrica, gas, vapore e aria condiz...",0,0,0,0,0,2021
MOL,IS,D 35,"Fornitura di energia elettrica, gas, vapore e aria condiz...",0,0,0,0,0,2021
MOL,IS,E   ,"Fornitura di acqua; reti fognarie, attività di gestione d...",0,0,0,0,0,2021
MOL,IS,E 36,"Raccolta, trattamento e fornitura di acqua                  ",0,0,0,0,0,2021
MOL,IS,E 37,Gestione delle reti fognarie                                ,0,0,0,0,0,2021
MOL,IS,E 38,"Attività di raccolta, trattamento e smaltimento dei rifiu...",0,0,0,0,0,2021
MOL,IS,E 39,Attività di risanamento e altri servizi di gestione dei r...,0,0,0,0,0,2021
MOL,IS,F   ,Costruzioni                                                 ,13,2,0,0,15,2021
MOL,IS,F 41,Costruzione di edifici                                      ,6,0,0,0,6,2021
MOL,IS,F 42,Ingegneria civile                                           ,1,0,0,0,1,2021
MOL,IS,F 43,Lavori di costruzione specializzati                         ,6,2,0,0,8,2021
MOL,IS,G   ,Commercio all'ingrosso e al dettaglio; riparazione di aut...,13,3,0,0,16,2021
MOL,IS,G 45,Commercio all'ingrosso e al dettaglio e riparazione di au...,4,1,0,0,5,2021
MOL,IS,G 46,Commercio all'ingrosso (escluso quello di autoveicoli e d...,3,0,0,0,3,2021
MOL,IS,G 47,Commercio al dettaglio (escluso quello di autoveicoli e d...,6,2,0,0,8,2021
MOL,IS,H   ,Trasporto e magazzinaggio                                   ,1,0,0,0,1,2021
MOL,IS,H 49,Trasporto terrestre e mediante condotte                     ,0,0,0,0,0,2021
MOL,IS,H 50,Trasporto marittimo e per vie d'acqua                       ,0,0,0,0,0,2021
MOL,IS,H 51,Trasporto aereo                                             ,0,0,0,0,0,2021
MOL,IS,H 52,Magazzinaggio e attività di supporto ai trasporti           ,1,0,0,0,1,2021
MOL,IS,H 53,Servizi postali e attività di corriere                      ,0,0,0,0,0,2021
MOL,IS,I   ,Attività dei servizi alloggio e ristorazione                ,3,4,0,0,7,2021
MOL,IS,I 55,Alloggio                                                    ,0,1,0,0,1,2021
MOL,IS,I 56,Attività dei servizi di ristorazione                        ,3,3,0,0,6,2021
MOL,IS,J   ,Servizi di informazione e comunicazione                     ,2,0,0,0,2,2021
MOL,IS,J 58,Attività editoriali                                         ,1,0,0,0,1,2021
MOL,IS,J 59,"Attività di produzione cinematografica, di video e di pro...",0,0,0,0,0,2021
MOL,IS,J 60,Attività di programmazione e trasmissione                   ,0,0,0,0,0,2021
MOL,IS,J 61,Telecomunicazioni                                           ,1,0,0,0,1,2021
MOL,IS,J 62,"Produzione di software, consulenza informatica e attività...",0,0,0,0,0,2021
MOL,IS,J 63,Attività dei servizi d'informazione e altri servizi infor...,0,0,0,0,0,2021
MOL,IS,K   ,Attività finanziarie e assicurative                         ,1,0,0,0,1,2021
MOL,IS,K 64,Attività di servizi finanziari (escluse le assicurazioni ...,1,0,0,0,1,2021
MOL,IS,K 65,"Assicurazioni, riassicurazioni e fondi pensione (escluse ...",0,0,0,0,0,2021
MOL,IS,K 66,Attività ausiliarie dei servizi finanziari e delle attivi...,0,0,0,0,0,2021
MOL,IS,L   ,Attivita' immobiliari                                       ,2,0,0,0,2,2021
MOL,IS,L 68,Attivita' immobiliari                                       ,2,0,0,0,2,2021
MOL,IS,M   ,"Attività professionali, scientifiche e tecniche             ",6,0,0,0,6,2021
MOL,IS,M 69,Attività legali e contabilità                               ,0,0,0,0,0,2021
MOL,IS,M 70,Attività di direzione aziendale e di consulenza gestional...,3,0,0,0,3,2021
MOL,IS,M 71,Attività degli studi di architettura e d'ingegneria; coll...,3,0,0,0,3,2021
MOL,IS,M 72,Ricerca scientifica e sviluppo                              ,0,0,0,0,0,2021
MOL,IS,M 73,Pubblicità e ricerche di mercato                            ,0,0,0,0,0,2021
MOL,IS,M 74,"Altre attività professionali, scientifiche e tecniche       ",0,0,0,0,0,2021
MOL,IS,M 75,Servizi veterinari                                          ,0,0,0,0,0,2021
MOL,IS,N   ,"Noleggio, agenzie di viaggio, servizi di supporto alle im...",7,0,0,0,7,2021
MOL,IS,N 77,Attività di noleggio e leasing operativo                    ,2,0,0,0,2,2021
MOL,IS,N 78,"Attività di ricerca, selezione, fornitura di personale      ",0,0,0,0,0,2021
MOL,IS,N 79,"Attività dei servizi delle agenzie di viaggio, dei tour o...",1,0,0,0,1,2021
MOL,IS,N 80,Servizi di vigilanza e investigazione                       ,0,0,0,0,0,2021
MOL,IS,N 81,Attività di servizi per edifici e paesaggio                 ,0,0,0,0,0,2021
MOL,IS,N 82,Attività di supporto per le funzioni d'ufficio e altri se...,4,0,0,0,4,2021
MOL,IS,O   ,Amministrazione pubblica e difesa; assicurazione sociale ...,0,0,0,0,0,2021
MOL,IS,O 84,Amministrazione pubblica e difesa; assicurazione sociale ...,0,0,0,0,0,2021
MOL,IS,P   ,Istruzione                                                  ,0,0,0,0,0,2021
MOL,IS,P 85,Istruzione                                                  ,0,0,0,0,0,2021
MOL,IS,Q   ,Sanita' e assistenza sociale                                ,0,0,0,0,0,2021
MOL,IS,Q 86,Assistenza sanitaria                                        ,0,0,0,0,0,2021
MOL,IS,Q 87,Servizi di assistenza sociale residenziale                  ,0,0,0,0,0,2021
MOL,IS,Q 88,Assistenza sociale non residenziale                         ,0,0,0,0,0,2021
MOL,IS,R   ,"Attività artistiche, sportive, di intrattenimento e diver...",0,0,0,0,0,2021
MOL,IS,R 90,"Attività creative, artistiche e di intrattenimento          ",0,0,0,0,0,2021
MOL,IS,R 91,"Attività di biblioteche, archivi, musei ed altre attività...",0,0,0,0,0,2021
MOL,IS,R 92,"Attività riguardanti le lotterie, le scommesse, le case d...",0,0,0,0,0,2021
MOL,IS,R 93,"Attività sportive, di intrattenimento e di divertimento     ",0,0,0,0,0,2021
MOL,IS,S   ,Altre attività di servizi                                   ,0,1,0,0,1,2021
MOL,IS,S 94,Attività di organizzazioni associative                      ,0,0,0,0,0,2021
MOL,IS,S 95,Riparazione di computer e di beni per uso personale e per...,0,0,0,0,0,2021
MOL,IS,S 96,Altre attività di servizi per la persona                    ,0,1,0,0,1,2021
MOL,IS,T   ,Attività di famiglie e convivenze come datori di lavoro p...,0,0,0,0,0,2021
MOL,IS,T 97,Attività di famiglie e convivenze come datori di lavoro p...,0,0,0,0,0,2021
MOL,IS,T 98,Produzione di beni e servizi indifferenziati per uso prop...,0,0,0,0,0,2021
MOL,IS,U   ,Organizzazioni ed organismi extraterritoriali               ,0,0,0,0,0,2021
MOL,IS,U 99,Organizzazioni ed organismi extraterritoriali               ,0,0,0,0,0,2021
MOL,IS,XX  ,Imprese non classificate                                    ,24,0,0,1,25,2021
MOL,IS,TOT ,TOTALE                                                      ,80,10,0,1,91,2021
CAM,  ,A   ,"Agricoltura, silvicoltura pesca                             ",2,0,343,0,345,2021
CAM,  ,A 01,"Coltivazioni agricole e produzione di prodotti animali, c...",2,0,334,0,336,2021
CAM,  ,A 02,Silvicoltura ed utilizzo di aree forestali                  ,0,0,9,0,9,2021
CAM,  ,A 03,Pesca e acquacoltura                                        ,0,0,0,0,0,2021
CAM,  ,B   ,Estrazione di minerali da cave e miniere                    ,2,0,2,0,4,2021
CAM,  ,B 05,Estrazione di carbone (esclusa torba)                       ,0,0,0,0,0,2021
CAM,  ,B 06,Estraz.di petrolio greggio e di gas naturale                ,0,0,0,0,0,2021
CAM,  ,B 07,Estrazione di minerali metalliferi                          ,0,0,0,0,0,2021
CAM,  ,B 08,Altre attività di estrazione di minerali da cave e miniere  ,2,0,2,0,4,2021
CAM,  ,B 09,Attività dei servizi di supporto all'estrazione             ,0,0,0,0,0,2021
CAM,  ,C   ,Attività manifatturiere                                     ,104,2,131,0,237,2021
CAM,  ,C 10,Industrie alimentari                                        ,7,0,12,0,19,2021
CAM,  ,C 11,Industria delle bevande                                     ,0,0,1,0,1,2021
CAM,  ,C 12,Industria del tabacco                                       ,1,0,0,0,1,2021
CAM,  ,C 13,Industrie tessili                                           ,2,0,3,0,5,2021
CAM,  ,C 14,Confezione di articoli di abbigliamento; confezione di ar...,15,0,32,0,47,2021
CAM,  ,C 15,Fabbricazione di articoli in pelle e simili                 ,8,1,18,0,27,2021
CAM,  ,C 16,Industria del legno e dei prodotti in legno e sughero (es...,6,0,14,0,20,2021
CAM,  ,C 17,Fabbricazione di carta e di prodotti di carta               ,2,0,3,0,5,2021
CAM,  ,C 18,Stampa e riproduzione di supporti registrati                ,2,0,2,0,4,2021
CAM,  ,C 19,Fabbricazione di coke e prodotti derivanti dalla raffinaz...,0,0,0,0,0,2021
CAM,  ,C 20,Fabbricazione di prodotti chimici                           ,4,0,2,0,6,2021
CAM,  ,C 21,Fabbricazione di prodotti farmaceutici di base e di prepa...,0,0,0,0,0,2021
CAM,  ,C 22,Fabbricazione di articoli in gomma e materie plastiche      ,2,0,1,0,3,2021
CAM,  ,C 23,Fabbricazione di altri prodotti della lavorazione di miner..,4,0,8,0,12,2021
CAM,  ,C 24,Metallurgia                                                 ,4,0,3,0,7,2021
CAM,  ,C 25,Fabbricazione di prodotti in metallo (esclusi macchinari ...,24,1,21,0,46,2021
CAM,  ,C 26,Fabbricazione di computer e prodotti di elettronica e ott...,4,0,2,0,6,2021
CAM,  ,C 27,Fabbricazione di apparecchiature elettriche ed apparecchi...,3,0,1,0,4,2021
CAM,  ,C 28,Fabbricazione di macchinari ed apparecchiature nca          ,4,0,1,0,5,2021
CAM,  ,C 29,"Fabbricazione di autoveicoli, rimorchi e semirimorchi       ",1,0,0,0,1,2021
CAM,  ,C 30,Fabbricazione di altri mezzi di trasporto                   ,0,0,0,0,0,2021
CAM,  ,C 31,Fabbricazione di mobili                                     ,7,0,1,0,8,2021
CAM,  ,C 32,Altre industrie manifatturiere                              ,1,0,3,0,4,2021
CAM,  ,C 33,"Riparazione, manutenzione ed installazione di macchine ed...",3,0,3,0,6,2021
CAM,  ,D   ,"Fornitura di energia elettrica, gas, vapore e aria condiz...",0,0,1,0,1,2021
CAM,  ,D 35,"Fornitura di energia elettrica, gas, vapore e aria condiz...",0,0,1,0,1,2021
CAM,  ,E   ,"Fornitura di acqua; reti fognarie, attività di gestione d...",2,0,6,0,8,2021
CAM,  ,E 36,"Raccolta, trattamento e fornitura di acqua                  ",0,0,0,0,0,2021
CAM,  ,E 37,Gestione delle reti fognarie                                ,1,0,0,0,1,2021
CAM,  ,E 38,"Attività di raccolta, trattamento e smaltimento dei rifiu...",1,0,2,0,3,2021
CAM,  ,E 39,Attività di risanamento e altri servizi di gestione dei r...,0,0,4,0,4,2021
CAM,  ,F   ,Costruzioni                                                 ,86,3,212,1,302,2021
CAM,  ,F 41,Costruzione di edifici                                      ,55,0,118,1,174,2021
CAM,  ,F 42,Ingegneria civile                                           ,2,0,4,0,6,2021
CAM,  ,F 43,Lavori di costruzione specializzati                         ,29,3,90,0,122,2021
CAM,  ,G   ,Commercio all'ingrosso e al dettaglio; riparazione di aut...,190,6,922,0,1118,2021
CAM,  ,G 45,Commercio all'ingrosso e al dettaglio e riparazione di au...,30,0,47,0,77,2021
CAM,  ,G 46,Commercio all'ingrosso (escluso quello di autoveicoli e d...,82,5,221,0,308,2021
CAM,  ,G 47,Commercio al dettaglio (escluso quello di autoveicoli e d...,78,1,654,0,733,2021
CAM,  ,H   ,Trasporto e magazzinaggio                                   ,14,1,37,0,52,2021
CAM,  ,H 49,Trasporto terrestre e mediante condotte                     ,10,0,31,0,41,2021
CAM,  ,H 50,Trasporto marittimo e per vie d'acqua                       ,0,0,0,0,0,2021
CAM,  ,H 51,Trasporto aereo                                             ,0,0,0,0,0,2021
CAM,  ,H 52,Magazzinaggio e attività di supporto ai trasporti           ,3,1,5,0,9,2021
CAM,  ,H 53,Servizi postali e attività di corriere                      ,1,0,1,0,2,2021
CAM,  ,I   ,Attività dei servizi alloggio e ristorazione                ,28,2,75,0,105,2021
CAM,  ,I 55,Alloggio                                                    ,4,0,1,0,5,2021
CAM,  ,I 56,Attività dei servizi di ristorazione                        ,24,2,74,0,100,2021
CAM,  ,J   ,Servizi di informazione e comunicazione                     ,17,1,37,0,55,2021
CAM,  ,J 58,Attività editoriali                                         ,4,1,4,0,9,2021
CAM,  ,J 59,"Attività di produzione cinematografica, di video e di pro...",1,0,2,0,3,2021
CAM,  ,J 60,Attività di programmazione e trasmissione                   ,0,0,0,0,0,2021
CAM,  ,J 61,Telecomunicazioni                                           ,0,0,3,0,3,2021
CAM,  ,J 62,"Produzione di software, consulenza informatica e attività...",6,0,3,0,9,2021
CAM,  ,J 63,Attività dei servizi d'informazione e altri servizi infor...,6,0,25,0,31,2021
CAM,  ,K   ,Attività finanziarie e assicurative                         ,6,1,15,0,22,2021
CAM,  ,K 64,Attività di servizi finanziari (escluse le assicurazioni ...,2,0,0,0,2,2021
CAM,  ,K 65,"Assicurazioni, riassicurazioni e fondi pensione (escluse ...",0,0,0,0,0,2021
CAM,  ,K 66,Attività ausiliarie dei servizi finanziari e delle attivi...,4,1,15,0,20,2021
CAM,  ,L   ,Attivita' immobiliari                                       ,8,0,7,0,15,2021
CAM,  ,L 68,Attivita' immobiliari                                       ,8,0,7,0,15,2021
CAM,  ,M   ,"Attività professionali, scientifiche e tecniche             ",17,0,20,2,39,2021
CAM,  ,M 69,Attività legali e contabilità                               ,0,0,0,1,1,2021
CAM,  ,M 70,Attività di direzione aziendale e di consulenza gestional...,1,0,0,1,2,2021
CAM,  ,M 71,Attività degli studi di architettura e d'ingegneria; coll...,5,0,1,0,6,2021
CAM,  ,M 72,Ricerca scientifica e sviluppo                              ,2,0,0,0,2,2021
CAM,  ,M 73,Pubblicità e ricerche di mercato                            ,7,0,7,0,14,2021
CAM,  ,M 74,"Altre attività professionali, scientifiche e tecniche       ",2,0,12,0,14,2021
CAM,  ,M 75,Servizi veterinari                                          ,0,0,0,0,0,2021
CAM,  ,N   ,"Noleggio, agenzie di viaggio, servizi di supporto alle im...",21,0,39,0,60,2021
CAM,  ,N 77,Attività di noleggio e leasing operativo                    ,2,0,10,0,12,2021
CAM,  ,N 78,"Attività di ricerca, selezione, fornitura di personale      ",0,0,0,0,0,2021
CAM,  ,N 79,"Attività dei servizi delle agenzie di viaggio, dei tour o...",2,0,1,0,3,2021
CAM,  ,N 80,Servizi di vigilanza e investigazione                       ,0,0,5,0,5,2021
CAM,  ,N 81,Attività di servizi per edifici e paesaggio                 ,2,0,16,0,18,2021
CAM,  ,N 82,Attività di supporto per le funzioni d'ufficio e altri se...,15,0,7,0,22,2021
CAM,  ,O   ,Amministrazione pubblica e difesa; assicurazione sociale ...,2,0,0,0,2,2021
CAM,  ,O 84,Amministrazione pubblica e difesa; assicurazione sociale ...,2,0,0,0,2,2021
CAM,  ,P   ,Istruzione                                                  ,2,0,3,0,5,2021
CAM,  ,P 85,Istruzione                                                  ,2,0,3,0,5,2021
CAM,  ,Q   ,Sanita' e assistenza sociale                                ,3,1,0,0,4,2021
CAM,  ,Q 86,Assistenza sanitaria                                        ,3,0,0,0,3,2021
CAM,  ,Q 87,Servizi di assistenza sociale residenziale                  ,0,1,0,0,1,2021
CAM,  ,Q 88,Assistenza sociale non residenziale                         ,0,0,0,0,0,2021
CAM,  ,R   ,"Attività artistiche, sportive, di intrattenimento e diver...",3,2,22,0,27,2021
CAM,  ,R 90,"Attività creative, artistiche e di intrattenimento          ",0,0,5,0,5,2021
CAM,  ,R 91,"Attività di biblioteche, archivi, musei ed altre attività...",1,1,0,0,2,2021
CAM,  ,R 92,"Attività riguardanti le lotterie, le scommesse, le case d...",0,0,0,0,0,2021
CAM,  ,R 93,"Attività sportive, di intrattenimento e di divertimento     ",2,1,17,0,20,2021
CAM,  ,S   ,Altre attività di servizi                                   ,6,0,23,0,29,2021
CAM,  ,S 94,Attività di organizzazioni associative                      ,0,0,0,0,0,2021
CAM,  ,S 95,Riparazione di computer e di beni per uso personale e per...,1,0,8,0,9,2021
CAM,  ,S 96,Altre attività di servizi per la persona                    ,5,0,15,0,20,2021
CAM,  ,T   ,Attività di famiglie e convivenze come datori di lavoro p...,0,0,0,0,0,2021
CAM,  ,T 97,Attività di famiglie e convivenze come datori di lavoro p...,0,0,0,0,0,2021
CAM,  ,T 98,Produzione di beni e servizi indifferenziati per uso prop...,0,0,0,0,0,2021
CAM,  ,U   ,Organizzazioni ed organismi extraterritoriali               ,0,0,0,0,0,2021
CAM,  ,U 99,Organizzazioni ed organismi extraterritoriali               ,0,0,0,0,0,2021
CAM,  ,XX  ,Imprese non classificate                                    ,143,0,11,6,160,2021
CAM,  ,TOT ,TOTALE                                                      ,656,19,1906,9,2590,2021
CAM,CE,A   ,"Agricoltura, silvicoltura pesca                             ",1,0,106,0,107,2021
CAM,CE,A 01,"Coltivazioni agricole e produzione di prodotti animali, c...",1,0,103,0,104,2021
CAM,CE,A 02,Silvicoltura ed utilizzo di aree forestali                  ,0,0,3,0,3,2021
CAM,CE,A 03,Pesca e acquacoltura                                        ,0,0,0,0,0,2021
CAM,CE,B   ,Estrazione di minerali da cave e miniere                    ,0,0,2,0,2,2021
CAM,CE,B 05,Estrazione di carbone (esclusa torba)                       ,0,0,0,0,0,2021
CAM,CE,B 06,Estraz.di petrolio greggio e di gas naturale                ,0,0,0,0,0,2021
CAM,CE,B 07,Estrazione di minerali metalliferi                          ,0,0,0,0,0,2021
CAM,CE,B 08,Altre attività di estrazione di minerali da cave e miniere  ,0,0,2,0,2,2021
CAM,CE,B 09,Attività dei servizi di supporto all'estrazione             ,0,0,0,0,0,2021
CAM,CE,C   ,Attività manifatturiere                                     ,37,0,19,0,56,2021
CAM,CE,C 10,Industrie alimentari                                        ,4,0,4,0,8,2021
CAM,CE,C 11,Industria delle bevande                                     ,0,0,0,0,0,2021
CAM,CE,C 12,Industria del tabacco                                       ,1,0,0,0,1,2021
CAM,CE,C 13,Industrie tessili                                           ,1,0,0,0,1,2021
CAM,CE,C 14,Confezione di articoli di abbigliamento; confezione di ar...,5,0,2,0,7,2021
CAM,CE,C 15,Fabbricazione di articoli in pelle e simili                 ,1,0,1,0,2,2021
CAM,CE,C 16,Industria del legno e dei prodotti in legno e sughero (es...,1,0,4,0,5,2021
CAM,CE,C 17,Fabbricazione di carta e di prodotti di carta               ,0,0,0,0,0,2021
CAM,CE,C 18,Stampa e riproduzione di supporti registrati                ,0,0,0,0,0,2021
CAM,CE,C 19,Fabbricazione di coke e prodotti derivanti dalla raffinaz...,0,0,0,0,0,2021
CAM,CE,C 20,Fabbricazione di prodotti chimici                           ,1,0,1,0,2,2021
CAM,CE,C 21,Fabbricazione di prodotti farmaceutici di base e di prepa...,0,0,0,0,0,2021
CAM,CE,C 22,Fabbricazione di articoli in gomma e materie plastiche      ,1,0,0,0,1,2021
CAM,CE,C 23,Fabbricazione di altri prodotti della lavorazione di miner..,2,0,0,0,2,2021
CAM,CE,C 24,Metallurgia                                                 ,1,0,0,0,1,2021
CAM,CE,C 25,Fabbricazione di prodotti in metallo (esclusi macchinari ...,12,0,4,0,16,2021
CAM,CE,C 26,Fabbricazione di computer e prodotti di elettronica e ott...,1,0,0,0,1,2021
CAM,CE,C 27,Fabbricazione di apparecchiature elettriche ed apparecchi...,1,0,1,0,2,2021
CAM,CE,C 28,Fabbricazione di macchinari ed apparecchiature nca          ,1,0,1,0,2,2021
CAM,CE,C 29,"Fabbricazione di autoveicoli, rimorchi e semirimorchi       ",0,0,0,0,0,2021
CAM,CE,C 30,Fabbricazione di altri mezzi di trasporto                   ,0,0,0,0,0,2021
CAM,CE,C 31,Fabbricazione di mobili                                     ,4,0,1,0,5,2021
CAM,CE,C 32,Altre industrie manifatturiere                              ,0,0,0,0,0,2021
CAM,CE,C 33,"Riparazione, manutenzione ed installazione di macchine ed...",0,0,0,0,0,2021
CAM,CE,D   ,"Fornitura di energia elettrica, gas, vapore e aria condiz...",0,0,0,0,0,2021
CAM,CE,D 35,"Fornitura di energia elettrica, gas, vapore e aria condiz...",0,0,0,0,0,2021
CAM,CE,E   ,"Fornitura di acqua; reti fognarie, attività di gestione d...",0,0,0,0,0,2021
CAM,CE,E 36,"Raccolta, trattamento e fornitura di acqua                  ",0,0,0,0,0,2021
CAM,CE,E 37,Gestione delle reti fognarie                                ,0,0,0,0,0,2021
CAM,CE,E 38,"Attività di raccolta, trattamento e smaltimento dei rifiu...",0,0,0,0,0,2021
CAM,CE,E 39,Attività di risanamento e altri servizi di gestione dei r...,0,0,0,0,0,2021
CAM,CE,F   ,Costruzioni                                                 ,42,0,27,1,70,2021
CAM,CE,F 41,Costruzione di edifici                                      ,27,0,17,1,45,2021
CAM,CE,F 42,Ingegneria civile                                           ,1,0,1,0,2,2021
CAM,CE,F 43,Lavori di costruzione specializzati                         ,14,0,9,0,23,2021
CAM,CE,G   ,Commercio all'ingrosso e al dettaglio; riparazione di aut...,62,0,56,0,118,2021
CAM,CE,G 45,Commercio all'ingrosso e al dettaglio e riparazione di au...,14,0,5,0,19,2021
CAM,CE,G 46,Commercio all'ingrosso (escluso quello di autoveicoli e d...,23,0,7,0,30,2021
CAM,CE,G 47,Commercio al dettaglio (escluso quello di autoveicoli e d...,25,0,44,0,69,2021
CAM,CE,H   ,Trasporto e magazzinaggio                                   ,3,0,7,0,10,2021
CAM,CE,H 49,Trasporto terrestre e mediante condotte                     ,2,0,7,0,9,2021
CAM,CE,H 50,Trasporto marittimo e per vie d'acqua                       ,0,0,0,0,0,2021
CAM,CE,H 51,Trasporto aereo                                             ,0,0,0,0,0,2021
CAM,CE,H 52,Magazzinaggio e attività di supporto ai trasporti           ,1,0,0,0,1,2021
CAM,CE,H 53,Servizi postali e attività di corriere                      ,0,0,0,0,0,2021
CAM,CE,I   ,Attività dei servizi alloggio e ristorazione                ,12,0,10,0,22,2021
CAM,CE,I 55,Alloggio                                                    ,0,0,0,0,0,2021
CAM,CE,I 56,Attività dei servizi di ristorazione                        ,12,0,10,0,22,2021
CAM,CE,J   ,Servizi di informazione e comunicazione                     ,4,0,2,0,6,2021
CAM,CE,J 58,Attività editoriali                                         ,0,0,0,0,0,2021
CAM,CE,J 59,"Attività di produzione cinematografica, di video e di pro...",0,0,1,0,1,2021
CAM,CE,J 60,Attività di programmazione e trasmissione                   ,0,0,0,0,0,2021
CAM,CE,J 61,Telecomunicazioni                                           ,0,0,0,0,0,2021
CAM,CE,J 62,"Produzione di software, consulenza informatica e attività...",2,0,0,0,2,2021
CAM,CE,J 63,Attività dei servizi d'informazione e altri servizi infor...,2,0,1,0,3,2021
CAM,CE,K   ,Attività finanziarie e assicurative                         ,2,0,0,0,2,2021
CAM,CE,K 64,Attività di servizi finanziari (escluse le assicurazioni ...,1,0,0,0,1,2021
CAM,CE,K 65,"Assicurazioni, riassicurazioni e fondi pensione (escluse ...",0,0,0,0,0,2021
CAM,CE,K 66,Attività ausiliarie dei servizi finanziari e delle attivi...,1,0,0,0,1,2021
CAM,CE,L   ,Attivita' immobiliari                                       ,5,0,0,0,5,2021
CAM,CE,L 68,Attivita' immobiliari                                       ,5,0,0,0,5,2021
CAM,CE,M   ,"Attività professionali, scientifiche e tecniche             ",9,0,2,2,13,2021
CAM,CE,M 69,Attività legali e contabilità                               ,0,0,0,1,1,2021
CAM,CE,M 70,Attività di direzione aziendale e di consulenza gestional...,1,0,0,1,2,2021
CAM,CE,M 71,Attività degli studi di architettura e d'ingegneria; coll...,4,0,0,0,4,2021
CAM,CE,M 72,Ricerca scientifica e sviluppo                              ,1,0,0,0,1,2021
CAM,CE,M 73,Pubblicità e ricerche di mercato                            ,2,0,0,0,2,2021
CAM,CE,M 74,"Altre attività professionali, scientifiche e tecniche       ",1,0,2,0,3,2021
CAM,CE,M 75,Servizi veterinari                                          ,0,0,0,0,0,2021
CAM,CE,N   ,"Noleggio, agenzie di viaggio, servizi di supporto alle im...",3,0,1,0,4,2021
CAM,CE,N 77,Attività di noleggio e leasing operativo                    ,0,0,0,0,0,2021
CAM,CE,N 78,"Attività di ricerca, selezione, fornitura di personale      ",0,0,0,0,0,2021
CAM,CE,N 79,"Attività dei servizi delle agenzie di viaggio, dei tour o...",0,0,0,0,0,2021
CAM,CE,N 80,Servizi di vigilanza e investigazione                       ,0,0,0,0,0,2021
CAM,CE,N 81,Attività di servizi per edifici e paesaggio                 ,0,0,1,0,1,2021
CAM,CE,N 82,Attività di supporto per le funzioni d'ufficio e altri se...,3,0,0,0,3,2021
CAM,CE,O   ,Amministrazione pubblica e difesa; assicurazione sociale ...,0,0,0,0,0,2021
CAM,CE,O 84,Amministrazione pubblica e difesa; assicurazione sociale ...,0,0,0,0,0,2021
CAM,CE,P   ,Istruzione                                                  ,0,0,0,0,0,2021
CAM,CE,P 85,Istruzione                                                  ,0,0,0,0,0,2021
CAM,CE,Q   ,Sanita' e assistenza sociale                                ,2,0,0,0,2,2021
CAM,CE,Q 86,Assistenza sanitaria                                        ,2,0,0,0,2,2021
CAM,CE,Q 87,Servizi di assistenza sociale residenziale                  ,0,0,0,0,0,2021
CAM,CE,Q 88,Assistenza sociale non residenziale                         ,0,0,0,0,0,2021
CAM,CE,R   ,"Attività artistiche, sportive, di intrattenimento e diver...",1,0,3,0,4,2021
CAM,CE,R 90,"Attività creative, artistiche e di intrattenimento          ",0,0,1,0,1,2021
CAM,CE,R 91,"Attività di biblioteche, archivi, musei ed altre attività...",0,0,0,0,0,2021
CAM,CE,R 92,"Attività riguardanti le lotterie, le scommesse, le case d...",0,0,0,0,0,2021
CAM,CE,R 93,"Attività sportive, di intrattenimento e di divertimento     ",1,0,2,0,3,2021
CAM,CE,S   ,Altre attività di servizi                                   ,3,0,3,0,6,2021
CAM,CE,S 94,Attività di organizzazioni associative                      ,0,0,0,0,0,2021
CAM,CE,S 95,Riparazione di computer e di beni per uso personale e per...,0,0,1,0,1,2021
CAM,CE,S 96,Altre attività di servizi per la persona                    ,3,0,2,0,5,2021
CAM,CE,T   ,Attività di famiglie e convivenze come datori di lavoro p...,0,0,0,0,0,2021
CAM,CE,T 97,Attività di famiglie e convivenze come datori di lavoro p...,0,0,0,0,0,2021
CAM,CE,T 98,Produzione di beni e servizi indifferenziati per uso prop...,0,0,0,0,0,2021
CAM,CE,U   ,Organizzazioni ed organismi extraterritoriali               ,0,0,0,0,0,2021
CAM,CE,U 99,Organizzazioni ed organismi extraterritoriali               ,0,0,0,0,0,2021
CAM,CE,XX  ,Imprese non classificate                                    ,93,0,1,6,100,2021
CAM,CE,TOT ,TOTALE                                                      ,279,0,239,9,527,2021
CAM,BN,A   ,"Agricoltura, silvicoltura pesca                             ",0,0,0,0,0,2021
CAM,BN,A 01,"Coltivazioni agricole e produzione di prodotti animali, c...",0,0,0,0,0,2021
CAM,BN,A 02,Silvicoltura ed utilizzo di aree forestali                  ,0,0,0,0,0,2021
CAM,BN,A 03,Pesca e acquacoltura                                        ,0,0,0,0,0,2021
CAM,BN,B   ,Estrazione di minerali da cave e miniere                    ,2,0,0,0,2,2021
CAM,BN,B 05,Estrazione di carbone (esclusa torba)                       ,0,0,0,0,0,2021
CAM,BN,B 06,Estraz.di petrolio greggio e di gas naturale                ,0,0,0,0,0,2021
CAM,BN,B 07,Estrazione di minerali metalliferi                          ,0,0,0,0,0,2021
CAM,BN,B 08,Altre attività di estrazione di minerali da cave e miniere  ,2,0,0,0,2,2021
CAM,BN,B 09,Attività dei servizi di supporto all'estrazione             ,0,0,0,0,0,2021
CAM,BN,C   ,Attività manifatturiere                                     ,19,0,0,0,19,2021
CAM,BN,C 10,Industrie alimentari                                        ,2,0,0,0,2,2021
CAM,BN,C 11,Industria delle bevande                                     ,0,0,0,0,0,2021
CAM,BN,C 12,Industria del tabacco                                       ,0,0,0,0,0,2021
CAM,BN,C 13,Industrie tessili                                           ,0,0,0,0,0,2021
CAM,BN,C 14,Confezione di articoli di abbigliamento; confezione di ar...,5,0,0,0,5,2021
CAM,BN,C 15,Fabbricazione di articoli in pelle e simili                 ,0,0,0,0,0,2021
CAM,BN,C 16,Industria del legno e dei prodotti in legno e sughero (es...,3,0,0,0,3,2021
CAM,BN,C 17,Fabbricazione di carta e di prodotti di carta               ,0,0,0,0,0,2021
CAM,BN,C 18,Stampa e riproduzione di supporti registrati                ,0,0,0,0,0,2021
CAM,BN,C 19,Fabbricazione di coke e prodotti derivanti dalla raffinaz...,0,0,0,0,0,2021
CAM,BN,C 20,Fabbricazione di prodotti chimici                           ,0,0,0,0,0,2021
CAM,BN,C 21,Fabbricazione di prodotti farmaceutici di base e di prepa...,0,0,0,0,0,2021
CAM,BN,C 22,Fabbricazione di articoli in gomma e materie plastiche      ,0,0,0,0,0,2021
CAM,BN,C 23,Fabbricazione di altri prodotti della lavorazione di miner..,1,0,0,0,1,2021
CAM,BN,C 24,Metallurgia                                                 ,1,0,0,0,1,2021
CAM,BN,C 25,Fabbricazione di prodotti in metallo (esclusi macchinari ...,3,0,0,0,3,2021
CAM,BN,C 26,Fabbricazione di computer e prodotti di elettronica e ott...,1,0,0,0,1,2021
CAM,BN,C 27,Fabbricazione di apparecchiature elettriche ed apparecchi...,0,0,0,0,0,2021
CAM,BN,C 28,Fabbricazione di macchinari ed apparecchiature nca          ,1,0,0,0,1,2021
CAM,BN,C 29,"Fabbricazione di autoveicoli, rimorchi e semirimorchi       ",0,0,0,0,0,2021
CAM,BN,C 30,Fabbricazione di altri mezzi di trasporto                   ,0,0,0,0,0,2021
CAM,BN,C 31,Fabbricazione di mobili                                     ,1,0,0,0,1,2021
CAM,BN,C 32,Altre industrie manifatturiere                              ,0,0,0,0,0,2021
CAM,BN,C 33,"Riparazione, manutenzione ed installazione di macchine ed...",1,0,0,0,1,2021
CAM,BN,D   ,"Fornitura di energia elettrica, gas, vapore e aria condiz...",0,0,0,0,0,2021
CAM,BN,D 35,"Fornitura di energia elettrica, gas, vapore e aria condiz...",0,0,0,0,0,2021
CAM,BN,E   ,"Fornitura di acqua; reti fognarie, attività di gestione d...",0,0,0,0,0,2021
CAM,BN,E 36,"Raccolta, trattamento e fornitura di acqua                  ",0,0,0,0,0,2021
CAM,BN,E 37,Gestione delle reti fognarie                                ,0,0,0,0,0,2021
CAM,BN,E 38,"Attività di raccolta, trattamento e smaltimento dei rifiu...",0,0,0,0,0,2021
CAM,BN,E 39,Attività di risanamento e altri servizi di gestione dei r...,0,0,0,0,0,2021
CAM,BN,F   ,Costruzioni                                                 ,27,0,1,0,28,2021
CAM,BN,F 41,Costruzione di edifici                                      ,19,0,1,0,20,2021
CAM,BN,F 42,Ingegneria civile                                           ,1,0,0,0,1,2021
CAM,BN,F 43,Lavori di costruzione specializzati                         ,7,0,0,0,7,2021
CAM,BN,G   ,Commercio all'ingrosso e al dettaglio; riparazione di aut...,37,0,2,0,39,2021
CAM,BN,G 45,Commercio all'ingrosso e al dettaglio e riparazione di au...,11,0,0,0,11,2021
CAM,BN,G 46,Commercio all'ingrosso (escluso quello di autoveicoli e d...,6,0,0,0,6,2021
CAM,BN,G 47,Commercio al dettaglio (escluso quello di autoveicoli e d...,20,0,2,0,22,2021
CAM,BN,H   ,Trasporto e magazzinaggio                                   ,6,0,0,0,6,2021
CAM,BN,H 49,Trasporto terrestre e mediante condotte                     ,6,0,0,0,6,2021
CAM,BN,H 50,Trasporto marittimo e per vie d'acqua                       ,0,0,0,0,0,2021
CAM,BN,H 51,Trasporto aereo                                             ,0,0,0,0,0,2021
CAM,BN,H 52,Magazzinaggio e attività di supporto ai trasporti           ,0,0,0,0,0,2021
CAM,BN,H 53,Servizi postali e attività di corriere                      ,0,0,0,0,0,2021
CAM,BN,I   ,Attività dei servizi alloggio e ristorazione                ,7,0,3,0,10,2021
CAM,BN,I 55,Alloggio                                                    ,0,0,0,0,0,2021
CAM,BN,I 56,Attività dei servizi di ristorazione                        ,7,0,3,0,10,2021
CAM,BN,J   ,Servizi di informazione e comunicazione                     ,3,0,0,0,3,2021
CAM,BN,J 58,Attività editoriali                                         ,1,0,0,0,1,2021
CAM,BN,J 59,"Attività di produzione cinematografica, di video e di pro...",0,0,0,0,0,2021
CAM,BN,J 60,Attività di programmazione e trasmissione                   ,0,0,0,0,0,2021
CAM,BN,J 61,Telecomunicazioni                                           ,0,0,0,0,0,2021
CAM,BN,J 62,"Produzione di software, consulenza informatica e attività...",0,0,0,0,0,2021
CAM,BN,J 63,Attività dei servizi d'informazione e altri servizi infor...,2,0,0,0,2,2021
CAM,BN,K   ,Attività finanziarie e assicurative                         ,1,0,0,0,1,2021
CAM,BN,K 64,Attività di servizi finanziari (escluse le assicurazioni ...,1,0,0,0,1,2021
CAM,BN,K 65,"Assicurazioni, riassicurazioni e fondi pensione (escluse ...",0,0,0,0,0,2021
CAM,BN,K 66,Attività ausiliarie dei servizi finanziari e delle attivi...,0,0,0,0,0,2021
CAM,BN,L   ,Attivita' immobiliari                                       ,0,0,0,0,0,2021
CAM,BN,L 68,Attivita' immobiliari                                       ,0,0,0,0,0,2021
CAM,BN,M   ,"Attività professionali, scientifiche e tecniche             ",1,0,0,0,1,2021
CAM,BN,M 69,Attività legali e contabilità                               ,0,0,0,0,0,2021
CAM,BN,M 70,Attività di direzione aziendale e di consulenza gestional...,0,0,0,0,0,2021
CAM,BN,M 71,Attività degli studi di architettura e d'ingegneria; coll...,1,0,0,0,1,2021
CAM,BN,M 72,Ricerca scientifica e sviluppo                              ,0,0,0,0,0,2021
CAM,BN,M 73,Pubblicità e ricerche di mercato                            ,0,0,0,0,0,2021
CAM,BN,M 74,"Altre attività professionali, scientifiche e tecniche       ",0,0,0,0,0,2021
CAM,BN,M 75,Servizi veterinari                                          ,0,0,0,0,0,2021
CAM,BN,N   ,"Noleggio, agenzie di viaggio, servizi di supporto alle im...",2,0,0,0,2,2021
CAM,BN,N 77,Attività di noleggio e leasing operativo                    ,1,0,0,0,1,2021
CAM,BN,N 78,"Attività di ricerca, selezione, fornitura di personale      ",0,0,0,0,0,2021
CAM,BN,N 79,"Attività dei servizi delle agenzie di viaggio, dei tour o...",0,0,0,0,0,2021
CAM,BN,N 80,Servizi di vigilanza e investigazione                       ,0,0,0,0,0,2021
CAM,BN,N 81,Attività di servizi per edifici e paesaggio                 ,0,0,0,0,0,2021
CAM,BN,N 82,Attività di supporto per le funzioni d'ufficio e altri se...,1,0,0,0,1,2021
CAM,BN,O   ,Amministrazione pubblica e difesa; assicurazione sociale ...,0,0,0,0,0,2021
CAM,BN,O 84,Amministrazione pubblica e difesa; assicurazione sociale ...,0,0,0,0,0,2021
CAM,BN,P   ,Istruzione                                                  ,0,0,1,0,1,2021
CAM,BN,P 85,Istruzione                                                  ,0,0,1,0,1,2021
CAM,BN,Q   ,Sanita' e assistenza sociale                                ,0,0,0,0,0,2021
CAM,BN,Q 86,Assistenza sanitaria                                        ,0,0,0,0,0,2021
CAM,BN,Q 87,Servizi di assistenza sociale residenziale                  ,0,0,0,0,0,2021
CAM,BN,Q 88,Assistenza sociale non residenziale                         ,0,0,0,0,0,2021
CAM,BN,R   ,"Attività artistiche, sportive, di intrattenimento e diver...",0,0,0,0,0,2021
CAM,BN,R 90,"Attività creative, artistiche e di intrattenimento          ",0,0,0,0,0,2021
CAM,BN,R 91,"Attività di biblioteche, archivi, musei ed altre attività...",0,0,0,0,0,2021
CAM,BN,R 92,"Attività riguardanti le lotterie, le scommesse, le case d...",0,0,0,0,0,2021
CAM,BN,R 93,"Attività sportive, di intrattenimento e di divertimento     ",0,0,0,0,0,2021
CAM,BN,S   ,Altre attività di servizi                                   ,1,0,0,0,1,2021
CAM,BN,S 94,Attività di organizzazioni associative                      ,0,0,0,0,0,2021
CAM,BN,S 95,Riparazione di computer e di beni per uso personale e per...,1,0,0,0,1,2021
CAM,BN,S 96,Altre attività di servizi per la persona                    ,0,0,0,0,0,2021
CAM,BN,T   ,Attività di famiglie e convivenze come datori di lavoro p...,0,0,0,0,0,2021
CAM,BN,T 97,Attività di famiglie e convivenze come datori di lavoro p...,0,0,0,0,0,2021
CAM,BN,T 98,Produzione di beni e servizi indifferenziati per uso prop...,0,0,0,0,0,2021
CAM,BN,U   ,Organizzazioni ed organismi extraterritoriali               ,0,0,0,0,0,2021
CAM,BN,U 99,Organizzazioni ed organismi extraterritoriali               ,0,0,0,0,0,2021
CAM,BN,XX  ,Imprese non classificate                                    ,33,0,0,0,33,2021
CAM,BN,TOT ,TOTALE                                                      ,139,0,7,0,146,2021
CAM,NA,A   ,"Agricoltura, silvicoltura pesca                             ",0,0,0,0,0,2021
CAM,NA,A 01,"Coltivazioni agricole e produzione di prodotti animali, c...",0,0,0,0,0,2021
CAM,NA,A 02,Silvicoltura ed utilizzo di aree forestali                  ,0,0,0,0,0,2021
CAM,NA,A 03,Pesca e acquacoltura                                        ,0,0,0,0,0,2021
CAM,NA,B   ,Estrazione di minerali da cave e miniere                    ,0,0,0,0,0,2021
CAM,NA,B 05,Estrazione di carbone (esclusa torba)                       ,0,0,0,0,0,2021
CAM,NA,B 06,Estraz.di petrolio greggio e di gas naturale                ,0,0,0,0,0,2021
CAM,NA,B 07,Estrazione di minerali metalliferi                          ,0,0,0,0,0,2021
CAM,NA,B 08,Altre attività di estrazione di minerali da cave e miniere  ,0,0,0,0,0,2021
CAM,NA,B 09,Attività dei servizi di supporto all'estrazione             ,0,0,0,0,0,2021
CAM,NA,C   ,Attività manifatturiere                                     ,46,2,2,0,50,2021
CAM,NA,C 10,Industrie alimentari                                        ,1,0,0,0,1,2021
CAM,NA,C 11,Industria delle bevande                                     ,0,0,0,0,0,2021
CAM,NA,C 12,Industria del tabacco                                       ,0,0,0,0,0,2021
CAM,NA,C 13,Industrie tessili                                           ,1,0,0,0,1,2021
CAM,NA,C 14,Confezione di articoli di abbigliamento; confezione di ar...,5,0,1,0,6,2021
CAM,NA,C 15,Fabbricazione di articoli in pelle e simili                 ,7,1,0,0,8,2021
CAM,NA,C 16,Industria del legno e dei prodotti in legno e sughero (es...,2,0,0,0,2,2021
CAM,NA,C 17,Fabbricazione di carta e di prodotti di carta               ,2,0,1,0,3,2021
CAM,NA,C 18,Stampa e riproduzione di supporti registrati                ,2,0,0,0,2,2021
CAM,NA,C 19,Fabbricazione di coke e prodotti derivanti dalla raffinaz...,0,0,0,0,0,2021
CAM,NA,C 20,Fabbricazione di prodotti chimici                           ,2,0,0,0,2,2021
CAM,NA,C 21,Fabbricazione di prodotti farmaceutici di base e di prepa...,0,0,0,0,0,2021
CAM,NA,C 22,Fabbricazione di articoli in gomma e materie plastiche      ,1,0,0,0,1,2021
CAM,NA,C 23,Fabbricazione di altri prodotti della lavorazione di miner..,1,0,0,0,1,2021
CAM,NA,C 24,Metallurgia                                                 ,2,0,0,0,2,2021
CAM,NA,C 25,Fabbricazione di prodotti in metallo (esclusi macchinari ...,9,1,0,0,10,2021
CAM,NA,C 26,Fabbricazione di computer e prodotti di elettronica e ott...,1,0,0,0,1,2021
CAM,NA,C 27,Fabbricazione di apparecchiature elettriche ed apparecchi...,2,0,0,0,2,2021
CAM,NA,C 28,Fabbricazione di macchinari ed apparecchiature nca          ,2,0,0,0,2,2021
CAM,NA,C 29,"Fabbricazione di autoveicoli, rimorchi e semirimorchi       ",1,0,0,0,1,2021
CAM,NA,C 30,Fabbricazione di altri mezzi di trasporto                   ,0,0,0,0,0,2021
CAM,NA,C 31,Fabbricazione di mobili                                     ,2,0,0,0,2,2021
CAM,NA,C 32,Altre industrie manifatturiere                              ,1,0,0,0,1,2021
CAM,NA,C 33,"Riparazione, manutenzione ed installazione di macchine ed...",2,0,0,0,2,2021
CAM,NA,D   ,"Fornitura di energia elettrica, gas, vapore e aria condiz...",0,0,0,0,0,2021
CAM,NA,D 35,"Fornitura di energia elettrica, gas, vapore e aria condiz...",0,0,0,0,0,2021
CAM,NA,E   ,"Fornitura di acqua; reti fognarie, attività di gestione d...",2,0,0,0,2,2021
CAM,NA,E 36,"Raccolta, trattamento e fornitura di acqua                  ",0,0,0,0,0,2021
CAM,NA,E 37,Gestione delle reti fognarie                                ,1,0,0,0,1,2021
CAM,NA,E 38,"Attività di raccolta, trattamento e smaltimento dei rifiu...",1,0,0,0,1,2021
CAM,NA,E 39,Attività di risanamento e altri servizi di gestione dei r...,0,0,0,0,0,2021
CAM,NA,F   ,Costruzioni                                                 ,16,3,0,0,19,2021
CAM,NA,F 41,Costruzione di edifici                                      ,8,0,0,0,8,2021
CAM,NA,F 42,Ingegneria civile                                           ,0,0,0,0,0,2021
CAM,NA,F 43,Lavori di costruzione specializzati                         ,8,3,0,0,11,2021
CAM,NA,G   ,Commercio all'ingrosso e al dettaglio; riparazione di aut...,90,6,6,0,102,2021
CAM,NA,G 45,Commercio all'ingrosso e al dettaglio e riparazione di au...,5,0,0,0,5,2021
CAM,NA,G 46,Commercio all'ingrosso (escluso quello di autoveicoli e d...,53,5,0,0,58,2021
CAM,NA,G 47,Commercio al dettaglio (escluso quello di autoveicoli e d...,32,1,6,0,39,2021
CAM,NA,H   ,Trasporto e magazzinaggio                                   ,5,1,0,0,6,2021
CAM,NA,H 49,Trasporto terrestre e mediante condotte                     ,2,0,0,0,2,2021
CAM,NA,H 50,Trasporto marittimo e per vie d'acqua                       ,0,0,0,0,0,2021
CAM,NA,H 51,Trasporto aereo                                             ,0,0,0,0,0,2021
CAM,NA,H 52,Magazzinaggio e attività di supporto ai trasporti           ,2,1,0,0,3,2021
CAM,NA,H 53,Servizi postali e attività di corriere                      ,1,0,0,0,1,2021
CAM,NA,I   ,Attività dei servizi alloggio e ristorazione                ,9,1,1,0,11,2021
CAM,NA,I 55,Alloggio                                                    ,4,0,0,0,4,2021
CAM,NA,I 56,Attività dei servizi di ristorazione                        ,5,1,1,0,7,2021
CAM,NA,J   ,Servizi di informazione e comunicazione                     ,10,1,0,0,11,2021
CAM,NA,J 58,Attività editoriali                                         ,3,1,0,0,4,2021
CAM,NA,J 59,"Attività di produzione cinematografica, di video e di pro...",1,0,0,0,1,2021
CAM,NA,J 60,Attività di programmazione e trasmissione                   ,0,0,0,0,0,2021
CAM,NA,J 61,Telecomunicazioni                                           ,0,0,0,0,0,2021
CAM,NA,J 62,"Produzione di software, consulenza informatica e attività...",4,0,0,0,4,2021
CAM,NA,J 63,Attività dei servizi d'informazione e altri servizi infor...,2,0,0,0,2,2021
CAM,NA,K   ,Attività finanziarie e assicurative                         ,3,1,0,0,4,2021
CAM,NA,K 64,Attività di servizi finanziari (escluse le assicurazioni ...,0,0,0,0,0,2021
CAM,NA,K 65,"Assicurazioni, riassicurazioni e fondi pensione (escluse ...",0,0,0,0,0,2021
CAM,NA,K 66,Attività ausiliarie dei servizi finanziari e delle attivi...,3,1,0,0,4,2021
CAM,NA,L   ,Attivita' immobiliari                                       ,3,0,0,0,3,2021
CAM,NA,L 68,Attivita' immobiliari                                       ,3,0,0,0,3,2021
CAM,NA,M   ,"Attività professionali, scientifiche e tecniche             ",7,0,0,0,7,2021
CAM,NA,M 69,Attività legali e contabilità                               ,0,0,0,0,0,2021
CAM,NA,M 70,Attività di direzione aziendale e di consulenza gestional...,0,0,0,0,0,2021
CAM,NA,M 71,Attività degli studi di architettura e d'ingegneria; coll...,0,0,0,0,0,2021
CAM,NA,M 72,Ricerca scientifica e sviluppo                              ,1,0,0,0,1,2021
CAM,NA,M 73,Pubblicità e ricerche di mercato                            ,5,0,0,0,5,2021
CAM,NA,M 74,"Altre attività professionali, scientifiche e tecniche       ",1,0,0,0,1,2021
CAM,NA,M 75,Servizi veterinari                                          ,0,0,0,0,0,2021
CAM,NA,N   ,"Noleggio, agenzie di viaggio, servizi di supporto alle im...",15,0,0,0,15,2021
CAM,NA,N 77,Attività di noleggio e leasing operativo                    ,1,0,0,0,1,2021
CAM,NA,N 78,"Attività di ricerca, selezione, fornitura di personale      ",0,0,0,0,0,2021
CAM,NA,N 79,"Attività dei servizi delle agenzie di viaggio, dei tour o...",1,0,0,0,1,2021
CAM,NA,N 80,Servizi di vigilanza e investigazione                       ,0,0,0,0,0,2021
CAM,NA,N 81,Attività di servizi per edifici e paesaggio                 ,2,0,0,0,2,2021
CAM,NA,N 82,Attività di supporto per le funzioni d'ufficio e altri se...,11,0,0,0,11,2021
CAM,NA,O   ,Amministrazione pubblica e difesa; assicurazione sociale ...,2,0,0,0,2,2021
CAM,NA,O 84,Amministrazione pubblica e difesa; assicurazione sociale ...,2,0,0,0,2,2021
CAM,NA,P   ,Istruzione                                                  ,2,0,0,0,2,2021
CAM,NA,P 85,Istruzione                                                  ,2,0,0,0,2,2021
CAM,NA,Q   ,Sanita' e assistenza sociale                                ,1,1,0,0,2,2021
CAM,NA,Q 86,Assistenza sanitaria                                        ,1,0,0,0,1,2021
CAM,NA,Q 87,Servizi di assistenza sociale residenziale                  ,0,1,0,0,1,2021
CAM,NA,Q 88,Assistenza sociale non residenziale                         ,0,0,0,0,0,2021
CAM,NA,R   ,"Attività artistiche, sportive, di intrattenimento e diver...",2,2,0,0,4,2021
CAM,NA,R 90,"Attività creative, artistiche e di intrattenimento          ",0,0,0,0,0,2021
CAM,NA,R 91,"Attività di biblioteche, archivi, musei ed altre attività...",1,1,0,0,2,2021
CAM,NA,R 92,"Attività riguardanti le lotterie, le scommesse, le case d...",0,0,0,0,0,2021
CAM,NA,R 93,"Attività sportive, di intrattenimento e di divertimento     ",1,1,0,0,2,2021
CAM,NA,S   ,Altre attività di servizi                                   ,2,0,0,0,2,2021
CAM,NA,S 94,Attività di organizzazioni associative                      ,0,0,0,0,0,2021
CAM,NA,S 95,Riparazione di computer e di beni per uso personale e per...,0,0,0,0,0,2021
CAM,NA,S 96,Altre attività di servizi per la persona                    ,2,0,0,0,2,2021
CAM,NA,T   ,Attività di famiglie e convivenze come datori di lavoro p...,0,0,0,0,0,2021
CAM,NA,T 97,Attività di famiglie e convivenze come datori di lavoro p...,0,0,0,0,0,2021
CAM,NA,T 98,Produzione di beni e servizi indifferenziati per uso prop...,0,0,0,0,0,2021
CAM,NA,U   ,Organizzazioni ed organismi extraterritoriali               ,0,0,0,0,0,2021
CAM,NA,U 99,Organizzazioni ed organismi extraterritoriali               ,0,0,0,0,0,2021
CAM,NA,XX  ,Imprese non classificate                                    ,17,0,2,0,19,2021
CAM,NA,TOT ,TOTALE                                                      ,232,18,11,0,261,2021
CAM,AV,A   ,"Agricoltura, silvicoltura pesca                             ",0,0,132,0,132,2021
CAM,AV,A 01,"Coltivazioni agricole e produzione di prodotti animali, c...",0,0,129,0,129,2021
CAM,AV,A 02,Silvicoltura ed utilizzo di aree forestali                  ,0,0,3,0,3,2021
CAM,AV,A 03,Pesca e acquacoltura                                        ,0,0,0,0,0,2021
CAM,AV,B   ,Estrazione di minerali da cave e miniere                    ,0,0,0,0,0,2021
CAM,AV,B 05,Estrazione di carbone (esclusa torba)                       ,0,0,0,0,0,2021
CAM,AV,B 06,Estraz.di petrolio greggio e di gas naturale                ,0,0,0,0,0,2021
CAM,AV,B 07,Estrazione di minerali metalliferi                          ,0,0,0,0,0,2021
CAM,AV,B 08,Altre attività di estrazione di minerali da cave e miniere  ,0,0,0,0,0,2021
CAM,AV,B 09,Attività dei servizi di supporto all'estrazione             ,0,0,0,0,0,2021
CAM,AV,C   ,Attività manifatturiere                                     ,0,0,75,0,75,2021
CAM,AV,C 10,Industrie alimentari                                        ,0,0,8,0,8,2021
CAM,AV,C 11,Industria delle bevande                                     ,0,0,1,0,1,2021
CAM,AV,C 12,Industria del tabacco                                       ,0,0,0,0,0,2021
CAM,AV,C 13,Industrie tessili                                           ,0,0,0,0,0,2021
CAM,AV,C 14,Confezione di articoli di abbigliamento; confezione di ar...,0,0,16,0,16,2021
CAM,AV,C 15,Fabbricazione di articoli in pelle e simili                 ,0,0,17,0,17,2021
CAM,AV,C 16,Industria del legno e dei prodotti in legno e sughero (es...,0,0,6,0,6,2021
CAM,AV,C 17,Fabbricazione di carta e di prodotti di carta               ,0,0,1,0,1,2021
CAM,AV,C 18,Stampa e riproduzione di supporti registrati                ,0,0,0,0,0,2021
CAM,AV,C 19,Fabbricazione di coke e prodotti derivanti dalla raffinaz...,0,0,0,0,0,2021
CAM,AV,C 20,Fabbricazione di prodotti chimici                           ,0,0,0,0,0,2021
CAM,AV,C 21,Fabbricazione di prodotti farmaceutici di base e di prepa...,0,0,0,0,0,2021
CAM,AV,C 22,Fabbricazione di articoli in gomma e materie plastiche      ,0,0,1,0,1,2021
CAM,AV,C 23,Fabbricazione di altri prodotti della lavorazione di miner..,0,0,5,0,5,2021
CAM,AV,C 24,Metallurgia                                                 ,0,0,0,0,0,2021
CAM,AV,C 25,Fabbricazione di prodotti in metallo (esclusi macchinari ...,0,0,13,0,13,2021
CAM,AV,C 26,Fabbricazione di computer e prodotti di elettronica e ott...,0,0,1,0,1,2021
CAM,AV,C 27,Fabbricazione di apparecchiature elettriche ed apparecchi...,0,0,0,0,0,2021
CAM,AV,C 28,Fabbricazione di macchinari ed apparecchiature nca          ,0,0,0,0,0,2021
CAM,AV,C 29,"Fabbricazione di autoveicoli, rimorchi e semirimorchi       ",0,0,0,0,0,2021
CAM,AV,C 30,Fabbricazione di altri mezzi di trasporto                   ,0,0,0,0,0,2021
CAM,AV,C 31,Fabbricazione di mobili                                     ,0,0,0,0,0,2021
CAM,AV,C 32,Altre industrie manifatturiere                              ,0,0,3,0,3,2021
CAM,AV,C 33,"Riparazione, manutenzione ed installazione di macchine ed...",0,0,3,0,3,2021
CAM,AV,D   ,"Fornitura di energia elettrica, gas, vapore e aria condiz...",0,0,1,0,1,2021
CAM,AV,D 35,"Fornitura di energia elettrica, gas, vapore e aria condiz...",0,0,1,0,1,2021
CAM,AV,E   ,"Fornitura di acqua; reti fognarie, attività di gestione d...",0,0,6,0,6,2021
CAM,AV,E 36,"Raccolta, trattamento e fornitura di acqua                  ",0,0,0,0,0,2021
CAM,AV,E 37,Gestione delle reti fognarie                                ,0,0,0,0,0,2021
CAM,AV,E 38,"Attività di raccolta, trattamento e smaltimento dei rifiu...",0,0,2,0,2,2021
CAM,AV,E 39,Attività di risanamento e altri servizi di gestione dei r...,0,0,4,0,4,2021
CAM,AV,F   ,Costruzioni                                                 ,0,0,127,0,127,2021
CAM,AV,F 41,Costruzione di edifici                                      ,0,0,67,0,67,2021
CAM,AV,F 42,Ingegneria civile                                           ,0,0,3,0,3,2021
CAM,AV,F 43,Lavori di costruzione specializzati                         ,0,0,57,0,57,2021
CAM,AV,G   ,Commercio all'ingrosso e al dettaglio; riparazione di aut...,0,0,273,0,273,2021
CAM,AV,G 45,Commercio all'ingrosso e al dettaglio e riparazione di au...,0,0,27,0,27,2021
CAM,AV,G 46,Commercio all'ingrosso (escluso quello di autoveicoli e d...,0,0,63,0,63,2021
CAM,AV,G 47,Commercio al dettaglio (escluso quello di autoveicoli e d...,0,0,183,0,183,2021
CAM,AV,H   ,Trasporto e magazzinaggio                                   ,0,0,22,0,22,2021
CAM,AV,H 49,Trasporto terrestre e mediante condotte                     ,0,0,20,0,20,2021
CAM,AV,H 50,Trasporto marittimo e per vie d'acqua                       ,0,0,0,0,0,2021
CAM,AV,H 51,Trasporto aereo                                             ,0,0,0,0,0,2021
CAM,AV,H 52,Magazzinaggio e attività di supporto ai trasporti           ,0,0,2,0,2,2021
CAM,AV,H 53,Servizi postali e attività di corriere                      ,0,0,0,0,0,2021
CAM,AV,I   ,Attività dei servizi alloggio e ristorazione                ,0,0,36,0,36,2021
CAM,AV,I 55,Alloggio                                                    ,0,0,1,0,1,2021
CAM,AV,I 56,Attività dei servizi di ristorazione                        ,0,0,35,0,35,2021
CAM,AV,J   ,Servizi di informazione e comunicazione                     ,0,0,13,0,13,2021
CAM,AV,J 58,Attività editoriali                                         ,0,0,2,0,2,2021
CAM,AV,J 59,"Attività di produzione cinematografica, di video e di pro...",0,0,0,0,0,2021
CAM,AV,J 60,Attività di programmazione e trasmissione                   ,0,0,0,0,0,2021
CAM,AV,J 61,Telecomunicazioni                                           ,0,0,0,0,0,2021
CAM,AV,J 62,"Produzione di software, consulenza informatica e attività...",0,0,2,0,2,2021
CAM,AV,J 63,Attività dei servizi d'informazione e altri servizi infor...,0,0,9,0,9,2021
CAM,AV,K   ,Attività finanziarie e assicurative                         ,0,0,3,0,3,2021
CAM,AV,K 64,Attività di servizi finanziari (escluse le assicurazioni ...,0,0,0,0,0,2021
CAM,AV,K 65,"Assicurazioni, riassicurazioni e fondi pensione (escluse ...",0,0,0,0,0,2021
CAM,AV,K 66,Attività ausiliarie dei servizi finanziari e delle attivi...,0,0,3,0,3,2021
CAM,AV,L   ,Attivita' immobiliari                                       ,0,0,1,0,1,2021
CAM,AV,L 68,Attivita' immobiliari                                       ,0,0,1,0,1,2021
CAM,AV,M   ,"Attività professionali, scientifiche e tecniche             ",0,0,9,0,9,2021
CAM,AV,M 69,Attività legali e contabilità                               ,0,0,0,0,0,2021
CAM,AV,M 70,Attività di direzione aziendale e di consulenza gestional...,0,0,0,0,0,2021
CAM,AV,M 71,Attività degli studi di architettura e d'ingegneria; coll...,0,0,1,0,1,2021
CAM,AV,M 72,Ricerca scientifica e sviluppo                              ,0,0,0,0,0,2021
CAM,AV,M 73,Pubblicità e ricerche di mercato                            ,0,0,2,0,2,2021
CAM,AV,M 74,"Altre attività professionali, scientifiche e tecniche       ",0,0,6,0,6,2021
CAM,AV,M 75,Servizi veterinari                                          ,0,0,0,0,0,2021
CAM,AV,N   ,"Noleggio, agenzie di viaggio, servizi di supporto alle im...",0,0,11,0,11,2021
CAM,AV,N 77,Attività di noleggio e leasing operativo                    ,0,0,0,0,0,2021
CAM,AV,N 78,"Attività di ricerca, selezione, fornitura di personale      ",0,0,0,0,0,2021
CAM,AV,N 79,"Attività dei servizi delle agenzie di viaggio, dei tour o...",0,0,0,0,0,2021
CAM,AV,N 80,Servizi di vigilanza e investigazione                       ,0,0,4,0,4,2021
CAM,AV,N 81,Attività di servizi per edifici e paesaggio                 ,0,0,6,0,6,2021
CAM,AV,N 82,Attività di supporto per le funzioni d'ufficio e altri se...,0,0,1,0,1,2021
CAM,AV,O   ,Amministrazione pubblica e difesa; assicurazione sociale ...,0,0,0,0,0,2021
CAM,AV,O 84,Amministrazione pubblica e difesa; assicurazione sociale ...,0,0,0,0,0,2021
CAM,AV,P   ,Istruzione                                                  ,0,0,1,0,1,2021
CAM,AV,P 85,Istruzione                                                  ,0,0,1,0,1,2021
CAM,AV,Q   ,Sanita' e assistenza sociale                                ,0,0,0,0,0,2021
CAM,AV,Q 86,Assistenza sanitaria                                        ,0,0,0,0,0,2021
CAM,AV,Q 87,Servizi di assistenza sociale residenziale                  ,0,0,0,0,0,2021
CAM,AV,Q 88,Assistenza sociale non residenziale                         ,0,0,0,0,0,2021
CAM,AV,R   ,"Attività artistiche, sportive, di intrattenimento e diver...",0,0,6,0,6,2021
CAM,AV,R 90,"Attività creative, artistiche e di intrattenimento          ",0,0,2,0,2,2021
CAM,AV,R 91,"Attività di biblioteche, archivi, musei ed altre attività...",0,0,0,0,0,2021
CAM,AV,R 92,"Attività riguardanti le lotterie, le scommesse, le case d...",0,0,0,0,0,2021
CAM,AV,R 93,"Attività sportive, di intrattenimento e di divertimento     ",0,0,4,0,4,2021
CAM,AV,S   ,Altre attività di servizi                                   ,0,0,16,0,16,2021
CAM,AV,S 94,Attività di organizzazioni associative                      ,0,0,0,0,0,2021
CAM,AV,S 95,Riparazione di computer e di beni per uso personale e per...,0,0,6,0,6,2021
CAM,AV,S 96,Altre attività di servizi per la persona                    ,0,0,10,0,10,2021
CAM,AV,T   ,Attività di famiglie e convivenze come datori di lavoro p...,0,0,0,0,0,2021
CAM,AV,T 97,Attività di famiglie e convivenze come datori di lavoro p...,0,0,0,0,0,2021
CAM,AV,T 98,Produzione di beni e servizi indifferenziati per uso prop...,0,0,0,0,0,2021
CAM,AV,U   ,Organizzazioni ed organismi extraterritoriali               ,0,0,0,0,0,2021
CAM,AV,U 99,Organizzazioni ed organismi extraterritoriali               ,0,0,0,0,0,2021
CAM,AV,XX  ,Imprese non classificate                                    ,0,0,8,0,8,2021
CAM,AV,TOT ,TOTALE                                                      ,0,0,740,0,740,2021
CAM,SA,A   ,"Agricoltura, silvicoltura pesca                             ",1,0,105,0,106,2021
CAM,SA,A 01,"Coltivazioni agricole e produzione di prodotti animali, c...",1,0,102,0,103,2021
CAM,SA,A 02,Silvicoltura ed utilizzo di aree forestali                  ,0,0,3,0,3,2021
CAM,SA,A 03,Pesca e acquacoltura                                        ,0,0,0,0,0,2021
CAM,SA,B   ,Estrazione di minerali da cave e miniere                    ,0,0,0,0,0,2021
CAM,SA,B 05,Estrazione di carbone (esclusa torba)                       ,0,0,0,0,0,2021
CAM,SA,B 06,Estraz.di petrolio greggio e di gas naturale                ,0,0,0,0,0,2021
CAM,SA,B 07,Estrazione di minerali metalliferi                          ,0,0,0,0,0,2021
CAM,SA,B 08,Altre attività di estrazione di minerali da cave e miniere  ,0,0,0,0,0,2021
CAM,SA,B 09,Attività dei servizi di supporto all'estrazione             ,0,0,0,0,0,2021
CAM,SA,C   ,Attività manifatturiere                                     ,2,0,35,0,37,2021
CAM,SA,C 10,Industrie alimentari                                        ,0,0,0,0,0,2021
CAM,SA,C 11,Industria delle bevande                                     ,0,0,0,0,0,2021
CAM,SA,C 12,Industria del tabacco                                       ,0,0,0,0,0,2021
CAM,SA,C 13,Industrie tessili                                           ,0,0,3,0,3,2021
CAM,SA,C 14,Confezione di articoli di abbigliamento; confezione di ar...,0,0,13,0,13,2021
CAM,SA,C 15,Fabbricazione di articoli in pelle e simili                 ,0,0,0,0,0,2021
CAM,SA,C 16,Industria del legno e dei prodotti in legno e sughero (es...,0,0,4,0,4,2021
CAM,SA,C 17,Fabbricazione di carta e di prodotti di carta               ,0,0,1,0,1,2021
CAM,SA,C 18,Stampa e riproduzione di supporti registrati                ,0,0,2,0,2,2021
CAM,SA,C 19,Fabbricazione di coke e prodotti derivanti dalla raffinaz...,0,0,0,0,0,2021
CAM,SA,C 20,Fabbricazione di prodotti chimici                           ,1,0,1,0,2,2021
CAM,SA,C 21,Fabbricazione di prodotti farmaceutici di base e di prepa...,0,0,0,0,0,2021
CAM,SA,C 22,Fabbricazione di articoli in gomma e materie plastiche      ,0,0,0,0,0,2021
CAM,SA,C 23,Fabbricazione di altri prodotti della lavorazione di miner..,0,0,3,0,3,2021
CAM,SA,C 24,Metallurgia                                                 ,0,0,3,0,3,2021
CAM,SA,C 25,Fabbricazione di prodotti in metallo (esclusi macchinari ...,0,0,4,0,4,2021
CAM,SA,C 26,Fabbricazione di computer e prodotti di elettronica e ott...,1,0,1,0,2,2021
CAM,SA,C 27,Fabbricazione di apparecchiature elettriche ed apparecchi...,0,0,0,0,0,2021
CAM,SA,C 28,Fabbricazione di macchinari ed apparecchiature nca          ,0,0,0,0,0,2021
CAM,SA,C 29,"Fabbricazione di autoveicoli, rimorchi e semirimorchi       ",0,0,0,0,0,2021
CAM,SA,C 30,Fabbricazione di altri mezzi di trasporto                   ,0,0,0,0,0,2021
CAM,SA,C 31,Fabbricazione di mobili                                     ,0,0,0,0,0,2021
CAM,SA,C 32,Altre industrie manifatturiere                              ,0,0,0,0,0,2021
CAM,SA,C 33,"Riparazione, manutenzione ed installazione di macchine ed...",0,0,0,0,0,2021
CAM,SA,D   ,"Fornitura di energia elettrica, gas, vapore e aria condiz...",0,0,0,0,0,2021
CAM,SA,D 35,"Fornitura di energia elettrica, gas, vapore e aria condiz...",0,0,0,0,0,2021
CAM,SA,E   ,"Fornitura di acqua; reti fognarie, attività di gestione d...",0,0,0,0,0,2021
CAM,SA,E 36,"Raccolta, trattamento e fornitura di acqua                  ",0,0,0,0,0,2021
CAM,SA,E 37,Gestione delle reti fognarie                                ,0,0,0,0,0,2021
CAM,SA,E 38,"Attività di raccolta, trattamento e smaltimento dei rifiu...",0,0,0,0,0,2021
CAM,SA,E 39,Attività di risanamento e altri servizi di gestione dei r...,0,0,0,0,0,2021
CAM,SA,F   ,Costruzioni                                                 ,1,0,57,0,58,2021
CAM,SA,F 41,Costruzione di edifici                                      ,1,0,33,0,34,2021
CAM,SA,F 42,Ingegneria civile                                           ,0,0,0,0,0,2021
CAM,SA,F 43,Lavori di costruzione specializzati                         ,0,0,24,0,24,2021
CAM,SA,G   ,Commercio all'ingrosso e al dettaglio; riparazione di aut...,1,0,585,0,586,2021
CAM,SA,G 45,Commercio all'ingrosso e al dettaglio e riparazione di au...,0,0,15,0,15,2021
CAM,SA,G 46,Commercio all'ingrosso (escluso quello di autoveicoli e d...,0,0,151,0,151,2021
CAM,SA,G 47,Commercio al dettaglio (escluso quello di autoveicoli e d...,1,0,419,0,420,2021
CAM,SA,H   ,Trasporto e magazzinaggio                                   ,0,0,8,0,8,2021
CAM,SA,H 49,Trasporto terrestre e mediante condotte                     ,0,0,4,0,4,2021
CAM,SA,H 50,Trasporto marittimo e per vie d'acqua                       ,0,0,0,0,0,2021
CAM,SA,H 51,Trasporto aereo                                             ,0,0,0,0,0,2021
CAM,SA,H 52,Magazzinaggio e attività di supporto ai trasporti           ,0,0,3,0,3,2021
CAM,SA,H 53,Servizi postali e attività di corriere                      ,0,0,1,0,1,2021
CAM,SA,I   ,Attività dei servizi alloggio e ristorazione                ,0,1,25,0,26,2021
CAM,SA,I 55,Alloggio                                                    ,0,0,0,0,0,2021
CAM,SA,I 56,Attività dei servizi di ristorazione                        ,0,1,25,0,26,2021
CAM,SA,J   ,Servizi di informazione e comunicazione                     ,0,0,22,0,22,2021
CAM,SA,J 58,Attività editoriali                                         ,0,0,2,0,2,2021
CAM,SA,J 59,"Attività di produzione cinematografica, di video e di pro...",0,0,1,0,1,2021
CAM,SA,J 60,Attività di programmazione e trasmissione                   ,0,0,0,0,0,2021
CAM,SA,J 61,Telecomunicazioni                                           ,0,0,3,0,3,2021
CAM,SA,J 62,"Produzione di software, consulenza informatica e attività...",0,0,1,0,1,2021
CAM,SA,J 63,Attività dei servizi d'informazione e altri servizi infor...,0,0,15,0,15,2021
CAM,SA,K   ,Attività finanziarie e assicurative                         ,0,0,12,0,12,2021
CAM,SA,K 64,Attività di servizi finanziari (escluse le assicurazioni ...,0,0,0,0,0,2021
CAM,SA,K 65,"Assicurazioni, riassicurazioni e fondi pensione (escluse ...",0,0,0,0,0,2021
CAM,SA,K 66,Attività ausiliarie dei servizi finanziari e delle attivi...,0,0,12,0,12,2021
CAM,SA,L   ,Attivita' immobiliari                                       ,0,0,6,0,6,2021
CAM,SA,L 68,Attivita' immobiliari                                       ,0,0,6,0,6,2021
CAM,SA,M   ,"Attività professionali, scientifiche e tecniche             ",0,0,9,0,9,2021
CAM,SA,M 69,Attività legali e contabilità                               ,0,0,0,0,0,2021
CAM,SA,M 70,Attività di direzione aziendale e di consulenza gestional...,0,0,0,0,0,2021
CAM,SA,M 71,Attività degli studi di architettura e d'ingegneria; coll...,0,0,0,0,0,2021
CAM,SA,M 72,Ricerca scientifica e sviluppo                              ,0,0,0,0,0,2021
CAM,SA,M 73,Pubblicità e ricerche di mercato                            ,0,0,5,0,5,2021
CAM,SA,M 74,"Altre attività professionali, scientifiche e tecniche       ",0,0,4,0,4,2021
CAM,SA,M 75,Servizi veterinari                                          ,0,0,0,0,0,2021
CAM,SA,N   ,"Noleggio, agenzie di viaggio, servizi di supporto alle im...",1,0,27,0,28,2021
CAM,SA,N 77,Attività di noleggio e leasing operativo                    ,0,0,10,0,10,2021
CAM,SA,N 78,"Attività di ricerca, selezione, fornitura di personale      ",0,0,0,0,0,2021
CAM,SA,N 79,"Attività dei servizi delle agenzie di viaggio, dei tour o...",1,0,1,0,2,2021
CAM,SA,N 80,Servizi di vigilanza e investigazione                       ,0,0,1,0,1,2021
CAM,SA,N 81,Attività di servizi per edifici e paesaggio                 ,0,0,9,0,9,2021
CAM,SA,N 82,Attività di supporto per le funzioni d'ufficio e altri se...,0,0,6,0,6,2021
CAM,SA,O   ,Amministrazione pubblica e difesa; assicurazione sociale ...,0,0,0,0,0,2021
CAM,SA,O 84,Amministrazione pubblica e difesa; assicurazione sociale ...,0,0,0,0,0,2021
CAM,SA,P   ,Istruzione                                                  ,0,0,1,0,1,2021
CAM,SA,P 85,Istruzione                                                  ,0,0,1,0,1,2021
CAM,SA,Q   ,Sanita' e assistenza sociale                                ,0,0,0,0,0,2021
CAM,SA,Q 86,Assistenza sanitaria                                        ,0,0,0,0,0,2021
CAM,SA,Q 87,Servizi di assistenza sociale residenziale                  ,0,0,0,0,0,2021
CAM,SA,Q 88,Assistenza sociale non residenziale                         ,0,0,0,0,0,2021
CAM,SA,R   ,"Attività artistiche, sportive, di intrattenimento e diver...",0,0,13,0,13,2021
CAM,SA,R 90,"Attività creative, artistiche e di intrattenimento          ",0,0,2,0,2,2021
CAM,SA,R 91,"Attività di biblioteche, archivi, musei ed altre attività...",0,0,0,0,0,2021
CAM,SA,R 92,"Attività riguardanti le lotterie, le scommesse, le case d...",0,0,0,0,0,2021
CAM,SA,R 93,"Attività sportive, di intrattenimento e di divertimento     ",0,0,11,0,11,2021
CAM,SA,S   ,Altre attività di servizi                                   ,0,0,4,0,4,2021
CAM,SA,S 94,Attività di organizzazioni associative                      ,0,0,0,0,0,2021
CAM,SA,S 95,Riparazione di computer e di beni per uso personale e per...,0,0,1,0,1,2021
CAM,SA,S 96,Altre attività di servizi per la persona                    ,0,0,3,0,3,2021
CAM,SA,T   ,Attività di famiglie e convivenze come datori di lavoro p...,0,0,0,0,0,2021
CAM,SA,T 97,Attività di famiglie e convivenze come datori di lavoro p...,0,0,0,0,0,2021
CAM,SA,T 98,Produzione di beni e servizi indifferenziati per uso prop...,0,0,0,0,0,2021
CAM,SA,U   ,Organizzazioni ed organismi extraterritoriali               ,0,0,0,0,0,2021
CAM,SA,U 99,Organizzazioni ed organismi extraterritoriali               ,0,0,0,0,0,2021
CAM,SA,XX  ,Imprese non classificate                                    ,0,0,0,0,0,2021
CAM,SA,TOT ,TOTALE                                                      ,6,1,909,0,916,2021
PUG,  ,A   ,"Agricoltura, silvicoltura pesca                             ",2,0,468,0,470,2021
PUG,  ,A 01,"Coltivazioni agricole e produzione di prodotti animali, c...",2,0,460,0,462,2021
PUG,  ,A 02,Silvicoltura ed utilizzo di aree forestali                  ,0,0,2,0,2,2021
PUG,  ,A 03,Pesca e acquacoltura                                        ,0,0,6,0,6,2021
PUG,  ,B   ,Estrazione di minerali da cave e miniere                    ,0,0,2,0,2,2021
PUG,  ,B 05,Estrazione di carbone (esclusa torba)                       ,0,0,0,0,0,2021
PUG,  ,B 06,Estraz.di petrolio greggio e di gas naturale                ,0,0,0,0,0,2021
PUG,  ,B 07,Estrazione di minerali metalliferi                          ,0,0,0,0,0,2021
PUG,  ,B 08,Altre attività di estrazione di minerali da cave e miniere  ,0,0,2,0,2,2021
PUG,  ,B 09,Attività dei servizi di supporto all'estrazione             ,0,0,0,0,0,2021
PUG,  ,C   ,Attività manifatturiere                                     ,66,7,187,0,260,2021
PUG,  ,C 10,Industrie alimentari                                        ,3,2,35,0,40,2021
PUG,  ,C 11,Industria delle bevande                                     ,0,0,5,0,5,2021
PUG,  ,C 12,Industria del tabacco                                       ,0,0,0,0,0,2021
PUG,  ,C 13,Industrie tessili                                           ,2,0,3,0,5,2021
PUG,  ,C 14,Confezione di articoli di abbigliamento; confezione di ar...,7,3,29,0,39,2021
PUG,  ,C 15,Fabbricazione di articoli in pelle e simili                 ,9,0,7,0,16,2021
PUG,  ,C 16,Industria del legno e dei prodotti in legno e sughero (es...,3,1,17,0,21,2021
PUG,  ,C 17,Fabbricazione di carta e di prodotti di carta               ,1,0,3,0,4,2021
PUG,  ,C 18,Stampa e riproduzione di supporti registrati                ,6,0,8,0,14,2021
PUG,  ,C 19,Fabbricazione di coke e prodotti derivanti dalla raffinaz...,0,0,0,0,0,2021
PUG,  ,C 20,Fabbricazione di prodotti chimici                           ,0,0,0,0,0,2021
PUG,  ,C 21,Fabbricazione di prodotti farmaceutici di base e di prepa...,0,0,0,0,0,2021
PUG,  ,C 22,Fabbricazione di articoli in gomma e materie plastiche      ,2,0,1,0,3,2021
PUG,  ,C 23,Fabbricazione di altri prodotti della lavorazione di miner..,6,0,14,0,20,2021
PUG,  ,C 24,Metallurgia                                                 ,0,0,1,0,1,2021
PUG,  ,C 25,Fabbricazione di prodotti in metallo (esclusi macchinari ...,10,0,25,0,35,2021
PUG,  ,C 26,Fabbricazione di computer e prodotti di elettronica e ott...,0,0,5,0,5,2021
PUG,  ,C 27,Fabbricazione di apparecchiature elettriche ed apparecchi...,2,0,3,0,5,2021
PUG,  ,C 28,Fabbricazione di macchinari ed apparecchiature nca          ,1,0,5,0,6,2021
PUG,  ,C 29,"Fabbricazione di autoveicoli, rimorchi e semirimorchi       ",0,0,3,0,3,2021
PUG,  ,C 30,Fabbricazione di altri mezzi di trasporto                   ,1,0,0,0,1,2021
PUG,  ,C 31,Fabbricazione di mobili                                     ,8,0,8,0,16,2021
PUG,  ,C 32,Altre industrie manifatturiere                              ,2,1,9,0,12,2021
PUG,  ,C 33,"Riparazione, manutenzione ed installazione di macchine ed...",3,0,6,0,9,2021
PUG,  ,D   ,"Fornitura di energia elettrica, gas, vapore e aria condiz...",1,0,0,0,1,2021
PUG,  ,D 35,"Fornitura di energia elettrica, gas, vapore e aria condiz...",1,0,0,0,1,2021
PUG,  ,E   ,"Fornitura di acqua; reti fognarie, attività di gestione d...",2,0,3,1,6,2021
PUG,  ,E 36,"Raccolta, trattamento e fornitura di acqua                  ",0,0,0,0,0,2021
PUG,  ,E 37,Gestione delle reti fognarie                                ,0,0,0,0,0,2021
PUG,  ,E 38,"Attività di raccolta, trattamento e smaltimento dei rifiu...",2,0,2,1,5,2021
PUG,  ,E 39,Attività di risanamento e altri servizi di gestione dei r...,0,0,1,0,1,2021
PUG,  ,F   ,Costruzioni                                                 ,99,11,393,3,506,2021
PUG,  ,F 41,Costruzione di edifici                                      ,52,3,152,0,207,2021
PUG,  ,F 42,Ingegneria civile                                           ,5,0,6,1,12,2021
PUG,  ,F 43,Lavori di costruzione specializzati                         ,42,8,235,2,287,2021
PUG,  ,G   ,Commercio all'ingrosso e al dettaglio; riparazione di aut...,174,27,1029,0,1230,2021
PUG,  ,G 45,Commercio all'ingrosso e al dettaglio e riparazione di au...,21,5,129,0,155,2021
PUG,  ,G 46,Commercio all'ingrosso (escluso quello di autoveicoli e d...,67,7,197,0,271,2021
PUG,  ,G 47,Commercio al dettaglio (escluso quello di autoveicoli e d...,86,15,703,0,804,2021
PUG,  ,H   ,Trasporto e magazzinaggio                                   ,25,3,63,0,91,2021
PUG,  ,H 49,Trasporto terrestre e mediante condotte                     ,12,1,49,0,62,2021
PUG,  ,H 50,Trasporto marittimo e per vie d'acqua                       ,0,1,0,0,1,2021
PUG,  ,H 51,Trasporto aereo                                             ,0,0,0,0,0,2021
PUG,  ,H 52,Magazzinaggio e attività di supporto ai trasporti           ,9,0,9,0,18,2021
PUG,  ,H 53,Servizi postali e attività di corriere                      ,4,1,5,0,10,2021
PUG,  ,I   ,Attività dei servizi alloggio e ristorazione                ,56,17,211,0,284,2021
PUG,  ,I 55,Alloggio                                                    ,3,1,8,0,12,2021
PUG,  ,I 56,Attività dei servizi di ristorazione                        ,53,16,203,0,272,2021
PUG,  ,J   ,Servizi di informazione e comunicazione                     ,22,0,30,1,53,2021
PUG,  ,J 58,Attività editoriali                                         ,3,0,3,0,6,2021
PUG,  ,J 59,"Attività di produzione cinematografica, di video e di pro...",0,0,1,0,1,2021
PUG,  ,J 60,Attività di programmazione e trasmissione                   ,2,0,0,0,2,2021
PUG,  ,J 61,Telecomunicazioni                                           ,3,0,9,0,12,2021
PUG,  ,J 62,"Produzione di software, consulenza informatica e attività...",4,0,1,1,6,2021
PUG,  ,J 63,Attività dei servizi d'informazione e altri servizi infor...,10,0,16,0,26,2021
PUG,  ,K   ,Attività finanziarie e assicurative                         ,5,1,15,0,21,2021
PUG,  ,K 64,Attività di servizi finanziari (escluse le assicurazioni ...,0,0,0,0,0,2021
PUG,  ,K 65,"Assicurazioni, riassicurazioni e fondi pensione (escluse ...",0,0,1,0,1,2021
PUG,  ,K 66,Attività ausiliarie dei servizi finanziari e delle attivi...,5,1,14,0,20,2021
PUG,  ,L   ,Attivita' immobiliari                                       ,11,2,4,0,17,2021
PUG,  ,L 68,Attivita' immobiliari                                       ,11,2,4,0,17,2021
PUG,  ,M   ,"Attività professionali, scientifiche e tecniche             ",37,3,45,0,85,2021
PUG,  ,M 69,Attività legali e contabilità                               ,0,0,0,0,0,2021
PUG,  ,M 70,Attività di direzione aziendale e di consulenza gestional...,12,0,5,0,17,2021
PUG,  ,M 71,Attività degli studi di architettura e d'ingegneria; coll...,5,0,3,0,8,2021
PUG,  ,M 72,Ricerca scientifica e sviluppo                              ,0,0,0,0,0,2021
PUG,  ,M 73,Pubblicità e ricerche di mercato                            ,11,0,11,0,22,2021
PUG,  ,M 74,"Altre attività professionali, scientifiche e tecniche       ",9,3,26,0,38,2021
PUG,  ,M 75,Servizi veterinari                                          ,0,0,0,0,0,2021
PUG,  ,N   ,"Noleggio, agenzie di viaggio, servizi di supporto alle im...",21,6,63,0,90,2021
PUG,  ,N 77,Attività di noleggio e leasing operativo                    ,4,3,7,0,14,2021
PUG,  ,N 78,"Attività di ricerca, selezione, fornitura di personale      ",0,0,0,0,0,2021
PUG,  ,N 79,"Attività dei servizi delle agenzie di viaggio, dei tour o...",2,0,2,0,4,2021
PUG,  ,N 80,Servizi di vigilanza e investigazione                       ,1,0,1,0,2,2021
PUG,  ,N 81,Attività di servizi per edifici e paesaggio                 ,4,1,24,0,29,2021
PUG,  ,N 82,Attività di supporto per le funzioni d'ufficio e altri se...,10,2,29,0,41,2021
PUG,  ,O   ,Amministrazione pubblica e difesa; assicurazione sociale ...,0,0,0,0,0,2021
PUG,  ,O 84,Amministrazione pubblica e difesa; assicurazione sociale ...,0,0,0,0,0,2021
PUG,  ,P   ,Istruzione                                                  ,4,0,2,0,6,2021
PUG,  ,P 85,Istruzione                                                  ,4,0,2,0,6,2021
PUG,  ,Q   ,Sanita' e assistenza sociale                                ,0,0,1,0,1,2021
PUG,  ,Q 86,Assistenza sanitaria                                        ,0,0,0,0,0,2021
PUG,  ,Q 87,Servizi di assistenza sociale residenziale                  ,0,0,0,0,0,2021
PUG,  ,Q 88,Assistenza sociale non residenziale                         ,0,0,1,0,1,2021
PUG,  ,R   ,"Attività artistiche, sportive, di intrattenimento e diver...",14,2,23,1,40,2021
PUG,  ,R 90,"Attività creative, artistiche e di intrattenimento          ",2,1,2,1,6,2021
PUG,  ,R 91,"Attività di biblioteche, archivi, musei ed altre attività...",0,0,0,0,0,2021
PUG,  ,R 92,"Attività riguardanti le lotterie, le scommesse, le case d...",3,1,3,0,7,2021
PUG,  ,R 93,"Attività sportive, di intrattenimento e di divertimento     ",9,0,18,0,27,2021
PUG,  ,S   ,Altre attività di servizi                                   ,6,3,58,0,67,2021
PUG,  ,S 94,Attività di organizzazioni associative                      ,0,0,0,0,0,2021
PUG,  ,S 95,Riparazione di computer e di beni per uso personale e per...,2,0,25,0,27,2021
PUG,  ,S 96,Altre attività di servizi per la persona                    ,4,3,33,0,40,2021
PUG,  ,T   ,Attività di famiglie e convivenze come datori di lavoro p...,0,0,0,0,0,2021
PUG,  ,T 97,Attività di famiglie e convivenze come datori di lavoro p...,0,0,0,0,0,2021
PUG,  ,T 98,Produzione di beni e servizi indifferenziati per uso prop...,0,0,0,0,0,2021
PUG,  ,U   ,Organizzazioni ed organismi extraterritoriali               ,0,0,0,0,0,2021
PUG,  ,U 99,Organizzazioni ed organismi extraterritoriali               ,0,0,0,0,0,2021
PUG,  ,XX  ,Imprese non classificate                                    ,274,25,86,9,394,2021
PUG,  ,TOT ,TOTALE                                                      ,819,107,2683,15,3624,2021
PUG,FG,A   ,"Agricoltura, silvicoltura pesca                             ",0,0,329,0,329,2021
PUG,FG,A 01,"Coltivazioni agricole e produzione di prodotti animali, c...",0,0,323,0,323,2021
PUG,FG,A 02,Silvicoltura ed utilizzo di aree forestali                  ,0,0,2,0,2,2021
PUG,FG,A 03,Pesca e acquacoltura                                        ,0,0,4,0,4,2021
PUG,FG,B   ,Estrazione di minerali da cave e miniere                    ,0,0,2,0,2,2021
PUG,FG,B 05,Estrazione di carbone (esclusa torba)                       ,0,0,0,0,0,2021
PUG,FG,B 06,Estraz.di petrolio greggio e di gas naturale                ,0,0,0,0,0,2021
PUG,FG,B 07,Estrazione di minerali metalliferi                          ,0,0,0,0,0,2021
PUG,FG,B 08,Altre attività di estrazione di minerali da cave e miniere  ,0,0,2,0,2,2021
PUG,FG,B 09,Attività dei servizi di supporto all'estrazione             ,0,0,0,0,0,2021
PUG,FG,C   ,Attività manifatturiere                                     ,0,0,83,0,83,2021
PUG,FG,C 10,Industrie alimentari                                        ,0,0,19,0,19,2021
PUG,FG,C 11,Industria delle bevande                                     ,0,0,3,0,3,2021
PUG,FG,C 12,Industria del tabacco                                       ,0,0,0,0,0,2021
PUG,FG,C 13,Industrie tessili                                           ,0,0,1,0,1,2021
PUG,FG,C 14,Confezione di articoli di abbigliamento; confezione di ar...,0,0,9,0,9,2021
PUG,FG,C 15,Fabbricazione di articoli in pelle e simili                 ,0,0,1,0,1,2021
PUG,FG,C 16,Industria del legno e dei prodotti in legno e sughero (es...,0,0,2,0,2,2021
PUG,FG,C 17,Fabbricazione di carta e di prodotti di carta               ,0,0,1,0,1,2021
PUG,FG,C 18,Stampa e riproduzione di supporti registrati                ,0,0,2,0,2,2021
PUG,FG,C 19,Fabbricazione di coke e prodotti derivanti dalla raffinaz...,0,0,0,0,0,2021
PUG,FG,C 20,Fabbricazione di prodotti chimici                           ,0,0,0,0,0,2021
PUG,FG,C 21,Fabbricazione di prodotti farmaceutici di base e di prepa...,0,0,0,0,0,2021
PUG,FG,C 22,Fabbricazione di articoli in gomma e materie plastiche      ,0,0,1,0,1,2021
PUG,FG,C 23,Fabbricazione di altri prodotti della lavorazione di miner..,0,0,8,0,8,2021
PUG,FG,C 24,Metallurgia                                                 ,0,0,1,0,1,2021
PUG,FG,C 25,Fabbricazione di prodotti in metallo (esclusi macchinari ...,0,0,16,0,16,2021
PUG,FG,C 26,Fabbricazione di computer e prodotti di elettronica e ott...,0,0,3,0,3,2021
PUG,FG,C 27,Fabbricazione di apparecchiature elettriche ed apparecchi...,0,0,1,0,1,2021
PUG,FG,C 28,Fabbricazione di macchinari ed apparecchiature nca          ,0,0,3,0,3,2021
PUG,FG,C 29,"Fabbricazione di autoveicoli, rimorchi e semirimorchi       ",0,0,2,0,2,2021
PUG,FG,C 30,Fabbricazione di altri mezzi di trasporto                   ,0,0,0,0,0,2021
PUG,FG,C 31,Fabbricazione di mobili                                     ,0,0,2,0,2,2021
PUG,FG,C 32,Altre industrie manifatturiere                              ,0,0,6,0,6,2021
PUG,FG,C 33,"Riparazione, manutenzione ed installazione di macchine ed...",0,0,2,0,2,2021
PUG,FG,D   ,"Fornitura di energia elettrica, gas, vapore e aria condiz...",0,0,0,0,0,2021
PUG,FG,D 35,"Fornitura di energia elettrica, gas, vapore e aria condiz...",0,0,0,0,0,2021
PUG,FG,E   ,"Fornitura di acqua; reti fognarie, attività di gestione d...",0,0,2,0,2,2021
PUG,FG,E 36,"Raccolta, trattamento e fornitura di acqua                  ",0,0,0,0,0,2021
PUG,FG,E 37,Gestione delle reti fognarie                                ,0,0,0,0,0,2021
PUG,FG,E 38,"Attività di raccolta, trattamento e smaltimento dei rifiu...",0,0,1,0,1,2021
PUG,FG,E 39,Attività di risanamento e altri servizi di gestione dei r...,0,0,1,0,1,2021
PUG,FG,F   ,Costruzioni                                                 ,2,2,243,0,247,2021
PUG,FG,F 41,Costruzione di edifici                                      ,2,1,106,0,109,2021
PUG,FG,F 42,Ingegneria civile                                           ,0,0,5,0,5,2021
PUG,FG,F 43,Lavori di costruzione specializzati                         ,0,1,132,0,133,2021
PUG,FG,G   ,Commercio all'ingrosso e al dettaglio; riparazione di aut...,0,0,643,0,643,2021
PUG,FG,G 45,Commercio all'ingrosso e al dettaglio e riparazione di au...,0,0,105,0,105,2021
PUG,FG,G 46,Commercio all'ingrosso (escluso quello di autoveicoli e d...,0,0,99,0,99,2021
PUG,FG,G 47,Commercio al dettaglio (escluso quello di autoveicoli e d...,0,0,439,0,439,2021
PUG,FG,H   ,Trasporto e magazzinaggio                                   ,0,0,38,0,38,2021
PUG,FG,H 49,Trasporto terrestre e mediante condotte                     ,0,0,30,0,30,2021
PUG,FG,H 50,Trasporto marittimo e per vie d'acqua                       ,0,0,0,0,0,2021
PUG,FG,H 51,Trasporto aereo                                             ,0,0,0,0,0,2021
PUG,FG,H 52,Magazzinaggio e attività di supporto ai trasporti           ,0,0,4,0,4,2021
PUG,FG,H 53,Servizi postali e attività di corriere                      ,0,0,4,0,4,2021
PUG,FG,I   ,Attività dei servizi alloggio e ristorazione                ,0,1,128,0,129,2021
PUG,FG,I 55,Alloggio                                                    ,0,0,7,0,7,2021
PUG,FG,I 56,Attività dei servizi di ristorazione                        ,0,1,121,0,122,2021
PUG,FG,J   ,Servizi di informazione e comunicazione                     ,0,0,15,0,15,2021
PUG,FG,J 58,Attività editoriali                                         ,0,0,2,0,2,2021
PUG,FG,J 59,"Attività di produzione cinematografica, di video e di pro...",0,0,0,0,0,2021
PUG,FG,J 60,Attività di programmazione e trasmissione                   ,0,0,0,0,0,2021
PUG,FG,J 61,Telecomunicazioni                                           ,0,0,5,0,5,2021
PUG,FG,J 62,"Produzione di software, consulenza informatica e attività...",0,0,1,0,1,2021
PUG,FG,J 63,Attività dei servizi d'informazione e altri servizi infor...,0,0,7,0,7,2021
PUG,FG,K   ,Attività finanziarie e assicurative                         ,0,0,9,0,9,2021
PUG,FG,K 64,Attività di servizi finanziari (escluse le assicurazioni ...,0,0,0,0,0,2021
PUG,FG,K 65,"Assicurazioni, riassicurazioni e fondi pensione (escluse ...",0,0,0,0,0,2021
PUG,FG,K 66,Attività ausiliarie dei servizi finanziari e delle attivi...,0,0,9,0,9,2021
PUG,FG,L   ,Attivita' immobiliari                                       ,0,0,1,0,1,2021
PUG,FG,L 68,Attivita' immobiliari                                       ,0,0,1,0,1,2021
PUG,FG,M   ,"Attività professionali, scientifiche e tecniche             ",0,0,18,0,18,2021
PUG,FG,M 69,Attività legali e contabilità                               ,0,0,0,0,0,2021
PUG,FG,M 70,Attività di direzione aziendale e di consulenza gestional...,0,0,3,0,3,2021
PUG,FG,M 71,Attività degli studi di architettura e d'ingegneria; coll...,0,0,2,0,2,2021
PUG,FG,M 72,Ricerca scientifica e sviluppo                              ,0,0,0,0,0,2021
PUG,FG,M 73,Pubblicità e ricerche di mercato                            ,0,0,4,0,4,2021
PUG,FG,M 74,"Altre attività professionali, scientifiche e tecniche       ",0,0,9,0,9,2021
PUG,FG,M 75,Servizi veterinari                                          ,0,0,0,0,0,2021
PUG,FG,N   ,"Noleggio, agenzie di viaggio, servizi di supporto alle im...",0,0,43,0,43,2021
PUG,FG,N 77,Attività di noleggio e leasing operativo                    ,0,0,5,0,5,2021
PUG,FG,N 78,"Attività di ricerca, selezione, fornitura di personale      ",0,0,0,0,0,2021
PUG,FG,N 79,"Attività dei servizi delle agenzie di viaggio, dei tour o...",0,0,2,0,2,2021
PUG,FG,N 80,Servizi di vigilanza e investigazione                       ,0,0,1,0,1,2021
PUG,FG,N 81,Attività di servizi per edifici e paesaggio                 ,0,0,18,0,18,2021
PUG,FG,N 82,Attività di supporto per le funzioni d'ufficio e altri se...,0,0,17,0,17,2021
PUG,FG,O   ,Amministrazione pubblica e difesa; assicurazione sociale ...,0,0,0,0,0,2021
PUG,FG,O 84,Amministrazione pubblica e difesa; assicurazione sociale ...,0,0,0,0,0,2021
PUG,FG,P   ,Istruzione                                                  ,0,0,1,0,1,2021
PUG,FG,P 85,Istruzione                                                  ,0,0,1,0,1,2021
PUG,FG,Q   ,Sanita' e assistenza sociale                                ,0,0,0,0,0,2021
PUG,FG,Q 86,Assistenza sanitaria                                        ,0,0,0,0,0,2021
PUG,FG,Q 87,Servizi di assistenza sociale residenziale                  ,0,0,0,0,0,2021
PUG,FG,Q 88,Assistenza sociale non residenziale                         ,0,0,0,0,0,2021
PUG,FG,R   ,"Attività artistiche, sportive, di intrattenimento e diver...",0,0,15,0,15,2021
PUG,FG,R 90,"Attività creative, artistiche e di intrattenimento          ",0,0,1,0,1,2021
PUG,FG,R 91,"Attività di biblioteche, archivi, musei ed altre attività...",0,0,0,0,0,2021
PUG,FG,R 92,"Attività riguardanti le lotterie, le scommesse, le case d...",0,0,2,0,2,2021
PUG,FG,R 93,"Attività sportive, di intrattenimento e di divertimento     ",0,0,12,0,12,2021
PUG,FG,S   ,Altre attività di servizi                                   ,0,0,29,0,29,2021
PUG,FG,S 94,Attività di organizzazioni associative                      ,0,0,0,0,0,2021
PUG,FG,S 95,Riparazione di computer e di beni per uso personale e per...,0,0,11,0,11,2021
PUG,FG,S 96,Altre attività di servizi per la persona                    ,0,0,18,0,18,2021
PUG,FG,T   ,Attività di famiglie e convivenze come datori di lavoro p...,0,0,0,0,0,2021
PUG,FG,T 97,Attività di famiglie e convivenze come datori di lavoro p...,0,0,0,0,0,2021
PUG,FG,T 98,Produzione di beni e servizi indifferenziati per uso prop...,0,0,0,0,0,2021
PUG,FG,U   ,Organizzazioni ed organismi extraterritoriali               ,0,0,0,0,0,2021
PUG,FG,U 99,Organizzazioni ed organismi extraterritoriali               ,0,0,0,0,0,2021
PUG,FG,XX  ,Imprese non classificate                                    ,2,1,61,0,64,2021
PUG,FG,TOT ,TOTALE                                                      ,4,4,1660,0,1668,2021
PUG,BA,A   ,"Agricoltura, silvicoltura pesca                             ",2,0,83,0,85,2021
PUG,BA,A 01,"Coltivazioni agricole e produzione di prodotti animali, c...",2,0,82,0,84,2021
PUG,BA,A 02,Silvicoltura ed utilizzo di aree forestali                  ,0,0,0,0,0,2021
PUG,BA,A 03,Pesca e acquacoltura                                        ,0,0,1,0,1,2021
PUG,BA,B   ,Estrazione di minerali da cave e miniere                    ,0,0,0,0,0,2021
PUG,BA,B 05,Estrazione di carbone (esclusa torba)                       ,0,0,0,0,0,2021
PUG,BA,B 06,Estraz.di petrolio greggio e di gas naturale                ,0,0,0,0,0,2021
PUG,BA,B 07,Estrazione di minerali metalliferi                          ,0,0,0,0,0,2021
PUG,BA,B 08,Altre attività di estrazione di minerali da cave e miniere  ,0,0,0,0,0,2021
PUG,BA,B 09,Attività dei servizi di supporto all'estrazione             ,0,0,0,0,0,2021
PUG,BA,C   ,Attività manifatturiere                                     ,46,0,46,0,92,2021
PUG,BA,C 10,Industrie alimentari                                        ,3,0,12,0,15,2021
PUG,BA,C 11,Industria delle bevande                                     ,0,0,0,0,0,2021
PUG,BA,C 12,Industria del tabacco                                       ,0,0,0,0,0,2021
PUG,BA,C 13,Industrie tessili                                           ,2,0,1,0,3,2021
PUG,BA,C 14,Confezione di articoli di abbigliamento; confezione di ar...,5,0,4,0,9,2021
PUG,BA,C 15,Fabbricazione di articoli in pelle e simili                 ,3,0,4,0,7,2021
PUG,BA,C 16,Industria del legno e dei prodotti in legno e sughero (es...,3,0,2,0,5,2021
PUG,BA,C 17,Fabbricazione di carta e di prodotti di carta               ,0,0,0,0,0,2021
PUG,BA,C 18,Stampa e riproduzione di supporti registrati                ,6,0,5,0,11,2021
PUG,BA,C 19,Fabbricazione di coke e prodotti derivanti dalla raffinaz...,0,0,0,0,0,2021
PUG,BA,C 20,Fabbricazione di prodotti chimici                           ,0,0,0,0,0,2021
PUG,BA,C 21,Fabbricazione di prodotti farmaceutici di base e di prepa...,0,0,0,0,0,2021
PUG,BA,C 22,Fabbricazione di articoli in gomma e materie plastiche      ,1,0,0,0,1,2021
PUG,BA,C 23,Fabbricazione di altri prodotti della lavorazione di miner..,1,0,4,0,5,2021
PUG,BA,C 24,Metallurgia                                                 ,0,0,0,0,0,2021
PUG,BA,C 25,Fabbricazione di prodotti in metallo (esclusi macchinari ...,7,0,3,0,10,2021
PUG,BA,C 26,Fabbricazione di computer e prodotti di elettronica e ott...,0,0,1,0,1,2021
PUG,BA,C 27,Fabbricazione di apparecchiature elettriche ed apparecchi...,2,0,2,0,4,2021
PUG,BA,C 28,Fabbricazione di macchinari ed apparecchiature nca          ,1,0,0,0,1,2021
PUG,BA,C 29,"Fabbricazione di autoveicoli, rimorchi e semirimorchi       ",0,0,1,0,1,2021
PUG,BA,C 30,Fabbricazione di altri mezzi di trasporto                   ,0,0,0,0,0,2021
PUG,BA,C 31,Fabbricazione di mobili                                     ,7,0,2,0,9,2021
PUG,BA,C 32,Altre industrie manifatturiere                              ,2,0,2,0,4,2021
PUG,BA,C 33,"Riparazione, manutenzione ed installazione di macchine ed...",3,0,3,0,6,2021
PUG,BA,D   ,"Fornitura di energia elettrica, gas, vapore e aria condiz...",0,0,0,0,0,2021
PUG,BA,D 35,"Fornitura di energia elettrica, gas, vapore e aria condiz...",0,0,0,0,0,2021
PUG,BA,E   ,"Fornitura di acqua; reti fognarie, attività di gestione d...",1,0,1,0,2,2021
PUG,BA,E 36,"Raccolta, trattamento e fornitura di acqua                  ",0,0,0,0,0,2021
PUG,BA,E 37,Gestione delle reti fognarie                                ,0,0,0,0,0,2021
PUG,BA,E 38,"Attività di raccolta, trattamento e smaltimento dei rifiu...",1,0,1,0,2,2021
PUG,BA,E 39,Attività di risanamento e altri servizi di gestione dei r...,0,0,0,0,0,2021
PUG,BA,F   ,Costruzioni                                                 ,64,0,50,2,116,2021
PUG,BA,F 41,Costruzione di edifici                                      ,28,0,13,0,41,2021
PUG,BA,F 42,Ingegneria civile                                           ,4,0,1,1,6,2021
PUG,BA,F 43,Lavori di costruzione specializzati                         ,32,0,36,1,69,2021
PUG,BA,G   ,Commercio all'ingrosso e al dettaglio; riparazione di aut...,137,0,197,0,334,2021
PUG,BA,G 45,Commercio all'ingrosso e al dettaglio e riparazione di au...,17,0,9,0,26,2021
PUG,BA,G 46,Commercio all'ingrosso (escluso quello di autoveicoli e d...,52,0,74,0,126,2021
PUG,BA,G 47,Commercio al dettaglio (escluso quello di autoveicoli e d...,68,0,114,0,182,2021
PUG,BA,H   ,Trasporto e magazzinaggio                                   ,22,0,13,0,35,2021
PUG,BA,H 49,Trasporto terrestre e mediante condotte                     ,11,0,9,0,20,2021
PUG,BA,H 50,Trasporto marittimo e per vie d'acqua                       ,0,0,0,0,0,2021
PUG,BA,H 51,Trasporto aereo                                             ,0,0,0,0,0,2021
PUG,BA,H 52,Magazzinaggio e attività di supporto ai trasporti           ,8,0,3,0,11,2021
PUG,BA,H 53,Servizi postali e attività di corriere                      ,3,0,1,0,4,2021
PUG,BA,I   ,Attività dei servizi alloggio e ristorazione                ,37,0,49,0,86,2021
PUG,BA,I 55,Alloggio                                                    ,2,0,0,0,2,2021
PUG,BA,I 56,Attività dei servizi di ristorazione                        ,35,0,49,0,84,2021
PUG,BA,J   ,Servizi di informazione e comunicazione                     ,15,0,12,0,27,2021
PUG,BA,J 58,Attività editoriali                                         ,2,0,0,0,2,2021
PUG,BA,J 59,"Attività di produzione cinematografica, di video e di pro...",0,0,1,0,1,2021
PUG,BA,J 60,Attività di programmazione e trasmissione                   ,1,0,0,0,1,2021
PUG,BA,J 61,Telecomunicazioni                                           ,2,0,4,0,6,2021
PUG,BA,J 62,"Produzione di software, consulenza informatica e attività...",2,0,0,0,2,2021
PUG,BA,J 63,Attività dei servizi d'informazione e altri servizi infor...,8,0,7,0,15,2021
PUG,BA,K   ,Attività finanziarie e assicurative                         ,5,0,5,0,10,2021
PUG,BA,K 64,Attività di servizi finanziari (escluse le assicurazioni ...,0,0,0,0,0,2021
PUG,BA,K 65,"Assicurazioni, riassicurazioni e fondi pensione (escluse ...",0,0,1,0,1,2021
PUG,BA,K 66,Attività ausiliarie dei servizi finanziari e delle attivi...,5,0,4,0,9,2021
PUG,BA,L   ,Attivita' immobiliari                                       ,8,0,3,0,11,2021
PUG,BA,L 68,Attivita' immobiliari                                       ,8,0,3,0,11,2021
PUG,BA,M   ,"Attività professionali, scientifiche e tecniche             ",27,0,19,0,46,2021
PUG,BA,M 69,Attività legali e contabilità                               ,0,0,0,0,0,2021
PUG,BA,M 70,Attività di direzione aziendale e di consulenza gestional...,9,0,2,0,11,2021
PUG,BA,M 71,Attività degli studi di architettura e d'ingegneria; coll...,2,0,1,0,3,2021
PUG,BA,M 72,Ricerca scientifica e sviluppo                              ,0,0,0,0,0,2021
PUG,BA,M 73,Pubblicità e ricerche di mercato                            ,9,0,4,0,13,2021
PUG,BA,M 74,"Altre attività professionali, scientifiche e tecniche       ",7,0,12,0,19,2021
PUG,BA,M 75,Servizi veterinari                                          ,0,0,0,0,0,2021
PUG,BA,N   ,"Noleggio, agenzie di viaggio, servizi di supporto alle im...",17,0,12,0,29,2021
PUG,BA,N 77,Attività di noleggio e leasing operativo                    ,4,0,0,0,4,2021
PUG,BA,N 78,"Attività di ricerca, selezione, fornitura di personale      ",0,0,0,0,0,2021
PUG,BA,N 79,"Attività dei servizi delle agenzie di viaggio, dei tour o...",2,0,0,0,2,2021
PUG,BA,N 80,Servizi di vigilanza e investigazione                       ,1,0,0,0,1,2021
PUG,BA,N 81,Attività di servizi per edifici e paesaggio                 ,2,0,3,0,5,2021
PUG,BA,N 82,Attività di supporto per le funzioni d'ufficio e altri se...,8,0,9,0,17,2021
PUG,BA,O   ,Amministrazione pubblica e difesa; assicurazione sociale ...,0,0,0,0,0,2021
PUG,BA,O 84,Amministrazione pubblica e difesa; assicurazione sociale ...,0,0,0,0,0,2021
PUG,BA,P   ,Istruzione                                                  ,4,0,0,0,4,2021
PUG,BA,P 85,Istruzione                                                  ,4,0,0,0,4,2021
PUG,BA,Q   ,Sanita' e assistenza sociale                                ,0,0,0,0,0,2021
PUG,BA,Q 86,Assistenza sanitaria                                        ,0,0,0,0,0,2021
PUG,BA,Q 87,Servizi di assistenza sociale residenziale                  ,0,0,0,0,0,2021
PUG,BA,Q 88,Assistenza sociale non residenziale                         ,0,0,0,0,0,2021
PUG,BA,R   ,"Attività artistiche, sportive, di intrattenimento e diver...",10,0,2,0,12,2021
PUG,BA,R 90,"Attività creative, artistiche e di intrattenimento          ",2,0,0,0,2,2021
PUG,BA,R 91,"Attività di biblioteche, archivi, musei ed altre attività...",0,0,0,0,0,2021
PUG,BA,R 92,"Attività riguardanti le lotterie, le scommesse, le case d...",2,0,1,0,3,2021
PUG,BA,R 93,"Attività sportive, di intrattenimento e di divertimento     ",6,0,1,0,7,2021
PUG,BA,S   ,Altre attività di servizi                                   ,6,0,17,0,23,2021
PUG,BA,S 94,Attività di organizzazioni associative                      ,0,0,0,0,0,2021
PUG,BA,S 95,Riparazione di computer e di beni per uso personale e per...,2,0,7,0,9,2021
PUG,BA,S 96,Altre attività di servizi per la persona                    ,4,0,10,0,14,2021
PUG,BA,T   ,Attività di famiglie e convivenze come datori di lavoro p...,0,0,0,0,0,2021
PUG,BA,T 97,Attività di famiglie e convivenze come datori di lavoro p...,0,0,0,0,0,2021
PUG,BA,T 98,Produzione di beni e servizi indifferenziati per uso prop...,0,0,0,0,0,2021
PUG,BA,U   ,Organizzazioni ed organismi extraterritoriali               ,0,0,0,0,0,2021
PUG,BA,U 99,Organizzazioni ed organismi extraterritoriali               ,0,0,0,0,0,2021
PUG,BA,XX  ,Imprese non classificate                                    ,239,0,1,5,245,2021
PUG,BA,TOT ,TOTALE                                                      ,640,0,510,7,1157,2021
PUG,TA,A   ,"Agricoltura, silvicoltura pesca                             ",0,0,13,0,13,2021
PUG,TA,A 01,"Coltivazioni agricole e produzione di prodotti animali, c...",0,0,13,0,13,2021
PUG,TA,A 02,Silvicoltura ed utilizzo di aree forestali                  ,0,0,0,0,0,2021
PUG,TA,A 03,Pesca e acquacoltura                                        ,0,0,0,0,0,2021
PUG,TA,B   ,Estrazione di minerali da cave e miniere                    ,0,0,0,0,0,2021
PUG,TA,B 05,Estrazione di carbone (esclusa torba)                       ,0,0,0,0,0,2021
PUG,TA,B 06,Estraz.di petrolio greggio e di gas naturale                ,0,0,0,0,0,2021
PUG,TA,B 07,Estrazione di minerali metalliferi                          ,0,0,0,0,0,2021
PUG,TA,B 08,Altre attività di estrazione di minerali da cave e miniere  ,0,0,0,0,0,2021
PUG,TA,B 09,Attività dei servizi di supporto all'estrazione             ,0,0,0,0,0,2021
PUG,TA,C   ,Attività manifatturiere                                     ,0,0,1,0,1,2021
PUG,TA,C 10,Industrie alimentari                                        ,0,0,0,0,0,2021
PUG,TA,C 11,Industria delle bevande                                     ,0,0,0,0,0,2021
PUG,TA,C 12,Industria del tabacco                                       ,0,0,0,0,0,2021
PUG,TA,C 13,Industrie tessili                                           ,0,0,0,0,0,2021
PUG,TA,C 14,Confezione di articoli di abbigliamento; confezione di ar...,0,0,0,0,0,2021
PUG,TA,C 15,Fabbricazione di articoli in pelle e simili                 ,0,0,0,0,0,2021
PUG,TA,C 16,Industria del legno e dei prodotti in legno e sughero (es...,0,0,0,0,0,2021
PUG,TA,C 17,Fabbricazione di carta e di prodotti di carta               ,0,0,0,0,0,2021
PUG,TA,C 18,Stampa e riproduzione di supporti registrati                ,0,0,0,0,0,2021
PUG,TA,C 19,Fabbricazione di coke e prodotti derivanti dalla raffinaz...,0,0,0,0,0,2021
PUG,TA,C 20,Fabbricazione di prodotti chimici                           ,0,0,0,0,0,2021
PUG,TA,C 21,Fabbricazione di prodotti farmaceutici di base e di prepa...,0,0,0,0,0,2021
PUG,TA,C 22,Fabbricazione di articoli in gomma e materie plastiche      ,0,0,0,0,0,2021
PUG,TA,C 23,Fabbricazione di altri prodotti della lavorazione di miner..,0,0,0,0,0,2021
PUG,TA,C 24,Metallurgia                                                 ,0,0,0,0,0,2021
PUG,TA,C 25,Fabbricazione di prodotti in metallo (esclusi macchinari ...,0,0,0,0,0,2021
PUG,TA,C 26,Fabbricazione di computer e prodotti di elettronica e ott...,0,0,0,0,0,2021
PUG,TA,C 27,Fabbricazione di apparecchiature elettriche ed apparecchi...,0,0,0,0,0,2021
PUG,TA,C 28,Fabbricazione di macchinari ed apparecchiature nca          ,0,0,0,0,0,2021
PUG,TA,C 29,"Fabbricazione di autoveicoli, rimorchi e semirimorchi       ",0,0,0,0,0,2021
PUG,TA,C 30,Fabbricazione di altri mezzi di trasporto                   ,0,0,0,0,0,2021
PUG,TA,C 31,Fabbricazione di mobili                                     ,0,0,1,0,1,2021
PUG,TA,C 32,Altre industrie manifatturiere                              ,0,0,0,0,0,2021
PUG,TA,C 33,"Riparazione, manutenzione ed installazione di macchine ed...",0,0,0,0,0,2021
PUG,TA,D   ,"Fornitura di energia elettrica, gas, vapore e aria condiz...",0,0,0,0,0,2021
PUG,TA,D 35,"Fornitura di energia elettrica, gas, vapore e aria condiz...",0,0,0,0,0,2021
PUG,TA,E   ,"Fornitura di acqua; reti fognarie, attività di gestione d...",0,0,0,0,0,2021
PUG,TA,E 36,"Raccolta, trattamento e fornitura di acqua                  ",0,0,0,0,0,2021
PUG,TA,E 37,Gestione delle reti fognarie                                ,0,0,0,0,0,2021
PUG,TA,E 38,"Attività di raccolta, trattamento e smaltimento dei rifiu...",0,0,0,0,0,2021
PUG,TA,E 39,Attività di risanamento e altri servizi di gestione dei r...,0,0,0,0,0,2021
PUG,TA,F   ,Costruzioni                                                 ,0,0,3,0,3,2021
PUG,TA,F 41,Costruzione di edifici                                      ,0,0,1,0,1,2021
PUG,TA,F 42,Ingegneria civile                                           ,0,0,0,0,0,2021
PUG,TA,F 43,Lavori di costruzione specializzati                         ,0,0,2,0,2,2021
PUG,TA,G   ,Commercio all'ingrosso e al dettaglio; riparazione di aut...,0,0,2,0,2,2021
PUG,TA,G 45,Commercio all'ingrosso e al dettaglio e riparazione di au...,0,0,1,0,1,2021
PUG,TA,G 46,Commercio all'ingrosso (escluso quello di autoveicoli e d...,0,0,0,0,0,2021
PUG,TA,G 47,Commercio al dettaglio (escluso quello di autoveicoli e d...,0,0,1,0,1,2021
PUG,TA,H   ,Trasporto e magazzinaggio                                   ,0,0,1,0,1,2021
PUG,TA,H 49,Trasporto terrestre e mediante condotte                     ,0,0,1,0,1,2021
PUG,TA,H 50,Trasporto marittimo e per vie d'acqua                       ,0,0,0,0,0,2021
PUG,TA,H 51,Trasporto aereo                                             ,0,0,0,0,0,2021
PUG,TA,H 52,Magazzinaggio e attività di supporto ai trasporti           ,0,0,0,0,0,2021
PUG,TA,H 53,Servizi postali e attività di corriere                      ,0,0,0,0,0,2021
PUG,TA,I   ,Attività dei servizi alloggio e ristorazione                ,0,0,5,0,5,2021
PUG,TA,I 55,Alloggio                                                    ,0,0,0,0,0,2021
PUG,TA,I 56,Attività dei servizi di ristorazione                        ,0,0,5,0,5,2021
PUG,TA,J   ,Servizi di informazione e comunicazione                     ,0,0,0,0,0,2021
PUG,TA,J 58,Attività editoriali                                         ,0,0,0,0,0,2021
PUG,TA,J 59,"Attività di produzione cinematografica, di video e di pro...",0,0,0,0,0,2021
PUG,TA,J 60,Attività di programmazione e trasmissione                   ,0,0,0,0,0,2021
PUG,TA,J 61,Telecomunicazioni                                           ,0,0,0,0,0,2021
PUG,TA,J 62,"Produzione di software, consulenza informatica e attività...",0,0,0,0,0,2021
PUG,TA,J 63,Attività dei servizi d'informazione e altri servizi infor...,0,0,0,0,0,2021
PUG,TA,K   ,Attività finanziarie e assicurative                         ,0,0,0,0,0,2021
PUG,TA,K 64,Attività di servizi finanziari (escluse le assicurazioni ...,0,0,0,0,0,2021
PUG,TA,K 65,"Assicurazioni, riassicurazioni e fondi pensione (escluse ...",0,0,0,0,0,2021
PUG,TA,K 66,Attività ausiliarie dei servizi finanziari e delle attivi...,0,0,0,0,0,2021
PUG,TA,L   ,Attivita' immobiliari                                       ,0,0,0,0,0,2021
PUG,TA,L 68,Attivita' immobiliari                                       ,0,0,0,0,0,2021
PUG,TA,M   ,"Attività professionali, scientifiche e tecniche             ",0,0,0,0,0,2021
PUG,TA,M 69,Attività legali e contabilità                               ,0,0,0,0,0,2021
PUG,TA,M 70,Attività di direzione aziendale e di consulenza gestional...,0,0,0,0,0,2021
PUG,TA,M 71,Attività degli studi di architettura e d'ingegneria; coll...,0,0,0,0,0,2021
PUG,TA,M 72,Ricerca scientifica e sviluppo                              ,0,0,0,0,0,2021
PUG,TA,M 73,Pubblicità e ricerche di mercato                            ,0,0,0,0,0,2021
PUG,TA,M 74,"Altre attività professionali, scientifiche e tecniche       ",0,0,0,0,0,2021
PUG,TA,M 75,Servizi veterinari                                          ,0,0,0,0,0,2021
PUG,TA,N   ,"Noleggio, agenzie di viaggio, servizi di supporto alle im...",0,0,0,0,0,2021
PUG,TA,N 77,Attività di noleggio e leasing operativo                    ,0,0,0,0,0,2021
PUG,TA,N 78,"Attività di ricerca, selezione, fornitura di personale      ",0,0,0,0,0,2021
PUG,TA,N 79,"Attività dei servizi delle agenzie di viaggio, dei tour o...",0,0,0,0,0,2021
PUG,TA,N 80,Servizi di vigilanza e investigazione                       ,0,0,0,0,0,2021
PUG,TA,N 81,Attività di servizi per edifici e paesaggio                 ,0,0,0,0,0,2021
PUG,TA,N 82,Attività di supporto per le funzioni d'ufficio e altri se...,0,0,0,0,0,2021
PUG,TA,O   ,Amministrazione pubblica e difesa; assicurazione sociale ...,0,0,0,0,0,2021
PUG,TA,O 84,Amministrazione pubblica e difesa; assicurazione sociale ...,0,0,0,0,0,2021
PUG,TA,P   ,Istruzione                                                  ,0,0,0,0,0,2021
PUG,TA,P 85,Istruzione                                                  ,0,0,0,0,0,2021
PUG,TA,Q   ,Sanita' e assistenza sociale                                ,0,0,0,0,0,2021
PUG,TA,Q 86,Assistenza sanitaria                                        ,0,0,0,0,0,2021
PUG,TA,Q 87,Servizi di assistenza sociale residenziale                  ,0,0,0,0,0,2021
PUG,TA,Q 88,Assistenza sociale non residenziale                         ,0,0,0,0,0,2021
PUG,TA,R   ,"Attività artistiche, sportive, di intrattenimento e diver...",0,0,0,0,0,2021
PUG,TA,R 90,"Attività creative, artistiche e di intrattenimento          ",0,0,0,0,0,2021
PUG,TA,R 91,"Attività di biblioteche, archivi, musei ed altre attività...",0,0,0,0,0,2021
PUG,TA,R 92,"Attività riguardanti le lotterie, le scommesse, le case d...",0,0,0,0,0,2021
PUG,TA,R 93,"Attività sportive, di intrattenimento e di divertimento     ",0,0,0,0,0,2021
PUG,TA,S   ,Altre attività di servizi                                   ,0,0,0,0,0,2021
PUG,TA,S 94,Attività di organizzazioni associative                      ,0,0,0,0,0,2021
PUG,TA,S 95,Riparazione di computer e di beni per uso personale e per...,0,0,0,0,0,2021
PUG,TA,S 96,Altre attività di servizi per la persona                    ,0,0,0,0,0,2021
PUG,TA,T   ,Attività di famiglie e convivenze come datori di lavoro p...,0,0,0,0,0,2021
PUG,TA,T 97,Attività di famiglie e convivenze come datori di lavoro p...,0,0,0,0,0,2021
PUG,TA,T 98,Produzione di beni e servizi indifferenziati per uso prop...,0,0,0,0,0,2021
PUG,TA,U   ,Organizzazioni ed organismi extraterritoriali               ,0,0,0,0,0,2021
PUG,TA,U 99,Organizzazioni ed organismi extraterritoriali               ,0,0,0,0,0,2021
PUG,TA,XX  ,Imprese non classificate                                    ,0,0,0,0,0,2021
PUG,TA,TOT ,TOTALE                                                      ,0,0,25,0,25,2021
PUG,BR,A   ,"Agricoltura, silvicoltura pesca                             ",0,0,0,0,0,2021
PUG,BR,A 01,"Coltivazioni agricole e produzione di prodotti animali, c...",0,0,0,0,0,2021
PUG,BR,A 02,Silvicoltura ed utilizzo di aree forestali                  ,0,0,0,0,0,2021
PUG,BR,A 03,Pesca e acquacoltura                                        ,0,0,0,0,0,2021
PUG,BR,B   ,Estrazione di minerali da cave e miniere                    ,0,0,0,0,0,2021
PUG,BR,B 05,Estrazione di carbone (esclusa torba)                       ,0,0,0,0,0,2021
PUG,BR,B 06,Estraz.di petrolio greggio e di gas naturale                ,0,0,0,0,0,2021
PUG,BR,B 07,Estrazione di minerali metalliferi                          ,0,0,0,0,0,2021
PUG,BR,B 08,Altre attività di estrazione di minerali da cave e miniere  ,0,0,0,0,0,2021
PUG,BR,B 09,Attività dei servizi di supporto all'estrazione             ,0,0,0,0,0,2021
PUG,BR,C   ,Attività manifatturiere                                     ,1,0,0,0,1,2021
PUG,BR,C 10,Industrie alimentari                                        ,0,0,0,0,0,2021
PUG,BR,C 11,Industria delle bevande                                     ,0,0,0,0,0,2021
PUG,BR,C 12,Industria del tabacco                                       ,0,0,0,0,0,2021
PUG,BR,C 13,Industrie tessili                                           ,0,0,0,0,0,2021
PUG,BR,C 14,Confezione di articoli di abbigliamento; confezione di ar...,0,0,0,0,0,2021
PUG,BR,C 15,Fabbricazione di articoli in pelle e simili                 ,0,0,0,0,0,2021
PUG,BR,C 16,Industria del legno e dei prodotti in legno e sughero (es...,0,0,0,0,0,2021
PUG,BR,C 17,Fabbricazione di carta e di prodotti di carta               ,0,0,0,0,0,2021
PUG,BR,C 18,Stampa e riproduzione di supporti registrati                ,0,0,0,0,0,2021
PUG,BR,C 19,Fabbricazione di coke e prodotti derivanti dalla raffinaz...,0,0,0,0,0,2021
PUG,BR,C 20,Fabbricazione di prodotti chimici                           ,0,0,0,0,0,2021
PUG,BR,C 21,Fabbricazione di prodotti farmaceutici di base e di prepa...,0,0,0,0,0,2021
PUG,BR,C 22,Fabbricazione di articoli in gomma e materie plastiche      ,0,0,0,0,0,2021
PUG,BR,C 23,Fabbricazione di altri prodotti della lavorazione di miner..,1,0,0,0,1,2021
PUG,BR,C 24,Metallurgia                                                 ,0,0,0,0,0,2021
PUG,BR,C 25,Fabbricazione di prodotti in metallo (esclusi macchinari ...,0,0,0,0,0,2021
PUG,BR,C 26,Fabbricazione di computer e prodotti di elettronica e ott...,0,0,0,0,0,2021
PUG,BR,C 27,Fabbricazione di apparecchiature elettriche ed apparecchi...,0,0,0,0,0,2021
PUG,BR,C 28,Fabbricazione di macchinari ed apparecchiature nca          ,0,0,0,0,0,2021
PUG,BR,C 29,"Fabbricazione di autoveicoli, rimorchi e semirimorchi       ",0,0,0,0,0,2021
PUG,BR,C 30,Fabbricazione di altri mezzi di trasporto                   ,0,0,0,0,0,2021
PUG,BR,C 31,Fabbricazione di mobili                                     ,0,0,0,0,0,2021
PUG,BR,C 32,Altre industrie manifatturiere                              ,0,0,0,0,0,2021
PUG,BR,C 33,"Riparazione, manutenzione ed installazione di macchine ed...",0,0,0,0,0,2021
PUG,BR,D   ,"Fornitura di energia elettrica, gas, vapore e aria condiz...",0,0,0,0,0,2021
PUG,BR,D 35,"Fornitura di energia elettrica, gas, vapore e aria condiz...",0,0,0,0,0,2021
PUG,BR,E   ,"Fornitura di acqua; reti fognarie, attività di gestione d...",1,0,0,0,1,2021
PUG,BR,E 36,"Raccolta, trattamento e fornitura di acqua                  ",0,0,0,0,0,2021
PUG,BR,E 37,Gestione delle reti fognarie                                ,0,0,0,0,0,2021
PUG,BR,E 38,"Attività di raccolta, trattamento e smaltimento dei rifiu...",1,0,0,0,1,2021
PUG,BR,E 39,Attività di risanamento e altri servizi di gestione dei r...,0,0,0,0,0,2021
PUG,BR,F   ,Costruzioni                                                 ,4,0,0,1,5,2021
PUG,BR,F 41,Costruzione di edifici                                      ,1,0,0,0,1,2021
PUG,BR,F 42,Ingegneria civile                                           ,0,0,0,0,0,2021
PUG,BR,F 43,Lavori di costruzione specializzati                         ,3,0,0,1,4,2021
PUG,BR,G   ,Commercio all'ingrosso e al dettaglio; riparazione di aut...,10,4,1,0,15,2021
PUG,BR,G 45,Commercio all'ingrosso e al dettaglio e riparazione di au...,1,0,0,0,1,2021
PUG,BR,G 46,Commercio all'ingrosso (escluso quello di autoveicoli e d...,5,0,1,0,6,2021
PUG,BR,G 47,Commercio al dettaglio (escluso quello di autoveicoli e d...,4,4,0,0,8,2021
PUG,BR,H   ,Trasporto e magazzinaggio                                   ,0,2,1,0,3,2021
PUG,BR,H 49,Trasporto terrestre e mediante condotte                     ,0,1,1,0,2,2021
PUG,BR,H 50,Trasporto marittimo e per vie d'acqua                       ,0,0,0,0,0,2021
PUG,BR,H 51,Trasporto aereo                                             ,0,0,0,0,0,2021
PUG,BR,H 52,Magazzinaggio e attività di supporto ai trasporti           ,0,0,0,0,0,2021
PUG,BR,H 53,Servizi postali e attività di corriere                      ,0,1,0,0,1,2021
PUG,BR,I   ,Attività dei servizi alloggio e ristorazione                ,4,3,0,0,7,2021
PUG,BR,I 55,Alloggio                                                    ,0,0,0,0,0,2021
PUG,BR,I 56,Attività dei servizi di ristorazione                        ,4,3,0,0,7,2021
PUG,BR,J   ,Servizi di informazione e comunicazione                     ,0,0,0,0,0,2021
PUG,BR,J 58,Attività editoriali                                         ,0,0,0,0,0,2021
PUG,BR,J 59,"Attività di produzione cinematografica, di video e di pro...",0,0,0,0,0,2021
PUG,BR,J 60,Attività di programmazione e trasmissione                   ,0,0,0,0,0,2021
PUG,BR,J 61,Telecomunicazioni                                           ,0,0,0,0,0,2021
PUG,BR,J 62,"Produzione di software, consulenza informatica e attività...",0,0,0,0,0,2021
PUG,BR,J 63,Attività dei servizi d'informazione e altri servizi infor...,0,0,0,0,0,2021
PUG,BR,K   ,Attività finanziarie e assicurative                         ,0,0,0,0,0,2021
PUG,BR,K 64,Attività di servizi finanziari (escluse le assicurazioni ...,0,0,0,0,0,2021
PUG,BR,K 65,"Assicurazioni, riassicurazioni e fondi pensione (escluse ...",0,0,0,0,0,2021
PUG,BR,K 66,Attività ausiliarie dei servizi finanziari e delle attivi...,0,0,0,0,0,2021
PUG,BR,L   ,Attivita' immobiliari                                       ,1,0,0,0,1,2021
PUG,BR,L 68,Attivita' immobiliari                                       ,1,0,0,0,1,2021
PUG,BR,M   ,"Attività professionali, scientifiche e tecniche             ",4,0,0,0,4,2021
PUG,BR,M 69,Attività legali e contabilità                               ,0,0,0,0,0,2021
PUG,BR,M 70,Attività di direzione aziendale e di consulenza gestional...,2,0,0,0,2,2021
PUG,BR,M 71,Attività degli studi di architettura e d'ingegneria; coll...,0,0,0,0,0,2021
PUG,BR,M 72,Ricerca scientifica e sviluppo                              ,0,0,0,0,0,2021
PUG,BR,M 73,Pubblicità e ricerche di mercato                            ,0,0,0,0,0,2021
PUG,BR,M 74,"Altre attività professionali, scientifiche e tecniche       ",2,0,0,0,2,2021
PUG,BR,M 75,Servizi veterinari                                          ,0,0,0,0,0,2021
PUG,BR,N   ,"Noleggio, agenzie di viaggio, servizi di supporto alle im...",2,0,0,0,2,2021
PUG,BR,N 77,Attività di noleggio e leasing operativo                    ,0,0,0,0,0,2021
PUG,BR,N 78,"Attività di ricerca, selezione, fornitura di personale      ",0,0,0,0,0,2021
PUG,BR,N 79,"Attività dei servizi delle agenzie di viaggio, dei tour o...",0,0,0,0,0,2021
PUG,BR,N 80,Servizi di vigilanza e investigazione                       ,0,0,0,0,0,2021
PUG,BR,N 81,Attività di servizi per edifici e paesaggio                 ,1,0,0,0,1,2021
PUG,BR,N 82,Attività di supporto per le funzioni d'ufficio e altri se...,1,0,0,0,1,2021
PUG,BR,O   ,Amministrazione pubblica e difesa; assicurazione sociale ...,0,0,0,0,0,2021
PUG,BR,O 84,Amministrazione pubblica e difesa; assicurazione sociale ...,0,0,0,0,0,2021
PUG,BR,P   ,Istruzione                                                  ,0,0,0,0,0,2021
PUG,BR,P 85,Istruzione                                                  ,0,0,0,0,0,2021
PUG,BR,Q   ,Sanita' e assistenza sociale                                ,0,0,0,0,0,2021
PUG,BR,Q 86,Assistenza sanitaria                                        ,0,0,0,0,0,2021
PUG,BR,Q 87,Servizi di assistenza sociale residenziale                  ,0,0,0,0,0,2021
PUG,BR,Q 88,Assistenza sociale non residenziale                         ,0,0,0,0,0,2021
PUG,BR,R   ,"Attività artistiche, sportive, di intrattenimento e diver...",0,0,0,1,1,2021
PUG,BR,R 90,"Attività creative, artistiche e di intrattenimento          ",0,0,0,1,1,2021
PUG,BR,R 91,"Attività di biblioteche, archivi, musei ed altre attività...",0,0,0,0,0,2021
PUG,BR,R 92,"Attività riguardanti le lotterie, le scommesse, le case d...",0,0,0,0,0,2021
PUG,BR,R 93,"Attività sportive, di intrattenimento e di divertimento     ",0,0,0,0,0,2021
PUG,BR,S   ,Altre attività di servizi                                   ,0,0,0,0,0,2021
PUG,BR,S 94,Attività di organizzazioni associative                      ,0,0,0,0,0,2021
PUG,BR,S 95,Riparazione di computer e di beni per uso personale e per...,0,0,0,0,0,2021
PUG,BR,S 96,Altre attività di servizi per la persona                    ,0,0,0,0,0,2021
PUG,BR,T   ,Attività di famiglie e convivenze come datori di lavoro p...,0,0,0,0,0,2021
PUG,BR,T 97,Attività di famiglie e convivenze come datori di lavoro p...,0,0,0,0,0,2021
PUG,BR,T 98,Produzione di beni e servizi indifferenziati per uso prop...,0,0,0,0,0,2021
PUG,BR,U   ,Organizzazioni ed organismi extraterritoriali               ,0,0,0,0,0,2021
PUG,BR,U 99,Organizzazioni ed organismi extraterritoriali               ,0,0,0,0,0,2021
PUG,BR,XX  ,Imprese non classificate                                    ,14,4,0,3,21,2021
PUG,BR,TOT ,TOTALE                                                      ,41,13,2,5,61,2021
PUG,LE,A   ,"Agricoltura, silvicoltura pesca                             ",0,0,43,0,43,2021
PUG,LE,A 01,"Coltivazioni agricole e produzione di prodotti animali, c...",0,0,42,0,42,2021
PUG,LE,A 02,Silvicoltura ed utilizzo di aree forestali                  ,0,0,0,0,0,2021
PUG,LE,A 03,Pesca e acquacoltura                                        ,0,0,1,0,1,2021
PUG,LE,B   ,Estrazione di minerali da cave e miniere                    ,0,0,0,0,0,2021
PUG,LE,B 05,Estrazione di carbone (esclusa torba)                       ,0,0,0,0,0,2021
PUG,LE,B 06,Estraz.di petrolio greggio e di gas naturale                ,0,0,0,0,0,2021
PUG,LE,B 07,Estrazione di minerali metalliferi                          ,0,0,0,0,0,2021
PUG,LE,B 08,Altre attività di estrazione di minerali da cave e miniere  ,0,0,0,0,0,2021
PUG,LE,B 09,Attività dei servizi di supporto all'estrazione             ,0,0,0,0,0,2021
PUG,LE,C   ,Attività manifatturiere                                     ,19,7,57,0,83,2021
PUG,LE,C 10,Industrie alimentari                                        ,0,2,4,0,6,2021
PUG,LE,C 11,Industria delle bevande                                     ,0,0,2,0,2,2021
PUG,LE,C 12,Industria del tabacco                                       ,0,0,0,0,0,2021
PUG,LE,C 13,Industrie tessili                                           ,0,0,1,0,1,2021
PUG,LE,C 14,Confezione di articoli di abbigliamento; confezione di ar...,2,3,16,0,21,2021
PUG,LE,C 15,Fabbricazione di articoli in pelle e simili                 ,6,0,2,0,8,2021
PUG,LE,C 16,Industria del legno e dei prodotti in legno e sughero (es...,0,1,13,0,14,2021
PUG,LE,C 17,Fabbricazione di carta e di prodotti di carta               ,1,0,2,0,3,2021
PUG,LE,C 18,Stampa e riproduzione di supporti registrati                ,0,0,1,0,1,2021
PUG,LE,C 19,Fabbricazione di coke e prodotti derivanti dalla raffinaz...,0,0,0,0,0,2021
PUG,LE,C 20,Fabbricazione di prodotti chimici                           ,0,0,0,0,0,2021
PUG,LE,C 21,Fabbricazione di prodotti farmaceutici di base e di prepa...,0,0,0,0,0,2021
PUG,LE,C 22,Fabbricazione di articoli in gomma e materie plastiche      ,1,0,0,0,1,2021
PUG,LE,C 23,Fabbricazione di altri prodotti della lavorazione di miner..,4,0,2,0,6,2021
PUG,LE,C 24,Metallurgia                                                 ,0,0,0,0,0,2021
PUG,LE,C 25,Fabbricazione di prodotti in metallo (esclusi macchinari ...,3,0,6,0,9,2021
PUG,LE,C 26,Fabbricazione di computer e prodotti di elettronica e ott...,0,0,1,0,1,2021
PUG,LE,C 27,Fabbricazione di apparecchiature elettriche ed apparecchi...,0,0,0,0,0,2021
PUG,LE,C 28,Fabbricazione di macchinari ed apparecchiature nca          ,0,0,2,0,2,2021
PUG,LE,C 29,"Fabbricazione di autoveicoli, rimorchi e semirimorchi       ",0,0,0,0,0,2021
PUG,LE,C 30,Fabbricazione di altri mezzi di trasporto                   ,1,0,0,0,1,2021
PUG,LE,C 31,Fabbricazione di mobili                                     ,1,0,3,0,4,2021
PUG,LE,C 32,Altre industrie manifatturiere                              ,0,1,1,0,2,2021
PUG,LE,C 33,"Riparazione, manutenzione ed installazione di macchine ed...",0,0,1,0,1,2021
PUG,LE,D   ,"Fornitura di energia elettrica, gas, vapore e aria condiz...",1,0,0,0,1,2021
PUG,LE,D 35,"Fornitura di energia elettrica, gas, vapore e aria condiz...",1,0,0,0,1,2021
PUG,LE,E   ,"Fornitura di acqua; reti fognarie, attività di gestione d...",0,0,0,1,1,2021
PUG,LE,E 36,"Raccolta, trattamento e fornitura di acqua                  ",0,0,0,0,0,2021
PUG,LE,E 37,Gestione delle reti fognarie                                ,0,0,0,0,0,2021
PUG,LE,E 38,"Attività di raccolta, trattamento e smaltimento dei rifiu...",0,0,0,1,1,2021
PUG,LE,E 39,Attività di risanamento e altri servizi di gestione dei r...,0,0,0,0,0,2021
PUG,LE,F   ,Costruzioni                                                 ,29,9,97,0,135,2021
PUG,LE,F 41,Costruzione di edifici                                      ,21,2,32,0,55,2021
PUG,LE,F 42,Ingegneria civile                                           ,1,0,0,0,1,2021
PUG,LE,F 43,Lavori di costruzione specializzati                         ,7,7,65,0,79,2021
PUG,LE,G   ,Commercio all'ingrosso e al dettaglio; riparazione di aut...,27,23,186,0,236,2021
PUG,LE,G 45,Commercio all'ingrosso e al dettaglio e riparazione di au...,3,5,14,0,22,2021
PUG,LE,G 46,Commercio all'ingrosso (escluso quello di autoveicoli e d...,10,7,23,0,40,2021
PUG,LE,G 47,Commercio al dettaglio (escluso quello di autoveicoli e d...,14,11,149,0,174,2021
PUG,LE,H   ,Trasporto e magazzinaggio                                   ,3,1,10,0,14,2021
PUG,LE,H 49,Trasporto terrestre e mediante condotte                     ,1,0,8,0,9,2021
PUG,LE,H 50,Trasporto marittimo e per vie d'acqua                       ,0,1,0,0,1,2021
PUG,LE,H 51,Trasporto aereo                                             ,0,0,0,0,0,2021
PUG,LE,H 52,Magazzinaggio e attività di supporto ai trasporti           ,1,0,2,0,3,2021
PUG,LE,H 53,Servizi postali e attività di corriere                      ,1,0,0,0,1,2021
PUG,LE,I   ,Attività dei servizi alloggio e ristorazione                ,15,13,29,0,57,2021
PUG,LE,I 55,Alloggio                                                    ,1,1,1,0,3,2021
PUG,LE,I 56,Attività dei servizi di ristorazione                        ,14,12,28,0,54,2021
PUG,LE,J   ,Servizi di informazione e comunicazione                     ,7,0,3,1,11,2021
PUG,LE,J 58,Attività editoriali                                         ,1,0,1,0,2,2021
PUG,LE,J 59,"Attività di produzione cinematografica, di video e di pro...",0,0,0,0,0,2021
PUG,LE,J 60,Attività di programmazione e trasmissione                   ,1,0,0,0,1,2021
PUG,LE,J 61,Telecomunicazioni                                           ,1,0,0,0,1,2021
PUG,LE,J 62,"Produzione di software, consulenza informatica e attività...",2,0,0,1,3,2021
PUG,LE,J 63,Attività dei servizi d'informazione e altri servizi infor...,2,0,2,0,4,2021
PUG,LE,K   ,Attività finanziarie e assicurative                         ,0,1,1,0,2,2021
PUG,LE,K 64,Attività di servizi finanziari (escluse le assicurazioni ...,0,0,0,0,0,2021
PUG,LE,K 65,"Assicurazioni, riassicurazioni e fondi pensione (escluse ...",0,0,0,0,0,2021
PUG,LE,K 66,Attività ausiliarie dei servizi finanziari e delle attivi...,0,1,1,0,2,2021
PUG,LE,L   ,Attivita' immobiliari                                       ,2,2,0,0,4,2021
PUG,LE,L 68,Attivita' immobiliari                                       ,2,2,0,0,4,2021
PUG,LE,M   ,"Attività professionali, scientifiche e tecniche             ",6,3,8,0,17,2021
PUG,LE,M 69,Attività legali e contabilità                               ,0,0,0,0,0,2021
PUG,LE,M 70,Attività di direzione aziendale e di consulenza gestional...,1,0,0,0,1,2021
PUG,LE,M 71,Attività degli studi di architettura e d'ingegneria; coll...,3,0,0,0,3,2021
PUG,LE,M 72,Ricerca scientifica e sviluppo                              ,0,0,0,0,0,2021
PUG,LE,M 73,Pubblicità e ricerche di mercato                            ,2,0,3,0,5,2021
PUG,LE,M 74,"Altre attività professionali, scientifiche e tecniche       ",0,3,5,0,8,2021
PUG,LE,M 75,Servizi veterinari                                          ,0,0,0,0,0,2021
PUG,LE,N   ,"Noleggio, agenzie di viaggio, servizi di supporto alle im...",2,6,8,0,16,2021
PUG,LE,N 77,Attività di noleggio e leasing operativo                    ,0,3,2,0,5,2021
PUG,LE,N 78,"Attività di ricerca, selezione, fornitura di personale      ",0,0,0,0,0,2021
PUG,LE,N 79,"Attività dei servizi delle agenzie di viaggio, dei tour o...",0,0,0,0,0,2021
PUG,LE,N 80,Servizi di vigilanza e investigazione                       ,0,0,0,0,0,2021
PUG,LE,N 81,Attività di servizi per edifici e paesaggio                 ,1,1,3,0,5,2021
PUG,LE,N 82,Attività di supporto per le funzioni d'ufficio e altri se...,1,2,3,0,6,2021
PUG,LE,O   ,Amministrazione pubblica e difesa; assicurazione sociale ...,0,0,0,0,0,2021
PUG,LE,O 84,Amministrazione pubblica e difesa; assicurazione sociale ...,0,0,0,0,0,2021
PUG,LE,P   ,Istruzione                                                  ,0,0,1,0,1,2021
PUG,LE,P 85,Istruzione                                                  ,0,0,1,0,1,2021
PUG,LE,Q   ,Sanita' e assistenza sociale                                ,0,0,1,0,1,2021
PUG,LE,Q 86,Assistenza sanitaria                                        ,0,0,0,0,0,2021
PUG,LE,Q 87,Servizi di assistenza sociale residenziale                  ,0,0,0,0,0,2021
PUG,LE,Q 88,Assistenza sociale non residenziale                         ,0,0,1,0,1,2021
PUG,LE,R   ,"Attività artistiche, sportive, di intrattenimento e diver...",4,2,6,0,12,2021
PUG,LE,R 90,"Attività creative, artistiche e di intrattenimento          ",0,1,1,0,2,2021
PUG,LE,R 91,"Attività di biblioteche, archivi, musei ed altre attività...",0,0,0,0,0,2021
PUG,LE,R 92,"Attività riguardanti le lotterie, le scommesse, le case d...",1,1,0,0,2,2021
PUG,LE,R 93,"Attività sportive, di intrattenimento e di divertimento     ",3,0,5,0,8,2021
PUG,LE,S   ,Altre attività di servizi                                   ,0,3,12,0,15,2021
PUG,LE,S 94,Attività di organizzazioni associative                      ,0,0,0,0,0,2021
PUG,LE,S 95,Riparazione di computer e di beni per uso personale e per...,0,0,7,0,7,2021
PUG,LE,S 96,Altre attività di servizi per la persona                    ,0,3,5,0,8,2021
PUG,LE,T   ,Attività di famiglie e convivenze come datori di lavoro p...,0,0,0,0,0,2021
PUG,LE,T 97,Attività di famiglie e convivenze come datori di lavoro p...,0,0,0,0,0,2021
PUG,LE,T 98,Produzione di beni e servizi indifferenziati per uso prop...,0,0,0,0,0,2021
PUG,LE,U   ,Organizzazioni ed organismi extraterritoriali               ,0,0,0,0,0,2021
PUG,LE,U 99,Organizzazioni ed organismi extraterritoriali               ,0,0,0,0,0,2021
PUG,LE,XX  ,Imprese non classificate                                    ,19,20,24,1,64,2021
PUG,LE,TOT ,TOTALE                                                      ,134,90,486,3,713,2021
BAS,  ,A   ,"Agricoltura, silvicoltura pesca                             ",1,1,93,0,95,2021
BAS,  ,A 01,"Coltivazioni agricole e produzione di prodotti animali, c...",1,1,89,0,91,2021
BAS,  ,A 02,Silvicoltura ed utilizzo di aree forestali                  ,0,0,3,0,3,2021
BAS,  ,A 03,Pesca e acquacoltura                                        ,0,0,1,0,1,2021
BAS,  ,B   ,Estrazione di minerali da cave e miniere                    ,0,0,0,0,0,2021
BAS,  ,B 05,Estrazione di carbone (esclusa torba)                       ,0,0,0,0,0,2021
BAS,  ,B 06,Estraz.di petrolio greggio e di gas naturale                ,0,0,0,0,0,2021
BAS,  ,B 07,Estrazione di minerali metalliferi                          ,0,0,0,0,0,2021
BAS,  ,B 08,Altre attività di estrazione di minerali da cave e miniere  ,0,0,0,0,0,2021
BAS,  ,B 09,Attività dei servizi di supporto all'estrazione             ,0,0,0,0,0,2021
BAS,  ,C   ,Attività manifatturiere                                     ,27,2,33,0,62,2021
BAS,  ,C 10,Industrie alimentari                                        ,2,1,4,0,7,2021
BAS,  ,C 11,Industria delle bevande                                     ,0,0,1,0,1,2021
BAS,  ,C 12,Industria del tabacco                                       ,0,0,0,0,0,2021
BAS,  ,C 13,Industrie tessili                                           ,1,0,0,0,1,2021
BAS,  ,C 14,Confezione di articoli di abbigliamento; confezione di ar...,2,0,5,0,7,2021
BAS,  ,C 15,Fabbricazione di articoli in pelle e simili                 ,0,0,0,0,0,2021
BAS,  ,C 16,Industria del legno e dei prodotti in legno e sughero (es...,0,0,3,0,3,2021
BAS,  ,C 17,Fabbricazione di carta e di prodotti di carta               ,0,0,0,0,0,2021
BAS,  ,C 18,Stampa e riproduzione di supporti registrati                ,2,0,0,0,2,2021
BAS,  ,C 19,Fabbricazione di coke e prodotti derivanti dalla raffinaz...,0,0,0,0,0,2021
BAS,  ,C 20,Fabbricazione di prodotti chimici                           ,1,0,0,0,1,2021
BAS,  ,C 21,Fabbricazione di prodotti farmaceutici di base e di prepa...,0,0,0,0,0,2021
BAS,  ,C 22,Fabbricazione di articoli in gomma e materie plastiche      ,1,0,0,0,1,2021
BAS,  ,C 23,Fabbricazione di altri prodotti della lavorazione di miner..,3,1,2,0,6,2021
BAS,  ,C 24,Metallurgia                                                 ,0,0,0,0,0,2021
BAS,  ,C 25,Fabbricazione di prodotti in metallo (esclusi macchinari ...,3,0,11,0,14,2021
BAS,  ,C 26,Fabbricazione di computer e prodotti di elettronica e ott...,0,0,0,0,0,2021
BAS,  ,C 27,Fabbricazione di apparecchiature elettriche ed apparecchi...,1,0,0,0,1,2021
BAS,  ,C 28,Fabbricazione di macchinari ed apparecchiature nca          ,7,0,0,0,7,2021
BAS,  ,C 29,"Fabbricazione di autoveicoli, rimorchi e semirimorchi       ",1,0,0,0,1,2021
BAS,  ,C 30,Fabbricazione di altri mezzi di trasporto                   ,1,0,0,0,1,2021
BAS,  ,C 31,Fabbricazione di mobili                                     ,1,0,6,0,7,2021
BAS,  ,C 32,Altre industrie manifatturiere                              ,0,0,0,0,0,2021
BAS,  ,C 33,"Riparazione, manutenzione ed installazione di macchine ed...",1,0,1,0,2,2021
BAS,  ,D   ,"Fornitura di energia elettrica, gas, vapore e aria condiz...",0,0,0,0,0,2021
BAS,  ,D 35,"Fornitura di energia elettrica, gas, vapore e aria condiz...",0,0,0,0,0,2021
BAS,  ,E   ,"Fornitura di acqua; reti fognarie, attività di gestione d...",0,0,0,0,0,2021
BAS,  ,E 36,"Raccolta, trattamento e fornitura di acqua                  ",0,0,0,0,0,2021
BAS,  ,E 37,Gestione delle reti fognarie                                ,0,0,0,0,0,2021
BAS,  ,E 38,"Attività di raccolta, trattamento e smaltimento dei rifiu...",0,0,0,0,0,2021
BAS,  ,E 39,Attività di risanamento e altri servizi di gestione dei r...,0,0,0,0,0,2021
BAS,  ,F   ,Costruzioni                                                 ,28,6,85,0,119,2021
BAS,  ,F 41,Costruzione di edifici                                      ,15,3,51,0,69,2021
BAS,  ,F 42,Ingegneria civile                                           ,1,1,4,0,6,2021
BAS,  ,F 43,Lavori di costruzione specializzati                         ,12,2,30,0,44,2021
BAS,  ,G   ,Commercio all'ingrosso e al dettaglio; riparazione di aut...,15,5,181,0,201,2021
BAS,  ,G 45,Commercio all'ingrosso e al dettaglio e riparazione di au...,1,0,9,0,10,2021
BAS,  ,G 46,Commercio all'ingrosso (escluso quello di autoveicoli e d...,9,0,51,0,60,2021
BAS,  ,G 47,Commercio al dettaglio (escluso quello di autoveicoli e d...,5,5,121,0,131,2021
BAS,  ,H   ,Trasporto e magazzinaggio                                   ,3,0,19,0,22,2021
BAS,  ,H 49,Trasporto terrestre e mediante condotte                     ,1,0,18,0,19,2021
BAS,  ,H 50,Trasporto marittimo e per vie d'acqua                       ,0,0,0,0,0,2021
BAS,  ,H 51,Trasporto aereo                                             ,0,0,0,0,0,2021
BAS,  ,H 52,Magazzinaggio e attività di supporto ai trasporti           ,2,0,1,0,3,2021
BAS,  ,H 53,Servizi postali e attività di corriere                      ,0,0,0,0,0,2021
BAS,  ,I   ,Attività dei servizi alloggio e ristorazione                ,4,4,13,2,23,2021
BAS,  ,I 55,Alloggio                                                    ,1,0,1,1,3,2021
BAS,  ,I 56,Attività dei servizi di ristorazione                        ,3,4,12,1,20,2021
BAS,  ,J   ,Servizi di informazione e comunicazione                     ,5,2,5,0,12,2021
BAS,  ,J 58,Attività editoriali                                         ,0,0,1,0,1,2021
BAS,  ,J 59,"Attività di produzione cinematografica, di video e di pro...",0,0,0,0,0,2021
BAS,  ,J 60,Attività di programmazione e trasmissione                   ,0,0,1,0,1,2021
BAS,  ,J 61,Telecomunicazioni                                           ,0,0,0,0,0,2021
BAS,  ,J 62,"Produzione di software, consulenza informatica e attività...",2,0,0,0,2,2021
BAS,  ,J 63,Attività dei servizi d'informazione e altri servizi infor...,3,2,3,0,8,2021
BAS,  ,K   ,Attività finanziarie e assicurative                         ,1,0,4,0,5,2021
BAS,  ,K 64,Attività di servizi finanziari (escluse le assicurazioni ...,1,0,0,0,1,2021
BAS,  ,K 65,"Assicurazioni, riassicurazioni e fondi pensione (escluse ...",0,0,0,0,0,2021
BAS,  ,K 66,Attività ausiliarie dei servizi finanziari e delle attivi...,0,0,4,0,4,2021
BAS,  ,L   ,Attivita' immobiliari                                       ,2,0,1,0,3,2021
BAS,  ,L 68,Attivita' immobiliari                                       ,2,0,1,0,3,2021
BAS,  ,M   ,"Attività professionali, scientifiche e tecniche             ",3,0,7,0,10,2021
BAS,  ,M 69,Attività legali e contabilità                               ,0,0,0,0,0,2021
BAS,  ,M 70,Attività di direzione aziendale e di consulenza gestional...,3,0,2,0,5,2021
BAS,  ,M 71,Attività degli studi di architettura e d'ingegneria; coll...,0,0,1,0,1,2021
BAS,  ,M 72,Ricerca scientifica e sviluppo                              ,0,0,0,0,0,2021
BAS,  ,M 73,Pubblicità e ricerche di mercato                            ,0,0,1,0,1,2021
BAS,  ,M 74,"Altre attività professionali, scientifiche e tecniche       ",0,0,3,0,3,2021
BAS,  ,M 75,Servizi veterinari                                          ,0,0,0,0,0,2021
BAS,  ,N   ,"Noleggio, agenzie di viaggio, servizi di supporto alle im...",4,0,10,1,15,2021
BAS,  ,N 77,Attività di noleggio e leasing operativo                    ,1,0,3,0,4,2021
BAS,  ,N 78,"Attività di ricerca, selezione, fornitura di personale      ",0,0,0,0,0,2021
BAS,  ,N 79,"Attività dei servizi delle agenzie di viaggio, dei tour o...",1,0,0,1,2,2021
BAS,  ,N 80,Servizi di vigilanza e investigazione                       ,0,0,0,0,0,2021
BAS,  ,N 81,Attività di servizi per edifici e paesaggio                 ,0,0,6,0,6,2021
BAS,  ,N 82,Attività di supporto per le funzioni d'ufficio e altri se...,2,0,1,0,3,2021
BAS,  ,O   ,Amministrazione pubblica e difesa; assicurazione sociale ...,0,0,0,0,0,2021
BAS,  ,O 84,Amministrazione pubblica e difesa; assicurazione sociale ...,0,0,0,0,0,2021
BAS,  ,P   ,Istruzione                                                  ,0,0,0,0,0,2021
BAS,  ,P 85,Istruzione                                                  ,0,0,0,0,0,2021
BAS,  ,Q   ,Sanita' e assistenza sociale                                ,2,0,0,0,2,2021
BAS,  ,Q 86,Assistenza sanitaria                                        ,2,0,0,0,2,2021
BAS,  ,Q 87,Servizi di assistenza sociale residenziale                  ,0,0,0,0,0,2021
BAS,  ,Q 88,Assistenza sociale non residenziale                         ,0,0,0,0,0,2021
BAS,  ,R   ,"Attività artistiche, sportive, di intrattenimento e diver...",3,0,5,2,10,2021
BAS,  ,R 90,"Attività creative, artistiche e di intrattenimento          ",0,0,1,0,1,2021
BAS,  ,R 91,"Attività di biblioteche, archivi, musei ed altre attività...",0,0,0,0,0,2021
BAS,  ,R 92,"Attività riguardanti le lotterie, le scommesse, le case d...",0,0,1,0,1,2021
BAS,  ,R 93,"Attività sportive, di intrattenimento e di divertimento     ",3,0,3,2,8,2021
BAS,  ,S   ,Altre attività di servizi                                   ,1,1,5,0,7,2021
BAS,  ,S 94,Attività di organizzazioni associative                      ,0,0,0,0,0,2021
BAS,  ,S 95,Riparazione di computer e di beni per uso personale e per...,0,0,4,0,4,2021
BAS,  ,S 96,Altre attività di servizi per la persona                    ,1,1,1,0,3,2021
BAS,  ,T   ,Attività di famiglie e convivenze come datori di lavoro p...,0,0,0,0,0,2021
BAS,  ,T 97,Attività di famiglie e convivenze come datori di lavoro p...,0,0,0,0,0,2021
BAS,  ,T 98,Produzione di beni e servizi indifferenziati per uso prop...,0,0,0,0,0,2021
BAS,  ,U   ,Organizzazioni ed organismi extraterritoriali               ,0,0,0,0,0,2021
BAS,  ,U 99,Organizzazioni ed organismi extraterritoriali               ,0,0,0,0,0,2021
BAS,  ,XX  ,Imprese non classificate                                    ,26,10,19,6,61,2021
BAS,  ,TOT ,TOTALE                                                      ,125,31,480,11,647,2021
BAS,PZ,A   ,"Agricoltura, silvicoltura pesca                             ",0,1,55,0,56,2021
BAS,PZ,A 01,"Coltivazioni agricole e produzione di prodotti animali, c...",0,1,52,0,53,2021
BAS,PZ,A 02,Silvicoltura ed utilizzo di aree forestali                  ,0,0,2,0,2,2021
BAS,PZ,A 03,Pesca e acquacoltura                                        ,0,0,1,0,1,2021
BAS,PZ,B   ,Estrazione di minerali da cave e miniere                    ,0,0,0,0,0,2021
BAS,PZ,B 05,Estrazione di carbone (esclusa torba)                       ,0,0,0,0,0,2021
BAS,PZ,B 06,Estraz.di petrolio greggio e di gas naturale                ,0,0,0,0,0,2021
BAS,PZ,B 07,Estrazione di minerali metalliferi                          ,0,0,0,0,0,2021
BAS,PZ,B 08,Altre attività di estrazione di minerali da cave e miniere  ,0,0,0,0,0,2021
BAS,PZ,B 09,Attività dei servizi di supporto all'estrazione             ,0,0,0,0,0,2021
BAS,PZ,C   ,Attività manifatturiere                                     ,13,2,8,0,23,2021
BAS,PZ,C 10,Industrie alimentari                                        ,1,1,2,0,4,2021
BAS,PZ,C 11,Industria delle bevande                                     ,0,0,0,0,0,2021
BAS,PZ,C 12,Industria del tabacco                                       ,0,0,0,0,0,2021
BAS,PZ,C 13,Industrie tessili                                           ,0,0,0,0,0,2021
BAS,PZ,C 14,Confezione di articoli di abbigliamento; confezione di ar...,1,0,2,0,3,2021
BAS,PZ,C 15,Fabbricazione di articoli in pelle e simili                 ,0,0,0,0,0,2021
BAS,PZ,C 16,Industria del legno e dei prodotti in legno e sughero (es...,0,0,2,0,2,2021
BAS,PZ,C 17,Fabbricazione di carta e di prodotti di carta               ,0,0,0,0,0,2021
BAS,PZ,C 18,Stampa e riproduzione di supporti registrati                ,2,0,0,0,2,2021
BAS,PZ,C 19,Fabbricazione di coke e prodotti derivanti dalla raffinaz...,0,0,0,0,0,2021
BAS,PZ,C 20,Fabbricazione di prodotti chimici                           ,1,0,0,0,1,2021
BAS,PZ,C 21,Fabbricazione di prodotti farmaceutici di base e di prepa...,0,0,0,0,0,2021
BAS,PZ,C 22,Fabbricazione di articoli in gomma e materie plastiche      ,1,0,0,0,1,2021
BAS,PZ,C 23,Fabbricazione di altri prodotti della lavorazione di miner..,1,1,0,0,2,2021
BAS,PZ,C 24,Metallurgia                                                 ,0,0,0,0,0,2021
BAS,PZ,C 25,Fabbricazione di prodotti in metallo (esclusi macchinari ...,2,0,2,0,4,2021
BAS,PZ,C 26,Fabbricazione di computer e prodotti di elettronica e ott...,0,0,0,0,0,2021
BAS,PZ,C 27,Fabbricazione di apparecchiature elettriche ed apparecchi...,0,0,0,0,0,2021
BAS,PZ,C 28,Fabbricazione di macchinari ed apparecchiature nca          ,3,0,0,0,3,2021
BAS,PZ,C 29,"Fabbricazione di autoveicoli, rimorchi e semirimorchi       ",0,0,0,0,0,2021
BAS,PZ,C 30,Fabbricazione di altri mezzi di trasporto                   ,0,0,0,0,0,2021
BAS,PZ,C 31,Fabbricazione di mobili                                     ,0,0,0,0,0,2021
BAS,PZ,C 32,Altre industrie manifatturiere                              ,0,0,0,0,0,2021
BAS,PZ,C 33,"Riparazione, manutenzione ed installazione di macchine ed...",1,0,0,0,1,2021
BAS,PZ,D   ,"Fornitura di energia elettrica, gas, vapore e aria condiz...",0,0,0,0,0,2021
BAS,PZ,D 35,"Fornitura di energia elettrica, gas, vapore e aria condiz...",0,0,0,0,0,2021
BAS,PZ,E   ,"Fornitura di acqua; reti fognarie, attività di gestione d...",0,0,0,0,0,2021
BAS,PZ,E 36,"Raccolta, trattamento e fornitura di acqua                  ",0,0,0,0,0,2021
BAS,PZ,E 37,Gestione delle reti fognarie                                ,0,0,0,0,0,2021
BAS,PZ,E 38,"Attività di raccolta, trattamento e smaltimento dei rifiu...",0,0,0,0,0,2021
BAS,PZ,E 39,Attività di risanamento e altri servizi di gestione dei r...,0,0,0,0,0,2021
BAS,PZ,F   ,Costruzioni                                                 ,12,6,32,0,50,2021
BAS,PZ,F 41,Costruzione di edifici                                      ,6,3,17,0,26,2021
BAS,PZ,F 42,Ingegneria civile                                           ,1,1,1,0,3,2021
BAS,PZ,F 43,Lavori di costruzione specializzati                         ,5,2,14,0,21,2021
BAS,PZ,G   ,Commercio all'ingrosso e al dettaglio; riparazione di aut...,9,5,51,0,65,2021
BAS,PZ,G 45,Commercio all'ingrosso e al dettaglio e riparazione di au...,1,0,3,0,4,2021
BAS,PZ,G 46,Commercio all'ingrosso (escluso quello di autoveicoli e d...,4,0,24,0,28,2021
BAS,PZ,G 47,Commercio al dettaglio (escluso quello di autoveicoli e d...,4,5,24,0,33,2021
BAS,PZ,H   ,Trasporto e magazzinaggio                                   ,2,0,10,0,12,2021
BAS,PZ,H 49,Trasporto terrestre e mediante condotte                     ,1,0,10,0,11,2021
BAS,PZ,H 50,Trasporto marittimo e per vie d'acqua                       ,0,0,0,0,0,2021
BAS,PZ,H 51,Trasporto aereo                                             ,0,0,0,0,0,2021
BAS,PZ,H 52,Magazzinaggio e attività di supporto ai trasporti           ,1,0,0,0,1,2021
BAS,PZ,H 53,Servizi postali e attività di corriere                      ,0,0,0,0,0,2021
BAS,PZ,I   ,Attività dei servizi alloggio e ristorazione                ,4,4,4,2,14,2021
BAS,PZ,I 55,Alloggio                                                    ,1,0,0,1,2,2021
BAS,PZ,I 56,Attività dei servizi di ristorazione                        ,3,4,4,1,12,2021
BAS,PZ,J   ,Servizi di informazione e comunicazione                     ,1,2,2,0,5,2021
BAS,PZ,J 58,Attività editoriali                                         ,0,0,1,0,1,2021
BAS,PZ,J 59,"Attività di produzione cinematografica, di video e di pro...",0,0,0,0,0,2021
BAS,PZ,J 60,Attività di programmazione e trasmissione                   ,0,0,0,0,0,2021
BAS,PZ,J 61,Telecomunicazioni                                           ,0,0,0,0,0,2021
BAS,PZ,J 62,"Produzione di software, consulenza informatica e attività...",1,0,0,0,1,2021
BAS,PZ,J 63,Attività dei servizi d'informazione e altri servizi infor...,0,2,1,0,3,2021
BAS,PZ,K   ,Attività finanziarie e assicurative                         ,1,0,3,0,4,2021
BAS,PZ,K 64,Attività di servizi finanziari (escluse le assicurazioni ...,1,0,0,0,1,2021
BAS,PZ,K 65,"Assicurazioni, riassicurazioni e fondi pensione (escluse ...",0,0,0,0,0,2021
BAS,PZ,K 66,Attività ausiliarie dei servizi finanziari e delle attivi...,0,0,3,0,3,2021
BAS,PZ,L   ,Attivita' immobiliari                                       ,2,0,0,0,2,2021
BAS,PZ,L 68,Attivita' immobiliari                                       ,2,0,0,0,2,2021
BAS,PZ,M   ,"Attività professionali, scientifiche e tecniche             ",2,0,5,0,7,2021
BAS,PZ,M 69,Attività legali e contabilità                               ,0,0,0,0,0,2021
BAS,PZ,M 70,Attività di direzione aziendale e di consulenza gestional...,2,0,2,0,4,2021
BAS,PZ,M 71,Attività degli studi di architettura e d'ingegneria; coll...,0,0,1,0,1,2021
BAS,PZ,M 72,Ricerca scientifica e sviluppo                              ,0,0,0,0,0,2021
BAS,PZ,M 73,Pubblicità e ricerche di mercato                            ,0,0,0,0,0,2021
BAS,PZ,M 74,"Altre attività professionali, scientifiche e tecniche       ",0,0,2,0,2,2021
BAS,PZ,M 75,Servizi veterinari                                          ,0,0,0,0,0,2021
BAS,PZ,N   ,"Noleggio, agenzie di viaggio, servizi di supporto alle im...",2,0,5,1,8,2021
BAS,PZ,N 77,Attività di noleggio e leasing operativo                    ,1,0,2,0,3,2021
BAS,PZ,N 78,"Attività di ricerca, selezione, fornitura di personale      ",0,0,0,0,0,2021
BAS,PZ,N 79,"Attività dei servizi delle agenzie di viaggio, dei tour o...",0,0,0,1,1,2021
BAS,PZ,N 80,Servizi di vigilanza e investigazione                       ,0,0,0,0,0,2021
BAS,PZ,N 81,Attività di servizi per edifici e paesaggio                 ,0,0,3,0,3,2021
BAS,PZ,N 82,Attività di supporto per le funzioni d'ufficio e altri se...,1,0,0,0,1,2021
BAS,PZ,O   ,Amministrazione pubblica e difesa; assicurazione sociale ...,0,0,0,0,0,2021
BAS,PZ,O 84,Amministrazione pubblica e difesa; assicurazione sociale ...,0,0,0,0,0,2021
BAS,PZ,P   ,Istruzione                                                  ,0,0,0,0,0,2021
BAS,PZ,P 85,Istruzione                                                  ,0,0,0,0,0,2021
BAS,PZ,Q   ,Sanita' e assistenza sociale                                ,1,0,0,0,1,2021
BAS,PZ,Q 86,Assistenza sanitaria                                        ,1,0,0,0,1,2021
BAS,PZ,Q 87,Servizi di assistenza sociale residenziale                  ,0,0,0,0,0,2021
BAS,PZ,Q 88,Assistenza sociale non residenziale                         ,0,0,0,0,0,2021
BAS,PZ,R   ,"Attività artistiche, sportive, di intrattenimento e diver...",1,0,5,2,8,2021
BAS,PZ,R 90,"Attività creative, artistiche e di intrattenimento          ",0,0,1,0,1,2021
BAS,PZ,R 91,"Attività di biblioteche, archivi, musei ed altre attività...",0,0,0,0,0,2021
BAS,PZ,R 92,"Attività riguardanti le lotterie, le scommesse, le case d...",0,0,1,0,1,2021
BAS,PZ,R 93,"Attività sportive, di intrattenimento e di divertimento     ",1,0,3,2,6,2021
BAS,PZ,S   ,Altre attività di servizi                                   ,0,1,3,0,4,2021
BAS,PZ,S 94,Attività di organizzazioni associative                      ,0,0,0,0,0,2021
BAS,PZ,S 95,Riparazione di computer e di beni per uso personale e per...,0,0,2,0,2,2021
BAS,PZ,S 96,Altre attività di servizi per la persona                    ,0,1,1,0,2,2021
BAS,PZ,T   ,Attività di famiglie e convivenze come datori di lavoro p...,0,0,0,0,0,2021
BAS,PZ,T 97,Attività di famiglie e convivenze come datori di lavoro p...,0,0,0,0,0,2021
BAS,PZ,T 98,Produzione di beni e servizi indifferenziati per uso prop...,0,0,0,0,0,2021
BAS,PZ,U   ,Organizzazioni ed organismi extraterritoriali               ,0,0,0,0,0,2021
BAS,PZ,U 99,Organizzazioni ed organismi extraterritoriali               ,0,0,0,0,0,2021
BAS,PZ,XX  ,Imprese non classificate                                    ,6,10,12,3,31,2021
BAS,PZ,TOT ,TOTALE                                                      ,56,31,195,8,290,2021
BAS,MT,A   ,"Agricoltura, silvicoltura pesca                             ",1,0,38,0,39,2021
BAS,MT,A 01,"Coltivazioni agricole e produzione di prodotti animali, c...",1,0,37,0,38,2021
BAS,MT,A 02,Silvicoltura ed utilizzo di aree forestali                  ,0,0,1,0,1,2021
BAS,MT,A 03,Pesca e acquacoltura                                        ,0,0,0,0,0,2021
BAS,MT,B   ,Estrazione di minerali da cave e miniere                    ,0,0,0,0,0,2021
BAS,MT,B 05,Estrazione di carbone (esclusa torba)                       ,0,0,0,0,0,2021
BAS,MT,B 06,Estraz.di petrolio greggio e di gas naturale                ,0,0,0,0,0,2021
BAS,MT,B 07,Estrazione di minerali metalliferi                          ,0,0,0,0,0,2021
BAS,MT,B 08,Altre attività di estrazione di minerali da cave e miniere  ,0,0,0,0,0,2021
BAS,MT,B 09,Attività dei servizi di supporto all'estrazione             ,0,0,0,0,0,2021
BAS,MT,C   ,Attività manifatturiere                                     ,14,0,25,0,39,2021
BAS,MT,C 10,Industrie alimentari                                        ,1,0,2,0,3,2021
BAS,MT,C 11,Industria delle bevande                                     ,0,0,1,0,1,2021
BAS,MT,C 12,Industria del tabacco                                       ,0,0,0,0,0,2021
BAS,MT,C 13,Industrie tessili                                           ,1,0,0,0,1,2021
BAS,MT,C 14,Confezione di articoli di abbigliamento; confezione di ar...,1,0,3,0,4,2021
BAS,MT,C 15,Fabbricazione di articoli in pelle e simili                 ,0,0,0,0,0,2021
BAS,MT,C 16,Industria del legno e dei prodotti in legno e sughero (es...,0,0,1,0,1,2021
BAS,MT,C 17,Fabbricazione di carta e di prodotti di carta               ,0,0,0,0,0,2021
BAS,MT,C 18,Stampa e riproduzione di supporti registrati                ,0,0,0,0,0,2021
BAS,MT,C 19,Fabbricazione di coke e prodotti derivanti dalla raffinaz...,0,0,0,0,0,2021
BAS,MT,C 20,Fabbricazione di prodotti chimici                           ,0,0,0,0,0,2021
BAS,MT,C 21,Fabbricazione di prodotti farmaceutici di base e di prepa...,0,0,0,0,0,2021
BAS,MT,C 22,Fabbricazione di articoli in gomma e materie plastiche      ,0,0,0,0,0,2021
BAS,MT,C 23,Fabbricazione di altri prodotti della lavorazione di miner..,2,0,2,0,4,2021
BAS,MT,C 24,Metallurgia                                                 ,0,0,0,0,0,2021
BAS,MT,C 25,Fabbricazione di prodotti in metallo (esclusi macchinari ...,1,0,9,0,10,2021
BAS,MT,C 26,Fabbricazione di computer e prodotti di elettronica e ott...,0,0,0,0,0,2021
BAS,MT,C 27,Fabbricazione di apparecchiature elettriche ed apparecchi...,1,0,0,0,1,2021
BAS,MT,C 28,Fabbricazione di macchinari ed apparecchiature nca          ,4,0,0,0,4,2021
BAS,MT,C 29,"Fabbricazione di autoveicoli, rimorchi e semirimorchi       ",1,0,0,0,1,2021
BAS,MT,C 30,Fabbricazione di altri mezzi di trasporto                   ,1,0,0,0,1,2021
BAS,MT,C 31,Fabbricazione di mobili                                     ,1,0,6,0,7,2021
BAS,MT,C 32,Altre industrie manifatturiere                              ,0,0,0,0,0,2021
BAS,MT,C 33,"Riparazione, manutenzione ed installazione di macchine ed...",0,0,1,0,1,2021
BAS,MT,D   ,"Fornitura di energia elettrica, gas, vapore e aria condiz...",0,0,0,0,0,2021
BAS,MT,D 35,"Fornitura di energia elettrica, gas, vapore e aria condiz...",0,0,0,0,0,2021
BAS,MT,E   ,"Fornitura di acqua; reti fognarie, attività di gestione d...",0,0,0,0,0,2021
BAS,MT,E 36,"Raccolta, trattamento e fornitura di acqua                  ",0,0,0,0,0,2021
BAS,MT,E 37,Gestione delle reti fognarie                                ,0,0,0,0,0,2021
BAS,MT,E 38,"Attività di raccolta, trattamento e smaltimento dei rifiu...",0,0,0,0,0,2021
BAS,MT,E 39,Attività di risanamento e altri servizi di gestione dei r...,0,0,0,0,0,2021
BAS,MT,F   ,Costruzioni                                                 ,16,0,53,0,69,2021
BAS,MT,F 41,Costruzione di edifici                                      ,9,0,34,0,43,2021
BAS,MT,F 42,Ingegneria civile                                           ,0,0,3,0,3,2021
BAS,MT,F 43,Lavori di costruzione specializzati                         ,7,0,16,0,23,2021
BAS,MT,G   ,Commercio all'ingrosso e al dettaglio; riparazione di aut...,6,0,130,0,136,2021
BAS,MT,G 45,Commercio all'ingrosso e al dettaglio e riparazione di au...,0,0,6,0,6,2021
BAS,MT,G 46,Commercio all'ingrosso (escluso quello di autoveicoli e d...,5,0,27,0,32,2021
BAS,MT,G 47,Commercio al dettaglio (escluso quello di autoveicoli e d...,1,0,97,0,98,2021
BAS,MT,H   ,Trasporto e magazzinaggio                                   ,1,0,9,0,10,2021
BAS,MT,H 49,Trasporto terrestre e mediante condotte                     ,0,0,8,0,8,2021
BAS,MT,H 50,Trasporto marittimo e per vie d'acqua                       ,0,0,0,0,0,2021
BAS,MT,H 51,Trasporto aereo                                             ,0,0,0,0,0,2021
BAS,MT,H 52,Magazzinaggio e attività di supporto ai trasporti           ,1,0,1,0,2,2021
BAS,MT,H 53,Servizi postali e attività di corriere                      ,0,0,0,0,0,2021
BAS,MT,I   ,Attività dei servizi alloggio e ristorazione                ,0,0,9,0,9,2021
BAS,MT,I 55,Alloggio                                                    ,0,0,1,0,1,2021
BAS,MT,I 56,Attività dei servizi di ristorazione                        ,0,0,8,0,8,2021
BAS,MT,J   ,Servizi di informazione e comunicazione                     ,4,0,3,0,7,2021
BAS,MT,J 58,Attività editoriali                                         ,0,0,0,0,0,2021
BAS,MT,J 59,"Attività di produzione cinematografica, di video e di pro...",0,0,0,0,0,2021
BAS,MT,J 60,Attività di programmazione e trasmissione                   ,0,0,1,0,1,2021
BAS,MT,J 61,Telecomunicazioni                                           ,0,0,0,0,0,2021
BAS,MT,J 62,"Produzione di software, consulenza informatica e attività...",1,0,0,0,1,2021
BAS,MT,J 63,Attività dei servizi d'informazione e altri servizi infor...,3,0,2,0,5,2021
BAS,MT,K   ,Attività finanziarie e assicurative                         ,0,0,1,0,1,2021
BAS,MT,K 64,Attività di servizi finanziari (escluse le assicurazioni ...,0,0,0,0,0,2021
BAS,MT,K 65,"Assicurazioni, riassicurazioni e fondi pensione (escluse ...",0,0,0,0,0,2021
BAS,MT,K 66,Attività ausiliarie dei servizi finanziari e delle attivi...,0,0,1,0,1,2021
BAS,MT,L   ,Attivita' immobiliari                                       ,0,0,1,0,1,2021
BAS,MT,L 68,Attivita' immobiliari                                       ,0,0,1,0,1,2021
BAS,MT,M   ,"Attività professionali, scientifiche e tecniche             ",1,0,2,0,3,2021
BAS,MT,M 69,Attività legali e contabilità                               ,0,0,0,0,0,2021
BAS,MT,M 70,Attività di direzione aziendale e di consulenza gestional...,1,0,0,0,1,2021
BAS,MT,M 71,Attività degli studi di architettura e d'ingegneria; coll...,0,0,0,0,0,2021
BAS,MT,M 72,Ricerca scientifica e sviluppo                              ,0,0,0,0,0,2021
BAS,MT,M 73,Pubblicità e ricerche di mercato                            ,0,0,1,0,1,2021
BAS,MT,M 74,"Altre attività professionali, scientifiche e tecniche       ",0,0,1,0,1,2021
BAS,MT,M 75,Servizi veterinari                                          ,0,0,0,0,0,2021
BAS,MT,N   ,"Noleggio, agenzie di viaggio, servizi di supporto alle im...",2,0,5,0,7,2021
BAS,MT,N 77,Attività di noleggio e leasing operativo                    ,0,0,1,0,1,2021
BAS,MT,N 78,"Attività di ricerca, selezione, fornitura di personale      ",0,0,0,0,0,2021
BAS,MT,N 79,"Attività dei servizi delle agenzie di viaggio, dei tour o...",1,0,0,0,1,2021
BAS,MT,N 80,Servizi di vigilanza e investigazione                       ,0,0,0,0,0,2021
BAS,MT,N 81,Attività di servizi per edifici e paesaggio                 ,0,0,3,0,3,2021
BAS,MT,N 82,Attività di supporto per le funzioni d'ufficio e altri se...,1,0,1,0,2,2021
BAS,MT,O   ,Amministrazione pubblica e difesa; assicurazione sociale ...,0,0,0,0,0,2021
BAS,MT,O 84,Amministrazione pubblica e difesa; assicurazione sociale ...,0,0,0,0,0,2021
BAS,MT,P   ,Istruzione                                                  ,0,0,0,0,0,2021
BAS,MT,P 85,Istruzione                                                  ,0,0,0,0,0,2021
BAS,MT,Q   ,Sanita' e assistenza sociale                                ,1,0,0,0,1,2021
BAS,MT,Q 86,Assistenza sanitaria                                        ,1,0,0,0,1,2021
BAS,MT,Q 87,Servizi di assistenza sociale residenziale                  ,0,0,0,0,0,2021
BAS,MT,Q 88,Assistenza sociale non residenziale                         ,0,0,0,0,0,2021
BAS,MT,R   ,"Attività artistiche, sportive, di intrattenimento e diver...",2,0,0,0,2,2021
BAS,MT,R 90,"Attività creative, artistiche e di intrattenimento          ",0,0,0,0,0,2021
BAS,MT,R 91,"Attività di biblioteche, archivi, musei ed altre attività...",0,0,0,0,0,2021
BAS,MT,R 92,"Attività riguardanti le lotterie, le scommesse, le case d...",0,0,0,0,0,2021
BAS,MT,R 93,"Attività sportive, di intrattenimento e di divertimento     ",2,0,0,0,2,2021
BAS,MT,S   ,Altre attività di servizi                                   ,1,0,2,0,3,2021
BAS,MT,S 94,Attività di organizzazioni associative                      ,0,0,0,0,0,2021
BAS,MT,S 95,Riparazione di computer e di beni per uso personale e per...,0,0,2,0,2,2021
BAS,MT,S 96,Altre attività di servizi per la persona                    ,1,0,0,0,1,2021
BAS,MT,T   ,Attività di famiglie e convivenze come datori di lavoro p...,0,0,0,0,0,2021
BAS,MT,T 97,Attività di famiglie e convivenze come datori di lavoro p...,0,0,0,0,0,2021
BAS,MT,T 98,Produzione di beni e servizi indifferenziati per uso prop...,0,0,0,0,0,2021
BAS,MT,U   ,Organizzazioni ed organismi extraterritoriali               ,0,0,0,0,0,2021
BAS,MT,U 99,Organizzazioni ed organismi extraterritoriali               ,0,0,0,0,0,2021
BAS,MT,XX  ,Imprese non classificate                                    ,20,0,7,3,30,2021
BAS,MT,TOT ,TOTALE                                                      ,69,0,285,3,357,2021
CAL,  ,A   ,"Agricoltura, silvicoltura pesca                             ",1,1,8,0,10,2021
CAL,  ,A 01,"Coltivazioni agricole e produzione di prodotti animali, c...",1,1,7,0,9,2021
CAL,  ,A 02,Silvicoltura ed utilizzo di aree forestali                  ,0,0,1,0,1,2021
CAL,  ,A 03,Pesca e acquacoltura                                        ,0,0,0,0,0,2021
CAL,  ,B   ,Estrazione di minerali da cave e miniere                    ,0,0,0,0,0,2021
CAL,  ,B 05,Estrazione di carbone (esclusa torba)                       ,0,0,0,0,0,2021
CAL,  ,B 06,Estraz.di petrolio greggio e di gas naturale                ,0,0,0,0,0,2021
CAL,  ,B 07,Estrazione di minerali metalliferi                          ,0,0,0,0,0,2021
CAL,  ,B 08,Altre attività di estrazione di minerali da cave e miniere  ,0,0,0,0,0,2021
CAL,  ,B 09,Attività dei servizi di supporto all'estrazione             ,0,0,0,0,0,2021
CAL,  ,C   ,Attività manifatturiere                                     ,4,18,7,0,29,2021
CAL,  ,C 10,Industrie alimentari                                        ,2,8,1,0,11,2021
CAL,  ,C 11,Industria delle bevande                                     ,0,0,0,0,0,2021
CAL,  ,C 12,Industria del tabacco                                       ,0,0,0,0,0,2021
CAL,  ,C 13,Industrie tessili                                           ,0,0,0,0,0,2021
CAL,  ,C 14,Confezione di articoli di abbigliamento; confezione di ar...,0,0,0,0,0,2021
CAL,  ,C 15,Fabbricazione di articoli in pelle e simili                 ,0,0,0,0,0,2021
CAL,  ,C 16,Industria del legno e dei prodotti in legno e sughero (es...,1,0,3,0,4,2021
CAL,  ,C 17,Fabbricazione di carta e di prodotti di carta               ,0,1,0,0,1,2021
CAL,  ,C 18,Stampa e riproduzione di supporti registrati                ,0,1,0,0,1,2021
CAL,  ,C 19,Fabbricazione di coke e prodotti derivanti dalla raffinaz...,0,0,0,0,0,2021
CAL,  ,C 20,Fabbricazione di prodotti chimici                           ,0,1,0,0,1,2021
CAL,  ,C 21,Fabbricazione di prodotti farmaceutici di base e di prepa...,0,0,0,0,0,2021
CAL,  ,C 22,Fabbricazione di articoli in gomma e materie plastiche      ,1,0,0,0,1,2021
CAL,  ,C 23,Fabbricazione di altri prodotti della lavorazione di miner..,0,1,2,0,3,2021
CAL,  ,C 24,Metallurgia                                                 ,0,0,0,0,0,2021
CAL,  ,C 25,Fabbricazione di prodotti in metallo (esclusi macchinari ...,0,1,0,0,1,2021
CAL,  ,C 26,Fabbricazione di computer e prodotti di elettronica e ott...,0,1,0,0,1,2021
CAL,  ,C 27,Fabbricazione di apparecchiature elettriche ed apparecchi...,0,0,0,0,0,2021
CAL,  ,C 28,Fabbricazione di macchinari ed apparecchiature nca          ,0,1,0,0,1,2021
CAL,  ,C 29,"Fabbricazione di autoveicoli, rimorchi e semirimorchi       ",0,0,0,0,0,2021
CAL,  ,C 30,Fabbricazione di altri mezzi di trasporto                   ,0,0,0,0,0,2021
CAL,  ,C 31,Fabbricazione di mobili                                     ,0,2,0,0,2,2021
CAL,  ,C 32,Altre industrie manifatturiere                              ,0,1,1,0,2,2021
CAL,  ,C 33,"Riparazione, manutenzione ed installazione di macchine ed...",0,0,0,0,0,2021
CAL,  ,D   ,"Fornitura di energia elettrica, gas, vapore e aria condiz...",0,0,0,0,0,2021
CAL,  ,D 35,"Fornitura di energia elettrica, gas, vapore e aria condiz...",0,0,0,0,0,2021
CAL,  ,E   ,"Fornitura di acqua; reti fognarie, attività di gestione d...",0,1,0,0,1,2021
CAL,  ,E 36,"Raccolta, trattamento e fornitura di acqua                  ",0,0,0,0,0,2021
CAL,  ,E 37,Gestione delle reti fognarie                                ,0,0,0,0,0,2021
CAL,  ,E 38,"Attività di raccolta, trattamento e smaltimento dei rifiu...",0,1,0,0,1,2021
CAL,  ,E 39,Attività di risanamento e altri servizi di gestione dei r...,0,0,0,0,0,2021
CAL,  ,F   ,Costruzioni                                                 ,5,9,11,0,25,2021
CAL,  ,F 41,Costruzione di edifici                                      ,4,5,9,0,18,2021
CAL,  ,F 42,Ingegneria civile                                           ,0,1,0,0,1,2021
CAL,  ,F 43,Lavori di costruzione specializzati                         ,1,3,2,0,6,2021
CAL,  ,G   ,Commercio all'ingrosso e al dettaglio; riparazione di aut...,15,63,33,0,111,2021
CAL,  ,G 45,Commercio all'ingrosso e al dettaglio e riparazione di au...,0,8,2,0,10,2021
CAL,  ,G 46,Commercio all'ingrosso (escluso quello di autoveicoli e d...,10,29,9,0,48,2021
CAL,  ,G 47,Commercio al dettaglio (escluso quello di autoveicoli e d...,5,26,22,0,53,2021
CAL,  ,H   ,Trasporto e magazzinaggio                                   ,0,3,10,0,13,2021
CAL,  ,H 49,Trasporto terrestre e mediante condotte                     ,0,2,10,0,12,2021
CAL,  ,H 50,Trasporto marittimo e per vie d'acqua                       ,0,0,0,0,0,2021
CAL,  ,H 51,Trasporto aereo                                             ,0,0,0,0,0,2021
CAL,  ,H 52,Magazzinaggio e attività di supporto ai trasporti           ,0,1,0,0,1,2021
CAL,  ,H 53,Servizi postali e attività di corriere                      ,0,0,0,0,0,2021
CAL,  ,I   ,Attività dei servizi alloggio e ristorazione                ,1,6,1,0,8,2021
CAL,  ,I 55,Alloggio                                                    ,0,1,0,0,1,2021
CAL,  ,I 56,Attività dei servizi di ristorazione                        ,1,5,1,0,7,2021
CAL,  ,J   ,Servizi di informazione e comunicazione                     ,0,5,0,0,5,2021
CAL,  ,J 58,Attività editoriali                                         ,0,1,0,0,1,2021
CAL,  ,J 59,"Attività di produzione cinematografica, di video e di pro...",0,0,0,0,0,2021
CAL,  ,J 60,Attività di programmazione e trasmissione                   ,0,0,0,0,0,2021
CAL,  ,J 61,Telecomunicazioni                                           ,0,0,0,0,0,2021
CAL,  ,J 62,"Produzione di software, consulenza informatica e attività...",0,1,0,0,1,2021
CAL,  ,J 63,Attività dei servizi d'informazione e altri servizi infor...,0,3,0,0,3,2021
CAL,  ,K   ,Attività finanziarie e assicurative                         ,1,1,0,0,2,2021
CAL,  ,K 64,Attività di servizi finanziari (escluse le assicurazioni ...,0,0,0,0,0,2021
CAL,  ,K 65,"Assicurazioni, riassicurazioni e fondi pensione (escluse ...",0,0,0,0,0,2021
CAL,  ,K 66,Attività ausiliarie dei servizi finanziari e delle attivi...,1,1,0,0,2,2021
CAL,  ,L   ,Attivita' immobiliari                                       ,2,1,1,0,4,2021
CAL,  ,L 68,Attivita' immobiliari                                       ,2,1,1,0,4,2021
CAL,  ,M   ,"Attività professionali, scientifiche e tecniche             ",3,2,3,0,8,2021
CAL,  ,M 69,Attività legali e contabilità                               ,1,0,0,0,1,2021
CAL,  ,M 70,Attività di direzione aziendale e di consulenza gestional...,2,0,0,0,2,2021
CAL,  ,M 71,Attività degli studi di architettura e d'ingegneria; coll...,0,2,1,0,3,2021
CAL,  ,M 72,Ricerca scientifica e sviluppo                              ,0,0,0,0,0,2021
CAL,  ,M 73,Pubblicità e ricerche di mercato                            ,0,0,0,0,0,2021
CAL,  ,M 74,"Altre attività professionali, scientifiche e tecniche       ",0,0,2,0,2,2021
CAL,  ,M 75,Servizi veterinari                                          ,0,0,0,0,0,2021
CAL,  ,N   ,"Noleggio, agenzie di viaggio, servizi di supporto alle im...",5,1,2,1,9,2021
CAL,  ,N 77,Attività di noleggio e leasing operativo                    ,3,0,1,0,4,2021
CAL,  ,N 78,"Attività di ricerca, selezione, fornitura di personale      ",0,0,0,0,0,2021
CAL,  ,N 79,"Attività dei servizi delle agenzie di viaggio, dei tour o...",1,0,0,0,1,2021
CAL,  ,N 80,Servizi di vigilanza e investigazione                       ,0,0,0,0,0,2021
CAL,  ,N 81,Attività di servizi per edifici e paesaggio                 ,0,1,1,0,2,2021
CAL,  ,N 82,Attività di supporto per le funzioni d'ufficio e altri se...,1,0,0,1,2,2021
CAL,  ,O   ,Amministrazione pubblica e difesa; assicurazione sociale ...,0,0,0,0,0,2021
CAL,  ,O 84,Amministrazione pubblica e difesa; assicurazione sociale ...,0,0,0,0,0,2021
CAL,  ,P   ,Istruzione                                                  ,0,0,0,0,0,2021
CAL,  ,P 85,Istruzione                                                  ,0,0,0,0,0,2021
CAL,  ,Q   ,Sanita' e assistenza sociale                                ,0,1,0,0,1,2021
CAL,  ,Q 86,Assistenza sanitaria                                        ,0,1,0,0,1,2021
CAL,  ,Q 87,Servizi di assistenza sociale residenziale                  ,0,0,0,0,0,2021
CAL,  ,Q 88,Assistenza sociale non residenziale                         ,0,0,0,0,0,2021
CAL,  ,R   ,"Attività artistiche, sportive, di intrattenimento e diver...",2,0,0,0,2,2021
CAL,  ,R 90,"Attività creative, artistiche e di intrattenimento          ",0,0,0,0,0,2021
CAL,  ,R 91,"Attività di biblioteche, archivi, musei ed altre attività...",0,0,0,0,0,2021
CAL,  ,R 92,"Attività riguardanti le lotterie, le scommesse, le case d...",1,0,0,0,1,2021
CAL,  ,R 93,"Attività sportive, di intrattenimento e di divertimento     ",1,0,0,0,1,2021
CAL,  ,S   ,Altre attività di servizi                                   ,1,3,1,0,5,2021
CAL,  ,S 94,Attività di organizzazioni associative                      ,0,0,0,0,0,2021
CAL,  ,S 95,Riparazione di computer e di beni per uso personale e per...,0,0,0,0,0,2021
CAL,  ,S 96,Altre attività di servizi per la persona                    ,1,3,1,0,5,2021
CAL,  ,T   ,Attività di famiglie e convivenze come datori di lavoro p...,0,0,0,0,0,2021
CAL,  ,T 97,Attività di famiglie e convivenze come datori di lavoro p...,0,0,0,0,0,2021
CAL,  ,T 98,Produzione di beni e servizi indifferenziati per uso prop...,0,0,0,0,0,2021
CAL,  ,U   ,Organizzazioni ed organismi extraterritoriali               ,0,0,0,0,0,2021
CAL,  ,U 99,Organizzazioni ed organismi extraterritoriali               ,0,0,0,0,0,2021
CAL,  ,XX  ,Imprese non classificate                                    ,24,14,0,1,39,2021
CAL,  ,TOT ,TOTALE                                                      ,64,129,77,2,272,2021
CAL,CS,A   ,"Agricoltura, silvicoltura pesca                             ",0,0,0,0,0,2021
CAL,CS,A 01,"Coltivazioni agricole e produzione di prodotti animali, c...",0,0,0,0,0,2021
CAL,CS,A 02,Silvicoltura ed utilizzo di aree forestali                  ,0,0,0,0,0,2021
CAL,CS,A 03,Pesca e acquacoltura                                        ,0,0,0,0,0,2021
CAL,CS,B   ,Estrazione di minerali da cave e miniere                    ,0,0,0,0,0,2021
CAL,CS,B 05,Estrazione di carbone (esclusa torba)                       ,0,0,0,0,0,2021
CAL,CS,B 06,Estraz.di petrolio greggio e di gas naturale                ,0,0,0,0,0,2021
CAL,CS,B 07,Estrazione di minerali metalliferi                          ,0,0,0,0,0,2021
CAL,CS,B 08,Altre attività di estrazione di minerali da cave e miniere  ,0,0,0,0,0,2021
CAL,CS,B 09,Attività dei servizi di supporto all'estrazione             ,0,0,0,0,0,2021
CAL,CS,C   ,Attività manifatturiere                                     ,0,0,0,0,0,2021
CAL,CS,C 10,Industrie alimentari                                        ,0,0,0,0,0,2021
CAL,CS,C 11,Industria delle bevande                                     ,0,0,0,0,0,2021
CAL,CS,C 12,Industria del tabacco                                       ,0,0,0,0,0,2021
CAL,CS,C 13,Industrie tessili                                           ,0,0,0,0,0,2021
CAL,CS,C 14,Confezione di articoli di abbigliamento; confezione di ar...,0,0,0,0,0,2021
CAL,CS,C 15,Fabbricazione di articoli in pelle e simili                 ,0,0,0,0,0,2021
CAL,CS,C 16,Industria del legno e dei prodotti in legno e sughero (es...,0,0,0,0,0,2021
CAL,CS,C 17,Fabbricazione di carta e di prodotti di carta               ,0,0,0,0,0,2021
CAL,CS,C 18,Stampa e riproduzione di supporti registrati                ,0,0,0,0,0,2021
CAL,CS,C 19,Fabbricazione di coke e prodotti derivanti dalla raffinaz...,0,0,0,0,0,2021
CAL,CS,C 20,Fabbricazione di prodotti chimici                           ,0,0,0,0,0,2021
CAL,CS,C 21,Fabbricazione di prodotti farmaceutici di base e di prepa...,0,0,0,0,0,2021
CAL,CS,C 22,Fabbricazione di articoli in gomma e materie plastiche      ,0,0,0,0,0,2021
CAL,CS,C 23,Fabbricazione di altri prodotti della lavorazione di miner..,0,0,0,0,0,2021
CAL,CS,C 24,Metallurgia                                                 ,0,0,0,0,0,2021
CAL,CS,C 25,Fabbricazione di prodotti in metallo (esclusi macchinari ...,0,0,0,0,0,2021
CAL,CS,C 26,Fabbricazione di computer e prodotti di elettronica e ott...,0,0,0,0,0,2021
CAL,CS,C 27,Fabbricazione di apparecchiature elettriche ed apparecchi...,0,0,0,0,0,2021
CAL,CS,C 28,Fabbricazione di macchinari ed apparecchiature nca          ,0,0,0,0,0,2021
CAL,CS,C 29,"Fabbricazione di autoveicoli, rimorchi e semirimorchi       ",0,0,0,0,0,2021
CAL,CS,C 30,Fabbricazione di altri mezzi di trasporto                   ,0,0,0,0,0,2021
CAL,CS,C 31,Fabbricazione di mobili                                     ,0,0,0,0,0,2021
CAL,CS,C 32,Altre industrie manifatturiere                              ,0,0,0,0,0,2021
CAL,CS,C 33,"Riparazione, manutenzione ed installazione di macchine ed...",0,0,0,0,0,2021
CAL,CS,D   ,"Fornitura di energia elettrica, gas, vapore e aria condiz...",0,0,0,0,0,2021
CAL,CS,D 35,"Fornitura di energia elettrica, gas, vapore e aria condiz...",0,0,0,0,0,2021
CAL,CS,E   ,"Fornitura di acqua; reti fognarie, attività di gestione d...",0,0,0,0,0,2021
CAL,CS,E 36,"Raccolta, trattamento e fornitura di acqua                  ",0,0,0,0,0,2021
CAL,CS,E 37,Gestione delle reti fognarie                                ,0,0,0,0,0,2021
CAL,CS,E 38,"Attività di raccolta, trattamento e smaltimento dei rifiu...",0,0,0,0,0,2021
CAL,CS,E 39,Attività di risanamento e altri servizi di gestione dei r...,0,0,0,0,0,2021
CAL,CS,F   ,Costruzioni                                                 ,0,0,0,0,0,2021
CAL,CS,F 41,Costruzione di edifici                                      ,0,0,0,0,0,2021
CAL,CS,F 42,Ingegneria civile                                           ,0,0,0,0,0,2021
CAL,CS,F 43,Lavori di costruzione specializzati                         ,0,0,0,0,0,2021
CAL,CS,G   ,Commercio all'ingrosso e al dettaglio; riparazione di aut...,0,0,0,0,0,2021
CAL,CS,G 45,Commercio all'ingrosso e al dettaglio e riparazione di au...,0,0,0,0,0,2021
CAL,CS,G 46,Commercio all'ingrosso (escluso quello di autoveicoli e d...,0,0,0,0,0,2021
CAL,CS,G 47,Commercio al dettaglio (escluso quello di autoveicoli e d...,0,0,0,0,0,2021
CAL,CS,H   ,Trasporto e magazzinaggio                                   ,0,0,0,0,0,2021
CAL,CS,H 49,Trasporto terrestre e mediante condotte                     ,0,0,0,0,0,2021
CAL,CS,H 50,Trasporto marittimo e per vie d'acqua                       ,0,0,0,0,0,2021
CAL,CS,H 51,Trasporto aereo                                             ,0,0,0,0,0,2021
CAL,CS,H 52,Magazzinaggio e attività di supporto ai trasporti           ,0,0,0,0,0,2021
CAL,CS,H 53,Servizi postali e attività di corriere                      ,0,0,0,0,0,2021
CAL,CS,I   ,Attività dei servizi alloggio e ristorazione                ,0,0,0,0,0,2021
CAL,CS,I 55,Alloggio                                                    ,0,0,0,0,0,2021
CAL,CS,I 56,Attività dei servizi di ristorazione                        ,0,0,0,0,0,2021
CAL,CS,J   ,Servizi di informazione e comunicazione                     ,0,0,0,0,0,2021
CAL,CS,J 58,Attività editoriali                                         ,0,0,0,0,0,2021
CAL,CS,J 59,"Attività di produzione cinematografica, di video e di pro...",0,0,0,0,0,2021
CAL,CS,J 60,Attività di programmazione e trasmissione                   ,0,0,0,0,0,2021
CAL,CS,J 61,Telecomunicazioni                                           ,0,0,0,0,0,2021
CAL,CS,J 62,"Produzione di software, consulenza informatica e attività...",0,0,0,0,0,2021
CAL,CS,J 63,Attività dei servizi d'informazione e altri servizi infor...,0,0,0,0,0,2021
CAL,CS,K   ,Attività finanziarie e assicurative                         ,0,0,0,0,0,2021
CAL,CS,K 64,Attività di servizi finanziari (escluse le assicurazioni ...,0,0,0,0,0,2021
CAL,CS,K 65,"Assicurazioni, riassicurazioni e fondi pensione (escluse ...",0,0,0,0,0,2021
CAL,CS,K 66,Attività ausiliarie dei servizi finanziari e delle attivi...,0,0,0,0,0,2021
CAL,CS,L   ,Attivita' immobiliari                                       ,0,0,0,0,0,2021
CAL,CS,L 68,Attivita' immobiliari                                       ,0,0,0,0,0,2021
CAL,CS,M   ,"Attività professionali, scientifiche e tecniche             ",0,0,0,0,0,2021
CAL,CS,M 69,Attività legali e contabilità                               ,0,0,0,0,0,2021
CAL,CS,M 70,Attività di direzione aziendale e di consulenza gestional...,0,0,0,0,0,2021
CAL,CS,M 71,Attività degli studi di architettura e d'ingegneria; coll...,0,0,0,0,0,2021
CAL,CS,M 72,Ricerca scientifica e sviluppo                              ,0,0,0,0,0,2021
CAL,CS,M 73,Pubblicità e ricerche di mercato                            ,0,0,0,0,0,2021
CAL,CS,M 74,"Altre attività professionali, scientifiche e tecniche       ",0,0,0,0,0,2021
CAL,CS,M 75,Servizi veterinari                                          ,0,0,0,0,0,2021
CAL,CS,N   ,"Noleggio, agenzie di viaggio, servizi di supporto alle im...",0,0,0,1,1,2021
CAL,CS,N 77,Attività di noleggio e leasing operativo                    ,0,0,0,0,0,2021
CAL,CS,N 78,"Attività di ricerca, selezione, fornitura di personale      ",0,0,0,0,0,2021
CAL,CS,N 79,"Attività dei servizi delle agenzie di viaggio, dei tour o...",0,0,0,0,0,2021
CAL,CS,N 80,Servizi di vigilanza e investigazione                       ,0,0,0,0,0,2021
CAL,CS,N 81,Attività di servizi per edifici e paesaggio                 ,0,0,0,0,0,2021
CAL,CS,N 82,Attività di supporto per le funzioni d'ufficio e altri se...,0,0,0,1,1,2021
CAL,CS,O   ,Amministrazione pubblica e difesa; assicurazione sociale ...,0,0,0,0,0,2021
CAL,CS,O 84,Amministrazione pubblica e difesa; assicurazione sociale ...,0,0,0,0,0,2021
CAL,CS,P   ,Istruzione                                                  ,0,0,0,0,0,2021
CAL,CS,P 85,Istruzione                                                  ,0,0,0,0,0,2021
CAL,CS,Q   ,Sanita' e assistenza sociale                                ,0,0,0,0,0,2021
CAL,CS,Q 86,Assistenza sanitaria                                        ,0,0,0,0,0,2021
CAL,CS,Q 87,Servizi di assistenza sociale residenziale                  ,0,0,0,0,0,2021
CAL,CS,Q 88,Assistenza sociale non residenziale                         ,0,0,0,0,0,2021
CAL,CS,R   ,"Attività artistiche, sportive, di intrattenimento e diver...",0,0,0,0,0,2021
CAL,CS,R 90,"Attività creative, artistiche e di intrattenimento          ",0,0,0,0,0,2021
CAL,CS,R 91,"Attività di biblioteche, archivi, musei ed altre attività...",0,0,0,0,0,2021
CAL,CS,R 92,"Attività riguardanti le lotterie, le scommesse, le case d...",0,0,0,0,0,2021
CAL,CS,R 93,"Attività sportive, di intrattenimento e di divertimento     ",0,0,0,0,0,2021
CAL,CS,S   ,Altre attività di servizi                                   ,0,0,0,0,0,2021
CAL,CS,S 94,Attività di organizzazioni associative                      ,0,0,0,0,0,2021
CAL,CS,S 95,Riparazione di computer e di beni per uso personale e per...,0,0,0,0,0,2021
CAL,CS,S 96,Altre attività di servizi per la persona                    ,0,0,0,0,0,2021
CAL,CS,T   ,Attività di famiglie e convivenze come datori di lavoro p...,0,0,0,0,0,2021
CAL,CS,T 97,Attività di famiglie e convivenze come datori di lavoro p...,0,0,0,0,0,2021
CAL,CS,T 98,Produzione di beni e servizi indifferenziati per uso prop...,0,0,0,0,0,2021
CAL,CS,U   ,Organizzazioni ed organismi extraterritoriali               ,0,0,0,0,0,2021
CAL,CS,U 99,Organizzazioni ed organismi extraterritoriali               ,0,0,0,0,0,2021
CAL,CS,XX  ,Imprese non classificate                                    ,0,0,0,0,0,2021
CAL,CS,TOT ,TOTALE                                                      ,0,0,0,1,1,2021
CAL,CZ,A   ,"Agricoltura, silvicoltura pesca                             ",1,0,4,0,5,2021
CAL,CZ,A 01,"Coltivazioni agricole e produzione di prodotti animali, c...",1,0,3,0,4,2021
CAL,CZ,A 02,Silvicoltura ed utilizzo di aree forestali                  ,0,0,1,0,1,2021
CAL,CZ,A 03,Pesca e acquacoltura                                        ,0,0,0,0,0,2021
CAL,CZ,B   ,Estrazione di minerali da cave e miniere                    ,0,0,0,0,0,2021
CAL,CZ,B 05,Estrazione di carbone (esclusa torba)                       ,0,0,0,0,0,2021
CAL,CZ,B 06,Estraz.di petrolio greggio e di gas naturale                ,0,0,0,0,0,2021
CAL,CZ,B 07,Estrazione di minerali metalliferi                          ,0,0,0,0,0,2021
CAL,CZ,B 08,Altre attività di estrazione di minerali da cave e miniere  ,0,0,0,0,0,2021
CAL,CZ,B 09,Attività dei servizi di supporto all'estrazione             ,0,0,0,0,0,2021
CAL,CZ,C   ,Attività manifatturiere                                     ,4,3,7,0,14,2021
CAL,CZ,C 10,Industrie alimentari                                        ,2,1,1,0,4,2021
CAL,CZ,C 11,Industria delle bevande                                     ,0,0,0,0,0,2021
CAL,CZ,C 12,Industria del tabacco                                       ,0,0,0,0,0,2021
CAL,CZ,C 13,Industrie tessili                                           ,0,0,0,0,0,2021
CAL,CZ,C 14,Confezione di articoli di abbigliamento; confezione di ar...,0,0,0,0,0,2021
CAL,CZ,C 15,Fabbricazione di articoli in pelle e simili                 ,0,0,0,0,0,2021
CAL,CZ,C 16,Industria del legno e dei prodotti in legno e sughero (es...,1,0,3,0,4,2021
CAL,CZ,C 17,Fabbricazione di carta e di prodotti di carta               ,0,0,0,0,0,2021
CAL,CZ,C 18,Stampa e riproduzione di supporti registrati                ,0,0,0,0,0,2021
CAL,CZ,C 19,Fabbricazione di coke e prodotti derivanti dalla raffinaz...,0,0,0,0,0,2021
CAL,CZ,C 20,Fabbricazione di prodotti chimici                           ,0,0,0,0,0,2021
CAL,CZ,C 21,Fabbricazione di prodotti farmaceutici di base e di prepa...,0,0,0,0,0,2021
CAL,CZ,C 22,Fabbricazione di articoli in gomma e materie plastiche      ,1,0,0,0,1,2021
CAL,CZ,C 23,Fabbricazione di altri prodotti della lavorazione di miner..,0,1,2,0,3,2021
CAL,CZ,C 24,Metallurgia                                                 ,0,0,0,0,0,2021
CAL,CZ,C 25,Fabbricazione di prodotti in metallo (esclusi macchinari ...,0,0,0,0,0,2021
CAL,CZ,C 26,Fabbricazione di computer e prodotti di elettronica e ott...,0,0,0,0,0,2021
CAL,CZ,C 27,Fabbricazione di apparecchiature elettriche ed apparecchi...,0,0,0,0,0,2021
CAL,CZ,C 28,Fabbricazione di macchinari ed apparecchiature nca          ,0,0,0,0,0,2021
CAL,CZ,C 29,"Fabbricazione di autoveicoli, rimorchi e semirimorchi       ",0,0,0,0,0,2021
CAL,CZ,C 30,Fabbricazione di altri mezzi di trasporto                   ,0,0,0,0,0,2021
CAL,CZ,C 31,Fabbricazione di mobili                                     ,0,0,0,0,0,2021
CAL,CZ,C 32,Altre industrie manifatturiere                              ,0,1,1,0,2,2021
CAL,CZ,C 33,"Riparazione, manutenzione ed installazione di macchine ed...",0,0,0,0,0,2021
CAL,CZ,D   ,"Fornitura di energia elettrica, gas, vapore e aria condiz...",0,0,0,0,0,2021
CAL,CZ,D 35,"Fornitura di energia elettrica, gas, vapore e aria condiz...",0,0,0,0,0,2021
CAL,CZ,E   ,"Fornitura di acqua; reti fognarie, attività di gestione d...",0,0,0,0,0,2021
CAL,CZ,E 36,"Raccolta, trattamento e fornitura di acqua                  ",0,0,0,0,0,2021
CAL,CZ,E 37,Gestione delle reti fognarie                                ,0,0,0,0,0,2021
CAL,CZ,E 38,"Attività di raccolta, trattamento e smaltimento dei rifiu...",0,0,0,0,0,2021
CAL,CZ,E 39,Attività di risanamento e altri servizi di gestione dei r...,0,0,0,0,0,2021
CAL,CZ,F   ,Costruzioni                                                 ,5,1,11,0,17,2021
CAL,CZ,F 41,Costruzione di edifici                                      ,4,0,9,0,13,2021
CAL,CZ,F 42,Ingegneria civile                                           ,0,0,0,0,0,2021
CAL,CZ,F 43,Lavori di costruzione specializzati                         ,1,1,2,0,4,2021
CAL,CZ,G   ,Commercio all'ingrosso e al dettaglio; riparazione di aut...,15,2,26,0,43,2021
CAL,CZ,G 45,Commercio all'ingrosso e al dettaglio e riparazione di au...,0,1,2,0,3,2021
CAL,CZ,G 46,Commercio all'ingrosso (escluso quello di autoveicoli e d...,10,1,6,0,17,2021
CAL,CZ,G 47,Commercio al dettaglio (escluso quello di autoveicoli e d...,5,0,18,0,23,2021
CAL,CZ,H   ,Trasporto e magazzinaggio                                   ,0,0,9,0,9,2021
CAL,CZ,H 49,Trasporto terrestre e mediante condotte                     ,0,0,9,0,9,2021
CAL,CZ,H 50,Trasporto marittimo e per vie d'acqua                       ,0,0,0,0,0,2021
CAL,CZ,H 51,Trasporto aereo                                             ,0,0,0,0,0,2021
CAL,CZ,H 52,Magazzinaggio e attività di supporto ai trasporti           ,0,0,0,0,0,2021
CAL,CZ,H 53,Servizi postali e attività di corriere                      ,0,0,0,0,0,2021
CAL,CZ,I   ,Attività dei servizi alloggio e ristorazione                ,1,3,1,0,5,2021
CAL,CZ,I 55,Alloggio                                                    ,0,0,0,0,0,2021
CAL,CZ,I 56,Attività dei servizi di ristorazione                        ,1,3,1,0,5,2021
CAL,CZ,J   ,Servizi di informazione e comunicazione                     ,0,3,0,0,3,2021
CAL,CZ,J 58,Attività editoriali                                         ,0,0,0,0,0,2021
CAL,CZ,J 59,"Attività di produzione cinematografica, di video e di pro...",0,0,0,0,0,2021
CAL,CZ,J 60,Attività di programmazione e trasmissione                   ,0,0,0,0,0,2021
CAL,CZ,J 61,Telecomunicazioni                                           ,0,0,0,0,0,2021
CAL,CZ,J 62,"Produzione di software, consulenza informatica e attività...",0,1,0,0,1,2021
CAL,CZ,J 63,Attività dei servizi d'informazione e altri servizi infor...,0,2,0,0,2,2021
CAL,CZ,K   ,Attività finanziarie e assicurative                         ,1,0,0,0,1,2021
CAL,CZ,K 64,Attività di servizi finanziari (escluse le assicurazioni ...,0,0,0,0,0,2021
CAL,CZ,K 65,"Assicurazioni, riassicurazioni e fondi pensione (escluse ...",0,0,0,0,0,2021
CAL,CZ,K 66,Attività ausiliarie dei servizi finanziari e delle attivi...,1,0,0,0,1,2021
CAL,CZ,L   ,Attivita' immobiliari                                       ,2,1,1,0,4,2021
CAL,CZ,L 68,Attivita' immobiliari                                       ,2,1,1,0,4,2021
CAL,CZ,M   ,"Attività professionali, scientifiche e tecniche             ",3,0,3,0,6,2021
CAL,CZ,M 69,Attività legali e contabilità                               ,1,0,0,0,1,2021
CAL,CZ,M 70,Attività di direzione aziendale e di consulenza gestional...,2,0,0,0,2,2021
CAL,CZ,M 71,Attività degli studi di architettura e d'ingegneria; coll...,0,0,1,0,1,2021
CAL,CZ,M 72,Ricerca scientifica e sviluppo                              ,0,0,0,0,0,2021
CAL,CZ,M 73,Pubblicità e ricerche di mercato                            ,0,0,0,0,0,2021
CAL,CZ,M 74,"Altre attività professionali, scientifiche e tecniche       ",0,0,2,0,2,2021
CAL,CZ,M 75,Servizi veterinari                                          ,0,0,0,0,0,2021
CAL,CZ,N   ,"Noleggio, agenzie di viaggio, servizi di supporto alle im...",4,0,1,0,5,2021
CAL,CZ,N 77,Attività di noleggio e leasing operativo                    ,2,0,1,0,3,2021
CAL,CZ,N 78,"Attività di ricerca, selezione, fornitura di personale      ",0,0,0,0,0,2021
CAL,CZ,N 79,"Attività dei servizi delle agenzie di viaggio, dei tour o...",1,0,0,0,1,2021
CAL,CZ,N 80,Servizi di vigilanza e investigazione                       ,0,0,0,0,0,2021
CAL,CZ,N 81,Attività di servizi per edifici e paesaggio                 ,0,0,0,0,0,2021
CAL,CZ,N 82,Attività di supporto per le funzioni d'ufficio e altri se...,1,0,0,0,1,2021
CAL,CZ,O   ,Amministrazione pubblica e difesa; assicurazione sociale ...,0,0,0,0,0,2021
CAL,CZ,O 84,Amministrazione pubblica e difesa; assicurazione sociale ...,0,0,0,0,0,2021
CAL,CZ,P   ,Istruzione                                                  ,0,0,0,0,0,2021
CAL,CZ,P 85,Istruzione                                                  ,0,0,0,0,0,2021
CAL,CZ,Q   ,Sanita' e assistenza sociale                                ,0,0,0,0,0,2021
CAL,CZ,Q 86,Assistenza sanitaria                                        ,0,0,0,0,0,2021
CAL,CZ,Q 87,Servizi di assistenza sociale residenziale                  ,0,0,0,0,0,2021
CAL,CZ,Q 88,Assistenza sociale non residenziale                         ,0,0,0,0,0,2021
CAL,CZ,R   ,"Attività artistiche, sportive, di intrattenimento e diver...",2,0,0,0,2,2021
CAL,CZ,R 90,"Attività creative, artistiche e di intrattenimento          ",0,0,0,0,0,2021
CAL,CZ,R 91,"Attività di biblioteche, archivi, musei ed altre attività...",0,0,0,0,0,2021
CAL,CZ,R 92,"Attività riguardanti le lotterie, le scommesse, le case d...",1,0,0,0,1,2021
CAL,CZ,R 93,"Attività sportive, di intrattenimento e di divertimento     ",1,0,0,0,1,2021
CAL,CZ,S   ,Altre attività di servizi                                   ,1,1,0,0,2,2021
CAL,CZ,S 94,Attività di organizzazioni associative                      ,0,0,0,0,0,2021
CAL,CZ,S 95,Riparazione di computer e di beni per uso personale e per...,0,0,0,0,0,2021
CAL,CZ,S 96,Altre attività di servizi per la persona                    ,1,1,0,0,2,2021
CAL,CZ,T   ,Attività di famiglie e convivenze come datori di lavoro p...,0,0,0,0,0,2021
CAL,CZ,T 97,Attività di famiglie e convivenze come datori di lavoro p...,0,0,0,0,0,2021
CAL,CZ,T 98,Produzione di beni e servizi indifferenziati per uso prop...,0,0,0,0,0,2021
CAL,CZ,U   ,Organizzazioni ed organismi extraterritoriali               ,0,0,0,0,0,2021
CAL,CZ,U 99,Organizzazioni ed organismi extraterritoriali               ,0,0,0,0,0,2021
CAL,CZ,XX  ,Imprese non classificate                                    ,23,3,0,0,26,2021
CAL,CZ,TOT ,TOTALE                                                      ,62,17,63,0,142,2021
CAL,RC,A   ,"Agricoltura, silvicoltura pesca                             ",0,1,3,0,4,2021
CAL,RC,A 01,"Coltivazioni agricole e produzione di prodotti animali, c...",0,1,3,0,4,2021
CAL,RC,A 02,Silvicoltura ed utilizzo di aree forestali                  ,0,0,0,0,0,2021
CAL,RC,A 03,Pesca e acquacoltura                                        ,0,0,0,0,0,2021
CAL,RC,B   ,Estrazione di minerali da cave e miniere                    ,0,0,0,0,0,2021
CAL,RC,B 05,Estrazione di carbone (esclusa torba)                       ,0,0,0,0,0,2021
CAL,RC,B 06,Estraz.di petrolio greggio e di gas naturale                ,0,0,0,0,0,2021
CAL,RC,B 07,Estrazione di minerali metalliferi                          ,0,0,0,0,0,2021
CAL,RC,B 08,Altre attività di estrazione di minerali da cave e miniere  ,0,0,0,0,0,2021
CAL,RC,B 09,Attività dei servizi di supporto all'estrazione             ,0,0,0,0,0,2021
CAL,RC,C   ,Attività manifatturiere                                     ,0,15,0,0,15,2021
CAL,RC,C 10,Industrie alimentari                                        ,0,7,0,0,7,2021
CAL,RC,C 11,Industria delle bevande                                     ,0,0,0,0,0,2021
CAL,RC,C 12,Industria del tabacco                                       ,0,0,0,0,0,2021
CAL,RC,C 13,Industrie tessili                                           ,0,0,0,0,0,2021
CAL,RC,C 14,Confezione di articoli di abbigliamento; confezione di ar...,0,0,0,0,0,2021
CAL,RC,C 15,Fabbricazione di articoli in pelle e simili                 ,0,0,0,0,0,2021
CAL,RC,C 16,Industria del legno e dei prodotti in legno e sughero (es...,0,0,0,0,0,2021
CAL,RC,C 17,Fabbricazione di carta e di prodotti di carta               ,0,1,0,0,1,2021
CAL,RC,C 18,Stampa e riproduzione di supporti registrati                ,0,1,0,0,1,2021
CAL,RC,C 19,Fabbricazione di coke e prodotti derivanti dalla raffinaz...,0,0,0,0,0,2021
CAL,RC,C 20,Fabbricazione di prodotti chimici                           ,0,1,0,0,1,2021
CAL,RC,C 21,Fabbricazione di prodotti farmaceutici di base e di prepa...,0,0,0,0,0,2021
CAL,RC,C 22,Fabbricazione di articoli in gomma e materie plastiche      ,0,0,0,0,0,2021
CAL,RC,C 23,Fabbricazione di altri prodotti della lavorazione di miner..,0,0,0,0,0,2021
CAL,RC,C 24,Metallurgia                                                 ,0,0,0,0,0,2021
CAL,RC,C 25,Fabbricazione di prodotti in metallo (esclusi macchinari ...,0,1,0,0,1,2021
CAL,RC,C 26,Fabbricazione di computer e prodotti di elettronica e ott...,0,1,0,0,1,2021
CAL,RC,C 27,Fabbricazione di apparecchiature elettriche ed apparecchi...,0,0,0,0,0,2021
CAL,RC,C 28,Fabbricazione di macchinari ed apparecchiature nca          ,0,1,0,0,1,2021
CAL,RC,C 29,"Fabbricazione di autoveicoli, rimorchi e semirimorchi       ",0,0,0,0,0,2021
CAL,RC,C 30,Fabbricazione di altri mezzi di trasporto                   ,0,0,0,0,0,2021
CAL,RC,C 31,Fabbricazione di mobili                                     ,0,2,0,0,2,2021
CAL,RC,C 32,Altre industrie manifatturiere                              ,0,0,0,0,0,2021
CAL,RC,C 33,"Riparazione, manutenzione ed installazione di macchine ed...",0,0,0,0,0,2021
CAL,RC,D   ,"Fornitura di energia elettrica, gas, vapore e aria condiz...",0,0,0,0,0,2021
CAL,RC,D 35,"Fornitura di energia elettrica, gas, vapore e aria condiz...",0,0,0,0,0,2021
CAL,RC,E   ,"Fornitura di acqua; reti fognarie, attività di gestione d...",0,1,0,0,1,2021
CAL,RC,E 36,"Raccolta, trattamento e fornitura di acqua                  ",0,0,0,0,0,2021
CAL,RC,E 37,Gestione delle reti fognarie                                ,0,0,0,0,0,2021
CAL,RC,E 38,"Attività di raccolta, trattamento e smaltimento dei rifiu...",0,1,0,0,1,2021
CAL,RC,E 39,Attività di risanamento e altri servizi di gestione dei r...,0,0,0,0,0,2021
CAL,RC,F   ,Costruzioni                                                 ,0,8,0,0,8,2021
CAL,RC,F 41,Costruzione di edifici                                      ,0,5,0,0,5,2021
CAL,RC,F 42,Ingegneria civile                                           ,0,1,0,0,1,2021
CAL,RC,F 43,Lavori di costruzione specializzati                         ,0,2,0,0,2,2021
CAL,RC,G   ,Commercio all'ingrosso e al dettaglio; riparazione di aut...,0,61,5,0,66,2021
CAL,RC,G 45,Commercio all'ingrosso e al dettaglio e riparazione di au...,0,7,0,0,7,2021
CAL,RC,G 46,Commercio all'ingrosso (escluso quello di autoveicoli e d...,0,28,2,0,30,2021
CAL,RC,G 47,Commercio al dettaglio (escluso quello di autoveicoli e d...,0,26,3,0,29,2021
CAL,RC,H   ,Trasporto e magazzinaggio                                   ,0,3,0,0,3,2021
CAL,RC,H 49,Trasporto terrestre e mediante condotte                     ,0,2,0,0,2,2021
CAL,RC,H 50,Trasporto marittimo e per vie d'acqua                       ,0,0,0,0,0,2021
CAL,RC,H 51,Trasporto aereo                                             ,0,0,0,0,0,2021
CAL,RC,H 52,Magazzinaggio e attività di supporto ai trasporti           ,0,1,0,0,1,2021
CAL,RC,H 53,Servizi postali e attività di corriere                      ,0,0,0,0,0,2021
CAL,RC,I   ,Attività dei servizi alloggio e ristorazione                ,0,3,0,0,3,2021
CAL,RC,I 55,Alloggio                                                    ,0,1,0,0,1,2021
CAL,RC,I 56,Attività dei servizi di ristorazione                        ,0,2,0,0,2,2021
CAL,RC,J   ,Servizi di informazione e comunicazione                     ,0,2,0,0,2,2021
CAL,RC,J 58,Attività editoriali                                         ,0,1,0,0,1,2021
CAL,RC,J 59,"Attività di produzione cinematografica, di video e di pro...",0,0,0,0,0,2021
CAL,RC,J 60,Attività di programmazione e trasmissione                   ,0,0,0,0,0,2021
CAL,RC,J 61,Telecomunicazioni                                           ,0,0,0,0,0,2021
CAL,RC,J 62,"Produzione di software, consulenza informatica e attività...",0,0,0,0,0,2021
CAL,RC,J 63,Attività dei servizi d'informazione e altri servizi infor...,0,1,0,0,1,2021
CAL,RC,K   ,Attività finanziarie e assicurative                         ,0,1,0,0,1,2021
CAL,RC,K 64,Attività di servizi finanziari (escluse le assicurazioni ...,0,0,0,0,0,2021
CAL,RC,K 65,"Assicurazioni, riassicurazioni e fondi pensione (escluse ...",0,0,0,0,0,2021
CAL,RC,K 66,Attività ausiliarie dei servizi finanziari e delle attivi...,0,1,0,0,1,2021
CAL,RC,L   ,Attivita' immobiliari                                       ,0,0,0,0,0,2021
CAL,RC,L 68,Attivita' immobiliari                                       ,0,0,0,0,0,2021
CAL,RC,M   ,"Attività professionali, scientifiche e tecniche             ",0,2,0,0,2,2021
CAL,RC,M 69,Attività legali e contabilità                               ,0,0,0,0,0,2021
CAL,RC,M 70,Attività di direzione aziendale e di consulenza gestional...,0,0,0,0,0,2021
CAL,RC,M 71,Attività degli studi di architettura e d'ingegneria; coll...,0,2,0,0,2,2021
CAL,RC,M 72,Ricerca scientifica e sviluppo                              ,0,0,0,0,0,2021
CAL,RC,M 73,Pubblicità e ricerche di mercato                            ,0,0,0,0,0,2021
CAL,RC,M 74,"Altre attività professionali, scientifiche e tecniche       ",0,0,0,0,0,2021
CAL,RC,M 75,Servizi veterinari                                          ,0,0,0,0,0,2021
CAL,RC,N   ,"Noleggio, agenzie di viaggio, servizi di supporto alle im...",1,1,1,0,3,2021
CAL,RC,N 77,Attività di noleggio e leasing operativo                    ,1,0,0,0,1,2021
CAL,RC,N 78,"Attività di ricerca, selezione, fornitura di personale      ",0,0,0,0,0,2021
CAL,RC,N 79,"Attività dei servizi delle agenzie di viaggio, dei tour o...",0,0,0,0,0,2021
CAL,RC,N 80,Servizi di vigilanza e investigazione                       ,0,0,0,0,0,2021
CAL,RC,N 81,Attività di servizi per edifici e paesaggio                 ,0,1,1,0,2,2021
CAL,RC,N 82,Attività di supporto per le funzioni d'ufficio e altri se...,0,0,0,0,0,2021
CAL,RC,O   ,Amministrazione pubblica e difesa; assicurazione sociale ...,0,0,0,0,0,2021
CAL,RC,O 84,Amministrazione pubblica e difesa; assicurazione sociale ...,0,0,0,0,0,2021
CAL,RC,P   ,Istruzione                                                  ,0,0,0,0,0,2021
CAL,RC,P 85,Istruzione                                                  ,0,0,0,0,0,2021
CAL,RC,Q   ,Sanita' e assistenza sociale                                ,0,1,0,0,1,2021
CAL,RC,Q 86,Assistenza sanitaria                                        ,0,1,0,0,1,2021
CAL,RC,Q 87,Servizi di assistenza sociale residenziale                  ,0,0,0,0,0,2021
CAL,RC,Q 88,Assistenza sociale non residenziale                         ,0,0,0,0,0,2021
CAL,RC,R   ,"Attività artistiche, sportive, di intrattenimento e diver...",0,0,0,0,0,2021
CAL,RC,R 90,"Attività creative, artistiche e di intrattenimento          ",0,0,0,0,0,2021
CAL,RC,R 91,"Attività di biblioteche, archivi, musei ed altre attività...",0,0,0,0,0,2021
CAL,RC,R 92,"Attività riguardanti le lotterie, le scommesse, le case d...",0,0,0,0,0,2021
CAL,RC,R 93,"Attività sportive, di intrattenimento e di divertimento     ",0,0,0,0,0,2021
CAL,RC,S   ,Altre attività di servizi                                   ,0,2,1,0,3,2021
CAL,RC,S 94,Attività di organizzazioni associative                      ,0,0,0,0,0,2021
CAL,RC,S 95,Riparazione di computer e di beni per uso personale e per...,0,0,0,0,0,2021
CAL,RC,S 96,Altre attività di servizi per la persona                    ,0,2,1,0,3,2021
CAL,RC,T   ,Attività di famiglie e convivenze come datori di lavoro p...,0,0,0,0,0,2021
CAL,RC,T 97,Attività di famiglie e convivenze come datori di lavoro p...,0,0,0,0,0,2021
CAL,RC,T 98,Produzione di beni e servizi indifferenziati per uso prop...,0,0,0,0,0,2021
CAL,RC,U   ,Organizzazioni ed organismi extraterritoriali               ,0,0,0,0,0,2021
CAL,RC,U 99,Organizzazioni ed organismi extraterritoriali               ,0,0,0,0,0,2021
CAL,RC,XX  ,Imprese non classificate                                    ,1,11,0,1,13,2021
CAL,RC,TOT ,TOTALE                                                      ,2,112,10,1,125,2021
CAL,KR,A   ,"Agricoltura, silvicoltura pesca                             ",0,0,1,0,1,2021
CAL,KR,A 01,"Coltivazioni agricole e produzione di prodotti animali, c...",0,0,1,0,1,2021
CAL,KR,A 02,Silvicoltura ed utilizzo di aree forestali                  ,0,0,0,0,0,2021
CAL,KR,A 03,Pesca e acquacoltura                                        ,0,0,0,0,0,2021
CAL,KR,B   ,Estrazione di minerali da cave e miniere                    ,0,0,0,0,0,2021
CAL,KR,B 05,Estrazione di carbone (esclusa torba)                       ,0,0,0,0,0,2021
CAL,KR,B 06,Estraz.di petrolio greggio e di gas naturale                ,0,0,0,0,0,2021
CAL,KR,B 07,Estrazione di minerali metalliferi                          ,0,0,0,0,0,2021
CAL,KR,B 08,Altre attività di estrazione di minerali da cave e miniere  ,0,0,0,0,0,2021
CAL,KR,B 09,Attività dei servizi di supporto all'estrazione             ,0,0,0,0,0,2021
CAL,KR,C   ,Attività manifatturiere                                     ,0,0,0,0,0,2021
CAL,KR,C 10,Industrie alimentari                                        ,0,0,0,0,0,2021
CAL,KR,C 11,Industria delle bevande                                     ,0,0,0,0,0,2021
CAL,KR,C 12,Industria del tabacco                                       ,0,0,0,0,0,2021
CAL,KR,C 13,Industrie tessili                                           ,0,0,0,0,0,2021
CAL,KR,C 14,Confezione di articoli di abbigliamento; confezione di ar...,0,0,0,0,0,2021
CAL,KR,C 15,Fabbricazione di articoli in pelle e simili                 ,0,0,0,0,0,2021
CAL,KR,C 16,Industria del legno e dei prodotti in legno e sughero (es...,0,0,0,0,0,2021
CAL,KR,C 17,Fabbricazione di carta e di prodotti di carta               ,0,0,0,0,0,2021
CAL,KR,C 18,Stampa e riproduzione di supporti registrati                ,0,0,0,0,0,2021
CAL,KR,C 19,Fabbricazione di coke e prodotti derivanti dalla raffinaz...,0,0,0,0,0,2021
CAL,KR,C 20,Fabbricazione di prodotti chimici                           ,0,0,0,0,0,2021
CAL,KR,C 21,Fabbricazione di prodotti farmaceutici di base e di prepa...,0,0,0,0,0,2021
CAL,KR,C 22,Fabbricazione di articoli in gomma e materie plastiche      ,0,0,0,0,0,2021
CAL,KR,C 23,Fabbricazione di altri prodotti della lavorazione di miner..,0,0,0,0,0,2021
CAL,KR,C 24,Metallurgia                                                 ,0,0,0,0,0,2021
CAL,KR,C 25,Fabbricazione di prodotti in metallo (esclusi macchinari ...,0,0,0,0,0,2021
CAL,KR,C 26,Fabbricazione di computer e prodotti di elettronica e ott...,0,0,0,0,0,2021
CAL,KR,C 27,Fabbricazione di apparecchiature elettriche ed apparecchi...,0,0,0,0,0,2021
CAL,KR,C 28,Fabbricazione di macchinari ed apparecchiature nca          ,0,0,0,0,0,2021
CAL,KR,C 29,"Fabbricazione di autoveicoli, rimorchi e semirimorchi       ",0,0,0,0,0,2021
CAL,KR,C 30,Fabbricazione di altri mezzi di trasporto                   ,0,0,0,0,0,2021
CAL,KR,C 31,Fabbricazione di mobili                                     ,0,0,0,0,0,2021
CAL,KR,C 32,Altre industrie manifatturiere                              ,0,0,0,0,0,2021
CAL,KR,C 33,"Riparazione, manutenzione ed installazione di macchine ed...",0,0,0,0,0,2021
CAL,KR,D   ,"Fornitura di energia elettrica, gas, vapore e aria condiz...",0,0,0,0,0,2021
CAL,KR,D 35,"Fornitura di energia elettrica, gas, vapore e aria condiz...",0,0,0,0,0,2021
CAL,KR,E   ,"Fornitura di acqua; reti fognarie, attività di gestione d...",0,0,0,0,0,2021
CAL,KR,E 36,"Raccolta, trattamento e fornitura di acqua                  ",0,0,0,0,0,2021
CAL,KR,E 37,Gestione delle reti fognarie                                ,0,0,0,0,0,2021
CAL,KR,E 38,"Attività di raccolta, trattamento e smaltimento dei rifiu...",0,0,0,0,0,2021
CAL,KR,E 39,Attività di risanamento e altri servizi di gestione dei r...,0,0,0,0,0,2021
CAL,KR,F   ,Costruzioni                                                 ,0,0,0,0,0,2021
CAL,KR,F 41,Costruzione di edifici                                      ,0,0,0,0,0,2021
CAL,KR,F 42,Ingegneria civile                                           ,0,0,0,0,0,2021
CAL,KR,F 43,Lavori di costruzione specializzati                         ,0,0,0,0,0,2021
CAL,KR,G   ,Commercio all'ingrosso e al dettaglio; riparazione di aut...,0,0,2,0,2,2021
CAL,KR,G 45,Commercio all'ingrosso e al dettaglio e riparazione di au...,0,0,0,0,0,2021
CAL,KR,G 46,Commercio all'ingrosso (escluso quello di autoveicoli e d...,0,0,1,0,1,2021
CAL,KR,G 47,Commercio al dettaglio (escluso quello di autoveicoli e d...,0,0,1,0,1,2021
CAL,KR,H   ,Trasporto e magazzinaggio                                   ,0,0,1,0,1,2021
CAL,KR,H 49,Trasporto terrestre e mediante condotte                     ,0,0,1,0,1,2021
CAL,KR,H 50,Trasporto marittimo e per vie d'acqua                       ,0,0,0,0,0,2021
CAL,KR,H 51,Trasporto aereo                                             ,0,0,0,0,0,2021
CAL,KR,H 52,Magazzinaggio e attività di supporto ai trasporti           ,0,0,0,0,0,2021
CAL,KR,H 53,Servizi postali e attività di corriere                      ,0,0,0,0,0,2021
CAL,KR,I   ,Attività dei servizi alloggio e ristorazione                ,0,0,0,0,0,2021
CAL,KR,I 55,Alloggio                                                    ,0,0,0,0,0,2021
CAL,KR,I 56,Attività dei servizi di ristorazione                        ,0,0,0,0,0,2021
CAL,KR,J   ,Servizi di informazione e comunicazione                     ,0,0,0,0,0,2021
CAL,KR,J 58,Attività editoriali                                         ,0,0,0,0,0,2021
CAL,KR,J 59,"Attività di produzione cinematografica, di video e di pro...",0,0,0,0,0,2021
CAL,KR,J 60,Attività di programmazione e trasmissione                   ,0,0,0,0,0,2021
CAL,KR,J 61,Telecomunicazioni                                           ,0,0,0,0,0,2021
CAL,KR,J 62,"Produzione di software, consulenza informatica e attività...",0,0,0,0,0,2021
CAL,KR,J 63,Attività dei servizi d'informazione e altri servizi infor...,0,0,0,0,0,2021
CAL,KR,K   ,Attività finanziarie e assicurative                         ,0,0,0,0,0,2021
CAL,KR,K 64,Attività di servizi finanziari (escluse le assicurazioni ...,0,0,0,0,0,2021
CAL,KR,K 65,"Assicurazioni, riassicurazioni e fondi pensione (escluse ...",0,0,0,0,0,2021
CAL,KR,K 66,Attività ausiliarie dei servizi finanziari e delle attivi...,0,0,0,0,0,2021
CAL,KR,L   ,Attivita' immobiliari                                       ,0,0,0,0,0,2021
CAL,KR,L 68,Attivita' immobiliari                                       ,0,0,0,0,0,2021
CAL,KR,M   ,"Attività professionali, scientifiche e tecniche             ",0,0,0,0,0,2021
CAL,KR,M 69,Attività legali e contabilità                               ,0,0,0,0,0,2021
CAL,KR,M 70,Attività di direzione aziendale e di consulenza gestional...,0,0,0,0,0,2021
CAL,KR,M 71,Attività degli studi di architettura e d'ingegneria; coll...,0,0,0,0,0,2021
CAL,KR,M 72,Ricerca scientifica e sviluppo                              ,0,0,0,0,0,2021
CAL,KR,M 73,Pubblicità e ricerche di mercato                            ,0,0,0,0,0,2021
CAL,KR,M 74,"Altre attività professionali, scientifiche e tecniche       ",0,0,0,0,0,2021
CAL,KR,M 75,Servizi veterinari                                          ,0,0,0,0,0,2021
CAL,KR,N   ,"Noleggio, agenzie di viaggio, servizi di supporto alle im...",0,0,0,0,0,2021
CAL,KR,N 77,Attività di noleggio e leasing operativo                    ,0,0,0,0,0,2021
CAL,KR,N 78,"Attività di ricerca, selezione, fornitura di personale      ",0,0,0,0,0,2021
CAL,KR,N 79,"Attività dei servizi delle agenzie di viaggio, dei tour o...",0,0,0,0,0,2021
CAL,KR,N 80,Servizi di vigilanza e investigazione                       ,0,0,0,0,0,2021
CAL,KR,N 81,Attività di servizi per edifici e paesaggio                 ,0,0,0,0,0,2021
CAL,KR,N 82,Attività di supporto per le funzioni d'ufficio e altri se...,0,0,0,0,0,2021
CAL,KR,O   ,Amministrazione pubblica e difesa; assicurazione sociale ...,0,0,0,0,0,2021
CAL,KR,O 84,Amministrazione pubblica e difesa; assicurazione sociale ...,0,0,0,0,0,2021
CAL,KR,P   ,Istruzione                                                  ,0,0,0,0,0,2021
CAL,KR,P 85,Istruzione                                                  ,0,0,0,0,0,2021
CAL,KR,Q   ,Sanita' e assistenza sociale                                ,0,0,0,0,0,2021
CAL,KR,Q 86,Assistenza sanitaria                                        ,0,0,0,0,0,2021
CAL,KR,Q 87,Servizi di assistenza sociale residenziale                  ,0,0,0,0,0,2021
CAL,KR,Q 88,Assistenza sociale non residenziale                         ,0,0,0,0,0,2021
CAL,KR,R   ,"Attività artistiche, sportive, di intrattenimento e diver...",0,0,0,0,0,2021
CAL,KR,R 90,"Attività creative, artistiche e di intrattenimento          ",0,0,0,0,0,2021
CAL,KR,R 91,"Attività di biblioteche, archivi, musei ed altre attività...",0,0,0,0,0,2021
CAL,KR,R 92,"Attività riguardanti le lotterie, le scommesse, le case d...",0,0,0,0,0,2021
CAL,KR,R 93,"Attività sportive, di intrattenimento e di divertimento     ",0,0,0,0,0,2021
CAL,KR,S   ,Altre attività di servizi                                   ,0,0,0,0,0,2021
CAL,KR,S 94,Attività di organizzazioni associative                      ,0,0,0,0,0,2021
CAL,KR,S 95,Riparazione di computer e di beni per uso personale e per...,0,0,0,0,0,2021
CAL,KR,S 96,Altre attività di servizi per la persona                    ,0,0,0,0,0,2021
CAL,KR,T   ,Attività di famiglie e convivenze come datori di lavoro p...,0,0,0,0,0,2021
CAL,KR,T 97,Attività di famiglie e convivenze come datori di lavoro p...,0,0,0,0,0,2021
CAL,KR,T 98,Produzione di beni e servizi indifferenziati per uso prop...,0,0,0,0,0,2021
CAL,KR,U   ,Organizzazioni ed organismi extraterritoriali               ,0,0,0,0,0,2021
CAL,KR,U 99,Organizzazioni ed organismi extraterritoriali               ,0,0,0,0,0,2021
CAL,KR,XX  ,Imprese non classificate                                    ,0,0,0,0,0,2021
CAL,KR,TOT ,TOTALE                                                      ,0,0,4,0,4,2021
CAL,VV,A   ,"Agricoltura, silvicoltura pesca                             ",0,0,0,0,0,2021
CAL,VV,A 01,"Coltivazioni agricole e produzione di prodotti animali, c...",0,0,0,0,0,2021
CAL,VV,A 02,Silvicoltura ed utilizzo di aree forestali                  ,0,0,0,0,0,2021
CAL,VV,A 03,Pesca e acquacoltura                                        ,0,0,0,0,0,2021
CAL,VV,B   ,Estrazione di minerali da cave e miniere                    ,0,0,0,0,0,2021
CAL,VV,B 05,Estrazione di carbone (esclusa torba)                       ,0,0,0,0,0,2021
CAL,VV,B 06,Estraz.di petrolio greggio e di gas naturale                ,0,0,0,0,0,2021
CAL,VV,B 07,Estrazione di minerali metalliferi                          ,0,0,0,0,0,2021
CAL,VV,B 08,Altre attività di estrazione di minerali da cave e miniere  ,0,0,0,0,0,2021
CAL,VV,B 09,Attività dei servizi di supporto all'estrazione             ,0,0,0,0,0,2021
CAL,VV,C   ,Attività manifatturiere                                     ,0,0,0,0,0,2021
CAL,VV,C 10,Industrie alimentari                                        ,0,0,0,0,0,2021
CAL,VV,C 11,Industria delle bevande                                     ,0,0,0,0,0,2021
CAL,VV,C 12,Industria del tabacco                                       ,0,0,0,0,0,2021
CAL,VV,C 13,Industrie tessili                                           ,0,0,0,0,0,2021
CAL,VV,C 14,Confezione di articoli di abbigliamento; confezione di ar...,0,0,0,0,0,2021
CAL,VV,C 15,Fabbricazione di articoli in pelle e simili                 ,0,0,0,0,0,2021
CAL,VV,C 16,Industria del legno e dei prodotti in legno e sughero (es...,0,0,0,0,0,2021
CAL,VV,C 17,Fabbricazione di carta e di prodotti di carta               ,0,0,0,0,0,2021
CAL,VV,C 18,Stampa e riproduzione di supporti registrati                ,0,0,0,0,0,2021
CAL,VV,C 19,Fabbricazione di coke e prodotti derivanti dalla raffinaz...,0,0,0,0,0,2021
CAL,VV,C 20,Fabbricazione di prodotti chimici                           ,0,0,0,0,0,2021
CAL,VV,C 21,Fabbricazione di prodotti farmaceutici di base e di prepa...,0,0,0,0,0,2021
CAL,VV,C 22,Fabbricazione di articoli in gomma e materie plastiche      ,0,0,0,0,0,2021
CAL,VV,C 23,Fabbricazione di altri prodotti della lavorazione di miner..,0,0,0,0,0,2021
CAL,VV,C 24,Metallurgia                                                 ,0,0,0,0,0,2021
CAL,VV,C 25,Fabbricazione di prodotti in metallo (esclusi macchinari ...,0,0,0,0,0,2021
CAL,VV,C 26,Fabbricazione di computer e prodotti di elettronica e ott...,0,0,0,0,0,2021
CAL,VV,C 27,Fabbricazione di apparecchiature elettriche ed apparecchi...,0,0,0,0,0,2021
CAL,VV,C 28,Fabbricazione di macchinari ed apparecchiature nca          ,0,0,0,0,0,2021
CAL,VV,C 29,"Fabbricazione di autoveicoli, rimorchi e semirimorchi       ",0,0,0,0,0,2021
CAL,VV,C 30,Fabbricazione di altri mezzi di trasporto                   ,0,0,0,0,0,2021
CAL,VV,C 31,Fabbricazione di mobili                                     ,0,0,0,0,0,2021
CAL,VV,C 32,Altre industrie manifatturiere                              ,0,0,0,0,0,2021
CAL,VV,C 33,"Riparazione, manutenzione ed installazione di macchine ed...",0,0,0,0,0,2021
CAL,VV,D   ,"Fornitura di energia elettrica, gas, vapore e aria condiz...",0,0,0,0,0,2021
CAL,VV,D 35,"Fornitura di energia elettrica, gas, vapore e aria condiz...",0,0,0,0,0,2021
CAL,VV,E   ,"Fornitura di acqua; reti fognarie, attività di gestione d...",0,0,0,0,0,2021
CAL,VV,E 36,"Raccolta, trattamento e fornitura di acqua                  ",0,0,0,0,0,2021
CAL,VV,E 37,Gestione delle reti fognarie                                ,0,0,0,0,0,2021
CAL,VV,E 38,"Attività di raccolta, trattamento e smaltimento dei rifiu...",0,0,0,0,0,2021
CAL,VV,E 39,Attività di risanamento e altri servizi di gestione dei r...,0,0,0,0,0,2021
CAL,VV,F   ,Costruzioni                                                 ,0,0,0,0,0,2021
CAL,VV,F 41,Costruzione di edifici                                      ,0,0,0,0,0,2021
CAL,VV,F 42,Ingegneria civile                                           ,0,0,0,0,0,2021
CAL,VV,F 43,Lavori di costruzione specializzati                         ,0,0,0,0,0,2021
CAL,VV,G   ,Commercio all'ingrosso e al dettaglio; riparazione di aut...,0,0,0,0,0,2021
CAL,VV,G 45,Commercio all'ingrosso e al dettaglio e riparazione di au...,0,0,0,0,0,2021
CAL,VV,G 46,Commercio all'ingrosso (escluso quello di autoveicoli e d...,0,0,0,0,0,2021
CAL,VV,G 47,Commercio al dettaglio (escluso quello di autoveicoli e d...,0,0,0,0,0,2021
CAL,VV,H   ,Trasporto e magazzinaggio                                   ,0,0,0,0,0,2021
CAL,VV,H 49,Trasporto terrestre e mediante condotte                     ,0,0,0,0,0,2021
CAL,VV,H 50,Trasporto marittimo e per vie d'acqua                       ,0,0,0,0,0,2021
CAL,VV,H 51,Trasporto aereo                                             ,0,0,0,0,0,2021
CAL,VV,H 52,Magazzinaggio e attività di supporto ai trasporti           ,0,0,0,0,0,2021
CAL,VV,H 53,Servizi postali e attività di corriere                      ,0,0,0,0,0,2021
CAL,VV,I   ,Attività dei servizi alloggio e ristorazione                ,0,0,0,0,0,2021
CAL,VV,I 55,Alloggio                                                    ,0,0,0,0,0,2021
CAL,VV,I 56,Attività dei servizi di ristorazione                        ,0,0,0,0,0,2021
CAL,VV,J   ,Servizi di informazione e comunicazione                     ,0,0,0,0,0,2021
CAL,VV,J 58,Attività editoriali                                         ,0,0,0,0,0,2021
CAL,VV,J 59,"Attività di produzione cinematografica, di video e di pro...",0,0,0,0,0,2021
CAL,VV,J 60,Attività di programmazione e trasmissione                   ,0,0,0,0,0,2021
CAL,VV,J 61,Telecomunicazioni                                           ,0,0,0,0,0,2021
CAL,VV,J 62,"Produzione di software, consulenza informatica e attività...",0,0,0,0,0,2021
CAL,VV,J 63,Attività dei servizi d'informazione e altri servizi infor...,0,0,0,0,0,2021
CAL,VV,K   ,Attività finanziarie e assicurative                         ,0,0,0,0,0,2021
CAL,VV,K 64,Attività di servizi finanziari (escluse le assicurazioni ...,0,0,0,0,0,2021
CAL,VV,K 65,"Assicurazioni, riassicurazioni e fondi pensione (escluse ...",0,0,0,0,0,2021
CAL,VV,K 66,Attività ausiliarie dei servizi finanziari e delle attivi...,0,0,0,0,0,2021
CAL,VV,L   ,Attivita' immobiliari                                       ,0,0,0,0,0,2021
CAL,VV,L 68,Attivita' immobiliari                                       ,0,0,0,0,0,2021
CAL,VV,M   ,"Attività professionali, scientifiche e tecniche             ",0,0,0,0,0,2021
CAL,VV,M 69,Attività legali e contabilità                               ,0,0,0,0,0,2021
CAL,VV,M 70,Attività di direzione aziendale e di consulenza gestional...,0,0,0,0,0,2021
CAL,VV,M 71,Attività degli studi di architettura e d'ingegneria; coll...,0,0,0,0,0,2021
CAL,VV,M 72,Ricerca scientifica e sviluppo                              ,0,0,0,0,0,2021
CAL,VV,M 73,Pubblicità e ricerche di mercato                            ,0,0,0,0,0,2021
CAL,VV,M 74,"Altre attività professionali, scientifiche e tecniche       ",0,0,0,0,0,2021
CAL,VV,M 75,Servizi veterinari                                          ,0,0,0,0,0,2021
CAL,VV,N   ,"Noleggio, agenzie di viaggio, servizi di supporto alle im...",0,0,0,0,0,2021
CAL,VV,N 77,Attività di noleggio e leasing operativo                    ,0,0,0,0,0,2021
CAL,VV,N 78,"Attività di ricerca, selezione, fornitura di personale      ",0,0,0,0,0,2021
CAL,VV,N 79,"Attività dei servizi delle agenzie di viaggio, dei tour o...",0,0,0,0,0,2021
CAL,VV,N 80,Servizi di vigilanza e investigazione                       ,0,0,0,0,0,2021
CAL,VV,N 81,Attività di servizi per edifici e paesaggio                 ,0,0,0,0,0,2021
CAL,VV,N 82,Attività di supporto per le funzioni d'ufficio e altri se...,0,0,0,0,0,2021
CAL,VV,O   ,Amministrazione pubblica e difesa; assicurazione sociale ...,0,0,0,0,0,2021
CAL,VV,O 84,Amministrazione pubblica e difesa; assicurazione sociale ...,0,0,0,0,0,2021
CAL,VV,P   ,Istruzione                                                  ,0,0,0,0,0,2021
CAL,VV,P 85,Istruzione                                                  ,0,0,0,0,0,2021
CAL,VV,Q   ,Sanita' e assistenza sociale                                ,0,0,0,0,0,2021
CAL,VV,Q 86,Assistenza sanitaria                                        ,0,0,0,0,0,2021
CAL,VV,Q 87,Servizi di assistenza sociale residenziale                  ,0,0,0,0,0,2021
CAL,VV,Q 88,Assistenza sociale non residenziale                         ,0,0,0,0,0,2021
CAL,VV,R   ,"Attività artistiche, sportive, di intrattenimento e diver...",0,0,0,0,0,2021
CAL,VV,R 90,"Attività creative, artistiche e di intrattenimento          ",0,0,0,0,0,2021
CAL,VV,R 91,"Attività di biblioteche, archivi, musei ed altre attività...",0,0,0,0,0,2021
CAL,VV,R 92,"Attività riguardanti le lotterie, le scommesse, le case d...",0,0,0,0,0,2021
CAL,VV,R 93,"Attività sportive, di intrattenimento e di divertimento     ",0,0,0,0,0,2021
CAL,VV,S   ,Altre attività di servizi                                   ,0,0,0,0,0,2021
CAL,VV,S 94,Attività di organizzazioni associative                      ,0,0,0,0,0,2021
CAL,VV,S 95,Riparazione di computer e di beni per uso personale e per...,0,0,0,0,0,2021
CAL,VV,S 96,Altre attività di servizi per la persona                    ,0,0,0,0,0,2021
CAL,VV,T   ,Attività di famiglie e convivenze come datori di lavoro p...,0,0,0,0,0,2021
CAL,VV,T 97,Attività di famiglie e convivenze come datori di lavoro p...,0,0,0,0,0,2021
CAL,VV,T 98,Produzione di beni e servizi indifferenziati per uso prop...,0,0,0,0,0,2021
CAL,VV,U   ,Organizzazioni ed organismi extraterritoriali               ,0,0,0,0,0,2021
CAL,VV,U 99,Organizzazioni ed organismi extraterritoriali               ,0,0,0,0,0,2021
CAL,VV,XX  ,Imprese non classificate                                    ,0,0,0,0,0,2021
CAL,VV,TOT ,TOTALE                                                      ,0,0,0,0,0,2021
SIC,  ,A   ,"Agricoltura, silvicoltura pesca                             ",0,0,0,2,2,2021
SIC,  ,A 01,"Coltivazioni agricole e produzione di prodotti animali, c...",0,0,0,2,2,2021
SIC,  ,A 02,Silvicoltura ed utilizzo di aree forestali                  ,0,0,0,0,0,2021
SIC,  ,A 03,Pesca e acquacoltura                                        ,0,0,0,0,0,2021
SIC,  ,B   ,Estrazione di minerali da cave e miniere                    ,0,0,0,0,0,2021
SIC,  ,B 05,Estrazione di carbone (esclusa torba)                       ,0,0,0,0,0,2021
SIC,  ,B 06,Estraz.di petrolio greggio e di gas naturale                ,0,0,0,0,0,2021
SIC,  ,B 07,Estrazione di minerali metalliferi                          ,0,0,0,0,0,2021
SIC,  ,B 08,Altre attività di estrazione di minerali da cave e miniere  ,0,0,0,0,0,2021
SIC,  ,B 09,Attività dei servizi di supporto all'estrazione             ,0,0,0,0,0,2021
SIC,  ,C   ,Attività manifatturiere                                     ,1,0,4,0,5,2021
SIC,  ,C 10,Industrie alimentari                                        ,0,0,3,0,3,2021
SIC,  ,C 11,Industria delle bevande                                     ,0,0,0,0,0,2021
SIC,  ,C 12,Industria del tabacco                                       ,0,0,0,0,0,2021
SIC,  ,C 13,Industrie tessili                                           ,0,0,0,0,0,2021
SIC,  ,C 14,Confezione di articoli di abbigliamento; confezione di ar...,0,0,0,0,0,2021
SIC,  ,C 15,Fabbricazione di articoli in pelle e simili                 ,0,0,0,0,0,2021
SIC,  ,C 16,Industria del legno e dei prodotti in legno e sughero (es...,0,0,0,0,0,2021
SIC,  ,C 17,Fabbricazione di carta e di prodotti di carta               ,0,0,0,0,0,2021
SIC,  ,C 18,Stampa e riproduzione di supporti registrati                ,0,0,0,0,0,2021
SIC,  ,C 19,Fabbricazione di coke e prodotti derivanti dalla raffinaz...,0,0,0,0,0,2021
SIC,  ,C 20,Fabbricazione di prodotti chimici                           ,0,0,0,0,0,2021
SIC,  ,C 21,Fabbricazione di prodotti farmaceutici di base e di prepa...,0,0,0,0,0,2021
SIC,  ,C 22,Fabbricazione di articoli in gomma e materie plastiche      ,0,0,0,0,0,2021
SIC,  ,C 23,Fabbricazione di altri prodotti della lavorazione di miner..,0,0,0,0,0,2021
SIC,  ,C 24,Metallurgia                                                 ,0,0,0,0,0,2021
SIC,  ,C 25,Fabbricazione di prodotti in metallo (esclusi macchinari ...,1,0,1,0,2,2021
SIC,  ,C 26,Fabbricazione di computer e prodotti di elettronica e ott...,0,0,0,0,0,2021
SIC,  ,C 27,Fabbricazione di apparecchiature elettriche ed apparecchi...,0,0,0,0,0,2021
SIC,  ,C 28,Fabbricazione di macchinari ed apparecchiature nca          ,0,0,0,0,0,2021
SIC,  ,C 29,"Fabbricazione di autoveicoli, rimorchi e semirimorchi       ",0,0,0,0,0,2021
SIC,  ,C 30,Fabbricazione di altri mezzi di trasporto                   ,0,0,0,0,0,2021
SIC,  ,C 31,Fabbricazione di mobili                                     ,0,0,0,0,0,2021
SIC,  ,C 32,Altre industrie manifatturiere                              ,0,0,0,0,0,2021
SIC,  ,C 33,"Riparazione, manutenzione ed installazione di macchine ed...",0,0,0,0,0,2021
SIC,  ,D   ,"Fornitura di energia elettrica, gas, vapore e aria condiz...",0,0,0,0,0,2021
SIC,  ,D 35,"Fornitura di energia elettrica, gas, vapore e aria condiz...",0,0,0,0,0,2021
SIC,  ,E   ,"Fornitura di acqua; reti fognarie, attività di gestione d...",0,0,0,0,0,2021
SIC,  ,E 36,"Raccolta, trattamento e fornitura di acqua                  ",0,0,0,0,0,2021
SIC,  ,E 37,Gestione delle reti fognarie                                ,0,0,0,0,0,2021
SIC,  ,E 38,"Attività di raccolta, trattamento e smaltimento dei rifiu...",0,0,0,0,0,2021
SIC,  ,E 39,Attività di risanamento e altri servizi di gestione dei r...,0,0,0,0,0,2021
SIC,  ,F   ,Costruzioni                                                 ,0,0,2,3,5,2021
SIC,  ,F 41,Costruzione di edifici                                      ,0,0,0,3,3,2021
SIC,  ,F 42,Ingegneria civile                                           ,0,0,0,0,0,2021
SIC,  ,F 43,Lavori di costruzione specializzati                         ,0,0,2,0,2,2021
SIC,  ,G   ,Commercio all'ingrosso e al dettaglio; riparazione di aut...,1,0,3,7,11,2021
SIC,  ,G 45,Commercio all'ingrosso e al dettaglio e riparazione di au...,0,0,3,1,4,2021
SIC,  ,G 46,Commercio all'ingrosso (escluso quello di autoveicoli e d...,0,0,0,3,3,2021
SIC,  ,G 47,Commercio al dettaglio (escluso quello di autoveicoli e d...,1,0,0,3,4,2021
SIC,  ,H   ,Trasporto e magazzinaggio                                   ,1,0,2,0,3,2021
SIC,  ,H 49,Trasporto terrestre e mediante condotte                     ,0,0,2,0,2,2021
SIC,  ,H 50,Trasporto marittimo e per vie d'acqua                       ,0,0,0,0,0,2021
SIC,  ,H 51,Trasporto aereo                                             ,0,0,0,0,0,2021
SIC,  ,H 52,Magazzinaggio e attività di supporto ai trasporti           ,0,0,0,0,0,2021
SIC,  ,H 53,Servizi postali e attività di corriere                      ,1,0,0,0,1,2021
SIC,  ,I   ,Attività dei servizi alloggio e ristorazione                ,0,1,2,0,3,2021
SIC,  ,I 55,Alloggio                                                    ,0,0,0,0,0,2021
SIC,  ,I 56,Attività dei servizi di ristorazione                        ,0,1,2,0,3,2021
SIC,  ,J   ,Servizi di informazione e comunicazione                     ,0,0,1,0,1,2021
SIC,  ,J 58,Attività editoriali                                         ,0,0,0,0,0,2021
SIC,  ,J 59,"Attività di produzione cinematografica, di video e di pro...",0,0,0,0,0,2021
SIC,  ,J 60,Attività di programmazione e trasmissione                   ,0,0,0,0,0,2021
SIC,  ,J 61,Telecomunicazioni                                           ,0,0,0,0,0,2021
SIC,  ,J 62,"Produzione di software, consulenza informatica e attività...",0,0,0,0,0,2021
SIC,  ,J 63,Attività dei servizi d'informazione e altri servizi infor...,0,0,1,0,1,2021
SIC,  ,K   ,Attività finanziarie e assicurative                         ,0,0,0,0,0,2021
SIC,  ,K 64,Attività di servizi finanziari (escluse le assicurazioni ...,0,0,0,0,0,2021
SIC,  ,K 65,"Assicurazioni, riassicurazioni e fondi pensione (escluse ...",0,0,0,0,0,2021
SIC,  ,K 66,Attività ausiliarie dei servizi finanziari e delle attivi...,0,0,0,0,0,2021
SIC,  ,L   ,Attivita' immobiliari                                       ,0,0,0,0,0,2021
SIC,  ,L 68,Attivita' immobiliari                                       ,0,0,0,0,0,2021
SIC,  ,M   ,"Attività professionali, scientifiche e tecniche             ",0,0,0,2,2,2021
SIC,  ,M 69,Attività legali e contabilità                               ,0,0,0,1,1,2021
SIC,  ,M 70,Attività di direzione aziendale e di consulenza gestional...,0,0,0,0,0,2021
SIC,  ,M 71,Attività degli studi di architettura e d'ingegneria; coll...,0,0,0,0,0,2021
SIC,  ,M 72,Ricerca scientifica e sviluppo                              ,0,0,0,0,0,2021
SIC,  ,M 73,Pubblicità e ricerche di mercato                            ,0,0,0,0,0,2021
SIC,  ,M 74,"Altre attività professionali, scientifiche e tecniche       ",0,0,0,1,1,2021
SIC,  ,M 75,Servizi veterinari                                          ,0,0,0,0,0,2021
SIC,  ,N   ,"Noleggio, agenzie di viaggio, servizi di supporto alle im...",0,0,1,1,2,2021
SIC,  ,N 77,Attività di noleggio e leasing operativo                    ,0,0,0,0,0,2021
SIC,  ,N 78,"Attività di ricerca, selezione, fornitura di personale      ",0,0,0,0,0,2021
SIC,  ,N 79,"Attività dei servizi delle agenzie di viaggio, dei tour o...",0,0,0,0,0,2021
SIC,  ,N 80,Servizi di vigilanza e investigazione                       ,0,0,0,0,0,2021
SIC,  ,N 81,Attività di servizi per edifici e paesaggio                 ,0,0,1,1,2,2021
SIC,  ,N 82,Attività di supporto per le funzioni d'ufficio e altri se...,0,0,0,0,0,2021
SIC,  ,O   ,Amministrazione pubblica e difesa; assicurazione sociale ...,0,0,0,0,0,2021
SIC,  ,O 84,Amministrazione pubblica e difesa; assicurazione sociale ...,0,0,0,0,0,2021
SIC,  ,P   ,Istruzione                                                  ,0,0,0,0,0,2021
SIC,  ,P 85,Istruzione                                                  ,0,0,0,0,0,2021
SIC,  ,Q   ,Sanita' e assistenza sociale                                ,0,0,0,3,3,2021
SIC,  ,Q 86,Assistenza sanitaria                                        ,0,0,0,1,1,2021
SIC,  ,Q 87,Servizi di assistenza sociale residenziale                  ,0,0,0,0,0,2021
SIC,  ,Q 88,Assistenza sociale non residenziale                         ,0,0,0,2,2,2021
SIC,  ,R   ,"Attività artistiche, sportive, di intrattenimento e diver...",0,0,0,2,2,2021
SIC,  ,R 90,"Attività creative, artistiche e di intrattenimento          ",0,0,0,1,1,2021
SIC,  ,R 91,"Attività di biblioteche, archivi, musei ed altre attività...",0,0,0,0,0,2021
SIC,  ,R 92,"Attività riguardanti le lotterie, le scommesse, le case d...",0,0,0,0,0,2021
SIC,  ,R 93,"Attività sportive, di intrattenimento e di divertimento     ",0,0,0,1,1,2021
SIC,  ,S   ,Altre attività di servizi                                   ,0,0,1,0,1,2021
SIC,  ,S 94,Attività di organizzazioni associative                      ,0,0,0,0,0,2021
SIC,  ,S 95,Riparazione di computer e di beni per uso personale e per...,0,0,1,0,1,2021
SIC,  ,S 96,Altre attività di servizi per la persona                    ,0,0,0,0,0,2021
SIC,  ,T   ,Attività di famiglie e convivenze come datori di lavoro p...,0,0,0,0,0,2021
SIC,  ,T 97,Attività di famiglie e convivenze come datori di lavoro p...,0,0,0,0,0,2021
SIC,  ,T 98,Produzione di beni e servizi indifferenziati per uso prop...,0,0,0,0,0,2021
SIC,  ,U   ,Organizzazioni ed organismi extraterritoriali               ,0,0,0,0,0,2021
SIC,  ,U 99,Organizzazioni ed organismi extraterritoriali               ,0,0,0,0,0,2021
SIC,  ,XX  ,Imprese non classificate                                    ,0,0,1,21,22,2021
SIC,  ,TOT ,TOTALE                                                      ,3,1,17,41,62,2021
SIC,TP,A   ,"Agricoltura, silvicoltura pesca                             ",0,0,0,1,1,2021
SIC,TP,A 01,"Coltivazioni agricole e produzione di prodotti animali, c...",0,0,0,1,1,2021
SIC,TP,A 02,Silvicoltura ed utilizzo di aree forestali                  ,0,0,0,0,0,2021
SIC,TP,A 03,Pesca e acquacoltura                                        ,0,0,0,0,0,2021
SIC,TP,B   ,Estrazione di minerali da cave e miniere                    ,0,0,0,0,0,2021
SIC,TP,B 05,Estrazione di carbone (esclusa torba)                       ,0,0,0,0,0,2021
SIC,TP,B 06,Estraz.di petrolio greggio e di gas naturale                ,0,0,0,0,0,2021
SIC,TP,B 07,Estrazione di minerali metalliferi                          ,0,0,0,0,0,2021
SIC,TP,B 08,Altre attività di estrazione di minerali da cave e miniere  ,0,0,0,0,0,2021
SIC,TP,B 09,Attività dei servizi di supporto all'estrazione             ,0,0,0,0,0,2021
SIC,TP,C   ,Attività manifatturiere                                     ,0,0,0,0,0,2021
SIC,TP,C 10,Industrie alimentari                                        ,0,0,0,0,0,2021
SIC,TP,C 11,Industria delle bevande                                     ,0,0,0,0,0,2021
SIC,TP,C 12,Industria del tabacco                                       ,0,0,0,0,0,2021
SIC,TP,C 13,Industrie tessili                                           ,0,0,0,0,0,2021
SIC,TP,C 14,Confezione di articoli di abbigliamento; confezione di ar...,0,0,0,0,0,2021
SIC,TP,C 15,Fabbricazione di articoli in pelle e simili                 ,0,0,0,0,0,2021
SIC,TP,C 16,Industria del legno e dei prodotti in legno e sughero (es...,0,0,0,0,0,2021
SIC,TP,C 17,Fabbricazione di carta e di prodotti di carta               ,0,0,0,0,0,2021
SIC,TP,C 18,Stampa e riproduzione di supporti registrati                ,0,0,0,0,0,2021
SIC,TP,C 19,Fabbricazione di coke e prodotti derivanti dalla raffinaz...,0,0,0,0,0,2021
SIC,TP,C 20,Fabbricazione di prodotti chimici                           ,0,0,0,0,0,2021
SIC,TP,C 21,Fabbricazione di prodotti farmaceutici di base e di prepa...,0,0,0,0,0,2021
SIC,TP,C 22,Fabbricazione di articoli in gomma e materie plastiche      ,0,0,0,0,0,2021
SIC,TP,C 23,Fabbricazione di altri prodotti della lavorazione di miner..,0,0,0,0,0,2021
SIC,TP,C 24,Metallurgia                                                 ,0,0,0,0,0,2021
SIC,TP,C 25,Fabbricazione di prodotti in metallo (esclusi macchinari ...,0,0,0,0,0,2021
SIC,TP,C 26,Fabbricazione di computer e prodotti di elettronica e ott...,0,0,0,0,0,2021
SIC,TP,C 27,Fabbricazione di apparecchiature elettriche ed apparecchi...,0,0,0,0,0,2021
SIC,TP,C 28,Fabbricazione di macchinari ed apparecchiature nca          ,0,0,0,0,0,2021
SIC,TP,C 29,"Fabbricazione di autoveicoli, rimorchi e semirimorchi       ",0,0,0,0,0,2021
SIC,TP,C 30,Fabbricazione di altri mezzi di trasporto                   ,0,0,0,0,0,2021
SIC,TP,C 31,Fabbricazione di mobili                                     ,0,0,0,0,0,2021
SIC,TP,C 32,Altre industrie manifatturiere                              ,0,0,0,0,0,2021
SIC,TP,C 33,"Riparazione, manutenzione ed installazione di macchine ed...",0,0,0,0,0,2021
SIC,TP,D   ,"Fornitura di energia elettrica, gas, vapore e aria condiz...",0,0,0,0,0,2021
SIC,TP,D 35,"Fornitura di energia elettrica, gas, vapore e aria condiz...",0,0,0,0,0,2021
SIC,TP,E   ,"Fornitura di acqua; reti fognarie, attività di gestione d...",0,0,0,0,0,2021
SIC,TP,E 36,"Raccolta, trattamento e fornitura di acqua                  ",0,0,0,0,0,2021
SIC,TP,E 37,Gestione delle reti fognarie                                ,0,0,0,0,0,2021
SIC,TP,E 38,"Attività di raccolta, trattamento e smaltimento dei rifiu...",0,0,0,0,0,2021
SIC,TP,E 39,Attività di risanamento e altri servizi di gestione dei r...,0,0,0,0,0,2021
SIC,TP,F   ,Costruzioni                                                 ,0,0,0,0,0,2021
SIC,TP,F 41,Costruzione di edifici                                      ,0,0,0,0,0,2021
SIC,TP,F 42,Ingegneria civile                                           ,0,0,0,0,0,2021
SIC,TP,F 43,Lavori di costruzione specializzati                         ,0,0,0,0,0,2021
SIC,TP,G   ,Commercio all'ingrosso e al dettaglio; riparazione di aut...,0,0,0,1,1,2021
SIC,TP,G 45,Commercio all'ingrosso e al dettaglio e riparazione di au...,0,0,0,1,1,2021
SIC,TP,G 46,Commercio all'ingrosso (escluso quello di autoveicoli e d...,0,0,0,0,0,2021
SIC,TP,G 47,Commercio al dettaglio (escluso quello di autoveicoli e d...,0,0,0,0,0,2021
SIC,TP,H   ,Trasporto e magazzinaggio                                   ,0,0,0,0,0,2021
SIC,TP,H 49,Trasporto terrestre e mediante condotte                     ,0,0,0,0,0,2021
SIC,TP,H 50,Trasporto marittimo e per vie d'acqua                       ,0,0,0,0,0,2021
SIC,TP,H 51,Trasporto aereo                                             ,0,0,0,0,0,2021
SIC,TP,H 52,Magazzinaggio e attività di supporto ai trasporti           ,0,0,0,0,0,2021
SIC,TP,H 53,Servizi postali e attività di corriere                      ,0,0,0,0,0,2021
SIC,TP,I   ,Attività dei servizi alloggio e ristorazione                ,0,0,0,0,0,2021
SIC,TP,I 55,Alloggio                                                    ,0,0,0,0,0,2021
SIC,TP,I 56,Attività dei servizi di ristorazione                        ,0,0,0,0,0,2021
SIC,TP,J   ,Servizi di informazione e comunicazione                     ,0,0,0,0,0,2021
SIC,TP,J 58,Attività editoriali                                         ,0,0,0,0,0,2021
SIC,TP,J 59,"Attività di produzione cinematografica, di video e di pro...",0,0,0,0,0,2021
SIC,TP,J 60,Attività di programmazione e trasmissione                   ,0,0,0,0,0,2021
SIC,TP,J 61,Telecomunicazioni                                           ,0,0,0,0,0,2021
SIC,TP,J 62,"Produzione di software, consulenza informatica e attività...",0,0,0,0,0,2021
SIC,TP,J 63,Attività dei servizi d'informazione e altri servizi infor...,0,0,0,0,0,2021
SIC,TP,K   ,Attività finanziarie e assicurative                         ,0,0,0,0,0,2021
SIC,TP,K 64,Attività di servizi finanziari (escluse le assicurazioni ...,0,0,0,0,0,2021
SIC,TP,K 65,"Assicurazioni, riassicurazioni e fondi pensione (escluse ...",0,0,0,0,0,2021
SIC,TP,K 66,Attività ausiliarie dei servizi finanziari e delle attivi...,0,0,0,0,0,2021
SIC,TP,L   ,Attivita' immobiliari                                       ,0,0,0,0,0,2021
SIC,TP,L 68,Attivita' immobiliari                                       ,0,0,0,0,0,2021
SIC,TP,M   ,"Attività professionali, scientifiche e tecniche             ",0,0,0,0,0,2021
SIC,TP,M 69,Attività legali e contabilità                               ,0,0,0,0,0,2021
SIC,TP,M 70,Attività di direzione aziendale e di consulenza gestional...,0,0,0,0,0,2021
SIC,TP,M 71,Attività degli studi di architettura e d'ingegneria; coll...,0,0,0,0,0,2021
SIC,TP,M 72,Ricerca scientifica e sviluppo                              ,0,0,0,0,0,2021
SIC,TP,M 73,Pubblicità e ricerche di mercato                            ,0,0,0,0,0,2021
SIC,TP,M 74,"Altre attività professionali, scientifiche e tecniche       ",0,0,0,0,0,2021
SIC,TP,M 75,Servizi veterinari                                          ,0,0,0,0,0,2021
SIC,TP,N   ,"Noleggio, agenzie di viaggio, servizi di supporto alle im...",0,0,0,0,0,2021
SIC,TP,N 77,Attività di noleggio e leasing operativo                    ,0,0,0,0,0,2021
SIC,TP,N 78,"Attività di ricerca, selezione, fornitura di personale      ",0,0,0,0,0,2021
SIC,TP,N 79,"Attività dei servizi delle agenzie di viaggio, dei tour o...",0,0,0,0,0,2021
SIC,TP,N 80,Servizi di vigilanza e investigazione                       ,0,0,0,0,0,2021
SIC,TP,N 81,Attività di servizi per edifici e paesaggio                 ,0,0,0,0,0,2021
SIC,TP,N 82,Attività di supporto per le funzioni d'ufficio e altri se...,0,0,0,0,0,2021
SIC,TP,O   ,Amministrazione pubblica e difesa; assicurazione sociale ...,0,0,0,0,0,2021
SIC,TP,O 84,Amministrazione pubblica e difesa; assicurazione sociale ...,0,0,0,0,0,2021
SIC,TP,P   ,Istruzione                                                  ,0,0,0,0,0,2021
SIC,TP,P 85,Istruzione                                                  ,0,0,0,0,0,2021
SIC,TP,Q   ,Sanita' e assistenza sociale                                ,0,0,0,0,0,2021
SIC,TP,Q 86,Assistenza sanitaria                                        ,0,0,0,0,0,2021
SIC,TP,Q 87,Servizi di assistenza sociale residenziale                  ,0,0,0,0,0,2021
SIC,TP,Q 88,Assistenza sociale non residenziale                         ,0,0,0,0,0,2021
SIC,TP,R   ,"Attività artistiche, sportive, di intrattenimento e diver...",0,0,0,1,1,2021
SIC,TP,R 90,"Attività creative, artistiche e di intrattenimento          ",0,0,0,1,1,2021
SIC,TP,R 91,"Attività di biblioteche, archivi, musei ed altre attività...",0,0,0,0,0,2021
SIC,TP,R 92,"Attività riguardanti le lotterie, le scommesse, le case d...",0,0,0,0,0,2021
SIC,TP,R 93,"Attività sportive, di intrattenimento e di divertimento     ",0,0,0,0,0,2021
SIC,TP,S   ,Altre attività di servizi                                   ,0,0,0,0,0,2021
SIC,TP,S 94,Attività di organizzazioni associative                      ,0,0,0,0,0,2021
SIC,TP,S 95,Riparazione di computer e di beni per uso personale e per...,0,0,0,0,0,2021
SIC,TP,S 96,Altre attività di servizi per la persona                    ,0,0,0,0,0,2021
SIC,TP,T   ,Attività di famiglie e convivenze come datori di lavoro p...,0,0,0,0,0,2021
SIC,TP,T 97,Attività di famiglie e convivenze come datori di lavoro p...,0,0,0,0,0,2021
SIC,TP,T 98,Produzione di beni e servizi indifferenziati per uso prop...,0,0,0,0,0,2021
SIC,TP,U   ,Organizzazioni ed organismi extraterritoriali               ,0,0,0,0,0,2021
SIC,TP,U 99,Organizzazioni ed organismi extraterritoriali               ,0,0,0,0,0,2021
SIC,TP,XX  ,Imprese non classificate                                    ,0,0,0,1,1,2021
SIC,TP,TOT ,TOTALE                                                      ,0,0,0,4,4,2021
SIC,PA,A   ,"Agricoltura, silvicoltura pesca                             ",0,0,0,1,1,2021
SIC,PA,A 01,"Coltivazioni agricole e produzione di prodotti animali, c...",0,0,0,1,1,2021
SIC,PA,A 02,Silvicoltura ed utilizzo di aree forestali                  ,0,0,0,0,0,2021
SIC,PA,A 03,Pesca e acquacoltura                                        ,0,0,0,0,0,2021
SIC,PA,B   ,Estrazione di minerali da cave e miniere                    ,0,0,0,0,0,2021
SIC,PA,B 05,Estrazione di carbone (esclusa torba)                       ,0,0,0,0,0,2021
SIC,PA,B 06,Estraz.di petrolio greggio e di gas naturale                ,0,0,0,0,0,2021
SIC,PA,B 07,Estrazione di minerali metalliferi                          ,0,0,0,0,0,2021
SIC,PA,B 08,Altre attività di estrazione di minerali da cave e miniere  ,0,0,0,0,0,2021
SIC,PA,B 09,Attività dei servizi di supporto all'estrazione             ,0,0,0,0,0,2021
SIC,PA,C   ,Attività manifatturiere                                     ,0,0,0,0,0,2021
SIC,PA,C 10,Industrie alimentari                                        ,0,0,0,0,0,2021
SIC,PA,C 11,Industria delle bevande                                     ,0,0,0,0,0,2021
SIC,PA,C 12,Industria del tabacco                                       ,0,0,0,0,0,2021
SIC,PA,C 13,Industrie tessili                                           ,0,0,0,0,0,2021
SIC,PA,C 14,Confezione di articoli di abbigliamento; confezione di ar...,0,0,0,0,0,2021
SIC,PA,C 15,Fabbricazione di articoli in pelle e simili                 ,0,0,0,0,0,2021
SIC,PA,C 16,Industria del legno e dei prodotti in legno e sughero (es...,0,0,0,0,0,2021
SIC,PA,C 17,Fabbricazione di carta e di prodotti di carta               ,0,0,0,0,0,2021
SIC,PA,C 18,Stampa e riproduzione di supporti registrati                ,0,0,0,0,0,2021
SIC,PA,C 19,Fabbricazione di coke e prodotti derivanti dalla raffinaz...,0,0,0,0,0,2021
SIC,PA,C 20,Fabbricazione di prodotti chimici                           ,0,0,0,0,0,2021
SIC,PA,C 21,Fabbricazione di prodotti farmaceutici di base e di prepa...,0,0,0,0,0,2021
SIC,PA,C 22,Fabbricazione di articoli in gomma e materie plastiche      ,0,0,0,0,0,2021
SIC,PA,C 23,Fabbricazione di altri prodotti della lavorazione di miner..,0,0,0,0,0,2021
SIC,PA,C 24,Metallurgia                                                 ,0,0,0,0,0,2021
SIC,PA,C 25,Fabbricazione di prodotti in metallo (esclusi macchinari ...,0,0,0,0,0,2021
SIC,PA,C 26,Fabbricazione di computer e prodotti di elettronica e ott...,0,0,0,0,0,2021
SIC,PA,C 27,Fabbricazione di apparecchiature elettriche ed apparecchi...,0,0,0,0,0,2021
SIC,PA,C 28,Fabbricazione di macchinari ed apparecchiature nca          ,0,0,0,0,0,2021
SIC,PA,C 29,"Fabbricazione di autoveicoli, rimorchi e semirimorchi       ",0,0,0,0,0,2021
SIC,PA,C 30,Fabbricazione di altri mezzi di trasporto                   ,0,0,0,0,0,2021
SIC,PA,C 31,Fabbricazione di mobili                                     ,0,0,0,0,0,2021
SIC,PA,C 32,Altre industrie manifatturiere                              ,0,0,0,0,0,2021
SIC,PA,C 33,"Riparazione, manutenzione ed installazione di macchine ed...",0,0,0,0,0,2021
SIC,PA,D   ,"Fornitura di energia elettrica, gas, vapore e aria condiz...",0,0,0,0,0,2021
SIC,PA,D 35,"Fornitura di energia elettrica, gas, vapore e aria condiz...",0,0,0,0,0,2021
SIC,PA,E   ,"Fornitura di acqua; reti fognarie, attività di gestione d...",0,0,0,0,0,2021
SIC,PA,E 36,"Raccolta, trattamento e fornitura di acqua                  ",0,0,0,0,0,2021
SIC,PA,E 37,Gestione delle reti fognarie                                ,0,0,0,0,0,2021
SIC,PA,E 38,"Attività di raccolta, trattamento e smaltimento dei rifiu...",0,0,0,0,0,2021
SIC,PA,E 39,Attività di risanamento e altri servizi di gestione dei r...,0,0,0,0,0,2021
SIC,PA,F   ,Costruzioni                                                 ,0,0,0,0,0,2021
SIC,PA,F 41,Costruzione di edifici                                      ,0,0,0,0,0,2021
SIC,PA,F 42,Ingegneria civile                                           ,0,0,0,0,0,2021
SIC,PA,F 43,Lavori di costruzione specializzati                         ,0,0,0,0,0,2021
SIC,PA,G   ,Commercio all'ingrosso e al dettaglio; riparazione di aut...,0,0,0,0,0,2021
SIC,PA,G 45,Commercio all'ingrosso e al dettaglio e riparazione di au...,0,0,0,0,0,2021
SIC,PA,G 46,Commercio all'ingrosso (escluso quello di autoveicoli e d...,0,0,0,0,0,2021
SIC,PA,G 47,Commercio al dettaglio (escluso quello di autoveicoli e d...,0,0,0,0,0,2021
SIC,PA,H   ,Trasporto e magazzinaggio                                   ,1,0,0,0,1,2021
SIC,PA,H 49,Trasporto terrestre e mediante condotte                     ,0,0,0,0,0,2021
SIC,PA,H 50,Trasporto marittimo e per vie d'acqua                       ,0,0,0,0,0,2021
SIC,PA,H 51,Trasporto aereo                                             ,0,0,0,0,0,2021
SIC,PA,H 52,Magazzinaggio e attività di supporto ai trasporti           ,0,0,0,0,0,2021
SIC,PA,H 53,Servizi postali e attività di corriere                      ,1,0,0,0,1,2021
SIC,PA,I   ,Attività dei servizi alloggio e ristorazione                ,0,1,0,0,1,2021
SIC,PA,I 55,Alloggio                                                    ,0,0,0,0,0,2021
SIC,PA,I 56,Attività dei servizi di ristorazione                        ,0,1,0,0,1,2021
SIC,PA,J   ,Servizi di informazione e comunicazione                     ,0,0,0,0,0,2021
SIC,PA,J 58,Attività editoriali                                         ,0,0,0,0,0,2021
SIC,PA,J 59,"Attività di produzione cinematografica, di video e di pro...",0,0,0,0,0,2021
SIC,PA,J 60,Attività di programmazione e trasmissione                   ,0,0,0,0,0,2021
SIC,PA,J 61,Telecomunicazioni                                           ,0,0,0,0,0,2021
SIC,PA,J 62,"Produzione di software, consulenza informatica e attività...",0,0,0,0,0,2021
SIC,PA,J 63,Attività dei servizi d'informazione e altri servizi infor...,0,0,0,0,0,2021
SIC,PA,K   ,Attività finanziarie e assicurative                         ,0,0,0,0,0,2021
SIC,PA,K 64,Attività di servizi finanziari (escluse le assicurazioni ...,0,0,0,0,0,2021
SIC,PA,K 65,"Assicurazioni, riassicurazioni e fondi pensione (escluse ...",0,0,0,0,0,2021
SIC,PA,K 66,Attività ausiliarie dei servizi finanziari e delle attivi...,0,0,0,0,0,2021
SIC,PA,L   ,Attivita' immobiliari                                       ,0,0,0,0,0,2021
SIC,PA,L 68,Attivita' immobiliari                                       ,0,0,0,0,0,2021
SIC,PA,M   ,"Attività professionali, scientifiche e tecniche             ",0,0,0,1,1,2021
SIC,PA,M 69,Attività legali e contabilità                               ,0,0,0,1,1,2021
SIC,PA,M 70,Attività di direzione aziendale e di consulenza gestional...,0,0,0,0,0,2021
SIC,PA,M 71,Attività degli studi di architettura e d'ingegneria; coll...,0,0,0,0,0,2021
SIC,PA,M 72,Ricerca scientifica e sviluppo                              ,0,0,0,0,0,2021
SIC,PA,M 73,Pubblicità e ricerche di mercato                            ,0,0,0,0,0,2021
SIC,PA,M 74,"Altre attività professionali, scientifiche e tecniche       ",0,0,0,0,0,2021
SIC,PA,M 75,Servizi veterinari                                          ,0,0,0,0,0,2021
SIC,PA,N   ,"Noleggio, agenzie di viaggio, servizi di supporto alle im...",0,0,0,1,1,2021
SIC,PA,N 77,Attività di noleggio e leasing operativo                    ,0,0,0,0,0,2021
SIC,PA,N 78,"Attività di ricerca, selezione, fornitura di personale      ",0,0,0,0,0,2021
SIC,PA,N 79,"Attività dei servizi delle agenzie di viaggio, dei tour o...",0,0,0,0,0,2021
SIC,PA,N 80,Servizi di vigilanza e investigazione                       ,0,0,0,0,0,2021
SIC,PA,N 81,Attività di servizi per edifici e paesaggio                 ,0,0,0,1,1,2021
SIC,PA,N 82,Attività di supporto per le funzioni d'ufficio e altri se...,0,0,0,0,0,2021
SIC,PA,O   ,Amministrazione pubblica e difesa; assicurazione sociale ...,0,0,0,0,0,2021
SIC,PA,O 84,Amministrazione pubblica e difesa; assicurazione sociale ...,0,0,0,0,0,2021
SIC,PA,P   ,Istruzione                                                  ,0,0,0,0,0,2021
SIC,PA,P 85,Istruzione                                                  ,0,0,0,0,0,2021
SIC,PA,Q   ,Sanita' e assistenza sociale                                ,0,0,0,2,2,2021
SIC,PA,Q 86,Assistenza sanitaria                                        ,0,0,0,1,1,2021
SIC,PA,Q 87,Servizi di assistenza sociale residenziale                  ,0,0,0,0,0,2021
SIC,PA,Q 88,Assistenza sociale non residenziale                         ,0,0,0,1,1,2021
SIC,PA,R   ,"Attività artistiche, sportive, di intrattenimento e diver...",0,0,0,0,0,2021
SIC,PA,R 90,"Attività creative, artistiche e di intrattenimento          ",0,0,0,0,0,2021
SIC,PA,R 91,"Attività di biblioteche, archivi, musei ed altre attività...",0,0,0,0,0,2021
SIC,PA,R 92,"Attività riguardanti le lotterie, le scommesse, le case d...",0,0,0,0,0,2021
SIC,PA,R 93,"Attività sportive, di intrattenimento e di divertimento     ",0,0,0,0,0,2021
SIC,PA,S   ,Altre attività di servizi                                   ,0,0,0,0,0,2021
SIC,PA,S 94,Attività di organizzazioni associative                      ,0,0,0,0,0,2021
SIC,PA,S 95,Riparazione di computer e di beni per uso personale e per...,0,0,0,0,0,2021
SIC,PA,S 96,Altre attività di servizi per la persona                    ,0,0,0,0,0,2021
SIC,PA,T   ,Attività di famiglie e convivenze come datori di lavoro p...,0,0,0,0,0,2021
SIC,PA,T 97,Attività di famiglie e convivenze come datori di lavoro p...,0,0,0,0,0,2021
SIC,PA,T 98,Produzione di beni e servizi indifferenziati per uso prop...,0,0,0,0,0,2021
SIC,PA,U   ,Organizzazioni ed organismi extraterritoriali               ,0,0,0,0,0,2021
SIC,PA,U 99,Organizzazioni ed organismi extraterritoriali               ,0,0,0,0,0,2021
SIC,PA,XX  ,Imprese non classificate                                    ,0,0,0,8,8,2021
SIC,PA,TOT ,TOTALE                                                      ,1,1,0,13,15,2021
SIC,ME,A   ,"Agricoltura, silvicoltura pesca                             ",0,0,0,0,0,2021
SIC,ME,A 01,"Coltivazioni agricole e produzione di prodotti animali, c...",0,0,0,0,0,2021
SIC,ME,A 02,Silvicoltura ed utilizzo di aree forestali                  ,0,0,0,0,0,2021
SIC,ME,A 03,Pesca e acquacoltura                                        ,0,0,0,0,0,2021
SIC,ME,B   ,Estrazione di minerali da cave e miniere                    ,0,0,0,0,0,2021
SIC,ME,B 05,Estrazione di carbone (esclusa torba)                       ,0,0,0,0,0,2021
SIC,ME,B 06,Estraz.di petrolio greggio e di gas naturale                ,0,0,0,0,0,2021
SIC,ME,B 07,Estrazione di minerali metalliferi                          ,0,0,0,0,0,2021
SIC,ME,B 08,Altre attività di estrazione di minerali da cave e miniere  ,0,0,0,0,0,2021
SIC,ME,B 09,Attività dei servizi di supporto all'estrazione             ,0,0,0,0,0,2021
SIC,ME,C   ,Attività manifatturiere                                     ,1,0,0,0,1,2021
SIC,ME,C 10,Industrie alimentari                                        ,0,0,0,0,0,2021
SIC,ME,C 11,Industria delle bevande                                     ,0,0,0,0,0,2021
SIC,ME,C 12,Industria del tabacco                                       ,0,0,0,0,0,2021
SIC,ME,C 13,Industrie tessili                                           ,0,0,0,0,0,2021
SIC,ME,C 14,Confezione di articoli di abbigliamento; confezione di ar...,0,0,0,0,0,2021
SIC,ME,C 15,Fabbricazione di articoli in pelle e simili                 ,0,0,0,0,0,2021
SIC,ME,C 16,Industria del legno e dei prodotti in legno e sughero (es...,0,0,0,0,0,2021
SIC,ME,C 17,Fabbricazione di carta e di prodotti di carta               ,0,0,0,0,0,2021
SIC,ME,C 18,Stampa e riproduzione di supporti registrati                ,0,0,0,0,0,2021
SIC,ME,C 19,Fabbricazione di coke e prodotti derivanti dalla raffinaz...,0,0,0,0,0,2021
SIC,ME,C 20,Fabbricazione di prodotti chimici                           ,0,0,0,0,0,2021
SIC,ME,C 21,Fabbricazione di prodotti farmaceutici di base e di prepa...,0,0,0,0,0,2021
SIC,ME,C 22,Fabbricazione di articoli in gomma e materie plastiche      ,0,0,0,0,0,2021
SIC,ME,C 23,Fabbricazione di altri prodotti della lavorazione di miner..,0,0,0,0,0,2021
SIC,ME,C 24,Metallurgia                                                 ,0,0,0,0,0,2021
SIC,ME,C 25,Fabbricazione di prodotti in metallo (esclusi macchinari ...,1,0,0,0,1,2021
SIC,ME,C 26,Fabbricazione di computer e prodotti di elettronica e ott...,0,0,0,0,0,2021
SIC,ME,C 27,Fabbricazione di apparecchiature elettriche ed apparecchi...,0,0,0,0,0,2021
SIC,ME,C 28,Fabbricazione di macchinari ed apparecchiature nca          ,0,0,0,0,0,2021
SIC,ME,C 29,"Fabbricazione di autoveicoli, rimorchi e semirimorchi       ",0,0,0,0,0,2021
SIC,ME,C 30,Fabbricazione di altri mezzi di trasporto                   ,0,0,0,0,0,2021
SIC,ME,C 31,Fabbricazione di mobili                                     ,0,0,0,0,0,2021
SIC,ME,C 32,Altre industrie manifatturiere                              ,0,0,0,0,0,2021
SIC,ME,C 33,"Riparazione, manutenzione ed installazione di macchine ed...",0,0,0,0,0,2021
SIC,ME,D   ,"Fornitura di energia elettrica, gas, vapore e aria condiz...",0,0,0,0,0,2021
SIC,ME,D 35,"Fornitura di energia elettrica, gas, vapore e aria condiz...",0,0,0,0,0,2021
SIC,ME,E   ,"Fornitura di acqua; reti fognarie, attività di gestione d...",0,0,0,0,0,2021
SIC,ME,E 36,"Raccolta, trattamento e fornitura di acqua                  ",0,0,0,0,0,2021
SIC,ME,E 37,Gestione delle reti fognarie                                ,0,0,0,0,0,2021
SIC,ME,E 38,"Attività di raccolta, trattamento e smaltimento dei rifiu...",0,0,0,0,0,2021
SIC,ME,E 39,Attività di risanamento e altri servizi di gestione dei r...,0,0,0,0,0,2021
SIC,ME,F   ,Costruzioni                                                 ,0,0,0,0,0,2021
SIC,ME,F 41,Costruzione di edifici                                      ,0,0,0,0,0,2021
SIC,ME,F 42,Ingegneria civile                                           ,0,0,0,0,0,2021
SIC,ME,F 43,Lavori di costruzione specializzati                         ,0,0,0,0,0,2021
SIC,ME,G   ,Commercio all'ingrosso e al dettaglio; riparazione di aut...,0,0,0,1,1,2021
SIC,ME,G 45,Commercio all'ingrosso e al dettaglio e riparazione di au...,0,0,0,0,0,2021
SIC,ME,G 46,Commercio all'ingrosso (escluso quello di autoveicoli e d...,0,0,0,1,1,2021
SIC,ME,G 47,Commercio al dettaglio (escluso quello di autoveicoli e d...,0,0,0,0,0,2021
SIC,ME,H   ,Trasporto e magazzinaggio                                   ,0,0,0,0,0,2021
SIC,ME,H 49,Trasporto terrestre e mediante condotte                     ,0,0,0,0,0,2021
SIC,ME,H 50,Trasporto marittimo e per vie d'acqua                       ,0,0,0,0,0,2021
SIC,ME,H 51,Trasporto aereo                                             ,0,0,0,0,0,2021
SIC,ME,H 52,Magazzinaggio e attività di supporto ai trasporti           ,0,0,0,0,0,2021
SIC,ME,H 53,Servizi postali e attività di corriere                      ,0,0,0,0,0,2021
SIC,ME,I   ,Attività dei servizi alloggio e ristorazione                ,0,0,0,0,0,2021
SIC,ME,I 55,Alloggio                                                    ,0,0,0,0,0,2021
SIC,ME,I 56,Attività dei servizi di ristorazione                        ,0,0,0,0,0,2021
SIC,ME,J   ,Servizi di informazione e comunicazione                     ,0,0,0,0,0,2021
SIC,ME,J 58,Attività editoriali                                         ,0,0,0,0,0,2021
SIC,ME,J 59,"Attività di produzione cinematografica, di video e di pro...",0,0,0,0,0,2021
SIC,ME,J 60,Attività di programmazione e trasmissione                   ,0,0,0,0,0,2021
SIC,ME,J 61,Telecomunicazioni                                           ,0,0,0,0,0,2021
SIC,ME,J 62,"Produzione di software, consulenza informatica e attività...",0,0,0,0,0,2021
SIC,ME,J 63,Attività dei servizi d'informazione e altri servizi infor...,0,0,0,0,0,2021
SIC,ME,K   ,Attività finanziarie e assicurative                         ,0,0,0,0,0,2021
SIC,ME,K 64,Attività di servizi finanziari (escluse le assicurazioni ...,0,0,0,0,0,2021
SIC,ME,K 65,"Assicurazioni, riassicurazioni e fondi pensione (escluse ...",0,0,0,0,0,2021
SIC,ME,K 66,Attività ausiliarie dei servizi finanziari e delle attivi...,0,0,0,0,0,2021
SIC,ME,L   ,Attivita' immobiliari                                       ,0,0,0,0,0,2021
SIC,ME,L 68,Attivita' immobiliari                                       ,0,0,0,0,0,2021
SIC,ME,M   ,"Attività professionali, scientifiche e tecniche             ",0,0,0,0,0,2021
SIC,ME,M 69,Attività legali e contabilità                               ,0,0,0,0,0,2021
SIC,ME,M 70,Attività di direzione aziendale e di consulenza gestional...,0,0,0,0,0,2021
SIC,ME,M 71,Attività degli studi di architettura e d'ingegneria; coll...,0,0,0,0,0,2021
SIC,ME,M 72,Ricerca scientifica e sviluppo                              ,0,0,0,0,0,2021
SIC,ME,M 73,Pubblicità e ricerche di mercato                            ,0,0,0,0,0,2021
SIC,ME,M 74,"Altre attività professionali, scientifiche e tecniche       ",0,0,0,0,0,2021
SIC,ME,M 75,Servizi veterinari                                          ,0,0,0,0,0,2021
SIC,ME,N   ,"Noleggio, agenzie di viaggio, servizi di supporto alle im...",0,0,0,0,0,2021
SIC,ME,N 77,Attività di noleggio e leasing operativo                    ,0,0,0,0,0,2021
SIC,ME,N 78,"Attività di ricerca, selezione, fornitura di personale      ",0,0,0,0,0,2021
SIC,ME,N 79,"Attività dei servizi delle agenzie di viaggio, dei tour o...",0,0,0,0,0,2021
SIC,ME,N 80,Servizi di vigilanza e investigazione                       ,0,0,0,0,0,2021
SIC,ME,N 81,Attività di servizi per edifici e paesaggio                 ,0,0,0,0,0,2021
SIC,ME,N 82,Attività di supporto per le funzioni d'ufficio e altri se...,0,0,0,0,0,2021
SIC,ME,O   ,Amministrazione pubblica e difesa; assicurazione sociale ...,0,0,0,0,0,2021
SIC,ME,O 84,Amministrazione pubblica e difesa; assicurazione sociale ...,0,0,0,0,0,2021
SIC,ME,P   ,Istruzione                                                  ,0,0,0,0,0,2021
SIC,ME,P 85,Istruzione                                                  ,0,0,0,0,0,2021
SIC,ME,Q   ,Sanita' e assistenza sociale                                ,0,0,0,0,0,2021
SIC,ME,Q 86,Assistenza sanitaria                                        ,0,0,0,0,0,2021
SIC,ME,Q 87,Servizi di assistenza sociale residenziale                  ,0,0,0,0,0,2021
SIC,ME,Q 88,Assistenza sociale non residenziale                         ,0,0,0,0,0,2021
SIC,ME,R   ,"Attività artistiche, sportive, di intrattenimento e diver...",0,0,0,1,1,2021
SIC,ME,R 90,"Attività creative, artistiche e di intrattenimento          ",0,0,0,0,0,2021
SIC,ME,R 91,"Attività di biblioteche, archivi, musei ed altre attività...",0,0,0,0,0,2021
SIC,ME,R 92,"Attività riguardanti le lotterie, le scommesse, le case d...",0,0,0,0,0,2021
SIC,ME,R 93,"Attività sportive, di intrattenimento e di divertimento     ",0,0,0,1,1,2021
SIC,ME,S   ,Altre attività di servizi                                   ,0,0,0,0,0,2021
SIC,ME,S 94,Attività di organizzazioni associative                      ,0,0,0,0,0,2021
SIC,ME,S 95,Riparazione di computer e di beni per uso personale e per...,0,0,0,0,0,2021
SIC,ME,S 96,Altre attività di servizi per la persona                    ,0,0,0,0,0,2021
SIC,ME,T   ,Attività di famiglie e convivenze come datori di lavoro p...,0,0,0,0,0,2021
SIC,ME,T 97,Attività di famiglie e convivenze come datori di lavoro p...,0,0,0,0,0,2021
SIC,ME,T 98,Produzione di beni e servizi indifferenziati per uso prop...,0,0,0,0,0,2021
SIC,ME,U   ,Organizzazioni ed organismi extraterritoriali               ,0,0,0,0,0,2021
SIC,ME,U 99,Organizzazioni ed organismi extraterritoriali               ,0,0,0,0,0,2021
SIC,ME,XX  ,Imprese non classificate                                    ,0,0,0,2,2,2021
SIC,ME,TOT ,TOTALE                                                      ,1,0,0,4,5,2021
SIC,AG,A   ,"Agricoltura, silvicoltura pesca                             ",0,0,0,0,0,2021
SIC,AG,A 01,"Coltivazioni agricole e produzione di prodotti animali, c...",0,0,0,0,0,2021
SIC,AG,A 02,Silvicoltura ed utilizzo di aree forestali                  ,0,0,0,0,0,2021
SIC,AG,A 03,Pesca e acquacoltura                                        ,0,0,0,0,0,2021
SIC,AG,B   ,Estrazione di minerali da cave e miniere                    ,0,0,0,0,0,2021
SIC,AG,B 05,Estrazione di carbone (esclusa torba)                       ,0,0,0,0,0,2021
SIC,AG,B 06,Estraz.di petrolio greggio e di gas naturale                ,0,0,0,0,0,2021
SIC,AG,B 07,Estrazione di minerali metalliferi                          ,0,0,0,0,0,2021
SIC,AG,B 08,Altre attività di estrazione di minerali da cave e miniere  ,0,0,0,0,0,2021
SIC,AG,B 09,Attività dei servizi di supporto all'estrazione             ,0,0,0,0,0,2021
SIC,AG,C   ,Attività manifatturiere                                     ,0,0,0,0,0,2021
SIC,AG,C 10,Industrie alimentari                                        ,0,0,0,0,0,2021
SIC,AG,C 11,Industria delle bevande                                     ,0,0,0,0,0,2021
SIC,AG,C 12,Industria del tabacco                                       ,0,0,0,0,0,2021
SIC,AG,C 13,Industrie tessili                                           ,0,0,0,0,0,2021
SIC,AG,C 14,Confezione di articoli di abbigliamento; confezione di ar...,0,0,0,0,0,2021
SIC,AG,C 15,Fabbricazione di articoli in pelle e simili                 ,0,0,0,0,0,2021
SIC,AG,C 16,Industria del legno e dei prodotti in legno e sughero (es...,0,0,0,0,0,2021
SIC,AG,C 17,Fabbricazione di carta e di prodotti di carta               ,0,0,0,0,0,2021
SIC,AG,C 18,Stampa e riproduzione di supporti registrati                ,0,0,0,0,0,2021
SIC,AG,C 19,Fabbricazione di coke e prodotti derivanti dalla raffinaz...,0,0,0,0,0,2021
SIC,AG,C 20,Fabbricazione di prodotti chimici                           ,0,0,0,0,0,2021
SIC,AG,C 21,Fabbricazione di prodotti farmaceutici di base e di prepa...,0,0,0,0,0,2021
SIC,AG,C 22,Fabbricazione di articoli in gomma e materie plastiche      ,0,0,0,0,0,2021
SIC,AG,C 23,Fabbricazione di altri prodotti della lavorazione di miner..,0,0,0,0,0,2021
SIC,AG,C 24,Metallurgia                                                 ,0,0,0,0,0,2021
SIC,AG,C 25,Fabbricazione di prodotti in metallo (esclusi macchinari ...,0,0,0,0,0,2021
SIC,AG,C 26,Fabbricazione di computer e prodotti di elettronica e ott...,0,0,0,0,0,2021
SIC,AG,C 27,Fabbricazione di apparecchiature elettriche ed apparecchi...,0,0,0,0,0,2021
SIC,AG,C 28,Fabbricazione di macchinari ed apparecchiature nca          ,0,0,0,0,0,2021
SIC,AG,C 29,"Fabbricazione di autoveicoli, rimorchi e semirimorchi       ",0,0,0,0,0,2021
SIC,AG,C 30,Fabbricazione di altri mezzi di trasporto                   ,0,0,0,0,0,2021
SIC,AG,C 31,Fabbricazione di mobili                                     ,0,0,0,0,0,2021
SIC,AG,C 32,Altre industrie manifatturiere                              ,0,0,0,0,0,2021
SIC,AG,C 33,"Riparazione, manutenzione ed installazione di macchine ed...",0,0,0,0,0,2021
SIC,AG,D   ,"Fornitura di energia elettrica, gas, vapore e aria condiz...",0,0,0,0,0,2021
SIC,AG,D 35,"Fornitura di energia elettrica, gas, vapore e aria condiz...",0,0,0,0,0,2021
SIC,AG,E   ,"Fornitura di acqua; reti fognarie, attività di gestione d...",0,0,0,0,0,2021
SIC,AG,E 36,"Raccolta, trattamento e fornitura di acqua                  ",0,0,0,0,0,2021
SIC,AG,E 37,Gestione delle reti fognarie                                ,0,0,0,0,0,2021
SIC,AG,E 38,"Attività di raccolta, trattamento e smaltimento dei rifiu...",0,0,0,0,0,2021
SIC,AG,E 39,Attività di risanamento e altri servizi di gestione dei r...,0,0,0,0,0,2021
SIC,AG,F   ,Costruzioni                                                 ,0,0,0,0,0,2021
SIC,AG,F 41,Costruzione di edifici                                      ,0,0,0,0,0,2021
SIC,AG,F 42,Ingegneria civile                                           ,0,0,0,0,0,2021
SIC,AG,F 43,Lavori di costruzione specializzati                         ,0,0,0,0,0,2021
SIC,AG,G   ,Commercio all'ingrosso e al dettaglio; riparazione di aut...,0,0,0,1,1,2021
SIC,AG,G 45,Commercio all'ingrosso e al dettaglio e riparazione di au...,0,0,0,0,0,2021
SIC,AG,G 46,Commercio all'ingrosso (escluso quello di autoveicoli e d...,0,0,0,1,1,2021
SIC,AG,G 47,Commercio al dettaglio (escluso quello di autoveicoli e d...,0,0,0,0,0,2021
SIC,AG,H   ,Trasporto e magazzinaggio                                   ,0,0,0,0,0,2021
SIC,AG,H 49,Trasporto terrestre e mediante condotte                     ,0,0,0,0,0,2021
SIC,AG,H 50,Trasporto marittimo e per vie d'acqua                       ,0,0,0,0,0,2021
SIC,AG,H 51,Trasporto aereo                                             ,0,0,0,0,0,2021
SIC,AG,H 52,Magazzinaggio e attività di supporto ai trasporti           ,0,0,0,0,0,2021
SIC,AG,H 53,Servizi postali e attività di corriere                      ,0,0,0,0,0,2021
SIC,AG,I   ,Attività dei servizi alloggio e ristorazione                ,0,0,0,0,0,2021
SIC,AG,I 55,Alloggio                                                    ,0,0,0,0,0,2021
SIC,AG,I 56,Attività dei servizi di ristorazione                        ,0,0,0,0,0,2021
SIC,AG,J   ,Servizi di informazione e comunicazione                     ,0,0,0,0,0,2021
SIC,AG,J 58,Attività editoriali                                         ,0,0,0,0,0,2021
SIC,AG,J 59,"Attività di produzione cinematografica, di video e di pro...",0,0,0,0,0,2021
SIC,AG,J 60,Attività di programmazione e trasmissione                   ,0,0,0,0,0,2021
SIC,AG,J 61,Telecomunicazioni                                           ,0,0,0,0,0,2021
SIC,AG,J 62,"Produzione di software, consulenza informatica e attività...",0,0,0,0,0,2021
SIC,AG,J 63,Attività dei servizi d'informazione e altri servizi infor...,0,0,0,0,0,2021
SIC,AG,K   ,Attività finanziarie e assicurative                         ,0,0,0,0,0,2021
SIC,AG,K 64,Attività di servizi finanziari (escluse le assicurazioni ...,0,0,0,0,0,2021
SIC,AG,K 65,"Assicurazioni, riassicurazioni e fondi pensione (escluse ...",0,0,0,0,0,2021
SIC,AG,K 66,Attività ausiliarie dei servizi finanziari e delle attivi...,0,0,0,0,0,2021
SIC,AG,L   ,Attivita' immobiliari                                       ,0,0,0,0,0,2021
SIC,AG,L 68,Attivita' immobiliari                                       ,0,0,0,0,0,2021
SIC,AG,M   ,"Attività professionali, scientifiche e tecniche             ",0,0,0,0,0,2021
SIC,AG,M 69,Attività legali e contabilità                               ,0,0,0,0,0,2021
SIC,AG,M 70,Attività di direzione aziendale e di consulenza gestional...,0,0,0,0,0,2021
SIC,AG,M 71,Attività degli studi di architettura e d'ingegneria; coll...,0,0,0,0,0,2021
SIC,AG,M 72,Ricerca scientifica e sviluppo                              ,0,0,0,0,0,2021
SIC,AG,M 73,Pubblicità e ricerche di mercato                            ,0,0,0,0,0,2021
SIC,AG,M 74,"Altre attività professionali, scientifiche e tecniche       ",0,0,0,0,0,2021
SIC,AG,M 75,Servizi veterinari                                          ,0,0,0,0,0,2021
SIC,AG,N   ,"Noleggio, agenzie di viaggio, servizi di supporto alle im...",0,0,0,0,0,2021
SIC,AG,N 77,Attività di noleggio e leasing operativo                    ,0,0,0,0,0,2021
SIC,AG,N 78,"Attività di ricerca, selezione, fornitura di personale      ",0,0,0,0,0,2021
SIC,AG,N 79,"Attività dei servizi delle agenzie di viaggio, dei tour o...",0,0,0,0,0,2021
SIC,AG,N 80,Servizi di vigilanza e investigazione                       ,0,0,0,0,0,2021
SIC,AG,N 81,Attività di servizi per edifici e paesaggio                 ,0,0,0,0,0,2021
SIC,AG,N 82,Attività di supporto per le funzioni d'ufficio e altri se...,0,0,0,0,0,2021
SIC,AG,O   ,Amministrazione pubblica e difesa; assicurazione sociale ...,0,0,0,0,0,2021
SIC,AG,O 84,Amministrazione pubblica e difesa; assicurazione sociale ...,0,0,0,0,0,2021
SIC,AG,P   ,Istruzione                                                  ,0,0,0,0,0,2021
SIC,AG,P 85,Istruzione                                                  ,0,0,0,0,0,2021
SIC,AG,Q   ,Sanita' e assistenza sociale                                ,0,0,0,0,0,2021
SIC,AG,Q 86,Assistenza sanitaria                                        ,0,0,0,0,0,2021
SIC,AG,Q 87,Servizi di assistenza sociale residenziale                  ,0,0,0,0,0,2021
SIC,AG,Q 88,Assistenza sociale non residenziale                         ,0,0,0,0,0,2021
SIC,AG,R   ,"Attività artistiche, sportive, di intrattenimento e diver...",0,0,0,0,0,2021
SIC,AG,R 90,"Attività creative, artistiche e di intrattenimento          ",0,0,0,0,0,2021
SIC,AG,R 91,"Attività di biblioteche, archivi, musei ed altre attività...",0,0,0,0,0,2021
SIC,AG,R 92,"Attività riguardanti le lotterie, le scommesse, le case d...",0,0,0,0,0,2021
SIC,AG,R 93,"Attività sportive, di intrattenimento e di divertimento     ",0,0,0,0,0,2021
SIC,AG,S   ,Altre attività di servizi                                   ,0,0,0,0,0,2021
SIC,AG,S 94,Attività di organizzazioni associative                      ,0,0,0,0,0,2021
SIC,AG,S 95,Riparazione di computer e di beni per uso personale e per...,0,0,0,0,0,2021
SIC,AG,S 96,Altre attività di servizi per la persona                    ,0,0,0,0,0,2021
SIC,AG,T   ,Attività di famiglie e convivenze come datori di lavoro p...,0,0,0,0,0,2021
SIC,AG,T 97,Attività di famiglie e convivenze come datori di lavoro p...,0,0,0,0,0,2021
SIC,AG,T 98,Produzione di beni e servizi indifferenziati per uso prop...,0,0,0,0,0,2021
SIC,AG,U   ,Organizzazioni ed organismi extraterritoriali               ,0,0,0,0,0,2021
SIC,AG,U 99,Organizzazioni ed organismi extraterritoriali               ,0,0,0,0,0,2021
SIC,AG,XX  ,Imprese non classificate                                    ,0,0,0,4,4,2021
SIC,AG,TOT ,TOTALE                                                      ,0,0,0,5,5,2021
SIC,CL,A   ,"Agricoltura, silvicoltura pesca                             ",0,0,0,0,0,2021
SIC,CL,A 01,"Coltivazioni agricole e produzione di prodotti animali, c...",0,0,0,0,0,2021
SIC,CL,A 02,Silvicoltura ed utilizzo di aree forestali                  ,0,0,0,0,0,2021
SIC,CL,A 03,Pesca e acquacoltura                                        ,0,0,0,0,0,2021
SIC,CL,B   ,Estrazione di minerali da cave e miniere                    ,0,0,0,0,0,2021
SIC,CL,B 05,Estrazione di carbone (esclusa torba)                       ,0,0,0,0,0,2021
SIC,CL,B 06,Estraz.di petrolio greggio e di gas naturale                ,0,0,0,0,0,2021
SIC,CL,B 07,Estrazione di minerali metalliferi                          ,0,0,0,0,0,2021
SIC,CL,B 08,Altre attività di estrazione di minerali da cave e miniere  ,0,0,0,0,0,2021
SIC,CL,B 09,Attività dei servizi di supporto all'estrazione             ,0,0,0,0,0,2021
SIC,CL,C   ,Attività manifatturiere                                     ,0,0,0,0,0,2021
SIC,CL,C 10,Industrie alimentari                                        ,0,0,0,0,0,2021
SIC,CL,C 11,Industria delle bevande                                     ,0,0,0,0,0,2021
SIC,CL,C 12,Industria del tabacco                                       ,0,0,0,0,0,2021
SIC,CL,C 13,Industrie tessili                                           ,0,0,0,0,0,2021
SIC,CL,C 14,Confezione di articoli di abbigliamento; confezione di ar...,0,0,0,0,0,2021
SIC,CL,C 15,Fabbricazione di articoli in pelle e simili                 ,0,0,0,0,0,2021
SIC,CL,C 16,Industria del legno e dei prodotti in legno e sughero (es...,0,0,0,0,0,2021
SIC,CL,C 17,Fabbricazione di carta e di prodotti di carta               ,0,0,0,0,0,2021
SIC,CL,C 18,Stampa e riproduzione di supporti registrati                ,0,0,0,0,0,2021
SIC,CL,C 19,Fabbricazione di coke e prodotti derivanti dalla raffinaz...,0,0,0,0,0,2021
SIC,CL,C 20,Fabbricazione di prodotti chimici                           ,0,0,0,0,0,2021
SIC,CL,C 21,Fabbricazione di prodotti farmaceutici di base e di prepa...,0,0,0,0,0,2021
SIC,CL,C 22,Fabbricazione di articoli in gomma e materie plastiche      ,0,0,0,0,0,2021
SIC,CL,C 23,Fabbricazione di altri prodotti della lavorazione di miner..,0,0,0,0,0,2021
SIC,CL,C 24,Metallurgia                                                 ,0,0,0,0,0,2021
SIC,CL,C 25,Fabbricazione di prodotti in metallo (esclusi macchinari ...,0,0,0,0,0,2021
SIC,CL,C 26,Fabbricazione di computer e prodotti di elettronica e ott...,0,0,0,0,0,2021
SIC,CL,C 27,Fabbricazione di apparecchiature elettriche ed apparecchi...,0,0,0,0,0,2021
SIC,CL,C 28,Fabbricazione di macchinari ed apparecchiature nca          ,0,0,0,0,0,2021
SIC,CL,C 29,"Fabbricazione di autoveicoli, rimorchi e semirimorchi       ",0,0,0,0,0,2021
SIC,CL,C 30,Fabbricazione di altri mezzi di trasporto                   ,0,0,0,0,0,2021
SIC,CL,C 31,Fabbricazione di mobili                                     ,0,0,0,0,0,2021
SIC,CL,C 32,Altre industrie manifatturiere                              ,0,0,0,0,0,2021
SIC,CL,C 33,"Riparazione, manutenzione ed installazione di macchine ed...",0,0,0,0,0,2021
SIC,CL,D   ,"Fornitura di energia elettrica, gas, vapore e aria condiz...",0,0,0,0,0,2021
SIC,CL,D 35,"Fornitura di energia elettrica, gas, vapore e aria condiz...",0,0,0,0,0,2021
SIC,CL,E   ,"Fornitura di acqua; reti fognarie, attività di gestione d...",0,0,0,0,0,2021
SIC,CL,E 36,"Raccolta, trattamento e fornitura di acqua                  ",0,0,0,0,0,2021
SIC,CL,E 37,Gestione delle reti fognarie                                ,0,0,0,0,0,2021
SIC,CL,E 38,"Attività di raccolta, trattamento e smaltimento dei rifiu...",0,0,0,0,0,2021
SIC,CL,E 39,Attività di risanamento e altri servizi di gestione dei r...,0,0,0,0,0,2021
SIC,CL,F   ,Costruzioni                                                 ,0,0,0,0,0,2021
SIC,CL,F 41,Costruzione di edifici                                      ,0,0,0,0,0,2021
SIC,CL,F 42,Ingegneria civile                                           ,0,0,0,0,0,2021
SIC,CL,F 43,Lavori di costruzione specializzati                         ,0,0,0,0,0,2021
SIC,CL,G   ,Commercio all'ingrosso e al dettaglio; riparazione di aut...,0,0,0,0,0,2021
SIC,CL,G 45,Commercio all'ingrosso e al dettaglio e riparazione di au...,0,0,0,0,0,2021
SIC,CL,G 46,Commercio all'ingrosso (escluso quello di autoveicoli e d...,0,0,0,0,0,2021
SIC,CL,G 47,Commercio al dettaglio (escluso quello di autoveicoli e d...,0,0,0,0,0,2021
SIC,CL,H   ,Trasporto e magazzinaggio                                   ,0,0,0,0,0,2021
SIC,CL,H 49,Trasporto terrestre e mediante condotte                     ,0,0,0,0,0,2021
SIC,CL,H 50,Trasporto marittimo e per vie d'acqua                       ,0,0,0,0,0,2021
SIC,CL,H 51,Trasporto aereo                                             ,0,0,0,0,0,2021
SIC,CL,H 52,Magazzinaggio e attività di supporto ai trasporti           ,0,0,0,0,0,2021
SIC,CL,H 53,Servizi postali e attività di corriere                      ,0,0,0,0,0,2021
SIC,CL,I   ,Attività dei servizi alloggio e ristorazione                ,0,0,0,0,0,2021
SIC,CL,I 55,Alloggio                                                    ,0,0,0,0,0,2021
SIC,CL,I 56,Attività dei servizi di ristorazione                        ,0,0,0,0,0,2021
SIC,CL,J   ,Servizi di informazione e comunicazione                     ,0,0,0,0,0,2021
SIC,CL,J 58,Attività editoriali                                         ,0,0,0,0,0,2021
SIC,CL,J 59,"Attività di produzione cinematografica, di video e di pro...",0,0,0,0,0,2021
SIC,CL,J 60,Attività di programmazione e trasmissione                   ,0,0,0,0,0,2021
SIC,CL,J 61,Telecomunicazioni                                           ,0,0,0,0,0,2021
SIC,CL,J 62,"Produzione di software, consulenza informatica e attività...",0,0,0,0,0,2021
SIC,CL,J 63,Attività dei servizi d'informazione e altri servizi infor...,0,0,0,0,0,2021
SIC,CL,K   ,Attività finanziarie e assicurative                         ,0,0,0,0,0,2021
SIC,CL,K 64,Attività di servizi finanziari (escluse le assicurazioni ...,0,0,0,0,0,2021
SIC,CL,K 65,"Assicurazioni, riassicurazioni e fondi pensione (escluse ...",0,0,0,0,0,2021
SIC,CL,K 66,Attività ausiliarie dei servizi finanziari e delle attivi...,0,0,0,0,0,2021
SIC,CL,L   ,Attivita' immobiliari                                       ,0,0,0,0,0,2021
SIC,CL,L 68,Attivita' immobiliari                                       ,0,0,0,0,0,2021
SIC,CL,M   ,"Attività professionali, scientifiche e tecniche             ",0,0,0,0,0,2021
SIC,CL,M 69,Attività legali e contabilità                               ,0,0,0,0,0,2021
SIC,CL,M 70,Attività di direzione aziendale e di consulenza gestional...,0,0,0,0,0,2021
SIC,CL,M 71,Attività degli studi di architettura e d'ingegneria; coll...,0,0,0,0,0,2021
SIC,CL,M 72,Ricerca scientifica e sviluppo                              ,0,0,0,0,0,2021
SIC,CL,M 73,Pubblicità e ricerche di mercato                            ,0,0,0,0,0,2021
SIC,CL,M 74,"Altre attività professionali, scientifiche e tecniche       ",0,0,0,0,0,2021
SIC,CL,M 75,Servizi veterinari                                          ,0,0,0,0,0,2021
SIC,CL,N   ,"Noleggio, agenzie di viaggio, servizi di supporto alle im...",0,0,0,0,0,2021
SIC,CL,N 77,Attività di noleggio e leasing operativo                    ,0,0,0,0,0,2021
SIC,CL,N 78,"Attività di ricerca, selezione, fornitura di personale      ",0,0,0,0,0,2021
SIC,CL,N 79,"Attività dei servizi delle agenzie di viaggio, dei tour o...",0,0,0,0,0,2021
SIC,CL,N 80,Servizi di vigilanza e investigazione                       ,0,0,0,0,0,2021
SIC,CL,N 81,Attività di servizi per edifici e paesaggio                 ,0,0,0,0,0,2021
SIC,CL,N 82,Attività di supporto per le funzioni d'ufficio e altri se...,0,0,0,0,0,2021
SIC,CL,O   ,Amministrazione pubblica e difesa; assicurazione sociale ...,0,0,0,0,0,2021
SIC,CL,O 84,Amministrazione pubblica e difesa; assicurazione sociale ...,0,0,0,0,0,2021
SIC,CL,P   ,Istruzione                                                  ,0,0,0,0,0,2021
SIC,CL,P 85,Istruzione                                                  ,0,0,0,0,0,2021
SIC,CL,Q   ,Sanita' e assistenza sociale                                ,0,0,0,0,0,2021
SIC,CL,Q 86,Assistenza sanitaria                                        ,0,0,0,0,0,2021
SIC,CL,Q 87,Servizi di assistenza sociale residenziale                  ,0,0,0,0,0,2021
SIC,CL,Q 88,Assistenza sociale non residenziale                         ,0,0,0,0,0,2021
SIC,CL,R   ,"Attività artistiche, sportive, di intrattenimento e diver...",0,0,0,0,0,2021
SIC,CL,R 90,"Attività creative, artistiche e di intrattenimento          ",0,0,0,0,0,2021
SIC,CL,R 91,"Attività di biblioteche, archivi, musei ed altre attività...",0,0,0,0,0,2021
SIC,CL,R 92,"Attività riguardanti le lotterie, le scommesse, le case d...",0,0,0,0,0,2021
SIC,CL,R 93,"Attività sportive, di intrattenimento e di divertimento     ",0,0,0,0,0,2021
SIC,CL,S   ,Altre attività di servizi                                   ,0,0,0,0,0,2021
SIC,CL,S 94,Attività di organizzazioni associative                      ,0,0,0,0,0,2021
SIC,CL,S 95,Riparazione di computer e di beni per uso personale e per...,0,0,0,0,0,2021
SIC,CL,S 96,Altre attività di servizi per la persona                    ,0,0,0,0,0,2021
SIC,CL,T   ,Attività di famiglie e convivenze come datori di lavoro p...,0,0,0,0,0,2021
SIC,CL,T 97,Attività di famiglie e convivenze come datori di lavoro p...,0,0,0,0,0,2021
SIC,CL,T 98,Produzione di beni e servizi indifferenziati per uso prop...,0,0,0,0,0,2021
SIC,CL,U   ,Organizzazioni ed organismi extraterritoriali               ,0,0,0,0,0,2021
SIC,CL,U 99,Organizzazioni ed organismi extraterritoriali               ,0,0,0,0,0,2021
SIC,CL,XX  ,Imprese non classificate                                    ,0,0,0,0,0,2021
SIC,CL,TOT ,TOTALE                                                      ,0,0,0,0,0,2021
SIC,EN,A   ,"Agricoltura, silvicoltura pesca                             ",0,0,0,0,0,2021
SIC,EN,A 01,"Coltivazioni agricole e produzione di prodotti animali, c...",0,0,0,0,0,2021
SIC,EN,A 02,Silvicoltura ed utilizzo di aree forestali                  ,0,0,0,0,0,2021
SIC,EN,A 03,Pesca e acquacoltura                                        ,0,0,0,0,0,2021
SIC,EN,B   ,Estrazione di minerali da cave e miniere                    ,0,0,0,0,0,2021
SIC,EN,B 05,Estrazione di carbone (esclusa torba)                       ,0,0,0,0,0,2021
SIC,EN,B 06,Estraz.di petrolio greggio e di gas naturale                ,0,0,0,0,0,2021
SIC,EN,B 07,Estrazione di minerali metalliferi                          ,0,0,0,0,0,2021
SIC,EN,B 08,Altre attività di estrazione di minerali da cave e miniere  ,0,0,0,0,0,2021
SIC,EN,B 09,Attività dei servizi di supporto all'estrazione             ,0,0,0,0,0,2021
SIC,EN,C   ,Attività manifatturiere                                     ,0,0,0,0,0,2021
SIC,EN,C 10,Industrie alimentari                                        ,0,0,0,0,0,2021
SIC,EN,C 11,Industria delle bevande                                     ,0,0,0,0,0,2021
SIC,EN,C 12,Industria del tabacco                                       ,0,0,0,0,0,2021
SIC,EN,C 13,Industrie tessili                                           ,0,0,0,0,0,2021
SIC,EN,C 14,Confezione di articoli di abbigliamento; confezione di ar...,0,0,0,0,0,2021
SIC,EN,C 15,Fabbricazione di articoli in pelle e simili                 ,0,0,0,0,0,2021
SIC,EN,C 16,Industria del legno e dei prodotti in legno e sughero (es...,0,0,0,0,0,2021
SIC,EN,C 17,Fabbricazione di carta e di prodotti di carta               ,0,0,0,0,0,2021
SIC,EN,C 18,Stampa e riproduzione di supporti registrati                ,0,0,0,0,0,2021
SIC,EN,C 19,Fabbricazione di coke e prodotti derivanti dalla raffinaz...,0,0,0,0,0,2021
SIC,EN,C 20,Fabbricazione di prodotti chimici                           ,0,0,0,0,0,2021
SIC,EN,C 21,Fabbricazione di prodotti farmaceutici di base e di prepa...,0,0,0,0,0,2021
SIC,EN,C 22,Fabbricazione di articoli in gomma e materie plastiche      ,0,0,0,0,0,2021
SIC,EN,C 23,Fabbricazione di altri prodotti della lavorazione di miner..,0,0,0,0,0,2021
SIC,EN,C 24,Metallurgia                                                 ,0,0,0,0,0,2021
SIC,EN,C 25,Fabbricazione di prodotti in metallo (esclusi macchinari ...,0,0,0,0,0,2021
SIC,EN,C 26,Fabbricazione di computer e prodotti di elettronica e ott...,0,0,0,0,0,2021
SIC,EN,C 27,Fabbricazione di apparecchiature elettriche ed apparecchi...,0,0,0,0,0,2021
SIC,EN,C 28,Fabbricazione di macchinari ed apparecchiature nca          ,0,0,0,0,0,2021
SIC,EN,C 29,"Fabbricazione di autoveicoli, rimorchi e semirimorchi       ",0,0,0,0,0,2021
SIC,EN,C 30,Fabbricazione di altri mezzi di trasporto                   ,0,0,0,0,0,2021
SIC,EN,C 31,Fabbricazione di mobili                                     ,0,0,0,0,0,2021
SIC,EN,C 32,Altre industrie manifatturiere                              ,0,0,0,0,0,2021
SIC,EN,C 33,"Riparazione, manutenzione ed installazione di macchine ed...",0,0,0,0,0,2021
SIC,EN,D   ,"Fornitura di energia elettrica, gas, vapore e aria condiz...",0,0,0,0,0,2021
SIC,EN,D 35,"Fornitura di energia elettrica, gas, vapore e aria condiz...",0,0,0,0,0,2021
SIC,EN,E   ,"Fornitura di acqua; reti fognarie, attività di gestione d...",0,0,0,0,0,2021
SIC,EN,E 36,"Raccolta, trattamento e fornitura di acqua                  ",0,0,0,0,0,2021
SIC,EN,E 37,Gestione delle reti fognarie                                ,0,0,0,0,0,2021
SIC,EN,E 38,"Attività di raccolta, trattamento e smaltimento dei rifiu...",0,0,0,0,0,2021
SIC,EN,E 39,Attività di risanamento e altri servizi di gestione dei r...,0,0,0,0,0,2021
SIC,EN,F   ,Costruzioni                                                 ,0,0,0,1,1,2021
SIC,EN,F 41,Costruzione di edifici                                      ,0,0,0,1,1,2021
SIC,EN,F 42,Ingegneria civile                                           ,0,0,0,0,0,2021
SIC,EN,F 43,Lavori di costruzione specializzati                         ,0,0,0,0,0,2021
SIC,EN,G   ,Commercio all'ingrosso e al dettaglio; riparazione di aut...,0,0,0,2,2,2021
SIC,EN,G 45,Commercio all'ingrosso e al dettaglio e riparazione di au...,0,0,0,0,0,2021
SIC,EN,G 46,Commercio all'ingrosso (escluso quello di autoveicoli e d...,0,0,0,1,1,2021
SIC,EN,G 47,Commercio al dettaglio (escluso quello di autoveicoli e d...,0,0,0,1,1,2021
SIC,EN,H   ,Trasporto e magazzinaggio                                   ,0,0,0,0,0,2021
SIC,EN,H 49,Trasporto terrestre e mediante condotte                     ,0,0,0,0,0,2021
SIC,EN,H 50,Trasporto marittimo e per vie d'acqua                       ,0,0,0,0,0,2021
SIC,EN,H 51,Trasporto aereo                                             ,0,0,0,0,0,2021
SIC,EN,H 52,Magazzinaggio e attività di supporto ai trasporti           ,0,0,0,0,0,2021
SIC,EN,H 53,Servizi postali e attività di corriere                      ,0,0,0,0,0,2021
SIC,EN,I   ,Attività dei servizi alloggio e ristorazione                ,0,0,0,0,0,2021
SIC,EN,I 55,Alloggio                                                    ,0,0,0,0,0,2021
SIC,EN,I 56,Attività dei servizi di ristorazione                        ,0,0,0,0,0,2021
SIC,EN,J   ,Servizi di informazione e comunicazione                     ,0,0,0,0,0,2021
SIC,EN,J 58,Attività editoriali                                         ,0,0,0,0,0,2021
SIC,EN,J 59,"Attività di produzione cinematografica, di video e di pro...",0,0,0,0,0,2021
SIC,EN,J 60,Attività di programmazione e trasmissione                   ,0,0,0,0,0,2021
SIC,EN,J 61,Telecomunicazioni                                           ,0,0,0,0,0,2021
SIC,EN,J 62,"Produzione di software, consulenza informatica e attività...",0,0,0,0,0,2021
SIC,EN,J 63,Attività dei servizi d'informazione e altri servizi infor...,0,0,0,0,0,2021
SIC,EN,K   ,Attività finanziarie e assicurative                         ,0,0,0,0,0,2021
SIC,EN,K 64,Attività di servizi finanziari (escluse le assicurazioni ...,0,0,0,0,0,2021
SIC,EN,K 65,"Assicurazioni, riassicurazioni e fondi pensione (escluse ...",0,0,0,0,0,2021
SIC,EN,K 66,Attività ausiliarie dei servizi finanziari e delle attivi...,0,0,0,0,0,2021
SIC,EN,L   ,Attivita' immobiliari                                       ,0,0,0,0,0,2021
SIC,EN,L 68,Attivita' immobiliari                                       ,0,0,0,0,0,2021
SIC,EN,M   ,"Attività professionali, scientifiche e tecniche             ",0,0,0,0,0,2021
SIC,EN,M 69,Attività legali e contabilità                               ,0,0,0,0,0,2021
SIC,EN,M 70,Attività di direzione aziendale e di consulenza gestional...,0,0,0,0,0,2021
SIC,EN,M 71,Attività degli studi di architettura e d'ingegneria; coll...,0,0,0,0,0,2021
SIC,EN,M 72,Ricerca scientifica e sviluppo                              ,0,0,0,0,0,2021
SIC,EN,M 73,Pubblicità e ricerche di mercato                            ,0,0,0,0,0,2021
SIC,EN,M 74,"Altre attività professionali, scientifiche e tecniche       ",0,0,0,0,0,2021
SIC,EN,M 75,Servizi veterinari                                          ,0,0,0,0,0,2021
SIC,EN,N   ,"Noleggio, agenzie di viaggio, servizi di supporto alle im...",0,0,0,0,0,2021
SIC,EN,N 77,Attività di noleggio e leasing operativo                    ,0,0,0,0,0,2021
SIC,EN,N 78,"Attività di ricerca, selezione, fornitura di personale      ",0,0,0,0,0,2021
SIC,EN,N 79,"Attività dei servizi delle agenzie di viaggio, dei tour o...",0,0,0,0,0,2021
SIC,EN,N 80,Servizi di vigilanza e investigazione                       ,0,0,0,0,0,2021
SIC,EN,N 81,Attività di servizi per edifici e paesaggio                 ,0,0,0,0,0,2021
SIC,EN,N 82,Attività di supporto per le funzioni d'ufficio e altri se...,0,0,0,0,0,2021
SIC,EN,O   ,Amministrazione pubblica e difesa; assicurazione sociale ...,0,0,0,0,0,2021
SIC,EN,O 84,Amministrazione pubblica e difesa; assicurazione sociale ...,0,0,0,0,0,2021
SIC,EN,P   ,Istruzione                                                  ,0,0,0,0,0,2021
SIC,EN,P 85,Istruzione                                                  ,0,0,0,0,0,2021
SIC,EN,Q   ,Sanita' e assistenza sociale                                ,0,0,0,1,1,2021
SIC,EN,Q 86,Assistenza sanitaria                                        ,0,0,0,0,0,2021
SIC,EN,Q 87,Servizi di assistenza sociale residenziale                  ,0,0,0,0,0,2021
SIC,EN,Q 88,Assistenza sociale non residenziale                         ,0,0,0,1,1,2021
SIC,EN,R   ,"Attività artistiche, sportive, di intrattenimento e diver...",0,0,0,0,0,2021
SIC,EN,R 90,"Attività creative, artistiche e di intrattenimento          ",0,0,0,0,0,2021
SIC,EN,R 91,"Attività di biblioteche, archivi, musei ed altre attività...",0,0,0,0,0,2021
SIC,EN,R 92,"Attività riguardanti le lotterie, le scommesse, le case d...",0,0,0,0,0,2021
SIC,EN,R 93,"Attività sportive, di intrattenimento e di divertimento     ",0,0,0,0,0,2021
SIC,EN,S   ,Altre attività di servizi                                   ,0,0,0,0,0,2021
SIC,EN,S 94,Attività di organizzazioni associative                      ,0,0,0,0,0,2021
SIC,EN,S 95,Riparazione di computer e di beni per uso personale e per...,0,0,0,0,0,2021
SIC,EN,S 96,Altre attività di servizi per la persona                    ,0,0,0,0,0,2021
SIC,EN,T   ,Attività di famiglie e convivenze come datori di lavoro p...,0,0,0,0,0,2021
SIC,EN,T 97,Attività di famiglie e convivenze come datori di lavoro p...,0,0,0,0,0,2021
SIC,EN,T 98,Produzione di beni e servizi indifferenziati per uso prop...,0,0,0,0,0,2021
SIC,EN,U   ,Organizzazioni ed organismi extraterritoriali               ,0,0,0,0,0,2021
SIC,EN,U 99,Organizzazioni ed organismi extraterritoriali               ,0,0,0,0,0,2021
SIC,EN,XX  ,Imprese non classificate                                    ,0,0,0,0,0,2021
SIC,EN,TOT ,TOTALE                                                      ,0,0,0,4,4,2021
SIC,CT,A   ,"Agricoltura, silvicoltura pesca                             ",0,0,0,0,0,2021
SIC,CT,A 01,"Coltivazioni agricole e produzione di prodotti animali, c...",0,0,0,0,0,2021
SIC,CT,A 02,Silvicoltura ed utilizzo di aree forestali                  ,0,0,0,0,0,2021
SIC,CT,A 03,Pesca e acquacoltura                                        ,0,0,0,0,0,2021
SIC,CT,B   ,Estrazione di minerali da cave e miniere                    ,0,0,0,0,0,2021
SIC,CT,B 05,Estrazione di carbone (esclusa torba)                       ,0,0,0,0,0,2021
SIC,CT,B 06,Estraz.di petrolio greggio e di gas naturale                ,0,0,0,0,0,2021
SIC,CT,B 07,Estrazione di minerali metalliferi                          ,0,0,0,0,0,2021
SIC,CT,B 08,Altre attività di estrazione di minerali da cave e miniere  ,0,0,0,0,0,2021
SIC,CT,B 09,Attività dei servizi di supporto all'estrazione             ,0,0,0,0,0,2021
SIC,CT,C   ,Attività manifatturiere                                     ,0,0,4,0,4,2021
SIC,CT,C 10,Industrie alimentari                                        ,0,0,3,0,3,2021
SIC,CT,C 11,Industria delle bevande                                     ,0,0,0,0,0,2021
SIC,CT,C 12,Industria del tabacco                                       ,0,0,0,0,0,2021
SIC,CT,C 13,Industrie tessili                                           ,0,0,0,0,0,2021
SIC,CT,C 14,Confezione di articoli di abbigliamento; confezione di ar...,0,0,0,0,0,2021
SIC,CT,C 15,Fabbricazione di articoli in pelle e simili                 ,0,0,0,0,0,2021
SIC,CT,C 16,Industria del legno e dei prodotti in legno e sughero (es...,0,0,0,0,0,2021
SIC,CT,C 17,Fabbricazione di carta e di prodotti di carta               ,0,0,0,0,0,2021
SIC,CT,C 18,Stampa e riproduzione di supporti registrati                ,0,0,0,0,0,2021
SIC,CT,C 19,Fabbricazione di coke e prodotti derivanti dalla raffinaz...,0,0,0,0,0,2021
SIC,CT,C 20,Fabbricazione di prodotti chimici                           ,0,0,0,0,0,2021
SIC,CT,C 21,Fabbricazione di prodotti farmaceutici di base e di prepa...,0,0,0,0,0,2021
SIC,CT,C 22,Fabbricazione di articoli in gomma e materie plastiche      ,0,0,0,0,0,2021
SIC,CT,C 23,Fabbricazione di altri prodotti della lavorazione di miner..,0,0,0,0,0,2021
SIC,CT,C 24,Metallurgia                                                 ,0,0,0,0,0,2021
SIC,CT,C 25,Fabbricazione di prodotti in metallo (esclusi macchinari ...,0,0,1,0,1,2021
SIC,CT,C 26,Fabbricazione di computer e prodotti di elettronica e ott...,0,0,0,0,0,2021
SIC,CT,C 27,Fabbricazione di apparecchiature elettriche ed apparecchi...,0,0,0,0,0,2021
SIC,CT,C 28,Fabbricazione di macchinari ed apparecchiature nca          ,0,0,0,0,0,2021
SIC,CT,C 29,"Fabbricazione di autoveicoli, rimorchi e semirimorchi       ",0,0,0,0,0,2021
SIC,CT,C 30,Fabbricazione di altri mezzi di trasporto                   ,0,0,0,0,0,2021
SIC,CT,C 31,Fabbricazione di mobili                                     ,0,0,0,0,0,2021
SIC,CT,C 32,Altre industrie manifatturiere                              ,0,0,0,0,0,2021
SIC,CT,C 33,"Riparazione, manutenzione ed installazione di macchine ed...",0,0,0,0,0,2021
SIC,CT,D   ,"Fornitura di energia elettrica, gas, vapore e aria condiz...",0,0,0,0,0,2021
SIC,CT,D 35,"Fornitura di energia elettrica, gas, vapore e aria condiz...",0,0,0,0,0,2021
SIC,CT,E   ,"Fornitura di acqua; reti fognarie, attività di gestione d...",0,0,0,0,0,2021
SIC,CT,E 36,"Raccolta, trattamento e fornitura di acqua                  ",0,0,0,0,0,2021
SIC,CT,E 37,Gestione delle reti fognarie                                ,0,0,0,0,0,2021
SIC,CT,E 38,"Attività di raccolta, trattamento e smaltimento dei rifiu...",0,0,0,0,0,2021
SIC,CT,E 39,Attività di risanamento e altri servizi di gestione dei r...,0,0,0,0,0,2021
SIC,CT,F   ,Costruzioni                                                 ,0,0,2,1,3,2021
SIC,CT,F 41,Costruzione di edifici                                      ,0,0,0,1,1,2021
SIC,CT,F 42,Ingegneria civile                                           ,0,0,0,0,0,2021
SIC,CT,F 43,Lavori di costruzione specializzati                         ,0,0,2,0,2,2021
SIC,CT,G   ,Commercio all'ingrosso e al dettaglio; riparazione di aut...,1,0,2,1,4,2021
SIC,CT,G 45,Commercio all'ingrosso e al dettaglio e riparazione di au...,0,0,2,0,2,2021
SIC,CT,G 46,Commercio all'ingrosso (escluso quello di autoveicoli e d...,0,0,0,0,0,2021
SIC,CT,G 47,Commercio al dettaglio (escluso quello di autoveicoli e d...,1,0,0,1,2,2021
SIC,CT,H   ,Trasporto e magazzinaggio                                   ,0,0,2,0,2,2021
SIC,CT,H 49,Trasporto terrestre e mediante condotte                     ,0,0,2,0,2,2021
SIC,CT,H 50,Trasporto marittimo e per vie d'acqua                       ,0,0,0,0,0,2021
SIC,CT,H 51,Trasporto aereo                                             ,0,0,0,0,0,2021
SIC,CT,H 52,Magazzinaggio e attività di supporto ai trasporti           ,0,0,0,0,0,2021
SIC,CT,H 53,Servizi postali e attività di corriere                      ,0,0,0,0,0,2021
SIC,CT,I   ,Attività dei servizi alloggio e ristorazione                ,0,0,2,0,2,2021
SIC,CT,I 55,Alloggio                                                    ,0,0,0,0,0,2021
SIC,CT,I 56,Attività dei servizi di ristorazione                        ,0,0,2,0,2,2021
SIC,CT,J   ,Servizi di informazione e comunicazione                     ,0,0,1,0,1,2021
SIC,CT,J 58,Attività editoriali                                         ,0,0,0,0,0,2021
SIC,CT,J 59,"Attività di produzione cinematografica, di video e di pro...",0,0,0,0,0,2021
SIC,CT,J 60,Attività di programmazione e trasmissione                   ,0,0,0,0,0,2021
SIC,CT,J 61,Telecomunicazioni                                           ,0,0,0,0,0,2021
SIC,CT,J 62,"Produzione di software, consulenza informatica e attività...",0,0,0,0,0,2021
SIC,CT,J 63,Attività dei servizi d'informazione e altri servizi infor...,0,0,1,0,1,2021
SIC,CT,K   ,Attività finanziarie e assicurative                         ,0,0,0,0,0,2021
SIC,CT,K 64,Attività di servizi finanziari (escluse le assicurazioni ...,0,0,0,0,0,2021
SIC,CT,K 65,"Assicurazioni, riassicurazioni e fondi pensione (escluse ...",0,0,0,0,0,2021
SIC,CT,K 66,Attività ausiliarie dei servizi finanziari e delle attivi...,0,0,0,0,0,2021
SIC,CT,L   ,Attivita' immobiliari                                       ,0,0,0,0,0,2021
SIC,CT,L 68,Attivita' immobiliari                                       ,0,0,0,0,0,2021
SIC,CT,M   ,"Attività professionali, scientifiche e tecniche             ",0,0,0,0,0,2021
SIC,CT,M 69,Attività legali e contabilità                               ,0,0,0,0,0,2021
SIC,CT,M 70,Attività di direzione aziendale e di consulenza gestional...,0,0,0,0,0,2021
SIC,CT,M 71,Attività degli studi di architettura e d'ingegneria; coll...,0,0,0,0,0,2021
SIC,CT,M 72,Ricerca scientifica e sviluppo                              ,0,0,0,0,0,2021
SIC,CT,M 73,Pubblicità e ricerche di mercato                            ,0,0,0,0,0,2021
SIC,CT,M 74,"Altre attività professionali, scientifiche e tecniche       ",0,0,0,0,0,2021
SIC,CT,M 75,Servizi veterinari                                          ,0,0,0,0,0,2021
SIC,CT,N   ,"Noleggio, agenzie di viaggio, servizi di supporto alle im...",0,0,0,0,0,2021
SIC,CT,N 77,Attività di noleggio e leasing operativo                    ,0,0,0,0,0,2021
SIC,CT,N 78,"Attività di ricerca, selezione, fornitura di personale      ",0,0,0,0,0,2021
SIC,CT,N 79,"Attività dei servizi delle agenzie di viaggio, dei tour o...",0,0,0,0,0,2021
SIC,CT,N 80,Servizi di vigilanza e investigazione                       ,0,0,0,0,0,2021
SIC,CT,N 81,Attività di servizi per edifici e paesaggio                 ,0,0,0,0,0,2021
SIC,CT,N 82,Attività di supporto per le funzioni d'ufficio e altri se...,0,0,0,0,0,2021
SIC,CT,O   ,Amministrazione pubblica e difesa; assicurazione sociale ...,0,0,0,0,0,2021
SIC,CT,O 84,Amministrazione pubblica e difesa; assicurazione sociale ...,0,0,0,0,0,2021
SIC,CT,P   ,Istruzione                                                  ,0,0,0,0,0,2021
SIC,CT,P 85,Istruzione                                                  ,0,0,0,0,0,2021
SIC,CT,Q   ,Sanita' e assistenza sociale                                ,0,0,0,0,0,2021
SIC,CT,Q 86,Assistenza sanitaria                                        ,0,0,0,0,0,2021
SIC,CT,Q 87,Servizi di assistenza sociale residenziale                  ,0,0,0,0,0,2021
SIC,CT,Q 88,Assistenza sociale non residenziale                         ,0,0,0,0,0,2021
SIC,CT,R   ,"Attività artistiche, sportive, di intrattenimento e diver...",0,0,0,0,0,2021
SIC,CT,R 90,"Attività creative, artistiche e di intrattenimento          ",0,0,0,0,0,2021
SIC,CT,R 91,"Attività di biblioteche, archivi, musei ed altre attività...",0,0,0,0,0,2021
SIC,CT,R 92,"Attività riguardanti le lotterie, le scommesse, le case d...",0,0,0,0,0,2021
SIC,CT,R 93,"Attività sportive, di intrattenimento e di divertimento     ",0,0,0,0,0,2021
SIC,CT,S   ,Altre attività di servizi                                   ,0,0,1,0,1,2021
SIC,CT,S 94,Attività di organizzazioni associative                      ,0,0,0,0,0,2021
SIC,CT,S 95,Riparazione di computer e di beni per uso personale e per...,0,0,1,0,1,2021
SIC,CT,S 96,Altre attività di servizi per la persona                    ,0,0,0,0,0,2021
SIC,CT,T   ,Attività di famiglie e convivenze come datori di lavoro p...,0,0,0,0,0,2021
SIC,CT,T 97,Attività di famiglie e convivenze come datori di lavoro p...,0,0,0,0,0,2021
SIC,CT,T 98,Produzione di beni e servizi indifferenziati per uso prop...,0,0,0,0,0,2021
SIC,CT,U   ,Organizzazioni ed organismi extraterritoriali               ,0,0,0,0,0,2021
SIC,CT,U 99,Organizzazioni ed organismi extraterritoriali               ,0,0,0,0,0,2021
SIC,CT,XX  ,Imprese non classificate                                    ,0,0,0,1,1,2021
SIC,CT,TOT ,TOTALE                                                      ,1,0,14,3,18,2021
SIC,RG,A   ,"Agricoltura, silvicoltura pesca                             ",0,0,0,0,0,2021
SIC,RG,A 01,"Coltivazioni agricole e produzione di prodotti animali, c...",0,0,0,0,0,2021
SIC,RG,A 02,Silvicoltura ed utilizzo di aree forestali                  ,0,0,0,0,0,2021
SIC,RG,A 03,Pesca e acquacoltura                                        ,0,0,0,0,0,2021
SIC,RG,B   ,Estrazione di minerali da cave e miniere                    ,0,0,0,0,0,2021
SIC,RG,B 05,Estrazione di carbone (esclusa torba)                       ,0,0,0,0,0,2021
SIC,RG,B 06,Estraz.di petrolio greggio e di gas naturale                ,0,0,0,0,0,2021
SIC,RG,B 07,Estrazione di minerali metalliferi                          ,0,0,0,0,0,2021
SIC,RG,B 08,Altre attività di estrazione di minerali da cave e miniere  ,0,0,0,0,0,2021
SIC,RG,B 09,Attività dei servizi di supporto all'estrazione             ,0,0,0,0,0,2021
SIC,RG,C   ,Attività manifatturiere                                     ,0,0,0,0,0,2021
SIC,RG,C 10,Industrie alimentari                                        ,0,0,0,0,0,2021
SIC,RG,C 11,Industria delle bevande                                     ,0,0,0,0,0,2021
SIC,RG,C 12,Industria del tabacco                                       ,0,0,0,0,0,2021
SIC,RG,C 13,Industrie tessili                                           ,0,0,0,0,0,2021
SIC,RG,C 14,Confezione di articoli di abbigliamento; confezione di ar...,0,0,0,0,0,2021
SIC,RG,C 15,Fabbricazione di articoli in pelle e simili                 ,0,0,0,0,0,2021
SIC,RG,C 16,Industria del legno e dei prodotti in legno e sughero (es...,0,0,0,0,0,2021
SIC,RG,C 17,Fabbricazione di carta e di prodotti di carta               ,0,0,0,0,0,2021
SIC,RG,C 18,Stampa e riproduzione di supporti registrati                ,0,0,0,0,0,2021
SIC,RG,C 19,Fabbricazione di coke e prodotti derivanti dalla raffinaz...,0,0,0,0,0,2021
SIC,RG,C 20,Fabbricazione di prodotti chimici                           ,0,0,0,0,0,2021
SIC,RG,C 21,Fabbricazione di prodotti farmaceutici di base e di prepa...,0,0,0,0,0,2021
SIC,RG,C 22,Fabbricazione di articoli in gomma e materie plastiche      ,0,0,0,0,0,2021
SIC,RG,C 23,Fabbricazione di altri prodotti della lavorazione di miner..,0,0,0,0,0,2021
SIC,RG,C 24,Metallurgia                                                 ,0,0,0,0,0,2021
SIC,RG,C 25,Fabbricazione di prodotti in metallo (esclusi macchinari ...,0,0,0,0,0,2021
SIC,RG,C 26,Fabbricazione di computer e prodotti di elettronica e ott...,0,0,0,0,0,2021
SIC,RG,C 27,Fabbricazione di apparecchiature elettriche ed apparecchi...,0,0,0,0,0,2021
SIC,RG,C 28,Fabbricazione di macchinari ed apparecchiature nca          ,0,0,0,0,0,2021
SIC,RG,C 29,"Fabbricazione di autoveicoli, rimorchi e semirimorchi       ",0,0,0,0,0,2021
SIC,RG,C 30,Fabbricazione di altri mezzi di trasporto                   ,0,0,0,0,0,2021
SIC,RG,C 31,Fabbricazione di mobili                                     ,0,0,0,0,0,2021
SIC,RG,C 32,Altre industrie manifatturiere                              ,0,0,0,0,0,2021
SIC,RG,C 33,"Riparazione, manutenzione ed installazione di macchine ed...",0,0,0,0,0,2021
SIC,RG,D   ,"Fornitura di energia elettrica, gas, vapore e aria condiz...",0,0,0,0,0,2021
SIC,RG,D 35,"Fornitura di energia elettrica, gas, vapore e aria condiz...",0,0,0,0,0,2021
SIC,RG,E   ,"Fornitura di acqua; reti fognarie, attività di gestione d...",0,0,0,0,0,2021
SIC,RG,E 36,"Raccolta, trattamento e fornitura di acqua                  ",0,0,0,0,0,2021
SIC,RG,E 37,Gestione delle reti fognarie                                ,0,0,0,0,0,2021
SIC,RG,E 38,"Attività di raccolta, trattamento e smaltimento dei rifiu...",0,0,0,0,0,2021
SIC,RG,E 39,Attività di risanamento e altri servizi di gestione dei r...,0,0,0,0,0,2021
SIC,RG,F   ,Costruzioni                                                 ,0,0,0,1,1,2021
SIC,RG,F 41,Costruzione di edifici                                      ,0,0,0,1,1,2021
SIC,RG,F 42,Ingegneria civile                                           ,0,0,0,0,0,2021
SIC,RG,F 43,Lavori di costruzione specializzati                         ,0,0,0,0,0,2021
SIC,RG,G   ,Commercio all'ingrosso e al dettaglio; riparazione di aut...,0,0,0,0,0,2021
SIC,RG,G 45,Commercio all'ingrosso e al dettaglio e riparazione di au...,0,0,0,0,0,2021
SIC,RG,G 46,Commercio all'ingrosso (escluso quello di autoveicoli e d...,0,0,0,0,0,2021
SIC,RG,G 47,Commercio al dettaglio (escluso quello di autoveicoli e d...,0,0,0,0,0,2021
SIC,RG,H   ,Trasporto e magazzinaggio                                   ,0,0,0,0,0,2021
SIC,RG,H 49,Trasporto terrestre e mediante condotte                     ,0,0,0,0,0,2021
SIC,RG,H 50,Trasporto marittimo e per vie d'acqua                       ,0,0,0,0,0,2021
SIC,RG,H 51,Trasporto aereo                                             ,0,0,0,0,0,2021
SIC,RG,H 52,Magazzinaggio e attività di supporto ai trasporti           ,0,0,0,0,0,2021
SIC,RG,H 53,Servizi postali e attività di corriere                      ,0,0,0,0,0,2021
SIC,RG,I   ,Attività dei servizi alloggio e ristorazione                ,0,0,0,0,0,2021
SIC,RG,I 55,Alloggio                                                    ,0,0,0,0,0,2021
SIC,RG,I 56,Attività dei servizi di ristorazione                        ,0,0,0,0,0,2021
SIC,RG,J   ,Servizi di informazione e comunicazione                     ,0,0,0,0,0,2021
SIC,RG,J 58,Attività editoriali                                         ,0,0,0,0,0,2021
SIC,RG,J 59,"Attività di produzione cinematografica, di video e di pro...",0,0,0,0,0,2021
SIC,RG,J 60,Attività di programmazione e trasmissione                   ,0,0,0,0,0,2021
SIC,RG,J 61,Telecomunicazioni                                           ,0,0,0,0,0,2021
SIC,RG,J 62,"Produzione di software, consulenza informatica e attività...",0,0,0,0,0,2021
SIC,RG,J 63,Attività dei servizi d'informazione e altri servizi infor...,0,0,0,0,0,2021
SIC,RG,K   ,Attività finanziarie e assicurative                         ,0,0,0,0,0,2021
SIC,RG,K 64,Attività di servizi finanziari (escluse le assicurazioni ...,0,0,0,0,0,2021
SIC,RG,K 65,"Assicurazioni, riassicurazioni e fondi pensione (escluse ...",0,0,0,0,0,2021
SIC,RG,K 66,Attività ausiliarie dei servizi finanziari e delle attivi...,0,0,0,0,0,2021
SIC,RG,L   ,Attivita' immobiliari                                       ,0,0,0,0,0,2021
SIC,RG,L 68,Attivita' immobiliari                                       ,0,0,0,0,0,2021
SIC,RG,M   ,"Attività professionali, scientifiche e tecniche             ",0,0,0,0,0,2021
SIC,RG,M 69,Attività legali e contabilità                               ,0,0,0,0,0,2021
SIC,RG,M 70,Attività di direzione aziendale e di consulenza gestional...,0,0,0,0,0,2021
SIC,RG,M 71,Attività degli studi di architettura e d'ingegneria; coll...,0,0,0,0,0,2021
SIC,RG,M 72,Ricerca scientifica e sviluppo                              ,0,0,0,0,0,2021
SIC,RG,M 73,Pubblicità e ricerche di mercato                            ,0,0,0,0,0,2021
SIC,RG,M 74,"Altre attività professionali, scientifiche e tecniche       ",0,0,0,0,0,2021
SIC,RG,M 75,Servizi veterinari                                          ,0,0,0,0,0,2021
SIC,RG,N   ,"Noleggio, agenzie di viaggio, servizi di supporto alle im...",0,0,0,0,0,2021
SIC,RG,N 77,Attività di noleggio e leasing operativo                    ,0,0,0,0,0,2021
SIC,RG,N 78,"Attività di ricerca, selezione, fornitura di personale      ",0,0,0,0,0,2021
SIC,RG,N 79,"Attività dei servizi delle agenzie di viaggio, dei tour o...",0,0,0,0,0,2021
SIC,RG,N 80,Servizi di vigilanza e investigazione                       ,0,0,0,0,0,2021
SIC,RG,N 81,Attività di servizi per edifici e paesaggio                 ,0,0,0,0,0,2021
SIC,RG,N 82,Attività di supporto per le funzioni d'ufficio e altri se...,0,0,0,0,0,2021
SIC,RG,O   ,Amministrazione pubblica e difesa; assicurazione sociale ...,0,0,0,0,0,2021
SIC,RG,O 84,Amministrazione pubblica e difesa; assicurazione sociale ...,0,0,0,0,0,2021
SIC,RG,P   ,Istruzione                                                  ,0,0,0,0,0,2021
SIC,RG,P 85,Istruzione                                                  ,0,0,0,0,0,2021
SIC,RG,Q   ,Sanita' e assistenza sociale                                ,0,0,0,0,0,2021
SIC,RG,Q 86,Assistenza sanitaria                                        ,0,0,0,0,0,2021
SIC,RG,Q 87,Servizi di assistenza sociale residenziale                  ,0,0,0,0,0,2021
SIC,RG,Q 88,Assistenza sociale non residenziale                         ,0,0,0,0,0,2021
SIC,RG,R   ,"Attività artistiche, sportive, di intrattenimento e diver...",0,0,0,0,0,2021
SIC,RG,R 90,"Attività creative, artistiche e di intrattenimento          ",0,0,0,0,0,2021
SIC,RG,R 91,"Attività di biblioteche, archivi, musei ed altre attività...",0,0,0,0,0,2021
SIC,RG,R 92,"Attività riguardanti le lotterie, le scommesse, le case d...",0,0,0,0,0,2021
SIC,RG,R 93,"Attività sportive, di intrattenimento e di divertimento     ",0,0,0,0,0,2021
SIC,RG,S   ,Altre attività di servizi                                   ,0,0,0,0,0,2021
SIC,RG,S 94,Attività di organizzazioni associative                      ,0,0,0,0,0,2021
SIC,RG,S 95,Riparazione di computer e di beni per uso personale e per...,0,0,0,0,0,2021
SIC,RG,S 96,Altre attività di servizi per la persona                    ,0,0,0,0,0,2021
SIC,RG,T   ,Attività di famiglie e convivenze come datori di lavoro p...,0,0,0,0,0,2021
SIC,RG,T 97,Attività di famiglie e convivenze come datori di lavoro p...,0,0,0,0,0,2021
SIC,RG,T 98,Produzione di beni e servizi indifferenziati per uso prop...,0,0,0,0,0,2021
SIC,RG,U   ,Organizzazioni ed organismi extraterritoriali               ,0,0,0,0,0,2021
SIC,RG,U 99,Organizzazioni ed organismi extraterritoriali               ,0,0,0,0,0,2021
SIC,RG,XX  ,Imprese non classificate                                    ,0,0,0,3,3,2021
SIC,RG,TOT ,TOTALE                                                      ,0,0,0,4,4,2021
SIC,SR,A   ,"Agricoltura, silvicoltura pesca                             ",0,0,0,0,0,2021
SIC,SR,A 01,"Coltivazioni agricole e produzione di prodotti animali, c...",0,0,0,0,0,2021
SIC,SR,A 02,Silvicoltura ed utilizzo di aree forestali                  ,0,0,0,0,0,2021
SIC,SR,A 03,Pesca e acquacoltura                                        ,0,0,0,0,0,2021
SIC,SR,B   ,Estrazione di minerali da cave e miniere                    ,0,0,0,0,0,2021
SIC,SR,B 05,Estrazione di carbone (esclusa torba)                       ,0,0,0,0,0,2021
SIC,SR,B 06,Estraz.di petrolio greggio e di gas naturale                ,0,0,0,0,0,2021
SIC,SR,B 07,Estrazione di minerali metalliferi                          ,0,0,0,0,0,2021
SIC,SR,B 08,Altre attività di estrazione di minerali da cave e miniere  ,0,0,0,0,0,2021
SIC,SR,B 09,Attività dei servizi di supporto all'estrazione             ,0,0,0,0,0,2021
SIC,SR,C   ,Attività manifatturiere                                     ,0,0,0,0,0,2021
SIC,SR,C 10,Industrie alimentari                                        ,0,0,0,0,0,2021
SIC,SR,C 11,Industria delle bevande                                     ,0,0,0,0,0,2021
SIC,SR,C 12,Industria del tabacco                                       ,0,0,0,0,0,2021
SIC,SR,C 13,Industrie tessili                                           ,0,0,0,0,0,2021
SIC,SR,C 14,Confezione di articoli di abbigliamento; confezione di ar...,0,0,0,0,0,2021
SIC,SR,C 15,Fabbricazione di articoli in pelle e simili                 ,0,0,0,0,0,2021
SIC,SR,C 16,Industria del legno e dei prodotti in legno e sughero (es...,0,0,0,0,0,2021
SIC,SR,C 17,Fabbricazione di carta e di prodotti di carta               ,0,0,0,0,0,2021
SIC,SR,C 18,Stampa e riproduzione di supporti registrati                ,0,0,0,0,0,2021
SIC,SR,C 19,Fabbricazione di coke e prodotti derivanti dalla raffinaz...,0,0,0,0,0,2021
SIC,SR,C 20,Fabbricazione di prodotti chimici                           ,0,0,0,0,0,2021
SIC,SR,C 21,Fabbricazione di prodotti farmaceutici di base e di prepa...,0,0,0,0,0,2021
SIC,SR,C 22,Fabbricazione di articoli in gomma e materie plastiche      ,0,0,0,0,0,2021
SIC,SR,C 23,Fabbricazione di altri prodotti della lavorazione di miner..,0,0,0,0,0,2021
SIC,SR,C 24,Metallurgia                                                 ,0,0,0,0,0,2021
SIC,SR,C 25,Fabbricazione di prodotti in metallo (esclusi macchinari ...,0,0,0,0,0,2021
SIC,SR,C 26,Fabbricazione di computer e prodotti di elettronica e ott...,0,0,0,0,0,2021
SIC,SR,C 27,Fabbricazione di apparecchiature elettriche ed apparecchi...,0,0,0,0,0,2021
SIC,SR,C 28,Fabbricazione di macchinari ed apparecchiature nca          ,0,0,0,0,0,2021
SIC,SR,C 29,"Fabbricazione di autoveicoli, rimorchi e semirimorchi       ",0,0,0,0,0,2021
SIC,SR,C 30,Fabbricazione di altri mezzi di trasporto                   ,0,0,0,0,0,2021
SIC,SR,C 31,Fabbricazione di mobili                                     ,0,0,0,0,0,2021
SIC,SR,C 32,Altre industrie manifatturiere                              ,0,0,0,0,0,2021
SIC,SR,C 33,"Riparazione, manutenzione ed installazione di macchine ed...",0,0,0,0,0,2021
SIC,SR,D   ,"Fornitura di energia elettrica, gas, vapore e aria condiz...",0,0,0,0,0,2021
SIC,SR,D 35,"Fornitura di energia elettrica, gas, vapore e aria condiz...",0,0,0,0,0,2021
SIC,SR,E   ,"Fornitura di acqua; reti fognarie, attività di gestione d...",0,0,0,0,0,2021
SIC,SR,E 36,"Raccolta, trattamento e fornitura di acqua                  ",0,0,0,0,0,2021
SIC,SR,E 37,Gestione delle reti fognarie                                ,0,0,0,0,0,2021
SIC,SR,E 38,"Attività di raccolta, trattamento e smaltimento dei rifiu...",0,0,0,0,0,2021
SIC,SR,E 39,Attività di risanamento e altri servizi di gestione dei r...,0,0,0,0,0,2021
SIC,SR,F   ,Costruzioni                                                 ,0,0,0,0,0,2021
SIC,SR,F 41,Costruzione di edifici                                      ,0,0,0,0,0,2021
SIC,SR,F 42,Ingegneria civile                                           ,0,0,0,0,0,2021
SIC,SR,F 43,Lavori di costruzione specializzati                         ,0,0,0,0,0,2021
SIC,SR,G   ,Commercio all'ingrosso e al dettaglio; riparazione di aut...,0,0,1,1,2,2021
SIC,SR,G 45,Commercio all'ingrosso e al dettaglio e riparazione di au...,0,0,1,0,1,2021
SIC,SR,G 46,Commercio all'ingrosso (escluso quello di autoveicoli e d...,0,0,0,0,0,2021
SIC,SR,G 47,Commercio al dettaglio (escluso quello di autoveicoli e d...,0,0,0,1,1,2021
SIC,SR,H   ,Trasporto e magazzinaggio                                   ,0,0,0,0,0,2021
SIC,SR,H 49,Trasporto terrestre e mediante condotte                     ,0,0,0,0,0,2021
SIC,SR,H 50,Trasporto marittimo e per vie d'acqua                       ,0,0,0,0,0,2021
SIC,SR,H 51,Trasporto aereo                                             ,0,0,0,0,0,2021
SIC,SR,H 52,Magazzinaggio e attività di supporto ai trasporti           ,0,0,0,0,0,2021
SIC,SR,H 53,Servizi postali e attività di corriere                      ,0,0,0,0,0,2021
SIC,SR,I   ,Attività dei servizi alloggio e ristorazione                ,0,0,0,0,0,2021
SIC,SR,I 55,Alloggio                                                    ,0,0,0,0,0,2021
SIC,SR,I 56,Attività dei servizi di ristorazione                        ,0,0,0,0,0,2021
SIC,SR,J   ,Servizi di informazione e comunicazione                     ,0,0,0,0,0,2021
SIC,SR,J 58,Attività editoriali                                         ,0,0,0,0,0,2021
SIC,SR,J 59,"Attività di produzione cinematografica, di video e di pro...",0,0,0,0,0,2021
SIC,SR,J 60,Attività di programmazione e trasmissione                   ,0,0,0,0,0,2021
SIC,SR,J 61,Telecomunicazioni                                           ,0,0,0,0,0,2021
SIC,SR,J 62,"Produzione di software, consulenza informatica e attività...",0,0,0,0,0,2021
SIC,SR,J 63,Attività dei servizi d'informazione e altri servizi infor...,0,0,0,0,0,2021
SIC,SR,K   ,Attività finanziarie e assicurative                         ,0,0,0,0,0,2021
SIC,SR,K 64,Attività di servizi finanziari (escluse le assicurazioni ...,0,0,0,0,0,2021
SIC,SR,K 65,"Assicurazioni, riassicurazioni e fondi pensione (escluse ...",0,0,0,0,0,2021
SIC,SR,K 66,Attività ausiliarie dei servizi finanziari e delle attivi...,0,0,0,0,0,2021
SIC,SR,L   ,Attivita' immobiliari                                       ,0,0,0,0,0,2021
SIC,SR,L 68,Attivita' immobiliari                                       ,0,0,0,0,0,2021
SIC,SR,M   ,"Attività professionali, scientifiche e tecniche             ",0,0,0,1,1,2021
SIC,SR,M 69,Attività legali e contabilità                               ,0,0,0,0,0,2021
SIC,SR,M 70,Attività di direzione aziendale e di consulenza gestional...,0,0,0,0,0,2021
SIC,SR,M 71,Attività degli studi di architettura e d'ingegneria; coll...,0,0,0,0,0,2021
SIC,SR,M 72,Ricerca scientifica e sviluppo                              ,0,0,0,0,0,2021
SIC,SR,M 73,Pubblicità e ricerche di mercato                            ,0,0,0,0,0,2021
SIC,SR,M 74,"Altre attività professionali, scientifiche e tecniche       ",0,0,0,1,1,2021
SIC,SR,M 75,Servizi veterinari                                          ,0,0,0,0,0,2021
SIC,SR,N   ,"Noleggio, agenzie di viaggio, servizi di supporto alle im...",0,0,1,0,1,2021
SIC,SR,N 77,Attività di noleggio e leasing operativo                    ,0,0,0,0,0,2021
SIC,SR,N 78,"Attività di ricerca, selezione, fornitura di personale      ",0,0,0,0,0,2021
SIC,SR,N 79,"Attività dei servizi delle agenzie di viaggio, dei tour o...",0,0,0,0,0,2021
SIC,SR,N 80,Servizi di vigilanza e investigazione                       ,0,0,0,0,0,2021
SIC,SR,N 81,Attività di servizi per edifici e paesaggio                 ,0,0,1,0,1,2021
SIC,SR,N 82,Attività di supporto per le funzioni d'ufficio e altri se...,0,0,0,0,0,2021
SIC,SR,O   ,Amministrazione pubblica e difesa; assicurazione sociale ...,0,0,0,0,0,2021
SIC,SR,O 84,Amministrazione pubblica e difesa; assicurazione sociale ...,0,0,0,0,0,2021
SIC,SR,P   ,Istruzione                                                  ,0,0,0,0,0,2021
SIC,SR,P 85,Istruzione                                                  ,0,0,0,0,0,2021
SIC,SR,Q   ,Sanita' e assistenza sociale                                ,0,0,0,0,0,2021
SIC,SR,Q 86,Assistenza sanitaria                                        ,0,0,0,0,0,2021
SIC,SR,Q 87,Servizi di assistenza sociale residenziale                  ,0,0,0,0,0,2021
SIC,SR,Q 88,Assistenza sociale non residenziale                         ,0,0,0,0,0,2021
SIC,SR,R   ,"Attività artistiche, sportive, di intrattenimento e diver...",0,0,0,0,0,2021
SIC,SR,R 90,"Attività creative, artistiche e di intrattenimento          ",0,0,0,0,0,2021
SIC,SR,R 91,"Attività di biblioteche, archivi, musei ed altre attività...",0,0,0,0,0,2021
SIC,SR,R 92,"Attività riguardanti le lotterie, le scommesse, le case d...",0,0,0,0,0,2021
SIC,SR,R 93,"Attività sportive, di intrattenimento e di divertimento     ",0,0,0,0,0,2021
SIC,SR,S   ,Altre attività di servizi                                   ,0,0,0,0,0,2021
SIC,SR,S 94,Attività di organizzazioni associative                      ,0,0,0,0,0,2021
SIC,SR,S 95,Riparazione di computer e di beni per uso personale e per...,0,0,0,0,0,2021
SIC,SR,S 96,Altre attività di servizi per la persona                    ,0,0,0,0,0,2021
SIC,SR,T   ,Attività di famiglie e convivenze come datori di lavoro p...,0,0,0,0,0,2021
SIC,SR,T 97,Attività di famiglie e convivenze come datori di lavoro p...,0,0,0,0,0,2021
SIC,SR,T 98,Produzione di beni e servizi indifferenziati per uso prop...,0,0,0,0,0,2021
SIC,SR,U   ,Organizzazioni ed organismi extraterritoriali               ,0,0,0,0,0,2021
SIC,SR,U 99,Organizzazioni ed organismi extraterritoriali               ,0,0,0,0,0,2021
SIC,SR,XX  ,Imprese non classificate                                    ,0,0,1,2,3,2021
SIC,SR,TOT ,TOTALE                                                      ,0,0,3,4,7,2021
SAR,  ,A   ,"Agricoltura, silvicoltura pesca                             ",0,0,226,4,230,2021
SAR,  ,A 01,"Coltivazioni agricole e produzione di prodotti animali, c...",0,0,217,2,219,2021
SAR,  ,A 02,Silvicoltura ed utilizzo di aree forestali                  ,0,0,2,2,4,2021
SAR,  ,A 03,Pesca e acquacoltura                                        ,0,0,7,0,7,2021
SAR,  ,B   ,Estrazione di minerali da cave e miniere                    ,0,0,5,0,5,2021
SAR,  ,B 05,Estrazione di carbone (esclusa torba)                       ,0,0,0,0,0,2021
SAR,  ,B 06,Estraz.di petrolio greggio e di gas naturale                ,0,0,0,0,0,2021
SAR,  ,B 07,Estrazione di minerali metalliferi                          ,0,0,0,0,0,2021
SAR,  ,B 08,Altre attività di estrazione di minerali da cave e miniere  ,0,0,5,0,5,2021
SAR,  ,B 09,Attività dei servizi di supporto all'estrazione             ,0,0,0,0,0,2021
SAR,  ,C   ,Attività manifatturiere                                     ,0,0,176,0,176,2021
SAR,  ,C 10,Industrie alimentari                                        ,0,0,17,0,17,2021
SAR,  ,C 11,Industria delle bevande                                     ,0,0,0,0,0,2021
SAR,  ,C 12,Industria del tabacco                                       ,0,0,0,0,0,2021
SAR,  ,C 13,Industrie tessili                                           ,0,0,3,0,3,2021
SAR,  ,C 14,Confezione di articoli di abbigliamento; confezione di ar...,0,0,8,0,8,2021
SAR,  ,C 15,Fabbricazione di articoli in pelle e simili                 ,0,0,9,0,9,2021
SAR,  ,C 16,Industria del legno e dei prodotti in legno e sughero (es...,0,0,33,0,33,2021
SAR,  ,C 17,Fabbricazione di carta e di prodotti di carta               ,0,0,0,0,0,2021
SAR,  ,C 18,Stampa e riproduzione di supporti registrati                ,0,0,4,0,4,2021
SAR,  ,C 19,Fabbricazione di coke e prodotti derivanti dalla raffinaz...,0,0,0,0,0,2021
SAR,  ,C 20,Fabbricazione di prodotti chimici                           ,0,0,0,0,0,2021
SAR,  ,C 21,Fabbricazione di prodotti farmaceutici di base e di prepa...,0,0,0,0,0,2021
SAR,  ,C 22,Fabbricazione di articoli in gomma e materie plastiche      ,0,0,0,0,0,2021
SAR,  ,C 23,Fabbricazione di altri prodotti della lavorazione di miner..,0,0,16,0,16,2021
SAR,  ,C 24,Metallurgia                                                 ,0,0,2,0,2,2021
SAR,  ,C 25,Fabbricazione di prodotti in metallo (esclusi macchinari ...,0,0,33,0,33,2021
SAR,  ,C 26,Fabbricazione di computer e prodotti di elettronica e ott...,0,0,2,0,2,2021
SAR,  ,C 27,Fabbricazione di apparecchiature elettriche ed apparecchi...,0,0,3,0,3,2021
SAR,  ,C 28,Fabbricazione di macchinari ed apparecchiature nca          ,0,0,6,0,6,2021
SAR,  ,C 29,"Fabbricazione di autoveicoli, rimorchi e semirimorchi       ",0,0,0,0,0,2021
SAR,  ,C 30,Fabbricazione di altri mezzi di trasporto                   ,0,0,10,0,10,2021
SAR,  ,C 31,Fabbricazione di mobili                                     ,0,0,7,0,7,2021
SAR,  ,C 32,Altre industrie manifatturiere                              ,0,0,11,0,11,2021
SAR,  ,C 33,"Riparazione, manutenzione ed installazione di macchine ed...",0,0,12,0,12,2021
SAR,  ,D   ,"Fornitura di energia elettrica, gas, vapore e aria condiz...",0,0,0,0,0,2021
SAR,  ,D 35,"Fornitura di energia elettrica, gas, vapore e aria condiz...",0,0,0,0,0,2021
SAR,  ,E   ,"Fornitura di acqua; reti fognarie, attività di gestione d...",0,0,2,0,2,2021
SAR,  ,E 36,"Raccolta, trattamento e fornitura di acqua                  ",0,0,0,0,0,2021
SAR,  ,E 37,Gestione delle reti fognarie                                ,0,0,0,0,0,2021
SAR,  ,E 38,"Attività di raccolta, trattamento e smaltimento dei rifiu...",0,0,2,0,2,2021
SAR,  ,E 39,Attività di risanamento e altri servizi di gestione dei r...,0,0,0,0,0,2021
SAR,  ,F   ,Costruzioni                                                 ,0,0,445,7,452,2021
SAR,  ,F 41,Costruzione di edifici                                      ,0,0,246,6,252,2021
SAR,  ,F 42,Ingegneria civile                                           ,0,0,4,0,4,2021
SAR,  ,F 43,Lavori di costruzione specializzati                         ,0,0,195,1,196,2021
SAR,  ,G   ,Commercio all'ingrosso e al dettaglio; riparazione di aut...,0,0,651,2,653,2021
SAR,  ,G 45,Commercio all'ingrosso e al dettaglio e riparazione di au...,0,0,58,0,58,2021
SAR,  ,G 46,Commercio all'ingrosso (escluso quello di autoveicoli e d...,0,0,92,0,92,2021
SAR,  ,G 47,Commercio al dettaglio (escluso quello di autoveicoli e d...,0,0,501,2,503,2021
SAR,  ,H   ,Trasporto e magazzinaggio                                   ,0,0,70,2,72,2021
SAR,  ,H 49,Trasporto terrestre e mediante condotte                     ,0,0,66,1,67,2021
SAR,  ,H 50,Trasporto marittimo e per vie d'acqua                       ,0,0,0,0,0,2021
SAR,  ,H 51,Trasporto aereo                                             ,0,0,0,0,0,2021
SAR,  ,H 52,Magazzinaggio e attività di supporto ai trasporti           ,0,0,2,0,2,2021
SAR,  ,H 53,Servizi postali e attività di corriere                      ,0,0,2,1,3,2021
SAR,  ,I   ,Attività dei servizi alloggio e ristorazione                ,0,0,114,3,117,2021
SAR,  ,I 55,Alloggio                                                    ,0,0,5,0,5,2021
SAR,  ,I 56,Attività dei servizi di ristorazione                        ,0,0,109,3,112,2021
SAR,  ,J   ,Servizi di informazione e comunicazione                     ,0,0,12,1,13,2021
SAR,  ,J 58,Attività editoriali                                         ,0,0,1,0,1,2021
SAR,  ,J 59,"Attività di produzione cinematografica, di video e di pro...",0,0,1,0,1,2021
SAR,  ,J 60,Attività di programmazione e trasmissione                   ,0,0,0,0,0,2021
SAR,  ,J 61,Telecomunicazioni                                           ,0,0,0,0,0,2021
SAR,  ,J 62,"Produzione di software, consulenza informatica e attività...",0,0,3,0,3,2021
SAR,  ,J 63,Attività dei servizi d'informazione e altri servizi infor...,0,0,7,1,8,2021
SAR,  ,K   ,Attività finanziarie e assicurative                         ,0,0,17,0,17,2021
SAR,  ,K 64,Attività di servizi finanziari (escluse le assicurazioni ...,0,0,0,0,0,2021
SAR,  ,K 65,"Assicurazioni, riassicurazioni e fondi pensione (escluse ...",0,0,0,0,0,2021
SAR,  ,K 66,Attività ausiliarie dei servizi finanziari e delle attivi...,0,0,17,0,17,2021
SAR,  ,L   ,Attivita' immobiliari                                       ,0,0,7,0,7,2021
SAR,  ,L 68,Attivita' immobiliari                                       ,0,0,7,0,7,2021
SAR,  ,M   ,"Attività professionali, scientifiche e tecniche             ",0,0,17,1,18,2021
SAR,  ,M 69,Attività legali e contabilità                               ,0,0,0,0,0,2021
SAR,  ,M 70,Attività di direzione aziendale e di consulenza gestional...,0,0,0,1,1,2021
SAR,  ,M 71,Attività degli studi di architettura e d'ingegneria; coll...,0,0,0,0,0,2021
SAR,  ,M 72,Ricerca scientifica e sviluppo                              ,0,0,0,0,0,2021
SAR,  ,M 73,Pubblicità e ricerche di mercato                            ,0,0,5,0,5,2021
SAR,  ,M 74,"Altre attività professionali, scientifiche e tecniche       ",0,0,12,0,12,2021
SAR,  ,M 75,Servizi veterinari                                          ,0,0,0,0,0,2021
SAR,  ,N   ,"Noleggio, agenzie di viaggio, servizi di supporto alle im...",0,0,58,7,65,2021
SAR,  ,N 77,Attività di noleggio e leasing operativo                    ,0,0,9,0,9,2021
SAR,  ,N 78,"Attività di ricerca, selezione, fornitura di personale      ",0,0,0,0,0,2021
SAR,  ,N 79,"Attività dei servizi delle agenzie di viaggio, dei tour o...",0,0,3,0,3,2021
SAR,  ,N 80,Servizi di vigilanza e investigazione                       ,0,0,1,0,1,2021
SAR,  ,N 81,Attività di servizi per edifici e paesaggio                 ,0,0,41,6,47,2021
SAR,  ,N 82,Attività di supporto per le funzioni d'ufficio e altri se...,0,0,4,1,5,2021
SAR,  ,O   ,Amministrazione pubblica e difesa; assicurazione sociale ...,0,0,0,0,0,2021
SAR,  ,O 84,Amministrazione pubblica e difesa; assicurazione sociale ...,0,0,0,0,0,2021
SAR,  ,P   ,Istruzione                                                  ,0,0,1,1,2,2021
SAR,  ,P 85,Istruzione                                                  ,0,0,1,1,2,2021
SAR,  ,Q   ,Sanita' e assistenza sociale                                ,0,0,1,4,5,2021
SAR,  ,Q 86,Assistenza sanitaria                                        ,0,0,1,1,2,2021
SAR,  ,Q 87,Servizi di assistenza sociale residenziale                  ,0,0,0,1,1,2021
SAR,  ,Q 88,Assistenza sociale non residenziale                         ,0,0,0,2,2,2021
SAR,  ,R   ,"Attività artistiche, sportive, di intrattenimento e diver...",0,0,13,0,13,2021
SAR,  ,R 90,"Attività creative, artistiche e di intrattenimento          ",0,0,3,0,3,2021
SAR,  ,R 91,"Attività di biblioteche, archivi, musei ed altre attività...",0,0,0,0,0,2021
SAR,  ,R 92,"Attività riguardanti le lotterie, le scommesse, le case d...",0,0,1,0,1,2021
SAR,  ,R 93,"Attività sportive, di intrattenimento e di divertimento     ",0,0,9,0,9,2021
SAR,  ,S   ,Altre attività di servizi                                   ,0,0,45,0,45,2021
SAR,  ,S 94,Attività di organizzazioni associative                      ,0,0,0,0,0,2021
SAR,  ,S 95,Riparazione di computer e di beni per uso personale e per...,0,0,20,0,20,2021
SAR,  ,S 96,Altre attività di servizi per la persona                    ,0,0,25,0,25,2021
SAR,  ,T   ,Attività di famiglie e convivenze come datori di lavoro p...,0,0,0,0,0,2021
SAR,  ,T 97,Attività di famiglie e convivenze come datori di lavoro p...,0,0,0,0,0,2021
SAR,  ,T 98,Produzione di beni e servizi indifferenziati per uso prop...,0,0,0,0,0,2021
SAR,  ,U   ,Organizzazioni ed organismi extraterritoriali               ,0,0,0,0,0,2021
SAR,  ,U 99,Organizzazioni ed organismi extraterritoriali               ,0,0,0,0,0,2021
SAR,  ,XX  ,Imprese non classificate                                    ,0,0,34,27,61,2021
SAR,  ,TOT ,TOTALE                                                      ,0,0,1894,59,1953,2021
SAR,SS,A   ,"Agricoltura, silvicoltura pesca                             ",0,0,78,0,78,2021
SAR,SS,A 01,"Coltivazioni agricole e produzione di prodotti animali, c...",0,0,71,0,71,2021
SAR,SS,A 02,Silvicoltura ed utilizzo di aree forestali                  ,0,0,2,0,2,2021
SAR,SS,A 03,Pesca e acquacoltura                                        ,0,0,5,0,5,2021
SAR,SS,B   ,Estrazione di minerali da cave e miniere                    ,0,0,5,0,5,2021
SAR,SS,B 05,Estrazione di carbone (esclusa torba)                       ,0,0,0,0,0,2021
SAR,SS,B 06,Estraz.di petrolio greggio e di gas naturale                ,0,0,0,0,0,2021
SAR,SS,B 07,Estrazione di minerali metalliferi                          ,0,0,0,0,0,2021
SAR,SS,B 08,Altre attività di estrazione di minerali da cave e miniere  ,0,0,5,0,5,2021
SAR,SS,B 09,Attività dei servizi di supporto all'estrazione             ,0,0,0,0,0,2021
SAR,SS,C   ,Attività manifatturiere                                     ,0,0,134,0,134,2021
SAR,SS,C 10,Industrie alimentari                                        ,0,0,13,0,13,2021
SAR,SS,C 11,Industria delle bevande                                     ,0,0,0,0,0,2021
SAR,SS,C 12,Industria del tabacco                                       ,0,0,0,0,0,2021
SAR,SS,C 13,Industrie tessili                                           ,0,0,3,0,3,2021
SAR,SS,C 14,Confezione di articoli di abbigliamento; confezione di ar...,0,0,7,0,7,2021
SAR,SS,C 15,Fabbricazione di articoli in pelle e simili                 ,0,0,6,0,6,2021
SAR,SS,C 16,Industria del legno e dei prodotti in legno e sughero (es...,0,0,23,0,23,2021
SAR,SS,C 17,Fabbricazione di carta e di prodotti di carta               ,0,0,0,0,0,2021
SAR,SS,C 18,Stampa e riproduzione di supporti registrati                ,0,0,3,0,3,2021
SAR,SS,C 19,Fabbricazione di coke e prodotti derivanti dalla raffinaz...,0,0,0,0,0,2021
SAR,SS,C 20,Fabbricazione di prodotti chimici                           ,0,0,0,0,0,2021
SAR,SS,C 21,Fabbricazione di prodotti farmaceutici di base e di prepa...,0,0,0,0,0,2021
SAR,SS,C 22,Fabbricazione di articoli in gomma e materie plastiche      ,0,0,0,0,0,2021
SAR,SS,C 23,Fabbricazione di altri prodotti della lavorazione di miner..,0,0,13,0,13,2021
SAR,SS,C 24,Metallurgia                                                 ,0,0,1,0,1,2021
SAR,SS,C 25,Fabbricazione di prodotti in metallo (esclusi macchinari ...,0,0,24,0,24,2021
SAR,SS,C 26,Fabbricazione di computer e prodotti di elettronica e ott...,0,0,0,0,0,2021
SAR,SS,C 27,Fabbricazione di apparecchiature elettriche ed apparecchi...,0,0,2,0,2,2021
SAR,SS,C 28,Fabbricazione di macchinari ed apparecchiature nca          ,0,0,6,0,6,2021
SAR,SS,C 29,"Fabbricazione di autoveicoli, rimorchi e semirimorchi       ",0,0,0,0,0,2021
SAR,SS,C 30,Fabbricazione di altri mezzi di trasporto                   ,0,0,8,0,8,2021
SAR,SS,C 31,Fabbricazione di mobili                                     ,0,0,7,0,7,2021
SAR,SS,C 32,Altre industrie manifatturiere                              ,0,0,9,0,9,2021
SAR,SS,C 33,"Riparazione, manutenzione ed installazione di macchine ed...",0,0,9,0,9,2021
SAR,SS,D   ,"Fornitura di energia elettrica, gas, vapore e aria condiz...",0,0,0,0,0,2021
SAR,SS,D 35,"Fornitura di energia elettrica, gas, vapore e aria condiz...",0,0,0,0,0,2021
SAR,SS,E   ,"Fornitura di acqua; reti fognarie, attività di gestione d...",0,0,1,0,1,2021
SAR,SS,E 36,"Raccolta, trattamento e fornitura di acqua                  ",0,0,0,0,0,2021
SAR,SS,E 37,Gestione delle reti fognarie                                ,0,0,0,0,0,2021
SAR,SS,E 38,"Attività di raccolta, trattamento e smaltimento dei rifiu...",0,0,1,0,1,2021
SAR,SS,E 39,Attività di risanamento e altri servizi di gestione dei r...,0,0,0,0,0,2021
SAR,SS,F   ,Costruzioni                                                 ,0,0,388,5,393,2021
SAR,SS,F 41,Costruzione di edifici                                      ,0,0,218,5,223,2021
SAR,SS,F 42,Ingegneria civile                                           ,0,0,4,0,4,2021
SAR,SS,F 43,Lavori di costruzione specializzati                         ,0,0,166,0,166,2021
SAR,SS,G   ,Commercio all'ingrosso e al dettaglio; riparazione di aut...,0,0,430,0,430,2021
SAR,SS,G 45,Commercio all'ingrosso e al dettaglio e riparazione di au...,0,0,49,0,49,2021
SAR,SS,G 46,Commercio all'ingrosso (escluso quello di autoveicoli e d...,0,0,53,0,53,2021
SAR,SS,G 47,Commercio al dettaglio (escluso quello di autoveicoli e d...,0,0,328,0,328,2021
SAR,SS,H   ,Trasporto e magazzinaggio                                   ,0,0,53,0,53,2021
SAR,SS,H 49,Trasporto terrestre e mediante condotte                     ,0,0,50,0,50,2021
SAR,SS,H 50,Trasporto marittimo e per vie d'acqua                       ,0,0,0,0,0,2021
SAR,SS,H 51,Trasporto aereo                                             ,0,0,0,0,0,2021
SAR,SS,H 52,Magazzinaggio e attività di supporto ai trasporti           ,0,0,2,0,2,2021
SAR,SS,H 53,Servizi postali e attività di corriere                      ,0,0,1,0,1,2021
SAR,SS,I   ,Attività dei servizi alloggio e ristorazione                ,0,0,83,0,83,2021
SAR,SS,I 55,Alloggio                                                    ,0,0,5,0,5,2021
SAR,SS,I 56,Attività dei servizi di ristorazione                        ,0,0,78,0,78,2021
SAR,SS,J   ,Servizi di informazione e comunicazione                     ,0,0,4,0,4,2021
SAR,SS,J 58,Attività editoriali                                         ,0,0,0,0,0,2021
SAR,SS,J 59,"Attività di produzione cinematografica, di video e di pro...",0,0,1,0,1,2021
SAR,SS,J 60,Attività di programmazione e trasmissione                   ,0,0,0,0,0,2021
SAR,SS,J 61,Telecomunicazioni                                           ,0,0,0,0,0,2021
SAR,SS,J 62,"Produzione di software, consulenza informatica e attività...",0,0,1,0,1,2021
SAR,SS,J 63,Attività dei servizi d'informazione e altri servizi infor...,0,0,2,0,2,2021
SAR,SS,K   ,Attività finanziarie e assicurative                         ,0,0,8,0,8,2021
SAR,SS,K 64,Attività di servizi finanziari (escluse le assicurazioni ...,0,0,0,0,0,2021
SAR,SS,K 65,"Assicurazioni, riassicurazioni e fondi pensione (escluse ...",0,0,0,0,0,2021
SAR,SS,K 66,Attività ausiliarie dei servizi finanziari e delle attivi...,0,0,8,0,8,2021
SAR,SS,L   ,Attivita' immobiliari                                       ,0,0,6,0,6,2021
SAR,SS,L 68,Attivita' immobiliari                                       ,0,0,6,0,6,2021
SAR,SS,M   ,"Attività professionali, scientifiche e tecniche             ",0,0,10,1,11,2021
SAR,SS,M 69,Attività legali e contabilità                               ,0,0,0,0,0,2021
SAR,SS,M 70,Attività di direzione aziendale e di consulenza gestional...,0,0,0,1,1,2021
SAR,SS,M 71,Attività degli studi di architettura e d'ingegneria; coll...,0,0,0,0,0,2021
SAR,SS,M 72,Ricerca scientifica e sviluppo                              ,0,0,0,0,0,2021
SAR,SS,M 73,Pubblicità e ricerche di mercato                            ,0,0,3,0,3,2021
SAR,SS,M 74,"Altre attività professionali, scientifiche e tecniche       ",0,0,7,0,7,2021
SAR,SS,M 75,Servizi veterinari                                          ,0,0,0,0,0,2021
SAR,SS,N   ,"Noleggio, agenzie di viaggio, servizi di supporto alle im...",0,0,30,2,32,2021
SAR,SS,N 77,Attività di noleggio e leasing operativo                    ,0,0,5,0,5,2021
SAR,SS,N 78,"Attività di ricerca, selezione, fornitura di personale      ",0,0,0,0,0,2021
SAR,SS,N 79,"Attività dei servizi delle agenzie di viaggio, dei tour o...",0,0,2,0,2,2021
SAR,SS,N 80,Servizi di vigilanza e investigazione                       ,0,0,1,0,1,2021
SAR,SS,N 81,Attività di servizi per edifici e paesaggio                 ,0,0,18,1,19,2021
SAR,SS,N 82,Attività di supporto per le funzioni d'ufficio e altri se...,0,0,4,1,5,2021
SAR,SS,O   ,Amministrazione pubblica e difesa; assicurazione sociale ...,0,0,0,0,0,2021
SAR,SS,O 84,Amministrazione pubblica e difesa; assicurazione sociale ...,0,0,0,0,0,2021
SAR,SS,P   ,Istruzione                                                  ,0,0,1,0,1,2021
SAR,SS,P 85,Istruzione                                                  ,0,0,1,0,1,2021
SAR,SS,Q   ,Sanita' e assistenza sociale                                ,0,0,0,0,0,2021
SAR,SS,Q 86,Assistenza sanitaria                                        ,0,0,0,0,0,2021
SAR,SS,Q 87,Servizi di assistenza sociale residenziale                  ,0,0,0,0,0,2021
SAR,SS,Q 88,Assistenza sociale non residenziale                         ,0,0,0,0,0,2021
SAR,SS,R   ,"Attività artistiche, sportive, di intrattenimento e diver...",0,0,9,0,9,2021
SAR,SS,R 90,"Attività creative, artistiche e di intrattenimento          ",0,0,2,0,2,2021
SAR,SS,R 91,"Attività di biblioteche, archivi, musei ed altre attività...",0,0,0,0,0,2021
SAR,SS,R 92,"Attività riguardanti le lotterie, le scommesse, le case d...",0,0,0,0,0,2021
SAR,SS,R 93,"Attività sportive, di intrattenimento e di divertimento     ",0,0,7,0,7,2021
SAR,SS,S   ,Altre attività di servizi                                   ,0,0,38,0,38,2021
SAR,SS,S 94,Attività di organizzazioni associative                      ,0,0,0,0,0,2021
SAR,SS,S 95,Riparazione di computer e di beni per uso personale e per...,0,0,15,0,15,2021
SAR,SS,S 96,Altre attività di servizi per la persona                    ,0,0,23,0,23,2021
SAR,SS,T   ,Attività di famiglie e convivenze come datori di lavoro p...,0,0,0,0,0,2021
SAR,SS,T 97,Attività di famiglie e convivenze come datori di lavoro p...,0,0,0,0,0,2021
SAR,SS,T 98,Produzione di beni e servizi indifferenziati per uso prop...,0,0,0,0,0,2021
SAR,SS,U   ,Organizzazioni ed organismi extraterritoriali               ,0,0,0,0,0,2021
SAR,SS,U 99,Organizzazioni ed organismi extraterritoriali               ,0,0,0,0,0,2021
SAR,SS,XX  ,Imprese non classificate                                    ,0,0,34,9,43,2021
SAR,SS,TOT ,TOTALE                                                      ,0,0,1312,17,1329,2021
SAR,NU,A   ,"Agricoltura, silvicoltura pesca                             ",0,0,0,3,3,2021
SAR,NU,A 01,"Coltivazioni agricole e produzione di prodotti animali, c...",0,0,0,1,1,2021
SAR,NU,A 02,Silvicoltura ed utilizzo di aree forestali                  ,0,0,0,2,2,2021
SAR,NU,A 03,Pesca e acquacoltura                                        ,0,0,0,0,0,2021
SAR,NU,B   ,Estrazione di minerali da cave e miniere                    ,0,0,0,0,0,2021
SAR,NU,B 05,Estrazione di carbone (esclusa torba)                       ,0,0,0,0,0,2021
SAR,NU,B 06,Estraz.di petrolio greggio e di gas naturale                ,0,0,0,0,0,2021
SAR,NU,B 07,Estrazione di minerali metalliferi                          ,0,0,0,0,0,2021
SAR,NU,B 08,Altre attività di estrazione di minerali da cave e miniere  ,0,0,0,0,0,2021
SAR,NU,B 09,Attività dei servizi di supporto all'estrazione             ,0,0,0,0,0,2021
SAR,NU,C   ,Attività manifatturiere                                     ,0,0,0,0,0,2021
SAR,NU,C 10,Industrie alimentari                                        ,0,0,0,0,0,2021
SAR,NU,C 11,Industria delle bevande                                     ,0,0,0,0,0,2021
SAR,NU,C 12,Industria del tabacco                                       ,0,0,0,0,0,2021
SAR,NU,C 13,Industrie tessili                                           ,0,0,0,0,0,2021
SAR,NU,C 14,Confezione di articoli di abbigliamento; confezione di ar...,0,0,0,0,0,2021
SAR,NU,C 15,Fabbricazione di articoli in pelle e simili                 ,0,0,0,0,0,2021
SAR,NU,C 16,Industria del legno e dei prodotti in legno e sughero (es...,0,0,0,0,0,2021
SAR,NU,C 17,Fabbricazione di carta e di prodotti di carta               ,0,0,0,0,0,2021
SAR,NU,C 18,Stampa e riproduzione di supporti registrati                ,0,0,0,0,0,2021
SAR,NU,C 19,Fabbricazione di coke e prodotti derivanti dalla raffinaz...,0,0,0,0,0,2021
SAR,NU,C 20,Fabbricazione di prodotti chimici                           ,0,0,0,0,0,2021
SAR,NU,C 21,Fabbricazione di prodotti farmaceutici di base e di prepa...,0,0,0,0,0,2021
SAR,NU,C 22,Fabbricazione di articoli in gomma e materie plastiche      ,0,0,0,0,0,2021
SAR,NU,C 23,Fabbricazione di altri prodotti della lavorazione di miner..,0,0,0,0,0,2021
SAR,NU,C 24,Metallurgia                                                 ,0,0,0,0,0,2021
SAR,NU,C 25,Fabbricazione di prodotti in metallo (esclusi macchinari ...,0,0,0,0,0,2021
SAR,NU,C 26,Fabbricazione di computer e prodotti di elettronica e ott...,0,0,0,0,0,2021
SAR,NU,C 27,Fabbricazione di apparecchiature elettriche ed apparecchi...,0,0,0,0,0,2021
SAR,NU,C 28,Fabbricazione di macchinari ed apparecchiature nca          ,0,0,0,0,0,2021
SAR,NU,C 29,"Fabbricazione di autoveicoli, rimorchi e semirimorchi       ",0,0,0,0,0,2021
SAR,NU,C 30,Fabbricazione di altri mezzi di trasporto                   ,0,0,0,0,0,2021
SAR,NU,C 31,Fabbricazione di mobili                                     ,0,0,0,0,0,2021
SAR,NU,C 32,Altre industrie manifatturiere                              ,0,0,0,0,0,2021
SAR,NU,C 33,"Riparazione, manutenzione ed installazione di macchine ed...",0,0,0,0,0,2021
SAR,NU,D   ,"Fornitura di energia elettrica, gas, vapore e aria condiz...",0,0,0,0,0,2021
SAR,NU,D 35,"Fornitura di energia elettrica, gas, vapore e aria condiz...",0,0,0,0,0,2021
SAR,NU,E   ,"Fornitura di acqua; reti fognarie, attività di gestione d...",0,0,0,0,0,2021
SAR,NU,E 36,"Raccolta, trattamento e fornitura di acqua                  ",0,0,0,0,0,2021
SAR,NU,E 37,Gestione delle reti fognarie                                ,0,0,0,0,0,2021
SAR,NU,E 38,"Attività di raccolta, trattamento e smaltimento dei rifiu...",0,0,0,0,0,2021
SAR,NU,E 39,Attività di risanamento e altri servizi di gestione dei r...,0,0,0,0,0,2021
SAR,NU,F   ,Costruzioni                                                 ,0,0,0,1,1,2021
SAR,NU,F 41,Costruzione di edifici                                      ,0,0,0,1,1,2021
SAR,NU,F 42,Ingegneria civile                                           ,0,0,0,0,0,2021
SAR,NU,F 43,Lavori di costruzione specializzati                         ,0,0,0,0,0,2021
SAR,NU,G   ,Commercio all'ingrosso e al dettaglio; riparazione di aut...,0,0,0,0,0,2021
SAR,NU,G 45,Commercio all'ingrosso e al dettaglio e riparazione di au...,0,0,0,0,0,2021
SAR,NU,G 46,Commercio all'ingrosso (escluso quello di autoveicoli e d...,0,0,0,0,0,2021
SAR,NU,G 47,Commercio al dettaglio (escluso quello di autoveicoli e d...,0,0,0,0,0,2021
SAR,NU,H   ,Trasporto e magazzinaggio                                   ,0,0,0,0,0,2021
SAR,NU,H 49,Trasporto terrestre e mediante condotte                     ,0,0,0,0,0,2021
SAR,NU,H 50,Trasporto marittimo e per vie d'acqua                       ,0,0,0,0,0,2021
SAR,NU,H 51,Trasporto aereo                                             ,0,0,0,0,0,2021
SAR,NU,H 52,Magazzinaggio e attività di supporto ai trasporti           ,0,0,0,0,0,2021
SAR,NU,H 53,Servizi postali e attività di corriere                      ,0,0,0,0,0,2021
SAR,NU,I   ,Attività dei servizi alloggio e ristorazione                ,0,0,0,2,2,2021
SAR,NU,I 55,Alloggio                                                    ,0,0,0,0,0,2021
SAR,NU,I 56,Attività dei servizi di ristorazione                        ,0,0,0,2,2,2021
SAR,NU,J   ,Servizi di informazione e comunicazione                     ,0,0,0,0,0,2021
SAR,NU,J 58,Attività editoriali                                         ,0,0,0,0,0,2021
SAR,NU,J 59,"Attività di produzione cinematografica, di video e di pro...",0,0,0,0,0,2021
SAR,NU,J 60,Attività di programmazione e trasmissione                   ,0,0,0,0,0,2021
SAR,NU,J 61,Telecomunicazioni                                           ,0,0,0,0,0,2021
SAR,NU,J 62,"Produzione di software, consulenza informatica e attività...",0,0,0,0,0,2021
SAR,NU,J 63,Attività dei servizi d'informazione e altri servizi infor...,0,0,0,0,0,2021
SAR,NU,K   ,Attività finanziarie e assicurative                         ,0,0,0,0,0,2021
SAR,NU,K 64,Attività di servizi finanziari (escluse le assicurazioni ...,0,0,0,0,0,2021
SAR,NU,K 65,"Assicurazioni, riassicurazioni e fondi pensione (escluse ...",0,0,0,0,0,2021
SAR,NU,K 66,Attività ausiliarie dei servizi finanziari e delle attivi...,0,0,0,0,0,2021
SAR,NU,L   ,Attivita' immobiliari                                       ,0,0,0,0,0,2021
SAR,NU,L 68,Attivita' immobiliari                                       ,0,0,0,0,0,2021
SAR,NU,M   ,"Attività professionali, scientifiche e tecniche             ",0,0,0,0,0,2021
SAR,NU,M 69,Attività legali e contabilità                               ,0,0,0,0,0,2021
SAR,NU,M 70,Attività di direzione aziendale e di consulenza gestional...,0,0,0,0,0,2021
SAR,NU,M 71,Attività degli studi di architettura e d'ingegneria; coll...,0,0,0,0,0,2021
SAR,NU,M 72,Ricerca scientifica e sviluppo                              ,0,0,0,0,0,2021
SAR,NU,M 73,Pubblicità e ricerche di mercato                            ,0,0,0,0,0,2021
SAR,NU,M 74,"Altre attività professionali, scientifiche e tecniche       ",0,0,0,0,0,2021
SAR,NU,M 75,Servizi veterinari                                          ,0,0,0,0,0,2021
SAR,NU,N   ,"Noleggio, agenzie di viaggio, servizi di supporto alle im...",0,0,0,3,3,2021
SAR,NU,N 77,Attività di noleggio e leasing operativo                    ,0,0,0,0,0,2021
SAR,NU,N 78,"Attività di ricerca, selezione, fornitura di personale      ",0,0,0,0,0,2021
SAR,NU,N 79,"Attività dei servizi delle agenzie di viaggio, dei tour o...",0,0,0,0,0,2021
SAR,NU,N 80,Servizi di vigilanza e investigazione                       ,0,0,0,0,0,2021
SAR,NU,N 81,Attività di servizi per edifici e paesaggio                 ,0,0,0,3,3,2021
SAR,NU,N 82,Attività di supporto per le funzioni d'ufficio e altri se...,0,0,0,0,0,2021
SAR,NU,O   ,Amministrazione pubblica e difesa; assicurazione sociale ...,0,0,0,0,0,2021
SAR,NU,O 84,Amministrazione pubblica e difesa; assicurazione sociale ...,0,0,0,0,0,2021
SAR,NU,P   ,Istruzione                                                  ,0,0,0,0,0,2021
SAR,NU,P 85,Istruzione                                                  ,0,0,0,0,0,2021
SAR,NU,Q   ,Sanita' e assistenza sociale                                ,0,0,0,0,0,2021
SAR,NU,Q 86,Assistenza sanitaria                                        ,0,0,0,0,0,2021
SAR,NU,Q 87,Servizi di assistenza sociale residenziale                  ,0,0,0,0,0,2021
SAR,NU,Q 88,Assistenza sociale non residenziale                         ,0,0,0,0,0,2021
SAR,NU,R   ,"Attività artistiche, sportive, di intrattenimento e diver...",0,0,0,0,0,2021
SAR,NU,R 90,"Attività creative, artistiche e di intrattenimento          ",0,0,0,0,0,2021
SAR,NU,R 91,"Attività di biblioteche, archivi, musei ed altre attività...",0,0,0,0,0,2021
SAR,NU,R 92,"Attività riguardanti le lotterie, le scommesse, le case d...",0,0,0,0,0,2021
SAR,NU,R 93,"Attività sportive, di intrattenimento e di divertimento     ",0,0,0,0,0,2021
SAR,NU,S   ,Altre attività di servizi                                   ,0,0,0,0,0,2021
SAR,NU,S 94,Attività di organizzazioni associative                      ,0,0,0,0,0,2021
SAR,NU,S 95,Riparazione di computer e di beni per uso personale e per...,0,0,0,0,0,2021
SAR,NU,S 96,Altre attività di servizi per la persona                    ,0,0,0,0,0,2021
SAR,NU,T   ,Attività di famiglie e convivenze come datori di lavoro p...,0,0,0,0,0,2021
SAR,NU,T 97,Attività di famiglie e convivenze come datori di lavoro p...,0,0,0,0,0,2021
SAR,NU,T 98,Produzione di beni e servizi indifferenziati per uso prop...,0,0,0,0,0,2021
SAR,NU,U   ,Organizzazioni ed organismi extraterritoriali               ,0,0,0,0,0,2021
SAR,NU,U 99,Organizzazioni ed organismi extraterritoriali               ,0,0,0,0,0,2021
SAR,NU,XX  ,Imprese non classificate                                    ,0,0,0,2,2,2021
SAR,NU,TOT ,TOTALE                                                      ,0,0,0,11,11,2021
SAR,CA,A   ,"Agricoltura, silvicoltura pesca                             ",0,0,148,1,149,2021
SAR,CA,A 01,"Coltivazioni agricole e produzione di prodotti animali, c...",0,0,146,1,147,2021
SAR,CA,A 02,Silvicoltura ed utilizzo di aree forestali                  ,0,0,0,0,0,2021
SAR,CA,A 03,Pesca e acquacoltura                                        ,0,0,2,0,2,2021
SAR,CA,B   ,Estrazione di minerali da cave e miniere                    ,0,0,0,0,0,2021
SAR,CA,B 05,Estrazione di carbone (esclusa torba)                       ,0,0,0,0,0,2021
SAR,CA,B 06,Estraz.di petrolio greggio e di gas naturale                ,0,0,0,0,0,2021
SAR,CA,B 07,Estrazione di minerali metalliferi                          ,0,0,0,0,0,2021
SAR,CA,B 08,Altre attività di estrazione di minerali da cave e miniere  ,0,0,0,0,0,2021
SAR,CA,B 09,Attività dei servizi di supporto all'estrazione             ,0,0,0,0,0,2021
SAR,CA,C   ,Attività manifatturiere                                     ,0,0,42,0,42,2021
SAR,CA,C 10,Industrie alimentari                                        ,0,0,4,0,4,2021
SAR,CA,C 11,Industria delle bevande                                     ,0,0,0,0,0,2021
SAR,CA,C 12,Industria del tabacco                                       ,0,0,0,0,0,2021
SAR,CA,C 13,Industrie tessili                                           ,0,0,0,0,0,2021
SAR,CA,C 14,Confezione di articoli di abbigliamento; confezione di ar...,0,0,1,0,1,2021
SAR,CA,C 15,Fabbricazione di articoli in pelle e simili                 ,0,0,3,0,3,2021
SAR,CA,C 16,Industria del legno e dei prodotti in legno e sughero (es...,0,0,10,0,10,2021
SAR,CA,C 17,Fabbricazione di carta e di prodotti di carta               ,0,0,0,0,0,2021
SAR,CA,C 18,Stampa e riproduzione di supporti registrati                ,0,0,1,0,1,2021
SAR,CA,C 19,Fabbricazione di coke e prodotti derivanti dalla raffinaz...,0,0,0,0,0,2021
SAR,CA,C 20,Fabbricazione di prodotti chimici                           ,0,0,0,0,0,2021
SAR,CA,C 21,Fabbricazione di prodotti farmaceutici di base e di prepa...,0,0,0,0,0,2021
SAR,CA,C 22,Fabbricazione di articoli in gomma e materie plastiche      ,0,0,0,0,0,2021
SAR,CA,C 23,Fabbricazione di altri prodotti della lavorazione di miner..,0,0,3,0,3,2021
SAR,CA,C 24,Metallurgia                                                 ,0,0,1,0,1,2021
SAR,CA,C 25,Fabbricazione di prodotti in metallo (esclusi macchinari ...,0,0,9,0,9,2021
SAR,CA,C 26,Fabbricazione di computer e prodotti di elettronica e ott...,0,0,2,0,2,2021
SAR,CA,C 27,Fabbricazione di apparecchiature elettriche ed apparecchi...,0,0,1,0,1,2021
SAR,CA,C 28,Fabbricazione di macchinari ed apparecchiature nca          ,0,0,0,0,0,2021
SAR,CA,C 29,"Fabbricazione di autoveicoli, rimorchi e semirimorchi       ",0,0,0,0,0,2021
SAR,CA,C 30,Fabbricazione di altri mezzi di trasporto                   ,0,0,2,0,2,2021
SAR,CA,C 31,Fabbricazione di mobili                                     ,0,0,0,0,0,2021
SAR,CA,C 32,Altre industrie manifatturiere                              ,0,0,2,0,2,2021
SAR,CA,C 33,"Riparazione, manutenzione ed installazione di macchine ed...",0,0,3,0,3,2021
SAR,CA,D   ,"Fornitura di energia elettrica, gas, vapore e aria condiz...",0,0,0,0,0,2021
SAR,CA,D 35,"Fornitura di energia elettrica, gas, vapore e aria condiz...",0,0,0,0,0,2021
SAR,CA,E   ,"Fornitura di acqua; reti fognarie, attività di gestione d...",0,0,1,0,1,2021
SAR,CA,E 36,"Raccolta, trattamento e fornitura di acqua                  ",0,0,0,0,0,2021
SAR,CA,E 37,Gestione delle reti fognarie                                ,0,0,0,0,0,2021
SAR,CA,E 38,"Attività di raccolta, trattamento e smaltimento dei rifiu...",0,0,1,0,1,2021
SAR,CA,E 39,Attività di risanamento e altri servizi di gestione dei r...,0,0,0,0,0,2021
SAR,CA,F   ,Costruzioni                                                 ,0,0,57,1,58,2021
SAR,CA,F 41,Costruzione di edifici                                      ,0,0,28,0,28,2021
SAR,CA,F 42,Ingegneria civile                                           ,0,0,0,0,0,2021
SAR,CA,F 43,Lavori di costruzione specializzati                         ,0,0,29,1,30,2021
SAR,CA,G   ,Commercio all'ingrosso e al dettaglio; riparazione di aut...,0,0,221,2,223,2021
SAR,CA,G 45,Commercio all'ingrosso e al dettaglio e riparazione di au...,0,0,9,0,9,2021
SAR,CA,G 46,Commercio all'ingrosso (escluso quello di autoveicoli e d...,0,0,39,0,39,2021
SAR,CA,G 47,Commercio al dettaglio (escluso quello di autoveicoli e d...,0,0,173,2,175,2021
SAR,CA,H   ,Trasporto e magazzinaggio                                   ,0,0,17,2,19,2021
SAR,CA,H 49,Trasporto terrestre e mediante condotte                     ,0,0,16,1,17,2021
SAR,CA,H 50,Trasporto marittimo e per vie d'acqua                       ,0,0,0,0,0,2021
SAR,CA,H 51,Trasporto aereo                                             ,0,0,0,0,0,2021
SAR,CA,H 52,Magazzinaggio e attività di supporto ai trasporti           ,0,0,0,0,0,2021
SAR,CA,H 53,Servizi postali e attività di corriere                      ,0,0,1,1,2,2021
SAR,CA,I   ,Attività dei servizi alloggio e ristorazione                ,0,0,31,1,32,2021
SAR,CA,I 55,Alloggio                                                    ,0,0,0,0,0,2021
SAR,CA,I 56,Attività dei servizi di ristorazione                        ,0,0,31,1,32,2021
SAR,CA,J   ,Servizi di informazione e comunicazione                     ,0,0,8,1,9,2021
SAR,CA,J 58,Attività editoriali                                         ,0,0,1,0,1,2021
SAR,CA,J 59,"Attività di produzione cinematografica, di video e di pro...",0,0,0,0,0,2021
SAR,CA,J 60,Attività di programmazione e trasmissione                   ,0,0,0,0,0,2021
SAR,CA,J 61,Telecomunicazioni                                           ,0,0,0,0,0,2021
SAR,CA,J 62,"Produzione di software, consulenza informatica e attività...",0,0,2,0,2,2021
SAR,CA,J 63,Attività dei servizi d'informazione e altri servizi infor...,0,0,5,1,6,2021
SAR,CA,K   ,Attività finanziarie e assicurative                         ,0,0,9,0,9,2021
SAR,CA,K 64,Attività di servizi finanziari (escluse le assicurazioni ...,0,0,0,0,0,2021
SAR,CA,K 65,"Assicurazioni, riassicurazioni e fondi pensione (escluse ...",0,0,0,0,0,2021
SAR,CA,K 66,Attività ausiliarie dei servizi finanziari e delle attivi...,0,0,9,0,9,2021
SAR,CA,L   ,Attivita' immobiliari                                       ,0,0,1,0,1,2021
SAR,CA,L 68,Attivita' immobiliari                                       ,0,0,1,0,1,2021
SAR,CA,M   ,"Attività professionali, scientifiche e tecniche             ",0,0,7,0,7,2021
SAR,CA,M 69,Attività legali e contabilità                               ,0,0,0,0,0,2021
SAR,CA,M 70,Attività di direzione aziendale e di consulenza gestional...,0,0,0,0,0,2021
SAR,CA,M 71,Attività degli studi di architettura e d'ingegneria; coll...,0,0,0,0,0,2021
SAR,CA,M 72,Ricerca scientifica e sviluppo                              ,0,0,0,0,0,2021
SAR,CA,M 73,Pubblicità e ricerche di mercato                            ,0,0,2,0,2,2021
SAR,CA,M 74,"Altre attività professionali, scientifiche e tecniche       ",0,0,5,0,5,2021
SAR,CA,M 75,Servizi veterinari                                          ,0,0,0,0,0,2021
SAR,CA,N   ,"Noleggio, agenzie di viaggio, servizi di supporto alle im...",0,0,28,2,30,2021
SAR,CA,N 77,Attività di noleggio e leasing operativo                    ,0,0,4,0,4,2021
SAR,CA,N 78,"Attività di ricerca, selezione, fornitura di personale      ",0,0,0,0,0,2021
SAR,CA,N 79,"Attività dei servizi delle agenzie di viaggio, dei tour o...",0,0,1,0,1,2021
SAR,CA,N 80,Servizi di vigilanza e investigazione                       ,0,0,0,0,0,2021
SAR,CA,N 81,Attività di servizi per edifici e paesaggio                 ,0,0,23,2,25,2021
SAR,CA,N 82,Attività di supporto per le funzioni d'ufficio e altri se...,0,0,0,0,0,2021
SAR,CA,O   ,Amministrazione pubblica e difesa; assicurazione sociale ...,0,0,0,0,0,2021
SAR,CA,O 84,Amministrazione pubblica e difesa; assicurazione sociale ...,0,0,0,0,0,2021
SAR,CA,P   ,Istruzione                                                  ,0,0,0,1,1,2021
SAR,CA,P 85,Istruzione                                                  ,0,0,0,1,1,2021
SAR,CA,Q   ,Sanita' e assistenza sociale                                ,0,0,1,2,3,2021
SAR,CA,Q 86,Assistenza sanitaria                                        ,0,0,1,1,2,2021
SAR,CA,Q 87,Servizi di assistenza sociale residenziale                  ,0,0,0,1,1,2021
SAR,CA,Q 88,Assistenza sociale non residenziale                         ,0,0,0,0,0,2021
SAR,CA,R   ,"Attività artistiche, sportive, di intrattenimento e diver...",0,0,4,0,4,2021
SAR,CA,R 90,"Attività creative, artistiche e di intrattenimento          ",0,0,1,0,1,2021
SAR,CA,R 91,"Attività di biblioteche, archivi, musei ed altre attività...",0,0,0,0,0,2021
SAR,CA,R 92,"Attività riguardanti le lotterie, le scommesse, le case d...",0,0,1,0,1,2021
SAR,CA,R 93,"Attività sportive, di intrattenimento e di divertimento     ",0,0,2,0,2,2021
SAR,CA,S   ,Altre attività di servizi                                   ,0,0,7,0,7,2021
SAR,CA,S 94,Attività di organizzazioni associative                      ,0,0,0,0,0,2021
SAR,CA,S 95,Riparazione di computer e di beni per uso personale e per...,0,0,5,0,5,2021
SAR,CA,S 96,Altre attività di servizi per la persona                    ,0,0,2,0,2,2021
SAR,CA,T   ,Attività di famiglie e convivenze come datori di lavoro p...,0,0,0,0,0,2021
SAR,CA,T 97,Attività di famiglie e convivenze come datori di lavoro p...,0,0,0,0,0,2021
SAR,CA,T 98,Produzione di beni e servizi indifferenziati per uso prop...,0,0,0,0,0,2021
SAR,CA,U   ,Organizzazioni ed organismi extraterritoriali               ,0,0,0,0,0,2021
SAR,CA,U 99,Organizzazioni ed organismi extraterritoriali               ,0,0,0,0,0,2021
SAR,CA,XX  ,Imprese non classificate                                    ,0,0,0,11,11,2021
SAR,CA,TOT ,TOTALE                                                      ,0,0,582,24,606,2021
SAR,OR,A   ,"Agricoltura, silvicoltura pesca                             ",0,0,0,0,0,2021
SAR,OR,A 01,"Coltivazioni agricole e produzione di prodotti animali, c...",0,0,0,0,0,2021
SAR,OR,A 02,Silvicoltura ed utilizzo di aree forestali                  ,0,0,0,0,0,2021
SAR,OR,A 03,Pesca e acquacoltura                                        ,0,0,0,0,0,2021
SAR,OR,B   ,Estrazione di minerali da cave e miniere                    ,0,0,0,0,0,2021
SAR,OR,B 05,Estrazione di carbone (esclusa torba)                       ,0,0,0,0,0,2021
SAR,OR,B 06,Estraz.di petrolio greggio e di gas naturale                ,0,0,0,0,0,2021
SAR,OR,B 07,Estrazione di minerali metalliferi                          ,0,0,0,0,0,2021
SAR,OR,B 08,Altre attività di estrazione di minerali da cave e miniere  ,0,0,0,0,0,2021
SAR,OR,B 09,Attività dei servizi di supporto all'estrazione             ,0,0,0,0,0,2021
SAR,OR,C   ,Attività manifatturiere                                     ,0,0,0,0,0,2021
SAR,OR,C 10,Industrie alimentari                                        ,0,0,0,0,0,2021
SAR,OR,C 11,Industria delle bevande                                     ,0,0,0,0,0,2021
SAR,OR,C 12,Industria del tabacco                                       ,0,0,0,0,0,2021
SAR,OR,C 13,Industrie tessili                                           ,0,0,0,0,0,2021
SAR,OR,C 14,Confezione di articoli di abbigliamento; confezione di ar...,0,0,0,0,0,2021
SAR,OR,C 15,Fabbricazione di articoli in pelle e simili                 ,0,0,0,0,0,2021
SAR,OR,C 16,Industria del legno e dei prodotti in legno e sughero (es...,0,0,0,0,0,2021
SAR,OR,C 17,Fabbricazione di carta e di prodotti di carta               ,0,0,0,0,0,2021
SAR,OR,C 18,Stampa e riproduzione di supporti registrati                ,0,0,0,0,0,2021
SAR,OR,C 19,Fabbricazione di coke e prodotti derivanti dalla raffinaz...,0,0,0,0,0,2021
SAR,OR,C 20,Fabbricazione di prodotti chimici                           ,0,0,0,0,0,2021
SAR,OR,C 21,Fabbricazione di prodotti farmaceutici di base e di prepa...,0,0,0,0,0,2021
SAR,OR,C 22,Fabbricazione di articoli in gomma e materie plastiche      ,0,0,0,0,0,2021
SAR,OR,C 23,Fabbricazione di altri prodotti della lavorazione di miner..,0,0,0,0,0,2021
SAR,OR,C 24,Metallurgia                                                 ,0,0,0,0,0,2021
SAR,OR,C 25,Fabbricazione di prodotti in metallo (esclusi macchinari ...,0,0,0,0,0,2021
SAR,OR,C 26,Fabbricazione di computer e prodotti di elettronica e ott...,0,0,0,0,0,2021
SAR,OR,C 27,Fabbricazione di apparecchiature elettriche ed apparecchi...,0,0,0,0,0,2021
SAR,OR,C 28,Fabbricazione di macchinari ed apparecchiature nca          ,0,0,0,0,0,2021
SAR,OR,C 29,"Fabbricazione di autoveicoli, rimorchi e semirimorchi       ",0,0,0,0,0,2021
SAR,OR,C 30,Fabbricazione di altri mezzi di trasporto                   ,0,0,0,0,0,2021
SAR,OR,C 31,Fabbricazione di mobili                                     ,0,0,0,0,0,2021
SAR,OR,C 32,Altre industrie manifatturiere                              ,0,0,0,0,0,2021
SAR,OR,C 33,"Riparazione, manutenzione ed installazione di macchine ed...",0,0,0,0,0,2021
SAR,OR,D   ,"Fornitura di energia elettrica, gas, vapore e aria condiz...",0,0,0,0,0,2021
SAR,OR,D 35,"Fornitura di energia elettrica, gas, vapore e aria condiz...",0,0,0,0,0,2021
SAR,OR,E   ,"Fornitura di acqua; reti fognarie, attività di gestione d...",0,0,0,0,0,2021
SAR,OR,E 36,"Raccolta, trattamento e fornitura di acqua                  ",0,0,0,0,0,2021
SAR,OR,E 37,Gestione delle reti fognarie                                ,0,0,0,0,0,2021
SAR,OR,E 38,"Attività di raccolta, trattamento e smaltimento dei rifiu...",0,0,0,0,0,2021
SAR,OR,E 39,Attività di risanamento e altri servizi di gestione dei r...,0,0,0,0,0,2021
SAR,OR,F   ,Costruzioni                                                 ,0,0,0,0,0,2021
SAR,OR,F 41,Costruzione di edifici                                      ,0,0,0,0,0,2021
SAR,OR,F 42,Ingegneria civile                                           ,0,0,0,0,0,2021
SAR,OR,F 43,Lavori di costruzione specializzati                         ,0,0,0,0,0,2021
SAR,OR,G   ,Commercio all'ingrosso e al dettaglio; riparazione di aut...,0,0,0,0,0,2021
SAR,OR,G 45,Commercio all'ingrosso e al dettaglio e riparazione di au...,0,0,0,0,0,2021
SAR,OR,G 46,Commercio all'ingrosso (escluso quello di autoveicoli e d...,0,0,0,0,0,2021
SAR,OR,G 47,Commercio al dettaglio (escluso quello di autoveicoli e d...,0,0,0,0,0,2021
SAR,OR,H   ,Trasporto e magazzinaggio                                   ,0,0,0,0,0,2021
SAR,OR,H 49,Trasporto terrestre e mediante condotte                     ,0,0,0,0,0,2021
SAR,OR,H 50,Trasporto marittimo e per vie d'acqua                       ,0,0,0,0,0,2021
SAR,OR,H 51,Trasporto aereo                                             ,0,0,0,0,0,2021
SAR,OR,H 52,Magazzinaggio e attività di supporto ai trasporti           ,0,0,0,0,0,2021
SAR,OR,H 53,Servizi postali e attività di corriere                      ,0,0,0,0,0,2021
SAR,OR,I   ,Attività dei servizi alloggio e ristorazione                ,0,0,0,0,0,2021
SAR,OR,I 55,Alloggio                                                    ,0,0,0,0,0,2021
SAR,OR,I 56,Attività dei servizi di ristorazione                        ,0,0,0,0,0,2021
SAR,OR,J   ,Servizi di informazione e comunicazione                     ,0,0,0,0,0,2021
SAR,OR,J 58,Attività editoriali                                         ,0,0,0,0,0,2021
SAR,OR,J 59,"Attività di produzione cinematografica, di video e di pro...",0,0,0,0,0,2021
SAR,OR,J 60,Attività di programmazione e trasmissione                   ,0,0,0,0,0,2021
SAR,OR,J 61,Telecomunicazioni                                           ,0,0,0,0,0,2021
SAR,OR,J 62,"Produzione di software, consulenza informatica e attività...",0,0,0,0,0,2021
SAR,OR,J 63,Attività dei servizi d'informazione e altri servizi infor...,0,0,0,0,0,2021
SAR,OR,K   ,Attività finanziarie e assicurative                         ,0,0,0,0,0,2021
SAR,OR,K 64,Attività di servizi finanziari (escluse le assicurazioni ...,0,0,0,0,0,2021
SAR,OR,K 65,"Assicurazioni, riassicurazioni e fondi pensione (escluse ...",0,0,0,0,0,2021
SAR,OR,K 66,Attività ausiliarie dei servizi finanziari e delle attivi...,0,0,0,0,0,2021
SAR,OR,L   ,Attivita' immobiliari                                       ,0,0,0,0,0,2021
SAR,OR,L 68,Attivita' immobiliari                                       ,0,0,0,0,0,2021
SAR,OR,M   ,"Attività professionali, scientifiche e tecniche             ",0,0,0,0,0,2021
SAR,OR,M 69,Attività legali e contabilità                               ,0,0,0,0,0,2021
SAR,OR,M 70,Attività di direzione aziendale e di consulenza gestional...,0,0,0,0,0,2021
SAR,OR,M 71,Attività degli studi di architettura e d'ingegneria; coll...,0,0,0,0,0,2021
SAR,OR,M 72,Ricerca scientifica e sviluppo                              ,0,0,0,0,0,2021
SAR,OR,M 73,Pubblicità e ricerche di mercato                            ,0,0,0,0,0,2021
SAR,OR,M 74,"Altre attività professionali, scientifiche e tecniche       ",0,0,0,0,0,2021
SAR,OR,M 75,Servizi veterinari                                          ,0,0,0,0,0,2021
SAR,OR,N   ,"Noleggio, agenzie di viaggio, servizi di supporto alle im...",0,0,0,0,0,2021
SAR,OR,N 77,Attività di noleggio e leasing operativo                    ,0,0,0,0,0,2021
SAR,OR,N 78,"Attività di ricerca, selezione, fornitura di personale      ",0,0,0,0,0,2021
SAR,OR,N 79,"Attività dei servizi delle agenzie di viaggio, dei tour o...",0,0,0,0,0,2021
SAR,OR,N 80,Servizi di vigilanza e investigazione                       ,0,0,0,0,0,2021
SAR,OR,N 81,Attività di servizi per edifici e paesaggio                 ,0,0,0,0,0,2021
SAR,OR,N 82,Attività di supporto per le funzioni d'ufficio e altri se...,0,0,0,0,0,2021
SAR,OR,O   ,Amministrazione pubblica e difesa; assicurazione sociale ...,0,0,0,0,0,2021
SAR,OR,O 84,Amministrazione pubblica e difesa; assicurazione sociale ...,0,0,0,0,0,2021
SAR,OR,P   ,Istruzione                                                  ,0,0,0,0,0,2021
SAR,OR,P 85,Istruzione                                                  ,0,0,0,0,0,2021
SAR,OR,Q   ,Sanita' e assistenza sociale                                ,0,0,0,2,2,2021
SAR,OR,Q 86,Assistenza sanitaria                                        ,0,0,0,0,0,2021
SAR,OR,Q 87,Servizi di assistenza sociale residenziale                  ,0,0,0,0,0,2021
SAR,OR,Q 88,Assistenza sociale non residenziale                         ,0,0,0,2,2,2021
SAR,OR,R   ,"Attività artistiche, sportive, di intrattenimento e diver...",0,0,0,0,0,2021
SAR,OR,R 90,"Attività creative, artistiche e di intrattenimento          ",0,0,0,0,0,2021
SAR,OR,R 91,"Attività di biblioteche, archivi, musei ed altre attività...",0,0,0,0,0,2021
SAR,OR,R 92,"Attività riguardanti le lotterie, le scommesse, le case d...",0,0,0,0,0,2021
SAR,OR,R 93,"Attività sportive, di intrattenimento e di divertimento     ",0,0,0,0,0,2021
SAR,OR,S   ,Altre attività di servizi                                   ,0,0,0,0,0,2021
SAR,OR,S 94,Attività di organizzazioni associative                      ,0,0,0,0,0,2021
SAR,OR,S 95,Riparazione di computer e di beni per uso personale e per...,0,0,0,0,0,2021
SAR,OR,S 96,Altre attività di servizi per la persona                    ,0,0,0,0,0,2021
SAR,OR,T   ,Attività di famiglie e convivenze come datori di lavoro p...,0,0,0,0,0,2021
SAR,OR,T 97,Attività di famiglie e convivenze come datori di lavoro p...,0,0,0,0,0,2021
SAR,OR,T 98,Produzione di beni e servizi indifferenziati per uso prop...,0,0,0,0,0,2021
SAR,OR,U   ,Organizzazioni ed organismi extraterritoriali               ,0,0,0,0,0,2021
SAR,OR,U 99,Organizzazioni ed organismi extraterritoriali               ,0,0,0,0,0,2021
SAR,OR,XX  ,Imprese non classificate                                    ,0,0,0,5,5,2021
SAR,OR,TOT ,TOTALE                                                      ,0,0,0,7,7,2021
